Country/Region,Date,Confirmed,Deaths,Recovered,Active,WHO Region
Afghanistan,22-01-2020,108933,705,699,108234,Eastern Mediterranean
Albania,22-01-2020,392235,354,856,391379,Europe
Algeria,22-01-2020,192063,1554,193,191870,Africa
Andorra,22-01-2020,386023,1659,837,385186,Europe
Angola,22-01-2020,44910,1304,502,44408,Africa
Antigua and Barbuda,22-01-2020,366212,543,1001,365211,Americas
Argentina,22-01-2020,370610,114,974,369636,Americas
Armenia,22-01-2020,398015,2244,270,397745,Europe
Australia,22-01-2020,447241,2404,335,446906,Western Pacific
Australia,22-01-2020,123012,813,964,122048,Western Pacific
Australia,22-01-2020,81212,1501,5,81207,Western Pacific
Australia,22-01-2020,96091,635,874,95217,Western Pacific
Australia,22-01-2020,272864,1689,1164,271700,Western Pacific
Australia,22-01-2020,163147,757,139,163008,Western Pacific
Australia,22-01-2020,163869,1353,396,163473,Western Pacific
Australia,22-01-2020,397687,274,163,397524,Western Pacific
Austria,22-01-2020,187556,318,1019,186537,Europe
Azerbaijan,22-01-2020,110292,151,667,109625,Europe
Bahamas,22-01-2020,388119,1006,231,387888,Americas
Bahrain,22-01-2020,367737,2171,597,367140,Eastern Mediterranean
Bangladesh,22-01-2020,386718,664,669,386049,South-East Asia
Barbados,22-01-2020,393562,794,59,393503,Americas
Belarus,22-01-2020,5809,2195,353,5456,Europe
Belgium,22-01-2020,76338,1199,1153,75185,Europe
Benin,22-01-2020,407044,81,804,406240,Africa
Bhutan,22-01-2020,231985,1315,1182,230803,South-East Asia
Bolivia,22-01-2020,201403,400,164,201239,Americas
Bosnia and Herzegovina,22-01-2020,255348,2015,489,254859,Europe
Brazil,22-01-2020,206398,964,1057,205341,Americas
Brunei,22-01-2020,185304,904,879,184425,Western Pacific
Bulgaria,22-01-2020,173049,388,255,172794,Europe
Burkina Faso,22-01-2020,330658,796,884,329774,Africa
Cabo Verde,22-01-2020,363409,404,644,362765,Africa
Cambodia,22-01-2020,245769,364,1169,244600,Western Pacific
Cameroon,22-01-2020,390869,1944,139,390730,Africa
Canada,22-01-2020,394911,2074,947,393964,Americas
Canada,22-01-2020,91067,2157,721,90346,Americas
Canada,22-01-2020,276187,1508,126,276061,Americas
Canada,22-01-2020,405823,1767,344,405479,Americas
Canada,22-01-2020,84990,1842,511,84479,Americas
Canada,22-01-2020,149591,532,205,149386,Americas
Canada,22-01-2020,127131,1209,1223,125908,Americas
Canada,22-01-2020,313911,1098,798,313113,Americas
Canada,22-01-2020,228420,1550,516,227904,Americas
Canada,22-01-2020,250054,1966,268,249786,Americas
Central African Republic,22-01-2020,49884,85,635,49249,Africa
Chad,22-01-2020,181337,908,451,180886,Africa
Chile,22-01-2020,242095,961,1045,241050,Americas
China,22-01-2020,377697,2021,1248,376449,Western Pacific
China,22-01-2020,249186,2212,526,248660,Western Pacific
China,22-01-2020,345757,825,744,345013,Western Pacific
China,22-01-2020,435474,520,1042,434432,Western Pacific
China,22-01-2020,436718,1940,728,435990,Western Pacific
China,22-01-2020,428744,332,1049,427695,Western Pacific
China,22-01-2020,253462,1717,22,253440,Western Pacific
China,22-01-2020,86237,692,216,86021,Western Pacific
China,22-01-2020,353191,1037,1193,351998,Western Pacific
China,22-01-2020,420676,434,341,420335,Western Pacific
China,22-01-2020,203469,492,477,202992,Western Pacific
China,22-01-2020,5934,539,326,5608,Western Pacific
China,22-01-2020,8585,1477,1060,7525,Western Pacific
China,22-01-2020,149093,429,642,148451,Western Pacific
China,22-01-2020,255255,1536,556,254699,Western Pacific
China,22-01-2020,216206,43,1210,214996,Western Pacific
China,22-01-2020,141237,1118,305,140932,Western Pacific
China,22-01-2020,401289,2211,400,400889,Western Pacific
China,22-01-2020,71961,668,260,71701,Western Pacific
China,22-01-2020,3361,716,674,2687,Western Pacific
China,22-01-2020,442107,1683,1054,441053,Western Pacific
China,22-01-2020,265535,308,684,264851,Western Pacific
China,22-01-2020,272295,471,1215,271080,Western Pacific
China,22-01-2020,17830,300,500,17330,Western Pacific
China,22-01-2020,237208,858,1092,236116,Western Pacific
China,22-01-2020,30058,2347,208,29850,Western Pacific
China,22-01-2020,250039,1942,750,249289,Western Pacific
China,22-01-2020,147769,1954,704,147065,Western Pacific
China,22-01-2020,374765,939,834,373931,Western Pacific
China,22-01-2020,60088,170,978,59110,Western Pacific
China,22-01-2020,86706,489,472,86234,Western Pacific
China,22-01-2020,447654,1227,794,446860,Western Pacific
China,22-01-2020,265022,2043,1133,263889,Western Pacific
Colombia,22-01-2020,363407,425,259,363148,Americas
Congo (Brazzaville),22-01-2020,357881,1628,232,357649,Africa
Congo (Kinshasa),22-01-2020,25984,1403,1144,24840,Africa
Costa Rica,22-01-2020,332868,1298,378,332490,Americas
Cote d'Ivoire,22-01-2020,208418,948,10,208408,Africa
Croatia,22-01-2020,25948,2428,954,24994,Europe
Cuba,22-01-2020,338183,2201,379,337804,Americas
Cyprus,22-01-2020,64975,1602,645,64330,Europe
Czechia,22-01-2020,408848,2044,1229,407619,Europe
Denmark,22-01-2020,248181,42,877,247304,Europe
Greenland,22-01-2020,327559,1423,310,327249,Europe
Denmark,22-01-2020,64985,1046,459,64526,Europe
Djibouti,22-01-2020,192659,584,455,192204,Eastern Mediterranean
Dominican Republic,22-01-2020,335554,1482,93,335461,Americas
Ecuador,22-01-2020,423240,584,841,422399,Americas
Egypt,22-01-2020,267514,938,572,266942,Eastern Mediterranean
El Salvador,22-01-2020,322539,1122,175,322364,Americas
Equatorial Guinea,22-01-2020,189953,250,342,189611,Africa
Eritrea,22-01-2020,419902,2426,1022,418880,Africa
Estonia,22-01-2020,201603,917,1119,200484,Europe
Eswatini,22-01-2020,37229,1459,610,36619,Africa
Ethiopia,22-01-2020,176286,2358,709,175577,Africa
Fiji,22-01-2020,433922,992,340,433582,Western Pacific
Finland,22-01-2020,98119,292,484,97635,Europe
France,22-01-2020,184878,55,594,184284,Europe
France,22-01-2020,62410,286,891,61519,Europe
France,22-01-2020,380700,869,1147,379553,Europe
France,22-01-2020,278924,2145,757,278167,Europe
France,22-01-2020,313770,123,269,313501,Europe
France,22-01-2020,176848,321,877,175971,Europe
France,22-01-2020,325233,1528,454,324779,Europe
France,22-01-2020,38863,2421,624,38239,Europe
France,22-01-2020,302317,1216,1034,301283,Europe
France,22-01-2020,97850,584,866,96984,Europe
Gabon,22-01-2020,299303,370,885,298418,Africa
Gambia,22-01-2020,163398,2368,1203,162195,Africa
Georgia,22-01-2020,199776,2294,543,199233,Europe
Germany,22-01-2020,161958,1373,547,161411,Europe
Ghana,22-01-2020,208680,1985,813,207867,Africa
Greece,22-01-2020,299666,2007,1062,298604,Europe
Guatemala,22-01-2020,249816,1219,540,249276,Americas
Guinea,22-01-2020,355437,1657,982,354455,Africa
Guyana,22-01-2020,6956,1335,477,6479,Americas
Haiti,22-01-2020,249071,1590,399,248672,Americas
Holy See,22-01-2020,145527,994,26,145501,Europe
Honduras,22-01-2020,440523,853,657,439866,Americas
Hungary,22-01-2020,223350,384,814,222536,Europe
Iceland,22-01-2020,333754,1037,323,333431,Europe
India,22-01-2020,428623,148,694,427929,South-East Asia
Indonesia,22-01-2020,22661,1102,1239,21422,South-East Asia
Iran,22-01-2020,293441,2194,670,292771,Eastern Mediterranean
Iraq,22-01-2020,318157,966,783,317374,Eastern Mediterranean
Ireland,22-01-2020,96504,1103,248,96256,Europe
Israel,22-01-2020,133270,2021,1142,132128,Europe
Italy,22-01-2020,82627,1782,364,82263,Europe
Jamaica,22-01-2020,136879,1002,236,136643,Americas
Japan,22-01-2020,417723,2298,668,417055,Western Pacific
Jordan,22-01-2020,429797,1486,1116,428681,Eastern Mediterranean
Kazakhstan,22-01-2020,389687,1099,1242,388445,Europe
Kenya,22-01-2020,224352,483,815,223537,Africa
South Korea,22-01-2020,141103,2395,45,141058,Western Pacific
Kuwait,22-01-2020,58193,1635,832,57361,Eastern Mediterranean
Kyrgyzstan,22-01-2020,372917,1262,1064,371853,Europe
Latvia,22-01-2020,171554,36,44,171510,Europe
Lebanon,22-01-2020,246667,376,749,245918,Eastern Mediterranean
Liberia,22-01-2020,301085,2012,543,300542,Africa
Liechtenstein,22-01-2020,107120,19,288,106832,Europe
Lithuania,22-01-2020,19864,1310,129,19735,Europe
Luxembourg,22-01-2020,443473,776,689,442784,Europe
Madagascar,22-01-2020,11421,1781,22,11399,Africa
Malaysia,22-01-2020,368581,254,293,368288,Western Pacific
Maldives,22-01-2020,73218,338,97,73121,South-East Asia
Malta,22-01-2020,431774,652,1218,430556,Europe
Mauritania,22-01-2020,415766,1892,719,415047,Africa
Mauritius,22-01-2020,387045,755,844,386201,Africa
Mexico,22-01-2020,304504,777,356,304148,Americas
Moldova,22-01-2020,438520,1136,395,438125,Europe
Monaco,22-01-2020,336363,2341,1131,335232,Europe
Mongolia,22-01-2020,40633,1898,366,40267,Western Pacific
Montenegro,22-01-2020,205189,1321,2,205187,Europe
Morocco,22-01-2020,111035,1125,1177,109858,Eastern Mediterranean
Namibia,22-01-2020,193721,1303,897,192824,Africa
Nepal,22-01-2020,44315,2416,221,44094,South-East Asia
Netherlands,22-01-2020,362856,2147,653,362203,Europe
Netherlands,22-01-2020,233913,820,431,233482,Europe
Netherlands,22-01-2020,212501,1091,827,211674,Europe
Netherlands,22-01-2020,378485,91,131,378354,Europe
New Zealand,22-01-2020,170346,510,1187,169159,Western Pacific
Nicaragua,22-01-2020,333822,123,658,333164,Americas
Niger,22-01-2020,13408,1375,874,12534,Africa
Nigeria,22-01-2020,49389,367,925,48464,Africa
North Macedonia,22-01-2020,357903,2167,1081,356822,Europe
Norway,22-01-2020,414418,962,1093,413325,Europe
Oman,22-01-2020,419122,1351,1230,417892,Eastern Mediterranean
Pakistan,22-01-2020,285117,2275,1099,284018,Eastern Mediterranean
Panama,22-01-2020,309601,716,880,308721,Americas
Papua New Guinea,22-01-2020,17397,1773,426,16971,Western Pacific
Paraguay,22-01-2020,341898,198,461,341437,Americas
Peru,22-01-2020,304660,1542,617,304043,Americas
Philippines,22-01-2020,225478,1383,813,224665,Western Pacific
Poland,22-01-2020,150300,298,336,149964,Europe
Portugal,22-01-2020,170893,38,685,170208,Europe
Qatar,22-01-2020,106562,833,44,106518,Eastern Mediterranean
Romania,22-01-2020,175433,1795,908,174525,Europe
Russia,22-01-2020,201381,283,943,200438,Europe
Rwanda,22-01-2020,291078,2357,600,290478,Africa
Saint Lucia,22-01-2020,54272,384,65,54207,Americas
Saint Vincent and the Grenadines,22-01-2020,4735,2361,52,4683,Americas
San Marino,22-01-2020,346186,954,447,345739,Europe
Saudi Arabia,22-01-2020,1166,587,689,477,Eastern Mediterranean
Senegal,22-01-2020,416604,1972,901,415703,Africa
Serbia,22-01-2020,159531,1985,406,159125,Europe
Seychelles,22-01-2020,128588,2029,283,128305,Africa
Singapore,22-01-2020,255126,2160,311,254815,Western Pacific
Slovakia,22-01-2020,182025,1316,770,181255,Europe
Slovenia,22-01-2020,372336,869,1134,371202,Europe
Somalia,22-01-2020,376862,368,411,376451,Eastern Mediterranean
South Africa,22-01-2020,320234,2339,1191,319043,Africa
Spain,22-01-2020,141084,2021,333,140751,Europe
Sri Lanka,22-01-2020,238855,367,1233,237622,South-East Asia
Sudan,22-01-2020,199031,949,197,198834,Eastern Mediterranean
Suriname,22-01-2020,179480,14,723,178757,Americas
Sweden,22-01-2020,77677,1597,600,77077,Europe
Switzerland,22-01-2020,208435,205,1075,207360,Europe
Taiwan*,22-01-2020,247279,612,722,246557,Western Pacific
Tanzania,22-01-2020,111664,1934,1213,110451,Africa
Thailand,22-01-2020,145332,1220,9,145323,South-East Asia
Togo,22-01-2020,426891,1534,1102,425789,Africa
Trinidad and Tobago,22-01-2020,248280,2236,588,247692,Americas
Tunisia,22-01-2020,363377,1880,1093,362284,Eastern Mediterranean
Turkey,22-01-2020,179134,444,441,178693,Europe
Uganda,22-01-2020,122687,2489,193,122494,Africa
Ukraine,22-01-2020,228855,1741,470,228385,Europe
United Arab Emirates,22-01-2020,79191,1893,498,78693,Eastern Mediterranean
United Kingdom,22-01-2020,39315,211,74,39241,Europe
United Kingdom,22-01-2020,24655,205,12,24643,Europe
United Kingdom,22-01-2020,70479,818,434,70045,Europe
United Kingdom,22-01-2020,409830,2478,106,409724,Europe
United Kingdom,22-01-2020,434186,1306,424,433762,Europe
United Kingdom,22-01-2020,173280,1254,363,172917,Europe
United Kingdom,22-01-2020,371936,1149,756,371180,Europe
Uruguay,22-01-2020,229365,1643,63,229302,Americas
US,22-01-2020,128831,2062,156,128675,Americas
Uzbekistan,22-01-2020,293556,1691,347,293209,Europe
Venezuela,22-01-2020,98341,1792,350,97991,Americas
Vietnam,22-01-2020,128836,2139,805,128031,Western Pacific
Zambia,22-01-2020,408743,1083,365,408378,Africa
Zimbabwe,22-01-2020,264360,122,1197,263163,Africa
Dominica,22-01-2020,131249,1676,793,130456,Americas
Grenada,22-01-2020,444147,1900,36,444111,Americas
Mozambique,22-01-2020,338085,1978,180,337905,Africa
Syria,22-01-2020,10749,200,31,10718,Eastern Mediterranean
Timor-Leste,22-01-2020,314223,2034,1108,313115,South-East Asia
Belize,22-01-2020,191619,120,255,191364,Americas
Laos,22-01-2020,327400,736,628,326772,Western Pacific
Libya,22-01-2020,331920,1115,98,331822,Eastern Mediterranean
West Bank and Gaza,22-01-2020,334252,1856,20,334232,Eastern Mediterranean
Guinea-Bissau,22-01-2020,425072,619,496,424576,Africa
Mali,22-01-2020,355445,1081,457,354988,Africa
Saint Kitts and Nevis,22-01-2020,10401,1505,230,10171,Americas
Canada,22-01-2020,266981,1789,248,266733,Americas
Canada,22-01-2020,244980,688,1106,243874,Americas
Kosovo,22-01-2020,17822,1984,237,17585,Europe
Burma,22-01-2020,368377,1807,870,367507,South-East Asia
United Kingdom,22-01-2020,29295,353,512,28783,Europe
United Kingdom,22-01-2020,299842,229,399,299443,Europe
United Kingdom,22-01-2020,234393,652,380,234013,Europe
Botswana,22-01-2020,440607,2083,779,439828,Africa
Burundi,22-01-2020,356077,816,1107,354970,Africa
Sierra Leone,22-01-2020,44120,2394,1045,43075,Africa
Malawi,22-01-2020,96929,1442,187,96742,Africa
United Kingdom,22-01-2020,186093,490,237,185856,Europe
France,22-01-2020,207470,2212,1173,206297,Europe
South Sudan,22-01-2020,395481,2267,67,395414,Africa
Western Sahara,22-01-2020,183683,2157,1005,182678,Africa
Sao Tome and Principe,22-01-2020,298329,649,875,297454,Africa
Yemen,22-01-2020,365002,1944,684,364318,Eastern Mediterranean
Comoros,22-01-2020,252930,672,1178,251752,Africa
Tajikistan,22-01-2020,334485,1885,1179,333306,Europe
Lesotho,22-01-2020,187431,2360,584,186847,Africa
Afghanistan,23-01-2020,244013,2125,115,243898,Eastern Mediterranean
Albania,23-01-2020,265398,1070,1245,264153,Europe
Algeria,23-01-2020,423874,2212,437,423437,Africa
Andorra,23-01-2020,311216,9,706,310510,Europe
Angola,23-01-2020,300728,2051,15,300713,Africa
Antigua and Barbuda,23-01-2020,250240,1637,1034,249206,Americas
Argentina,23-01-2020,381807,1918,609,381198,Americas
Armenia,23-01-2020,330050,1422,170,329880,Europe
Australia,23-01-2020,399198,1076,591,398607,Western Pacific
Australia,23-01-2020,406206,1400,219,405987,Western Pacific
Australia,23-01-2020,16557,1174,542,16015,Western Pacific
Australia,23-01-2020,191754,650,391,191363,Western Pacific
Australia,23-01-2020,87887,163,404,87483,Western Pacific
Australia,23-01-2020,392345,765,715,391630,Western Pacific
Australia,23-01-2020,295070,1770,1191,293879,Western Pacific
Australia,23-01-2020,170345,1084,331,170014,Western Pacific
Austria,23-01-2020,447164,1269,950,446214,Europe
Azerbaijan,23-01-2020,433673,93,930,432743,Europe
Bahamas,23-01-2020,23469,2261,623,22846,Americas
Bahrain,23-01-2020,393763,797,258,393505,Eastern Mediterranean
Bangladesh,23-01-2020,366266,1239,464,365802,South-East Asia
Barbados,23-01-2020,240905,1135,828,240077,Americas
Belarus,23-01-2020,445119,197,984,444135,Europe
Belgium,23-01-2020,365624,332,612,365012,Europe
Benin,23-01-2020,71903,707,767,71136,Africa
Bhutan,23-01-2020,274810,1787,632,274178,South-East Asia
Bolivia,23-01-2020,447623,147,921,446702,Americas
Bosnia and Herzegovina,23-01-2020,175175,267,381,174794,Europe
Brazil,23-01-2020,441049,532,606,440443,Americas
Brunei,23-01-2020,381251,1498,604,380647,Western Pacific
Bulgaria,23-01-2020,252001,1761,384,251617,Europe
Burkina Faso,23-01-2020,22322,1297,1158,21164,Africa
Cabo Verde,23-01-2020,239586,458,111,239475,Africa
Cambodia,23-01-2020,380748,658,702,380046,Western Pacific
Cameroon,23-01-2020,396342,2036,838,395504,Africa
Canada,23-01-2020,220105,1214,1231,218874,Americas
Canada,23-01-2020,22420,1417,276,22144,Americas
Canada,23-01-2020,91262,257,1217,90045,Americas
Canada,23-01-2020,449999,678,857,449142,Americas
Canada,23-01-2020,118503,1770,134,118369,Americas
Canada,23-01-2020,104610,2457,453,104157,Americas
Canada,23-01-2020,381660,30,183,381477,Americas
Canada,23-01-2020,296870,2151,93,296777,Americas
Canada,23-01-2020,110277,2335,353,109924,Americas
Canada,23-01-2020,13540,1973,767,12773,Americas
Central African Republic,23-01-2020,192707,753,42,192665,Africa
Chad,23-01-2020,198477,388,146,198331,Africa
Chile,23-01-2020,225140,152,370,224770,Americas
China,23-01-2020,296518,2188,426,296092,Western Pacific
China,23-01-2020,150868,1437,848,150020,Western Pacific
China,23-01-2020,36586,1227,686,35900,Western Pacific
China,23-01-2020,130418,497,14,130404,Western Pacific
China,23-01-2020,337340,313,1092,336248,Western Pacific
China,23-01-2020,408212,450,1113,407099,Western Pacific
China,23-01-2020,324297,439,680,323617,Western Pacific
China,23-01-2020,115752,2362,1084,114668,Western Pacific
China,23-01-2020,69793,553,1122,68671,Western Pacific
China,23-01-2020,37456,998,568,36888,Western Pacific
China,23-01-2020,339215,1906,883,338332,Western Pacific
China,23-01-2020,13281,1510,738,12543,Western Pacific
China,23-01-2020,143134,1588,992,142142,Western Pacific
China,23-01-2020,238850,989,55,238795,Western Pacific
China,23-01-2020,288900,1753,1108,287792,Western Pacific
China,23-01-2020,153066,798,572,152494,Western Pacific
China,23-01-2020,260724,2007,698,260026,Western Pacific
China,23-01-2020,214563,1015,858,213705,Western Pacific
China,23-01-2020,282888,777,438,282450,Western Pacific
China,23-01-2020,210985,1754,95,210890,Western Pacific
China,23-01-2020,135529,411,1036,134493,Western Pacific
China,23-01-2020,207697,681,1035,206662,Western Pacific
China,23-01-2020,395113,621,379,394734,Western Pacific
China,23-01-2020,134101,2186,1024,133077,Western Pacific
China,23-01-2020,131680,295,1219,130461,Western Pacific
China,23-01-2020,113129,631,292,112837,Western Pacific
China,23-01-2020,194985,587,819,194166,Western Pacific
China,23-01-2020,429800,2481,208,429592,Western Pacific
China,23-01-2020,98352,2180,1217,97135,Western Pacific
China,23-01-2020,356367,1495,114,356253,Western Pacific
China,23-01-2020,415171,2353,529,414642,Western Pacific
China,23-01-2020,42740,2213,273,42467,Western Pacific
China,23-01-2020,37932,1492,607,37325,Western Pacific
Colombia,23-01-2020,241664,338,914,240750,Americas
Congo (Brazzaville),23-01-2020,215822,2293,94,215728,Africa
Congo (Kinshasa),23-01-2020,55538,2490,883,54655,Africa
Costa Rica,23-01-2020,170117,314,993,169124,Americas
Cote d'Ivoire,23-01-2020,295426,1174,1203,294223,Africa
Croatia,23-01-2020,343952,1954,308,343644,Europe
Cuba,23-01-2020,153714,2278,1066,152648,Americas
Cyprus,23-01-2020,172469,1912,334,172135,Europe
Czechia,23-01-2020,115410,1593,1217,114193,Europe
Denmark,23-01-2020,374890,494,252,374638,Europe
Greenland,23-01-2020,320279,772,712,319567,Europe
Denmark,23-01-2020,138080,1263,100,137980,Europe
Djibouti,23-01-2020,22613,2235,819,21794,Eastern Mediterranean
Dominican Republic,23-01-2020,24845,956,590,24255,Americas
Ecuador,23-01-2020,347550,2136,872,346678,Americas
Egypt,23-01-2020,54838,2221,859,53979,Eastern Mediterranean
El Salvador,23-01-2020,131717,2035,688,131029,Americas
Equatorial Guinea,23-01-2020,193413,1043,645,192768,Africa
Eritrea,23-01-2020,284124,2476,72,284052,Africa
Estonia,23-01-2020,303329,976,571,302758,Europe
Eswatini,23-01-2020,18960,218,390,18570,Africa
Ethiopia,23-01-2020,97577,1846,652,96925,Africa
Fiji,23-01-2020,32406,1931,111,32295,Western Pacific
Finland,23-01-2020,127298,1673,354,126944,Europe
France,23-01-2020,84910,2482,245,84665,Europe
France,23-01-2020,377205,1572,782,376423,Europe
France,23-01-2020,364969,659,451,364518,Europe
France,23-01-2020,41965,1810,395,41570,Europe
France,23-01-2020,92646,1519,395,92251,Europe
France,23-01-2020,348696,1432,10,348686,Europe
France,23-01-2020,129469,738,661,128808,Europe
France,23-01-2020,249680,2365,827,248853,Europe
France,23-01-2020,304323,758,1121,303202,Europe
France,23-01-2020,162816,1806,203,162613,Europe
Gabon,23-01-2020,71204,248,71,71133,Africa
Gambia,23-01-2020,281718,1612,968,280750,Africa
Georgia,23-01-2020,227531,750,380,227151,Europe
Germany,23-01-2020,213854,1910,1212,212642,Europe
Ghana,23-01-2020,152339,681,600,151739,Africa
Greece,23-01-2020,179849,2275,854,178995,Europe
Guatemala,23-01-2020,335788,2354,527,335261,Americas
Guinea,23-01-2020,145294,375,1013,144281,Africa
Guyana,23-01-2020,18923,993,737,18186,Americas
Haiti,23-01-2020,378727,2226,822,377905,Americas
Holy See,23-01-2020,298780,26,638,298142,Europe
Honduras,23-01-2020,206957,2455,457,206500,Americas
Hungary,23-01-2020,91629,540,381,91248,Europe
Iceland,23-01-2020,239467,2260,65,239402,Europe
India,23-01-2020,337437,914,566,336871,South-East Asia
Indonesia,23-01-2020,253315,162,273,253042,South-East Asia
Iran,23-01-2020,268883,249,958,267925,Eastern Mediterranean
Iraq,23-01-2020,380256,2438,837,379419,Eastern Mediterranean
Ireland,23-01-2020,310457,364,291,310166,Europe
Israel,23-01-2020,47059,2402,181,46878,Europe
Italy,23-01-2020,322731,1347,200,322531,Europe
Jamaica,23-01-2020,78128,1963,1249,76879,Americas
Japan,23-01-2020,272402,248,516,271886,Western Pacific
Jordan,23-01-2020,283199,964,930,282269,Eastern Mediterranean
Kazakhstan,23-01-2020,45476,415,1002,44474,Europe
Kenya,23-01-2020,160030,1794,1110,158920,Africa
South Korea,23-01-2020,437409,941,936,436473,Western Pacific
Kuwait,23-01-2020,366364,1315,809,365555,Eastern Mediterranean
Kyrgyzstan,23-01-2020,330534,1007,852,329682,Europe
Latvia,23-01-2020,259508,2359,1072,258436,Europe
Lebanon,23-01-2020,389842,2355,376,389466,Eastern Mediterranean
Liberia,23-01-2020,363238,2180,1121,362117,Africa
Liechtenstein,23-01-2020,33776,2367,810,32966,Europe
Lithuania,23-01-2020,12801,1741,998,11803,Europe
Luxembourg,23-01-2020,226853,270,255,226598,Europe
Madagascar,23-01-2020,356880,1659,681,356199,Africa
Malaysia,23-01-2020,368864,412,280,368584,Western Pacific
Maldives,23-01-2020,132343,166,119,132224,South-East Asia
Malta,23-01-2020,331976,250,980,330996,Europe
Mauritania,23-01-2020,67456,2279,975,66481,Africa
Mauritius,23-01-2020,47113,371,285,46828,Africa
Mexico,23-01-2020,360633,461,932,359701,Americas
Moldova,23-01-2020,127752,2004,406,127346,Europe
Monaco,23-01-2020,44801,698,73,44728,Europe
Mongolia,23-01-2020,257722,1120,689,257033,Western Pacific
Montenegro,23-01-2020,413131,305,532,412599,Europe
Morocco,23-01-2020,125044,1020,526,124518,Eastern Mediterranean
Namibia,23-01-2020,409706,1089,149,409557,Africa
Nepal,23-01-2020,155629,1385,503,155126,South-East Asia
Netherlands,23-01-2020,334298,40,130,334168,Europe
Netherlands,23-01-2020,300853,800,496,300357,Europe
Netherlands,23-01-2020,418793,641,1098,417695,Europe
Netherlands,23-01-2020,288828,688,1193,287635,Europe
New Zealand,23-01-2020,177302,805,492,176810,Western Pacific
Nicaragua,23-01-2020,68828,1654,1168,67660,Americas
Niger,23-01-2020,295255,1325,177,295078,Africa
Nigeria,23-01-2020,104112,1152,1202,102910,Africa
North Macedonia,23-01-2020,113216,1850,56,113160,Europe
Norway,23-01-2020,201230,2316,1076,200154,Europe
Oman,23-01-2020,74198,1223,590,73608,Eastern Mediterranean
Pakistan,23-01-2020,172400,252,794,171606,Eastern Mediterranean
Panama,23-01-2020,146697,334,92,146605,Americas
Papua New Guinea,23-01-2020,345287,1728,632,344655,Western Pacific
Paraguay,23-01-2020,400225,308,902,399323,Americas
Peru,23-01-2020,421622,1820,118,421504,Americas
Philippines,23-01-2020,330255,781,1016,329239,Western Pacific
Poland,23-01-2020,390930,2101,608,390322,Europe
Portugal,23-01-2020,312604,374,739,311865,Europe
Qatar,23-01-2020,185372,1471,1083,184289,Eastern Mediterranean
Romania,23-01-2020,125352,299,1225,124127,Europe
Russia,23-01-2020,260724,1691,866,259858,Europe
Rwanda,23-01-2020,108861,1275,275,108586,Africa
Saint Lucia,23-01-2020,409347,927,845,408502,Americas
Saint Vincent and the Grenadines,23-01-2020,326225,2057,1201,325024,Americas
San Marino,23-01-2020,219857,2171,322,219535,Europe
Saudi Arabia,23-01-2020,177298,1425,1134,176164,Eastern Mediterranean
Senegal,23-01-2020,280261,2161,898,279363,Africa
Serbia,23-01-2020,129390,1710,295,129095,Europe
Seychelles,23-01-2020,223559,653,373,223186,Africa
Singapore,23-01-2020,384575,1594,969,383606,Western Pacific
Slovakia,23-01-2020,396119,1011,691,395428,Europe
Slovenia,23-01-2020,348784,842,804,347980,Europe
Somalia,23-01-2020,314949,583,1030,313919,Eastern Mediterranean
South Africa,23-01-2020,210876,2260,213,210663,Africa
Spain,23-01-2020,386626,257,463,386163,Europe
Sri Lanka,23-01-2020,223518,18,490,223028,South-East Asia
Sudan,23-01-2020,50032,1020,1213,48819,Eastern Mediterranean
Suriname,23-01-2020,255538,1779,34,255504,Americas
Sweden,23-01-2020,284362,702,972,283390,Europe
Switzerland,23-01-2020,424085,1971,100,423985,Europe
Taiwan*,23-01-2020,311120,2223,615,310505,Western Pacific
Tanzania,23-01-2020,244125,2452,1160,242965,Africa
Thailand,23-01-2020,174309,1199,350,173959,South-East Asia
Togo,23-01-2020,413688,245,742,412946,Africa
Trinidad and Tobago,23-01-2020,15129,283,914,14215,Americas
Tunisia,23-01-2020,276598,1263,308,276290,Eastern Mediterranean
Turkey,23-01-2020,9177,1540,551,8626,Europe
Uganda,23-01-2020,152896,2343,276,152620,Africa
Ukraine,23-01-2020,270576,1607,630,269946,Europe
United Arab Emirates,23-01-2020,286650,789,77,286573,Eastern Mediterranean
United Kingdom,23-01-2020,240643,39,1013,239630,Europe
United Kingdom,23-01-2020,253470,749,347,253123,Europe
United Kingdom,23-01-2020,278305,2400,374,277931,Europe
United Kingdom,23-01-2020,394277,2093,844,393433,Europe
United Kingdom,23-01-2020,361347,464,522,360825,Europe
United Kingdom,23-01-2020,87589,2083,788,86801,Europe
United Kingdom,23-01-2020,273089,2053,768,272321,Europe
Uruguay,23-01-2020,156079,2048,252,155827,Americas
US,23-01-2020,100663,97,919,99744,Americas
Uzbekistan,23-01-2020,189170,400,1051,188119,Europe
Venezuela,23-01-2020,54355,2468,1088,53267,Americas
Vietnam,23-01-2020,286852,547,41,286811,Western Pacific
Zambia,23-01-2020,77097,976,872,76225,Africa
Zimbabwe,23-01-2020,370432,1409,257,370175,Africa
Dominica,23-01-2020,68299,804,1084,67215,Americas
Grenada,23-01-2020,363646,445,1242,362404,Americas
Mozambique,23-01-2020,172682,369,990,171692,Africa
Syria,23-01-2020,307254,60,242,307012,Eastern Mediterranean
Timor-Leste,23-01-2020,171182,918,522,170660,South-East Asia
Belize,23-01-2020,184685,1574,654,184031,Americas
Laos,23-01-2020,328071,1427,710,327361,Western Pacific
Libya,23-01-2020,332632,2034,727,331905,Eastern Mediterranean
West Bank and Gaza,23-01-2020,382266,71,1056,381210,Eastern Mediterranean
Guinea-Bissau,23-01-2020,293679,1056,239,293440,Africa
Mali,23-01-2020,122583,431,651,121932,Africa
Saint Kitts and Nevis,23-01-2020,435521,1310,973,434548,Americas
Canada,23-01-2020,199534,675,318,199216,Americas
Canada,23-01-2020,332410,1218,276,332134,Americas
Kosovo,23-01-2020,404731,848,266,404465,Europe
Burma,23-01-2020,148234,2254,465,147769,South-East Asia
United Kingdom,23-01-2020,63159,1491,1029,62130,Europe
United Kingdom,23-01-2020,290799,1933,197,290602,Europe
United Kingdom,23-01-2020,79672,1981,205,79467,Europe
Botswana,23-01-2020,121455,359,766,120689,Africa
Burundi,23-01-2020,187502,1013,1062,186440,Africa
Sierra Leone,23-01-2020,177024,638,982,176042,Africa
Malawi,23-01-2020,246665,1705,212,246453,Africa
United Kingdom,23-01-2020,18407,2104,1079,17328,Europe
France,23-01-2020,361642,504,505,361137,Europe
South Sudan,23-01-2020,422040,1120,360,421680,Africa
Western Sahara,23-01-2020,181008,1611,108,180900,Africa
Sao Tome and Principe,23-01-2020,224416,1661,948,223468,Africa
Yemen,23-01-2020,152496,2382,952,151544,Eastern Mediterranean
Comoros,23-01-2020,237747,287,143,237604,Africa
Tajikistan,23-01-2020,410886,1960,544,410342,Europe
Lesotho,23-01-2020,284680,2455,292,284388,Africa
Afghanistan,24-01-2020,121179,2053,1010,120169,Eastern Mediterranean
Albania,24-01-2020,281734,1714,1241,280493,Europe
Algeria,24-01-2020,210381,1627,1182,209199,Africa
Andorra,24-01-2020,287824,384,701,287123,Europe
Angola,24-01-2020,149630,1811,549,149081,Africa
Antigua and Barbuda,24-01-2020,198673,2048,794,197879,Americas
Argentina,24-01-2020,312269,1549,76,312193,Americas
Armenia,24-01-2020,409696,1551,117,409579,Europe
Australia,24-01-2020,391053,1660,1214,389839,Western Pacific
Australia,24-01-2020,236245,938,751,235494,Western Pacific
Australia,24-01-2020,418018,1346,394,417624,Western Pacific
Australia,24-01-2020,273333,2,824,272509,Western Pacific
Australia,24-01-2020,60525,760,469,60056,Western Pacific
Australia,24-01-2020,60438,2114,1029,59409,Western Pacific
Australia,24-01-2020,123618,1405,283,123335,Western Pacific
Australia,24-01-2020,24753,1703,1246,23507,Western Pacific
Austria,24-01-2020,394709,2488,548,394161,Europe
Azerbaijan,24-01-2020,404309,1510,1245,403064,Europe
Bahamas,24-01-2020,433454,402,942,432512,Americas
Bahrain,24-01-2020,35272,1608,129,35143,Eastern Mediterranean
Bangladesh,24-01-2020,169280,2220,636,168644,South-East Asia
Barbados,24-01-2020,158775,1886,543,158232,Americas
Belarus,24-01-2020,222592,1699,277,222315,Europe
Belgium,24-01-2020,424980,1232,821,424159,Europe
Benin,24-01-2020,185782,1832,66,185716,Africa
Bhutan,24-01-2020,305925,762,127,305798,South-East Asia
Bolivia,24-01-2020,308460,1018,993,307467,Americas
Bosnia and Herzegovina,24-01-2020,396453,1187,647,395806,Europe
Brazil,24-01-2020,134882,1067,1238,133644,Americas
Brunei,24-01-2020,373846,1505,933,372913,Western Pacific
Bulgaria,24-01-2020,215828,1494,620,215208,Europe
Burkina Faso,24-01-2020,114303,2004,769,113534,Africa
Cabo Verde,24-01-2020,300151,1920,44,300107,Africa
Cambodia,24-01-2020,221877,282,1016,220861,Western Pacific
Cameroon,24-01-2020,251884,1038,718,251166,Africa
Canada,24-01-2020,238896,380,666,238230,Americas
Canada,24-01-2020,165907,816,931,164976,Americas
Canada,24-01-2020,308919,1206,995,307924,Americas
Canada,24-01-2020,26366,868,617,25749,Americas
Canada,24-01-2020,35949,1373,1104,34845,Americas
Canada,24-01-2020,209369,2282,433,208936,Americas
Canada,24-01-2020,285207,768,373,284834,Americas
Canada,24-01-2020,301770,1111,915,300855,Americas
Canada,24-01-2020,104641,1850,1128,103513,Americas
Canada,24-01-2020,36150,1184,344,35806,Americas
Central African Republic,24-01-2020,258083,2041,563,257520,Africa
Chad,24-01-2020,135781,934,1061,134720,Africa
Chile,24-01-2020,315909,1108,584,315325,Americas
China,24-01-2020,44581,2004,700,43881,Western Pacific
China,24-01-2020,388570,1422,716,387854,Western Pacific
China,24-01-2020,346505,1789,753,345752,Western Pacific
China,24-01-2020,217616,1207,766,216850,Western Pacific
China,24-01-2020,178584,2295,337,178247,Western Pacific
China,24-01-2020,303865,1492,1107,302758,Western Pacific
China,24-01-2020,149299,1923,665,148634,Western Pacific
China,24-01-2020,369125,1443,651,368474,Western Pacific
China,24-01-2020,207275,441,477,206798,Western Pacific
China,24-01-2020,10640,839,996,9644,Western Pacific
China,24-01-2020,71213,351,838,70375,Western Pacific
China,24-01-2020,123075,1882,865,122210,Western Pacific
China,24-01-2020,314626,247,480,314146,Western Pacific
China,24-01-2020,29588,2491,200,29388,Western Pacific
China,24-01-2020,82521,1610,905,81616,Western Pacific
China,24-01-2020,89363,1857,261,89102,Western Pacific
China,24-01-2020,334820,2056,178,334642,Western Pacific
China,24-01-2020,17978,507,1116,16862,Western Pacific
China,24-01-2020,25119,1713,144,24975,Western Pacific
China,24-01-2020,114685,1820,1134,113551,Western Pacific
China,24-01-2020,184159,2226,825,183334,Western Pacific
China,24-01-2020,264428,798,597,263831,Western Pacific
China,24-01-2020,68824,520,804,68020,Western Pacific
China,24-01-2020,319740,788,701,319039,Western Pacific
China,24-01-2020,341425,1511,717,340708,Western Pacific
China,24-01-2020,232609,2015,428,232181,Western Pacific
China,24-01-2020,355576,252,401,355175,Western Pacific
China,24-01-2020,332379,1187,840,331539,Western Pacific
China,24-01-2020,102639,467,759,101880,Western Pacific
China,24-01-2020,18231,642,898,17333,Western Pacific
China,24-01-2020,63689,2130,1034,62655,Western Pacific
China,24-01-2020,181899,1079,120,181779,Western Pacific
China,24-01-2020,255386,2245,71,255315,Western Pacific
Colombia,24-01-2020,310734,1106,467,310267,Americas
Congo (Brazzaville),24-01-2020,148257,50,293,147964,Africa
Congo (Kinshasa),24-01-2020,365055,63,133,364922,Africa
Costa Rica,24-01-2020,441459,268,864,440595,Americas
Cote d'Ivoire,24-01-2020,79316,114,288,79028,Africa
Croatia,24-01-2020,248019,1766,437,247582,Europe
Cuba,24-01-2020,356953,757,1160,355793,Americas
Cyprus,24-01-2020,25375,2401,1080,24295,Europe
Czechia,24-01-2020,340789,1812,1210,339579,Europe
Denmark,24-01-2020,306122,1884,1035,305087,Europe
Greenland,24-01-2020,430722,1119,1080,429642,Europe
Denmark,24-01-2020,345063,310,747,344316,Europe
Djibouti,24-01-2020,163140,553,991,162149,Eastern Mediterranean
Dominican Republic,24-01-2020,263695,2280,741,262954,Americas
Ecuador,24-01-2020,33369,1303,157,33212,Americas
Egypt,24-01-2020,387822,874,717,387105,Eastern Mediterranean
El Salvador,24-01-2020,99800,697,987,98813,Americas
Equatorial Guinea,24-01-2020,266454,554,183,266271,Africa
Eritrea,24-01-2020,137318,2066,306,137012,Africa
Estonia,24-01-2020,122807,992,1081,121726,Europe
Eswatini,24-01-2020,146426,852,539,145887,Africa
Ethiopia,24-01-2020,161293,2272,170,161123,Africa
Fiji,24-01-2020,382680,512,432,382248,Western Pacific
Finland,24-01-2020,301294,2109,418,300876,Europe
France,24-01-2020,312308,39,1220,311088,Europe
France,24-01-2020,435005,2326,719,434286,Europe
France,24-01-2020,197299,1884,1033,196266,Europe
France,24-01-2020,306974,1231,661,306313,Europe
France,24-01-2020,306930,257,1232,305698,Europe
France,24-01-2020,448656,386,170,448486,Europe
France,24-01-2020,18472,1142,811,17661,Europe
France,24-01-2020,333380,455,119,333261,Europe
France,24-01-2020,200568,1381,608,199960,Europe
France,24-01-2020,137188,2166,944,136244,Europe
Gabon,24-01-2020,437723,2211,110,437613,Africa
Gambia,24-01-2020,110117,1202,987,109130,Africa
Georgia,24-01-2020,334613,253,231,334382,Europe
Germany,24-01-2020,23772,1138,4,23768,Europe
Ghana,24-01-2020,34573,1442,945,33628,Africa
Greece,24-01-2020,258206,535,311,257895,Europe
Guatemala,24-01-2020,89230,1221,1057,88173,Americas
Guinea,24-01-2020,297132,1666,304,296828,Africa
Guyana,24-01-2020,324799,485,333,324466,Americas
Haiti,24-01-2020,254983,1191,340,254643,Americas
Holy See,24-01-2020,280923,275,624,280299,Europe
Honduras,24-01-2020,380083,2107,509,379574,Americas
Hungary,24-01-2020,211085,1977,517,210568,Europe
Iceland,24-01-2020,416761,722,409,416352,Europe
India,24-01-2020,436937,1315,374,436563,South-East Asia
Indonesia,24-01-2020,226584,7,789,225795,South-East Asia
Iran,24-01-2020,152521,1070,1175,151346,Eastern Mediterranean
Iraq,24-01-2020,16191,156,692,15499,Eastern Mediterranean
Ireland,24-01-2020,154947,1229,407,154540,Europe
Israel,24-01-2020,133166,402,784,132382,Europe
Italy,24-01-2020,141457,1347,189,141268,Europe
Jamaica,24-01-2020,449530,1769,304,449226,Americas
Japan,24-01-2020,322261,62,552,321709,Western Pacific
Jordan,24-01-2020,280302,1413,1023,279279,Eastern Mediterranean
Kazakhstan,24-01-2020,19025,2090,694,18331,Europe
Kenya,24-01-2020,94110,88,793,93317,Africa
South Korea,24-01-2020,192957,1481,1064,191893,Western Pacific
Kuwait,24-01-2020,424660,506,18,424642,Eastern Mediterranean
Kyrgyzstan,24-01-2020,204019,1802,1245,202774,Europe
Latvia,24-01-2020,188344,634,1115,187229,Europe
Lebanon,24-01-2020,199779,2176,800,198979,Eastern Mediterranean
Liberia,24-01-2020,93292,2484,250,93042,Africa
Liechtenstein,24-01-2020,96159,654,952,95207,Europe
Lithuania,24-01-2020,14419,2149,151,14268,Europe
Luxembourg,24-01-2020,186611,129,150,186461,Europe
Madagascar,24-01-2020,156247,588,764,155483,Africa
Malaysia,24-01-2020,434642,1238,236,434406,Western Pacific
Maldives,24-01-2020,359585,358,1004,358581,South-East Asia
Malta,24-01-2020,302390,2396,597,301793,Europe
Mauritania,24-01-2020,156285,1165,573,155712,Africa
Mauritius,24-01-2020,94226,532,879,93347,Africa
Mexico,24-01-2020,304247,1000,658,303589,Americas
Moldova,24-01-2020,169960,269,1044,168916,Europe
Monaco,24-01-2020,165128,1933,312,164816,Europe
Mongolia,24-01-2020,95386,1801,822,94564,Western Pacific
Montenegro,24-01-2020,245319,1456,208,245111,Europe
Morocco,24-01-2020,438545,1674,600,437945,Eastern Mediterranean
Namibia,24-01-2020,260314,1020,953,259361,Africa
Nepal,24-01-2020,444066,253,1080,442986,South-East Asia
Netherlands,24-01-2020,311404,902,419,310985,Europe
Netherlands,24-01-2020,109923,212,1097,108826,Europe
Netherlands,24-01-2020,340709,2147,133,340576,Europe
Netherlands,24-01-2020,73953,2010,138,73815,Europe
New Zealand,24-01-2020,324640,1168,82,324558,Western Pacific
Nicaragua,24-01-2020,440049,569,1021,439028,Americas
Niger,24-01-2020,437467,369,1178,436289,Africa
Nigeria,24-01-2020,355253,585,593,354660,Africa
North Macedonia,24-01-2020,249780,882,137,249643,Europe
Norway,24-01-2020,99383,1852,555,98828,Europe
Oman,24-01-2020,318167,468,998,317169,Eastern Mediterranean
Pakistan,24-01-2020,56871,1449,1146,55725,Eastern Mediterranean
Panama,24-01-2020,370190,1039,955,369235,Americas
Papua New Guinea,24-01-2020,302523,1857,78,302445,Western Pacific
Paraguay,24-01-2020,333702,155,1244,332458,Americas
Peru,24-01-2020,217484,37,147,217337,Americas
Philippines,24-01-2020,180007,638,449,179558,Western Pacific
Poland,24-01-2020,165062,985,281,164781,Europe
Portugal,24-01-2020,325328,2050,1052,324276,Europe
Qatar,24-01-2020,52686,1452,175,52511,Eastern Mediterranean
Romania,24-01-2020,306537,2395,162,306375,Europe
Russia,24-01-2020,229963,795,597,229366,Europe
Rwanda,24-01-2020,414116,1343,678,413438,Africa
Saint Lucia,24-01-2020,258102,2216,107,257995,Americas
Saint Vincent and the Grenadines,24-01-2020,166674,1768,1129,165545,Americas
San Marino,24-01-2020,91115,9,768,90347,Europe
Saudi Arabia,24-01-2020,416127,904,339,415788,Eastern Mediterranean
Senegal,24-01-2020,176366,589,995,175371,Africa
Serbia,24-01-2020,89580,1254,118,89462,Europe
Seychelles,24-01-2020,272669,797,932,271737,Africa
Singapore,24-01-2020,365342,106,71,365271,Western Pacific
Slovakia,24-01-2020,73365,1478,251,73114,Europe
Slovenia,24-01-2020,394086,1784,425,393661,Europe
Somalia,24-01-2020,380406,1606,1006,379400,Eastern Mediterranean
South Africa,24-01-2020,306890,1824,315,306575,Africa
Spain,24-01-2020,84369,1100,566,83803,Europe
Sri Lanka,24-01-2020,405120,1741,876,404244,South-East Asia
Sudan,24-01-2020,110328,719,791,109537,Eastern Mediterranean
Suriname,24-01-2020,30021,760,1068,28953,Americas
Sweden,24-01-2020,449034,888,531,448503,Europe
Switzerland,24-01-2020,213774,161,635,213139,Europe
Taiwan*,24-01-2020,361383,2292,573,360810,Western Pacific
Tanzania,24-01-2020,180937,566,1117,179820,Africa
Thailand,24-01-2020,13128,1223,555,12573,South-East Asia
Togo,24-01-2020,182560,244,922,181638,Africa
Trinidad and Tobago,24-01-2020,205038,1723,930,204108,Americas
Tunisia,24-01-2020,119399,1713,216,119183,Eastern Mediterranean
Turkey,24-01-2020,236645,233,1209,235436,Europe
Uganda,24-01-2020,15903,1511,978,14925,Africa
Ukraine,24-01-2020,108368,1544,349,108019,Europe
United Arab Emirates,24-01-2020,123781,1158,1007,122774,Eastern Mediterranean
United Kingdom,24-01-2020,13385,528,815,12570,Europe
United Kingdom,24-01-2020,396213,1013,1080,395133,Europe
United Kingdom,24-01-2020,235983,1142,638,235345,Europe
United Kingdom,24-01-2020,115966,1352,2,115964,Europe
United Kingdom,24-01-2020,415687,1269,107,415580,Europe
United Kingdom,24-01-2020,315193,172,71,315122,Europe
United Kingdom,24-01-2020,325244,201,1146,324098,Europe
Uruguay,24-01-2020,272387,412,831,271556,Americas
US,24-01-2020,223594,1424,492,223102,Americas
Uzbekistan,24-01-2020,14530,998,622,13908,Europe
Venezuela,24-01-2020,279007,1110,994,278013,Americas
Vietnam,24-01-2020,446710,499,1009,445701,Western Pacific
Zambia,24-01-2020,304303,810,192,304111,Africa
Zimbabwe,24-01-2020,217957,1778,427,217530,Africa
Dominica,24-01-2020,422299,450,1084,421215,Americas
Grenada,24-01-2020,409333,761,345,408988,Americas
Mozambique,24-01-2020,324582,1146,829,323753,Africa
Syria,24-01-2020,189496,965,75,189421,Eastern Mediterranean
Timor-Leste,24-01-2020,265812,1146,181,265631,South-East Asia
Belize,24-01-2020,196063,1168,272,195791,Americas
Laos,24-01-2020,54506,631,1186,53320,Western Pacific
Libya,24-01-2020,399122,2287,178,398944,Eastern Mediterranean
West Bank and Gaza,24-01-2020,282883,514,818,282065,Eastern Mediterranean
Guinea-Bissau,24-01-2020,207335,2096,1202,206133,Africa
Mali,24-01-2020,23903,2262,584,23319,Africa
Saint Kitts and Nevis,24-01-2020,306139,2130,215,305924,Americas
Canada,24-01-2020,112723,860,483,112240,Americas
Canada,24-01-2020,202943,1375,604,202339,Americas
Kosovo,24-01-2020,13574,2020,784,12790,Europe
Burma,24-01-2020,284990,1117,535,284455,South-East Asia
United Kingdom,24-01-2020,13315,2292,1143,12172,Europe
United Kingdom,24-01-2020,371812,2384,32,371780,Europe
United Kingdom,24-01-2020,401728,1163,773,400955,Europe
Botswana,24-01-2020,157716,416,344,157372,Africa
Burundi,24-01-2020,238706,387,1010,237696,Africa
Sierra Leone,24-01-2020,349781,1481,1068,348713,Africa
Malawi,24-01-2020,204916,2092,1165,203751,Africa
United Kingdom,24-01-2020,120857,2232,994,119863,Europe
France,24-01-2020,393348,1349,1065,392283,Europe
South Sudan,24-01-2020,292662,2062,745,291917,Africa
Western Sahara,24-01-2020,427513,1118,768,426745,Africa
Sao Tome and Principe,24-01-2020,37341,2041,1185,36156,Africa
Yemen,24-01-2020,411103,432,783,410320,Eastern Mediterranean
Comoros,24-01-2020,49616,343,450,49166,Africa
Tajikistan,24-01-2020,355492,1367,675,354817,Europe
Lesotho,24-01-2020,85743,646,971,84772,Africa
Afghanistan,25-01-2020,262220,716,764,261456,Eastern Mediterranean
Albania,25-01-2020,283499,2040,615,282884,Europe
Algeria,25-01-2020,437984,821,782,437202,Africa
Andorra,25-01-2020,208558,631,701,207857,Europe
Angola,25-01-2020,294090,2320,1164,292926,Africa
Antigua and Barbuda,25-01-2020,370194,2381,361,369833,Americas
Argentina,25-01-2020,15374,1665,252,15122,Americas
Armenia,25-01-2020,64076,1199,210,63866,Europe
Australia,25-01-2020,407743,1222,40,407703,Western Pacific
Australia,25-01-2020,147652,858,622,147030,Western Pacific
Australia,25-01-2020,140867,1331,371,140496,Western Pacific
Australia,25-01-2020,245687,181,1157,244530,Western Pacific
Australia,25-01-2020,152531,1869,1102,151429,Western Pacific
Australia,25-01-2020,87579,708,296,87283,Western Pacific
Australia,25-01-2020,418956,1595,494,418462,Western Pacific
Australia,25-01-2020,77603,613,908,76695,Western Pacific
Austria,25-01-2020,175600,1733,607,174993,Europe
Azerbaijan,25-01-2020,31664,1222,402,31262,Europe
Bahamas,25-01-2020,37549,2136,879,36670,Americas
Bahrain,25-01-2020,207319,1390,736,206583,Eastern Mediterranean
Bangladesh,25-01-2020,77725,1222,1145,76580,South-East Asia
Barbados,25-01-2020,226901,531,618,226283,Americas
Belarus,25-01-2020,294177,356,356,293821,Europe
Belgium,25-01-2020,39082,1182,235,38847,Europe
Benin,25-01-2020,290349,1702,501,289848,Africa
Bhutan,25-01-2020,42513,1992,1182,41331,South-East Asia
Bolivia,25-01-2020,208716,21,1055,207661,Americas
Bosnia and Herzegovina,25-01-2020,77685,643,341,77344,Europe
Brazil,25-01-2020,258842,289,894,257948,Americas
Brunei,25-01-2020,173036,593,631,172405,Western Pacific
Bulgaria,25-01-2020,127399,1185,402,126997,Europe
Burkina Faso,25-01-2020,280324,390,745,279579,Africa
Cabo Verde,25-01-2020,212034,891,272,211762,Africa
Cambodia,25-01-2020,148965,2052,33,148932,Western Pacific
Cameroon,25-01-2020,304506,636,372,304134,Africa
Canada,25-01-2020,188018,2238,1002,187016,Americas
Canada,25-01-2020,78962,939,72,78890,Americas
Canada,25-01-2020,309422,2241,740,308682,Americas
Canada,25-01-2020,56583,14,1209,55374,Americas
Canada,25-01-2020,421612,1234,1014,420598,Americas
Canada,25-01-2020,219671,388,814,218857,Americas
Canada,25-01-2020,273295,396,681,272614,Americas
Canada,25-01-2020,330214,2322,618,329596,Americas
Canada,25-01-2020,296955,900,944,296011,Americas
Canada,25-01-2020,364915,632,669,364246,Americas
Central African Republic,25-01-2020,195954,2363,790,195164,Africa
Chad,25-01-2020,9622,1913,858,8764,Africa
Chile,25-01-2020,413939,749,846,413093,Americas
China,25-01-2020,280168,1307,1052,279116,Western Pacific
China,25-01-2020,319117,407,918,318199,Western Pacific
China,25-01-2020,62396,1643,1040,61356,Western Pacific
China,25-01-2020,328995,656,566,328429,Western Pacific
China,25-01-2020,375438,376,776,374662,Western Pacific
China,25-01-2020,361271,243,1070,360201,Western Pacific
China,25-01-2020,404497,2147,865,403632,Western Pacific
China,25-01-2020,130399,1817,461,129938,Western Pacific
China,25-01-2020,433271,569,582,432689,Western Pacific
China,25-01-2020,316103,1046,379,315724,Western Pacific
China,25-01-2020,70353,1106,1139,69214,Western Pacific
China,25-01-2020,270004,39,591,269413,Western Pacific
China,25-01-2020,222174,2297,246,221928,Western Pacific
China,25-01-2020,108639,1823,114,108525,Western Pacific
China,25-01-2020,386036,859,369,385667,Western Pacific
China,25-01-2020,328778,1749,895,327883,Western Pacific
China,25-01-2020,76382,298,811,75571,Western Pacific
China,25-01-2020,183402,1158,1199,182203,Western Pacific
China,25-01-2020,239344,2069,339,239005,Western Pacific
China,25-01-2020,57020,1268,524,56496,Western Pacific
China,25-01-2020,299651,453,1011,298640,Western Pacific
China,25-01-2020,159089,2001,1187,157902,Western Pacific
China,25-01-2020,420783,1821,1222,419561,Western Pacific
China,25-01-2020,337237,1178,38,337199,Western Pacific
China,25-01-2020,154677,993,1196,153481,Western Pacific
China,25-01-2020,337689,475,1034,336655,Western Pacific
China,25-01-2020,135395,2372,1007,134388,Western Pacific
China,25-01-2020,102739,356,1246,101493,Western Pacific
China,25-01-2020,236583,1743,953,235630,Western Pacific
China,25-01-2020,68401,176,291,68110,Western Pacific
China,25-01-2020,234444,2222,412,234032,Western Pacific
China,25-01-2020,74437,2019,70,74367,Western Pacific
China,25-01-2020,161012,2313,146,160866,Western Pacific
Colombia,25-01-2020,309252,778,660,308592,Americas
Congo (Brazzaville),25-01-2020,118262,1194,817,117445,Africa
Congo (Kinshasa),25-01-2020,129929,392,190,129739,Africa
Costa Rica,25-01-2020,172693,166,60,172633,Americas
Cote d'Ivoire,25-01-2020,315983,1416,1119,314864,Africa
Croatia,25-01-2020,264125,1001,732,263393,Europe
Cuba,25-01-2020,361376,2036,866,360510,Americas
Cyprus,25-01-2020,95804,1505,24,95780,Europe
Czechia,25-01-2020,414294,1538,57,414237,Europe
Denmark,25-01-2020,83305,39,352,82953,Europe
Greenland,25-01-2020,250082,1599,880,249202,Europe
Denmark,25-01-2020,445376,2208,613,444763,Europe
Djibouti,25-01-2020,437623,2009,836,436787,Eastern Mediterranean
Dominican Republic,25-01-2020,148640,923,339,148301,Americas
Ecuador,25-01-2020,66322,1647,562,65760,Americas
Egypt,25-01-2020,279586,419,546,279040,Eastern Mediterranean
El Salvador,25-01-2020,190822,2003,618,190204,Americas
Equatorial Guinea,25-01-2020,341957,1963,117,341840,Africa
Eritrea,25-01-2020,280751,1245,525,280226,Africa
Estonia,25-01-2020,366363,2160,1173,365190,Europe
Eswatini,25-01-2020,203682,238,1240,202442,Africa
Ethiopia,25-01-2020,65621,183,38,65583,Africa
Fiji,25-01-2020,86749,894,539,86210,Western Pacific
Finland,25-01-2020,162106,2396,10,162096,Europe
France,25-01-2020,215183,525,884,214299,Europe
France,25-01-2020,263380,187,829,262551,Europe
France,25-01-2020,388711,1750,552,388159,Europe
France,25-01-2020,137028,1476,1023,136005,Europe
France,25-01-2020,251381,1402,11,251370,Europe
France,25-01-2020,247122,285,727,246395,Europe
France,25-01-2020,115082,373,865,114217,Europe
France,25-01-2020,319997,281,1024,318973,Europe
France,25-01-2020,55887,1081,671,55216,Europe
France,25-01-2020,173613,2018,1045,172568,Europe
Gabon,25-01-2020,166975,543,493,166482,Africa
Gambia,25-01-2020,39449,2072,981,38468,Africa
Georgia,25-01-2020,350961,398,911,350050,Europe
Germany,25-01-2020,174290,1858,539,173751,Europe
Ghana,25-01-2020,214006,434,495,213511,Africa
Greece,25-01-2020,82651,1727,318,82333,Europe
Guatemala,25-01-2020,108854,1543,233,108621,Americas
Guinea,25-01-2020,48049,1669,1077,46972,Africa
Guyana,25-01-2020,172668,1257,23,172645,Americas
Haiti,25-01-2020,346933,2342,1016,345917,Americas
Holy See,25-01-2020,428846,1987,114,428732,Europe
Honduras,25-01-2020,381875,2301,682,381193,Americas
Hungary,25-01-2020,409978,1107,896,409082,Europe
Iceland,25-01-2020,437615,1285,911,436704,Europe
India,25-01-2020,434543,1687,372,434171,South-East Asia
Indonesia,25-01-2020,149986,1264,396,149590,South-East Asia
Iran,25-01-2020,295811,1478,444,295367,Eastern Mediterranean
Iraq,25-01-2020,205740,2087,568,205172,Eastern Mediterranean
Ireland,25-01-2020,30109,1148,1058,29051,Europe
Israel,25-01-2020,419697,392,323,419374,Europe
Italy,25-01-2020,395945,197,1035,394910,Europe
Jamaica,25-01-2020,390672,22,570,390102,Americas
Japan,25-01-2020,143539,2309,1015,142524,Western Pacific
Jordan,25-01-2020,343673,248,700,342973,Eastern Mediterranean
Kazakhstan,25-01-2020,131639,711,12,131627,Europe
Kenya,25-01-2020,397535,2197,31,397504,Africa
South Korea,25-01-2020,252442,2445,788,251654,Western Pacific
Kuwait,25-01-2020,15992,2404,947,15045,Eastern Mediterranean
Kyrgyzstan,25-01-2020,20337,237,745,19592,Europe
Latvia,25-01-2020,198657,2210,402,198255,Europe
Lebanon,25-01-2020,196272,675,0,196272,Eastern Mediterranean
Liberia,25-01-2020,25342,1752,62,25280,Africa
Liechtenstein,25-01-2020,77568,1918,20,77548,Europe
Lithuania,25-01-2020,264942,2171,182,264760,Europe
Luxembourg,25-01-2020,1524,1651,209,1315,Europe
Madagascar,25-01-2020,284014,1370,791,283223,Africa
Malaysia,25-01-2020,52396,2426,954,51442,Western Pacific
Maldives,25-01-2020,229935,1425,860,229075,South-East Asia
Malta,25-01-2020,334221,2162,1087,333134,Europe
Mauritania,25-01-2020,380711,907,398,380313,Africa
Mauritius,25-01-2020,8925,88,207,8718,Africa
Mexico,25-01-2020,334779,1770,1041,333738,Americas
Moldova,25-01-2020,60727,366,875,59852,Europe
Monaco,25-01-2020,8387,448,1044,7343,Europe
Mongolia,25-01-2020,368034,2240,98,367936,Western Pacific
Montenegro,25-01-2020,421793,238,921,420872,Europe
Morocco,25-01-2020,428524,1622,521,428003,Eastern Mediterranean
Namibia,25-01-2020,371413,812,136,371277,Africa
Nepal,25-01-2020,350692,2100,194,350498,South-East Asia
Netherlands,25-01-2020,428446,1454,443,428003,Europe
Netherlands,25-01-2020,382545,1691,496,382049,Europe
Netherlands,25-01-2020,7182,1277,733,6449,Europe
Netherlands,25-01-2020,89868,28,1084,88784,Europe
New Zealand,25-01-2020,437377,615,972,436405,Western Pacific
Nicaragua,25-01-2020,260598,1090,926,259672,Americas
Niger,25-01-2020,261500,2332,97,261403,Africa
Nigeria,25-01-2020,282739,854,208,282531,Africa
North Macedonia,25-01-2020,272423,629,205,272218,Europe
Norway,25-01-2020,115336,1189,501,114835,Europe
Oman,25-01-2020,23527,239,1182,22345,Eastern Mediterranean
Pakistan,25-01-2020,133115,778,330,132785,Eastern Mediterranean
Panama,25-01-2020,389820,1708,829,388991,Americas
Papua New Guinea,25-01-2020,270938,579,321,270617,Western Pacific
Paraguay,25-01-2020,150233,1925,899,149334,Americas
Peru,25-01-2020,245233,1233,78,245155,Americas
Philippines,25-01-2020,364092,792,716,363376,Western Pacific
Poland,25-01-2020,263653,1351,1069,262584,Europe
Portugal,25-01-2020,76663,1269,811,75852,Europe
Qatar,25-01-2020,33628,303,73,33555,Eastern Mediterranean
Romania,25-01-2020,31523,841,38,31485,Europe
Russia,25-01-2020,292097,1667,384,291713,Europe
Rwanda,25-01-2020,437697,2119,903,436794,Africa
Saint Lucia,25-01-2020,137594,908,433,137161,Americas
Saint Vincent and the Grenadines,25-01-2020,441880,63,1177,440703,Americas
San Marino,25-01-2020,406337,1262,157,406180,Europe
Saudi Arabia,25-01-2020,369107,1968,1185,367922,Eastern Mediterranean
Senegal,25-01-2020,61363,537,605,60758,Africa
Serbia,25-01-2020,24917,166,870,24047,Europe
Seychelles,25-01-2020,157496,1536,617,156879,Africa
Singapore,25-01-2020,62451,1109,660,61791,Western Pacific
Slovakia,25-01-2020,250950,790,217,250733,Europe
Slovenia,25-01-2020,305972,900,502,305470,Europe
Somalia,25-01-2020,286740,254,740,286000,Eastern Mediterranean
South Africa,25-01-2020,22287,1796,1108,21179,Africa
Spain,25-01-2020,287878,1038,612,287266,Europe
Sri Lanka,25-01-2020,212626,380,1070,211556,South-East Asia
Sudan,25-01-2020,448930,1940,981,447949,Eastern Mediterranean
Suriname,25-01-2020,76630,341,40,76590,Americas
Sweden,25-01-2020,177907,32,746,177161,Europe
Switzerland,25-01-2020,285937,6,357,285580,Europe
Taiwan*,25-01-2020,202844,2218,733,202111,Western Pacific
Tanzania,25-01-2020,74499,336,480,74019,Africa
Thailand,25-01-2020,70886,347,985,69901,South-East Asia
Togo,25-01-2020,423191,2378,55,423136,Africa
Trinidad and Tobago,25-01-2020,80743,1027,735,80008,Americas
Tunisia,25-01-2020,291703,56,1001,290702,Eastern Mediterranean
Turkey,25-01-2020,3483,2356,1250,2233,Europe
Uganda,25-01-2020,111734,2033,1225,110509,Africa
Ukraine,25-01-2020,42274,1468,1119,41155,Europe
United Arab Emirates,25-01-2020,36026,324,688,35338,Eastern Mediterranean
United Kingdom,25-01-2020,214583,98,530,214053,Europe
United Kingdom,25-01-2020,213218,265,320,212898,Europe
United Kingdom,25-01-2020,424328,2448,484,423844,Europe
United Kingdom,25-01-2020,320176,939,311,319865,Europe
United Kingdom,25-01-2020,295537,1714,277,295260,Europe
United Kingdom,25-01-2020,57197,651,18,57179,Europe
United Kingdom,25-01-2020,46725,2374,1147,45578,Europe
Uruguay,25-01-2020,263993,170,624,263369,Americas
US,25-01-2020,275015,118,872,274143,Americas
Uzbekistan,25-01-2020,360838,23,696,360142,Europe
Venezuela,25-01-2020,377936,1093,772,377164,Americas
Vietnam,25-01-2020,432642,1108,1196,431446,Western Pacific
Zambia,25-01-2020,150477,605,770,149707,Africa
Zimbabwe,25-01-2020,301186,1810,335,300851,Africa
Dominica,25-01-2020,91036,679,999,90037,Americas
Grenada,25-01-2020,168336,1117,995,167341,Americas
Mozambique,25-01-2020,119253,1548,993,118260,Africa
Syria,25-01-2020,275882,546,1007,274875,Eastern Mediterranean
Timor-Leste,25-01-2020,343658,1354,847,342811,South-East Asia
Belize,25-01-2020,125238,1661,1024,124214,Americas
Laos,25-01-2020,246473,2104,659,245814,Western Pacific
Libya,25-01-2020,114882,1299,45,114837,Eastern Mediterranean
West Bank and Gaza,25-01-2020,406715,310,345,406370,Eastern Mediterranean
Guinea-Bissau,25-01-2020,14260,1963,207,14053,Africa
Mali,25-01-2020,414834,1201,691,414143,Africa
Saint Kitts and Nevis,25-01-2020,37378,1027,1200,36178,Americas
Canada,25-01-2020,201416,583,1230,200186,Americas
Canada,25-01-2020,307997,1733,1218,306779,Americas
Kosovo,25-01-2020,313006,50,69,312937,Europe
Burma,25-01-2020,360659,1303,758,359901,South-East Asia
United Kingdom,25-01-2020,169937,392,655,169282,Europe
United Kingdom,25-01-2020,159686,2182,849,158837,Europe
United Kingdom,25-01-2020,326331,1041,784,325547,Europe
Botswana,25-01-2020,136662,845,585,136077,Africa
Burundi,25-01-2020,2733,206,1117,1616,Africa
Sierra Leone,25-01-2020,107407,313,713,106694,Africa
Malawi,25-01-2020,244308,2397,109,244199,Africa
United Kingdom,25-01-2020,14614,1446,1065,13549,Europe
France,25-01-2020,125216,1968,729,124487,Europe
South Sudan,25-01-2020,424280,1084,33,424247,Africa
Western Sahara,25-01-2020,305451,1049,220,305231,Africa
Sao Tome and Principe,25-01-2020,233377,2369,155,233222,Africa
Yemen,25-01-2020,332819,888,341,332478,Eastern Mediterranean
Comoros,25-01-2020,31447,1063,1181,30266,Africa
Tajikistan,25-01-2020,192293,1675,209,192084,Europe
Lesotho,25-01-2020,355322,1958,449,354873,Africa
Afghanistan,26-01-2020,253189,673,373,252816,Eastern Mediterranean
Albania,26-01-2020,206073,752,267,205806,Europe
Algeria,26-01-2020,338834,1923,780,338054,Africa
Andorra,26-01-2020,391142,1105,1134,390008,Europe
Angola,26-01-2020,17434,1471,470,16964,Africa
Antigua and Barbuda,26-01-2020,28793,1448,1022,27771,Americas
Argentina,26-01-2020,351859,1899,638,351221,Americas
Armenia,26-01-2020,449998,718,292,449706,Europe
Australia,26-01-2020,171471,958,37,171434,Western Pacific
Australia,26-01-2020,163033,331,979,162054,Western Pacific
Australia,26-01-2020,144915,1449,951,143964,Western Pacific
Australia,26-01-2020,60106,126,1178,58928,Western Pacific
Australia,26-01-2020,19369,461,102,19267,Western Pacific
Australia,26-01-2020,316760,1840,1124,315636,Western Pacific
Australia,26-01-2020,116381,2343,584,115797,Western Pacific
Australia,26-01-2020,321306,2251,941,320365,Western Pacific
Austria,26-01-2020,301850,1344,384,301466,Europe
Azerbaijan,26-01-2020,186752,2412,825,185927,Europe
Bahamas,26-01-2020,371655,2084,335,371320,Americas
Bahrain,26-01-2020,141956,129,1234,140722,Eastern Mediterranean
Bangladesh,26-01-2020,225911,756,587,225324,South-East Asia
Barbados,26-01-2020,312198,1595,1121,311077,Americas
Belarus,26-01-2020,103795,935,993,102802,Europe
Belgium,26-01-2020,353634,1790,689,352945,Europe
Benin,26-01-2020,397101,747,1074,396027,Africa
Bhutan,26-01-2020,20554,1809,37,20517,South-East Asia
Bolivia,26-01-2020,350695,1573,722,349973,Americas
Bosnia and Herzegovina,26-01-2020,215461,1432,259,215202,Europe
Brazil,26-01-2020,80192,1375,70,80122,Americas
Brunei,26-01-2020,278960,1410,744,278216,Western Pacific
Bulgaria,26-01-2020,338945,461,221,338724,Europe
Burkina Faso,26-01-2020,119217,1568,713,118504,Africa
Cabo Verde,26-01-2020,78912,743,843,78069,Africa
Cambodia,26-01-2020,113413,1461,539,112874,Western Pacific
Cameroon,26-01-2020,97728,911,574,97154,Africa
Canada,26-01-2020,88543,2261,758,87785,Americas
Canada,26-01-2020,171782,996,125,171657,Americas
Canada,26-01-2020,66939,2063,957,65982,Americas
Canada,26-01-2020,79190,2388,1009,78181,Americas
Canada,26-01-2020,144208,113,267,143941,Americas
Canada,26-01-2020,413026,1512,1155,411871,Americas
Canada,26-01-2020,54246,2497,386,53860,Americas
Canada,26-01-2020,432956,2256,155,432801,Americas
Canada,26-01-2020,28847,2039,1225,27622,Americas
Canada,26-01-2020,267345,593,1226,266119,Americas
Central African Republic,26-01-2020,90603,1220,294,90309,Africa
Chad,26-01-2020,368480,1288,1024,367456,Africa
Chile,26-01-2020,174672,1032,80,174592,Americas
China,26-01-2020,224575,1862,729,223846,Western Pacific
China,26-01-2020,384901,2448,453,384448,Western Pacific
China,26-01-2020,16537,1186,242,16295,Western Pacific
China,26-01-2020,142539,1802,126,142413,Western Pacific
China,26-01-2020,194167,40,553,193614,Western Pacific
China,26-01-2020,98113,2424,818,97295,Western Pacific
China,26-01-2020,298191,888,462,297729,Western Pacific
China,26-01-2020,68207,1051,134,68073,Western Pacific
China,26-01-2020,183930,2317,972,182958,Western Pacific
China,26-01-2020,1602,1767,967,635,Western Pacific
China,26-01-2020,324305,362,1122,323183,Western Pacific
China,26-01-2020,236018,2379,215,235803,Western Pacific
China,26-01-2020,202402,823,65,202337,Western Pacific
China,26-01-2020,397744,483,270,397474,Western Pacific
China,26-01-2020,233588,6,609,232979,Western Pacific
China,26-01-2020,21456,1854,510,20946,Western Pacific
China,26-01-2020,61523,1481,1108,60415,Western Pacific
China,26-01-2020,257577,256,396,257181,Western Pacific
China,26-01-2020,168619,332,655,167964,Western Pacific
China,26-01-2020,301194,2443,466,300728,Western Pacific
China,26-01-2020,248628,1821,46,248582,Western Pacific
China,26-01-2020,254067,2019,340,253727,Western Pacific
China,26-01-2020,342296,436,232,342064,Western Pacific
China,26-01-2020,417669,1638,186,417483,Western Pacific
China,26-01-2020,124442,1003,39,124403,Western Pacific
China,26-01-2020,431561,1787,926,430635,Western Pacific
China,26-01-2020,260861,995,717,260144,Western Pacific
China,26-01-2020,293477,1497,735,292742,Western Pacific
China,26-01-2020,249500,2394,796,248704,Western Pacific
China,26-01-2020,276072,2346,383,275689,Western Pacific
China,26-01-2020,175004,940,866,174138,Western Pacific
China,26-01-2020,427523,1481,1111,426412,Western Pacific
China,26-01-2020,18360,2060,234,18126,Western Pacific
Colombia,26-01-2020,387259,1282,1168,386091,Americas
Congo (Brazzaville),26-01-2020,321917,787,715,321202,Africa
Congo (Kinshasa),26-01-2020,25712,2496,266,25446,Africa
Costa Rica,26-01-2020,225995,51,915,225080,Americas
Cote d'Ivoire,26-01-2020,168080,883,382,167698,Africa
Croatia,26-01-2020,230258,1546,1086,229172,Europe
Cuba,26-01-2020,246905,912,683,246222,Americas
Cyprus,26-01-2020,217600,1820,720,216880,Europe
Czechia,26-01-2020,232777,2439,1230,231547,Europe
Denmark,26-01-2020,348438,2136,10,348428,Europe
Greenland,26-01-2020,100808,1283,1000,99808,Europe
Denmark,26-01-2020,36588,998,224,36364,Europe
Djibouti,26-01-2020,149544,1290,952,148592,Eastern Mediterranean
Dominican Republic,26-01-2020,288616,295,418,288198,Americas
Ecuador,26-01-2020,245692,2358,764,244928,Americas
Egypt,26-01-2020,282642,1660,260,282382,Eastern Mediterranean
El Salvador,26-01-2020,130279,1372,693,129586,Americas
Equatorial Guinea,26-01-2020,140691,1364,447,140244,Africa
Eritrea,26-01-2020,314194,178,452,313742,Africa
Estonia,26-01-2020,267711,1107,1114,266597,Europe
Eswatini,26-01-2020,21712,1824,1020,20692,Africa
Ethiopia,26-01-2020,118140,1279,441,117699,Africa
Fiji,26-01-2020,23775,972,321,23454,Western Pacific
Finland,26-01-2020,317390,995,273,317117,Europe
France,26-01-2020,294808,2456,85,294723,Europe
France,26-01-2020,67223,337,635,66588,Europe
France,26-01-2020,65560,1452,765,64795,Europe
France,26-01-2020,359799,431,1127,358672,Europe
France,26-01-2020,208378,1295,968,207410,Europe
France,26-01-2020,423569,2131,1146,422423,Europe
France,26-01-2020,317129,773,480,316649,Europe
France,26-01-2020,68458,1436,745,67713,Europe
France,26-01-2020,253980,194,1157,252823,Europe
France,26-01-2020,68910,1701,607,68303,Europe
Gabon,26-01-2020,209857,1664,1114,208743,Africa
Gambia,26-01-2020,220926,2094,1242,219684,Africa
Georgia,26-01-2020,314836,1006,1045,313791,Europe
Germany,26-01-2020,345297,2225,1023,344274,Europe
Ghana,26-01-2020,340469,1259,884,339585,Africa
Greece,26-01-2020,106988,2123,175,106813,Europe
Guatemala,26-01-2020,240085,1059,515,239570,Americas
Guinea,26-01-2020,49805,956,1200,48605,Africa
Guyana,26-01-2020,78980,923,688,78292,Americas
Haiti,26-01-2020,80841,1157,659,80182,Americas
Holy See,26-01-2020,66873,1422,272,66601,Europe
Honduras,26-01-2020,371612,943,1198,370414,Americas
Hungary,26-01-2020,199235,293,27,199208,Europe
Iceland,26-01-2020,149430,2353,272,149158,Europe
India,26-01-2020,285010,1651,666,284344,South-East Asia
Indonesia,26-01-2020,339290,2172,669,338621,South-East Asia
Iran,26-01-2020,39761,256,10,39751,Eastern Mediterranean
Iraq,26-01-2020,131439,1904,1097,130342,Eastern Mediterranean
Ireland,26-01-2020,383765,1854,809,382956,Europe
Israel,26-01-2020,6815,1166,1145,5670,Europe
Italy,26-01-2020,32920,1703,283,32637,Europe
Jamaica,26-01-2020,214822,753,286,214536,Americas
Japan,26-01-2020,423374,787,885,422489,Western Pacific
Jordan,26-01-2020,180264,734,58,180206,Eastern Mediterranean
Kazakhstan,26-01-2020,313149,1347,748,312401,Europe
Kenya,26-01-2020,373049,244,367,372682,Africa
South Korea,26-01-2020,88639,941,19,88620,Western Pacific
Kuwait,26-01-2020,39180,329,1244,37936,Eastern Mediterranean
Kyrgyzstan,26-01-2020,403341,2157,836,402505,Europe
Latvia,26-01-2020,285575,2495,839,284736,Europe
Lebanon,26-01-2020,224470,734,157,224313,Eastern Mediterranean
Liberia,26-01-2020,269056,107,410,268646,Africa
Liechtenstein,26-01-2020,437608,664,31,437577,Europe
Lithuania,26-01-2020,59956,463,610,59346,Europe
Luxembourg,26-01-2020,73677,1928,453,73224,Europe
Madagascar,26-01-2020,59100,1524,488,58612,Africa
Malaysia,26-01-2020,154657,496,682,153975,Western Pacific
Maldives,26-01-2020,350735,92,1237,349498,South-East Asia
Malta,26-01-2020,96935,2384,550,96385,Europe
Mauritania,26-01-2020,40220,2364,930,39290,Africa
Mauritius,26-01-2020,233222,947,1031,232191,Africa
Mexico,26-01-2020,96185,867,676,95509,Americas
Moldova,26-01-2020,325204,1646,1213,323991,Europe
Monaco,26-01-2020,341842,1752,691,341151,Europe
Mongolia,26-01-2020,197402,451,440,196962,Western Pacific
Montenegro,26-01-2020,70534,1282,694,69840,Europe
Morocco,26-01-2020,75561,468,545,75016,Eastern Mediterranean
Namibia,26-01-2020,329738,1177,685,329053,Africa
Nepal,26-01-2020,76427,1623,318,76109,South-East Asia
Netherlands,26-01-2020,391929,433,544,391385,Europe
Netherlands,26-01-2020,136179,2191,1005,135174,Europe
Netherlands,26-01-2020,243543,2239,1095,242448,Europe
Netherlands,26-01-2020,301288,1226,190,301098,Europe
New Zealand,26-01-2020,207801,1927,958,206843,Western Pacific
Nicaragua,26-01-2020,212558,1804,746,211812,Americas
Niger,26-01-2020,27829,1946,636,27193,Africa
Nigeria,26-01-2020,213328,622,553,212775,Africa
North Macedonia,26-01-2020,423818,2095,792,423026,Europe
Norway,26-01-2020,207721,1688,354,207367,Europe
Oman,26-01-2020,427632,403,170,427462,Eastern Mediterranean
Pakistan,26-01-2020,379951,2155,997,378954,Eastern Mediterranean
Panama,26-01-2020,388036,330,365,387671,Americas
Papua New Guinea,26-01-2020,197094,1038,878,196216,Western Pacific
Paraguay,26-01-2020,92277,1958,478,91799,Americas
Peru,26-01-2020,270753,1749,457,270296,Americas
Philippines,26-01-2020,169846,1328,1225,168621,Western Pacific
Poland,26-01-2020,47736,1620,1132,46604,Europe
Portugal,26-01-2020,392947,1678,256,392691,Europe
Qatar,26-01-2020,203586,2143,499,203087,Eastern Mediterranean
Romania,26-01-2020,101161,2237,314,100847,Europe
Russia,26-01-2020,69479,392,353,69126,Europe
Rwanda,26-01-2020,262322,1458,356,261966,Africa
Saint Lucia,26-01-2020,362409,992,751,361658,Americas
Saint Vincent and the Grenadines,26-01-2020,350858,477,1088,349770,Americas
San Marino,26-01-2020,349832,280,637,349195,Europe
Saudi Arabia,26-01-2020,270351,2125,250,270101,Eastern Mediterranean
Senegal,26-01-2020,187743,774,1008,186735,Africa
Serbia,26-01-2020,423126,2393,1012,422114,Europe
Seychelles,26-01-2020,196087,679,709,195378,Africa
Singapore,26-01-2020,141053,2407,918,140135,Western Pacific
Slovakia,26-01-2020,78591,803,1085,77506,Europe
Slovenia,26-01-2020,364385,439,1171,363214,Europe
Somalia,26-01-2020,268629,362,181,268448,Eastern Mediterranean
South Africa,26-01-2020,257142,1038,390,256752,Africa
Spain,26-01-2020,364813,1860,446,364367,Europe
Sri Lanka,26-01-2020,66892,709,1,66891,South-East Asia
Sudan,26-01-2020,329964,1980,1092,328872,Eastern Mediterranean
Suriname,26-01-2020,360802,711,996,359806,Americas
Sweden,26-01-2020,374572,1578,854,373718,Europe
Switzerland,26-01-2020,25180,586,335,24845,Europe
Taiwan*,26-01-2020,149259,708,767,148492,Western Pacific
Tanzania,26-01-2020,416802,2133,491,416311,Africa
Thailand,26-01-2020,224712,795,30,224682,South-East Asia
Togo,26-01-2020,14200,1425,522,13678,Africa
Trinidad and Tobago,26-01-2020,351747,2254,367,351380,Americas
Tunisia,26-01-2020,150539,1581,421,150118,Eastern Mediterranean
Turkey,26-01-2020,69516,2291,791,68725,Europe
Uganda,26-01-2020,113215,1028,325,112890,Africa
Ukraine,26-01-2020,289808,1571,509,289299,Europe
United Arab Emirates,26-01-2020,57026,1729,782,56244,Eastern Mediterranean
United Kingdom,26-01-2020,45017,486,1203,43814,Europe
United Kingdom,26-01-2020,406914,151,869,406045,Europe
United Kingdom,26-01-2020,270233,700,1180,269053,Europe
United Kingdom,26-01-2020,281555,2171,94,281461,Europe
United Kingdom,26-01-2020,111847,682,1072,110775,Europe
United Kingdom,26-01-2020,197014,802,9,197005,Europe
United Kingdom,26-01-2020,135531,670,569,134962,Europe
Uruguay,26-01-2020,413090,1212,39,413051,Americas
US,26-01-2020,226365,932,876,225489,Americas
Uzbekistan,26-01-2020,91926,2096,583,91343,Europe
Venezuela,26-01-2020,244359,1485,385,243974,Americas
Vietnam,26-01-2020,146027,334,853,145174,Western Pacific
Zambia,26-01-2020,344626,1148,639,343987,Africa
Zimbabwe,26-01-2020,242023,2274,633,241390,Africa
Dominica,26-01-2020,202189,2034,1060,201129,Americas
Grenada,26-01-2020,259271,163,683,258588,Americas
Mozambique,26-01-2020,292062,1330,788,291274,Africa
Syria,26-01-2020,354196,1330,1151,353045,Eastern Mediterranean
Timor-Leste,26-01-2020,411887,2444,10,411877,South-East Asia
Belize,26-01-2020,306789,1753,119,306670,Americas
Laos,26-01-2020,15833,454,461,15372,Western Pacific
Libya,26-01-2020,138912,2191,792,138120,Eastern Mediterranean
West Bank and Gaza,26-01-2020,313392,986,903,312489,Eastern Mediterranean
Guinea-Bissau,26-01-2020,181184,1226,456,180728,Africa
Mali,26-01-2020,105520,1572,275,105245,Africa
Saint Kitts and Nevis,26-01-2020,177846,82,72,177774,Americas
Canada,26-01-2020,56402,1768,72,56330,Americas
Canada,26-01-2020,79713,2165,145,79568,Americas
Kosovo,26-01-2020,371961,2165,774,371187,Europe
Burma,26-01-2020,425311,1239,580,424731,South-East Asia
United Kingdom,26-01-2020,384963,1066,96,384867,Europe
United Kingdom,26-01-2020,2731,398,667,2064,Europe
United Kingdom,26-01-2020,71537,274,189,71348,Europe
Botswana,26-01-2020,324605,1599,624,323981,Africa
Burundi,26-01-2020,323050,1227,692,322358,Africa
Sierra Leone,26-01-2020,120548,305,1073,119475,Africa
Malawi,26-01-2020,186783,925,911,185872,Africa
United Kingdom,26-01-2020,304241,311,797,303444,Europe
France,26-01-2020,446569,1854,994,445575,Europe
South Sudan,26-01-2020,221745,2331,915,220830,Africa
Western Sahara,26-01-2020,266206,1500,1231,264975,Africa
Sao Tome and Principe,26-01-2020,321901,430,1210,320691,Africa
Yemen,26-01-2020,446887,1646,28,446859,Eastern Mediterranean
Comoros,26-01-2020,278169,1806,441,277728,Africa
Tajikistan,26-01-2020,137954,2418,411,137543,Europe
Lesotho,26-01-2020,150008,1439,681,149327,Africa
Afghanistan,27-01-2020,296722,211,1096,295626,Eastern Mediterranean
Albania,27-01-2020,444417,40,1216,443201,Europe
Algeria,27-01-2020,314897,777,826,314071,Africa
Andorra,27-01-2020,185761,1909,554,185207,Europe
Angola,27-01-2020,297500,1171,710,296790,Africa
Antigua and Barbuda,27-01-2020,176273,1047,687,175586,Americas
Argentina,27-01-2020,219667,97,770,218897,Americas
Armenia,27-01-2020,202824,2201,250,202574,Europe
Australia,27-01-2020,168537,234,1070,167467,Western Pacific
Australia,27-01-2020,356024,607,905,355119,Western Pacific
Australia,27-01-2020,194541,2215,1200,193341,Western Pacific
Australia,27-01-2020,321908,1651,326,321582,Western Pacific
Australia,27-01-2020,294752,2086,1184,293568,Western Pacific
Australia,27-01-2020,39720,1462,178,39542,Western Pacific
Australia,27-01-2020,75875,2170,868,75007,Western Pacific
Australia,27-01-2020,2018,1859,980,1038,Western Pacific
Austria,27-01-2020,6272,927,455,5817,Europe
Azerbaijan,27-01-2020,3005,1521,306,2699,Europe
Bahamas,27-01-2020,363427,177,687,362740,Americas
Bahrain,27-01-2020,172826,610,739,172087,Eastern Mediterranean
Bangladesh,27-01-2020,423610,1141,493,423117,South-East Asia
Barbados,27-01-2020,349837,1517,404,349433,Americas
Belarus,27-01-2020,90170,762,127,90043,Europe
Belgium,27-01-2020,77377,1311,1149,76228,Europe
Benin,27-01-2020,437258,108,569,436689,Africa
Bhutan,27-01-2020,216195,198,575,215620,South-East Asia
Bolivia,27-01-2020,65822,931,205,65617,Americas
Bosnia and Herzegovina,27-01-2020,118597,2474,131,118466,Europe
Brazil,27-01-2020,306219,853,1180,305039,Americas
Brunei,27-01-2020,355593,601,547,355046,Western Pacific
Bulgaria,27-01-2020,375251,1500,536,374715,Europe
Burkina Faso,27-01-2020,225742,1800,603,225139,Africa
Cabo Verde,27-01-2020,436238,1418,1019,435219,Africa
Cambodia,27-01-2020,250795,584,370,250425,Western Pacific
Cameroon,27-01-2020,385054,1121,934,384120,Africa
Canada,27-01-2020,158527,508,777,157750,Americas
Canada,27-01-2020,355070,1712,180,354890,Americas
Canada,27-01-2020,214636,1206,65,214571,Americas
Canada,27-01-2020,97477,2278,10,97467,Americas
Canada,27-01-2020,329950,790,490,329460,Americas
Canada,27-01-2020,57170,1339,108,57062,Americas
Canada,27-01-2020,259279,2236,682,258597,Americas
Canada,27-01-2020,229130,280,684,228446,Americas
Canada,27-01-2020,244235,1902,1216,243019,Americas
Canada,27-01-2020,419118,1372,527,418591,Americas
Central African Republic,27-01-2020,387680,999,742,386938,Africa
Chad,27-01-2020,117432,341,492,116940,Africa
Chile,27-01-2020,289002,570,575,288427,Americas
China,27-01-2020,370946,2235,1022,369924,Western Pacific
China,27-01-2020,93275,2025,738,92537,Western Pacific
China,27-01-2020,405434,326,909,404525,Western Pacific
China,27-01-2020,152909,2111,1031,151878,Western Pacific
China,27-01-2020,436241,1318,15,436226,Western Pacific
China,27-01-2020,201968,2387,1053,200915,Western Pacific
China,27-01-2020,297784,522,785,296999,Western Pacific
China,27-01-2020,252244,863,7,252237,Western Pacific
China,27-01-2020,421911,2074,464,421447,Western Pacific
China,27-01-2020,3984,2079,755,3229,Western Pacific
China,27-01-2020,200593,2123,862,199731,Western Pacific
China,27-01-2020,20220,2497,886,19334,Western Pacific
China,27-01-2020,106307,150,274,106033,Western Pacific
China,27-01-2020,333179,515,63,333116,Western Pacific
China,27-01-2020,170946,543,296,170650,Western Pacific
China,27-01-2020,183262,2143,624,182638,Western Pacific
China,27-01-2020,278418,1317,418,278000,Western Pacific
China,27-01-2020,304309,166,950,303359,Western Pacific
China,27-01-2020,7128,2471,206,6922,Western Pacific
China,27-01-2020,287435,666,451,286984,Western Pacific
China,27-01-2020,396550,868,803,395747,Western Pacific
China,27-01-2020,115815,1218,41,115774,Western Pacific
China,27-01-2020,301122,1120,1179,299943,Western Pacific
China,27-01-2020,277630,778,1212,276418,Western Pacific
China,27-01-2020,142327,1855,406,141921,Western Pacific
China,27-01-2020,37870,731,494,37376,Western Pacific
China,27-01-2020,408766,2351,842,407924,Western Pacific
China,27-01-2020,3422,1875,67,3355,Western Pacific
China,27-01-2020,30174,1331,185,29989,Western Pacific
China,27-01-2020,390231,1662,396,389835,Western Pacific
China,27-01-2020,128245,1230,550,127695,Western Pacific
China,27-01-2020,330474,988,87,330387,Western Pacific
China,27-01-2020,386211,1002,1100,385111,Western Pacific
Colombia,27-01-2020,215568,1461,1033,214535,Americas
Congo (Brazzaville),27-01-2020,8248,157,758,7490,Africa
Congo (Kinshasa),27-01-2020,438521,1701,803,437718,Africa
Costa Rica,27-01-2020,116915,1899,371,116544,Americas
Cote d'Ivoire,27-01-2020,124073,303,357,123716,Africa
Croatia,27-01-2020,313730,246,356,313374,Europe
Cuba,27-01-2020,160559,700,678,159881,Americas
Cyprus,27-01-2020,71345,1782,1105,70240,Europe
Czechia,27-01-2020,293873,781,1230,292643,Europe
Denmark,27-01-2020,3971,110,65,3906,Europe
Greenland,27-01-2020,144534,675,457,144077,Europe
Denmark,27-01-2020,410831,2400,976,409855,Europe
Djibouti,27-01-2020,139251,1307,653,138598,Eastern Mediterranean
Dominican Republic,27-01-2020,8586,1657,1078,7508,Americas
Ecuador,27-01-2020,399605,627,923,398682,Americas
Egypt,27-01-2020,421954,1921,297,421657,Eastern Mediterranean
El Salvador,27-01-2020,173524,1995,695,172829,Americas
Equatorial Guinea,27-01-2020,449724,1807,1224,448500,Africa
Eritrea,27-01-2020,187047,999,1022,186025,Africa
Estonia,27-01-2020,417337,277,342,416995,Europe
Eswatini,27-01-2020,330647,251,380,330267,Africa
Ethiopia,27-01-2020,131355,836,743,130612,Africa
Fiji,27-01-2020,375428,1081,22,375406,Western Pacific
Finland,27-01-2020,426217,515,655,425562,Europe
France,27-01-2020,192735,312,312,192423,Europe
France,27-01-2020,285054,573,690,284364,Europe
France,27-01-2020,286842,1857,879,285963,Europe
France,27-01-2020,273602,977,1004,272598,Europe
France,27-01-2020,12848,1657,137,12711,Europe
France,27-01-2020,385592,1721,616,384976,Europe
France,27-01-2020,147527,1374,1152,146375,Europe
France,27-01-2020,42153,2199,54,42099,Europe
France,27-01-2020,366796,159,368,366428,Europe
France,27-01-2020,395004,2138,335,394669,Europe
Gabon,27-01-2020,359903,617,842,359061,Africa
Gambia,27-01-2020,261337,2216,161,261176,Africa
Georgia,27-01-2020,372477,1135,794,371683,Europe
Germany,27-01-2020,245504,2202,1086,244418,Europe
Ghana,27-01-2020,4442,310,759,3683,Africa
Greece,27-01-2020,97267,1600,523,96744,Europe
Guatemala,27-01-2020,181104,1897,637,180467,Americas
Guinea,27-01-2020,115977,1724,887,115090,Africa
Guyana,27-01-2020,14686,1013,983,13703,Americas
Haiti,27-01-2020,61869,1995,26,61843,Americas
Holy See,27-01-2020,137355,447,78,137277,Europe
Honduras,27-01-2020,424323,1919,1018,423305,Americas
Hungary,27-01-2020,243552,1220,593,242959,Europe
Iceland,27-01-2020,347757,2443,982,346775,Europe
India,27-01-2020,370801,1433,204,370597,South-East Asia
Indonesia,27-01-2020,387037,1108,210,386827,South-East Asia
Iran,27-01-2020,108937,2455,1153,107784,Eastern Mediterranean
Iraq,27-01-2020,375163,2324,211,374952,Eastern Mediterranean
Ireland,27-01-2020,449698,2419,227,449471,Europe
Israel,27-01-2020,401570,1291,370,401200,Europe
Italy,27-01-2020,247040,1164,98,246942,Europe
Jamaica,27-01-2020,187509,417,61,187448,Americas
Japan,27-01-2020,201231,1342,999,200232,Western Pacific
Jordan,27-01-2020,259527,1550,365,259162,Eastern Mediterranean
Kazakhstan,27-01-2020,319249,1903,1240,318009,Europe
Kenya,27-01-2020,37074,2197,512,36562,Africa
South Korea,27-01-2020,312299,1400,1247,311052,Western Pacific
Kuwait,27-01-2020,239864,517,1035,238829,Eastern Mediterranean
Kyrgyzstan,27-01-2020,12964,1950,353,12611,Europe
Latvia,27-01-2020,329699,1507,903,328796,Europe
Lebanon,27-01-2020,20854,2350,127,20727,Eastern Mediterranean
Liberia,27-01-2020,354213,2420,948,353265,Africa
Liechtenstein,27-01-2020,441068,145,33,441035,Europe
Lithuania,27-01-2020,399183,1999,408,398775,Europe
Luxembourg,27-01-2020,332098,1600,359,331739,Europe
Madagascar,27-01-2020,24776,1160,597,24179,Africa
Malaysia,27-01-2020,7964,592,116,7848,Western Pacific
Maldives,27-01-2020,165583,1092,395,165188,South-East Asia
Malta,27-01-2020,233260,1490,731,232529,Europe
Mauritania,27-01-2020,86558,683,961,85597,Africa
Mauritius,27-01-2020,109719,22,1041,108678,Africa
Mexico,27-01-2020,394887,2256,884,394003,Americas
Moldova,27-01-2020,391501,1546,509,390992,Europe
Monaco,27-01-2020,363096,288,706,362390,Europe
Mongolia,27-01-2020,69813,2399,219,69594,Western Pacific
Montenegro,27-01-2020,201204,1679,129,201075,Europe
Morocco,27-01-2020,331428,435,769,330659,Eastern Mediterranean
Namibia,27-01-2020,155656,1492,1053,154603,Africa
Nepal,27-01-2020,419089,1401,563,418526,South-East Asia
Netherlands,27-01-2020,314489,61,611,313878,Europe
Netherlands,27-01-2020,210159,1218,528,209631,Europe
Netherlands,27-01-2020,387189,1944,1007,386182,Europe
Netherlands,27-01-2020,16267,1425,888,15379,Europe
New Zealand,27-01-2020,265023,739,81,264942,Western Pacific
Nicaragua,27-01-2020,61676,115,402,61274,Americas
Niger,27-01-2020,419770,1260,835,418935,Africa
Nigeria,27-01-2020,42858,1635,179,42679,Africa
North Macedonia,27-01-2020,247830,2296,1074,246756,Europe
Norway,27-01-2020,67737,25,820,66917,Europe
Oman,27-01-2020,58241,1139,829,57412,Eastern Mediterranean
Pakistan,27-01-2020,106352,1551,719,105633,Eastern Mediterranean
Panama,27-01-2020,1292,372,1041,251,Americas
Papua New Guinea,27-01-2020,414195,1038,798,413397,Western Pacific
Paraguay,27-01-2020,105749,1986,436,105313,Americas
Peru,27-01-2020,23930,50,366,23564,Americas
Philippines,27-01-2020,249853,1639,488,249365,Western Pacific
Poland,27-01-2020,62166,1708,425,61741,Europe
Portugal,27-01-2020,218120,1394,894,217226,Europe
Qatar,27-01-2020,342914,1129,808,342106,Eastern Mediterranean
Romania,27-01-2020,65780,1448,707,65073,Europe
Russia,27-01-2020,384440,1668,168,384272,Europe
Rwanda,27-01-2020,105052,2079,958,104094,Africa
Saint Lucia,27-01-2020,367677,1913,183,367494,Americas
Saint Vincent and the Grenadines,27-01-2020,187633,1266,998,186635,Americas
San Marino,27-01-2020,20741,601,1196,19545,Europe
Saudi Arabia,27-01-2020,292443,17,1092,291351,Eastern Mediterranean
Senegal,27-01-2020,141113,2065,1109,140004,Africa
Serbia,27-01-2020,368104,1066,503,367601,Europe
Seychelles,27-01-2020,144489,402,780,143709,Africa
Singapore,27-01-2020,216828,1597,1078,215750,Western Pacific
Slovakia,27-01-2020,201084,2416,1221,199863,Europe
Slovenia,27-01-2020,52580,1995,871,51709,Europe
Somalia,27-01-2020,225776,90,366,225410,Eastern Mediterranean
South Africa,27-01-2020,159668,2127,575,159093,Africa
Spain,27-01-2020,182383,314,739,181644,Europe
Sri Lanka,27-01-2020,297342,1886,554,296788,South-East Asia
Sudan,27-01-2020,71888,1702,171,71717,Eastern Mediterranean
Suriname,27-01-2020,392164,1570,306,391858,Americas
Sweden,27-01-2020,339492,543,906,338586,Europe
Switzerland,27-01-2020,322636,222,385,322251,Europe
Taiwan*,27-01-2020,233115,1591,428,232687,Western Pacific
Tanzania,27-01-2020,148133,1266,817,147316,Africa
Thailand,27-01-2020,130470,33,953,129517,South-East Asia
Togo,27-01-2020,31701,1856,422,31279,Africa
Trinidad and Tobago,27-01-2020,203800,94,632,203168,Americas
Tunisia,27-01-2020,55151,70,659,54492,Eastern Mediterranean
Turkey,27-01-2020,443996,2000,739,443257,Europe
Uganda,27-01-2020,411204,991,776,410428,Africa
Ukraine,27-01-2020,436557,2033,339,436218,Europe
United Arab Emirates,27-01-2020,121762,940,847,120915,Eastern Mediterranean
United Kingdom,27-01-2020,225394,987,896,224498,Europe
United Kingdom,27-01-2020,368869,1927,702,368167,Europe
United Kingdom,27-01-2020,141971,424,809,141162,Europe
United Kingdom,27-01-2020,47160,2354,397,46763,Europe
United Kingdom,27-01-2020,57995,970,837,57158,Europe
United Kingdom,27-01-2020,253244,1894,302,252942,Europe
United Kingdom,27-01-2020,447608,741,118,447490,Europe
Uruguay,27-01-2020,323134,102,743,322391,Americas
US,27-01-2020,272564,1654,533,272031,Americas
Uzbekistan,27-01-2020,85832,1956,1057,84775,Europe
Venezuela,27-01-2020,173637,375,14,173623,Americas
Vietnam,27-01-2020,382755,2444,842,381913,Western Pacific
Zambia,27-01-2020,53448,2436,969,52479,Africa
Zimbabwe,27-01-2020,425094,841,1005,424089,Africa
Dominica,27-01-2020,257378,1501,771,256607,Americas
Grenada,27-01-2020,196581,77,1150,195431,Americas
Mozambique,27-01-2020,160298,1492,675,159623,Africa
Syria,27-01-2020,52437,544,843,51594,Eastern Mediterranean
Timor-Leste,27-01-2020,270616,1441,215,270401,South-East Asia
Belize,27-01-2020,159718,2233,557,159161,Americas
Laos,27-01-2020,366906,278,680,366226,Western Pacific
Libya,27-01-2020,373618,215,246,373372,Eastern Mediterranean
West Bank and Gaza,27-01-2020,88934,26,1169,87765,Eastern Mediterranean
Guinea-Bissau,27-01-2020,274644,1266,448,274196,Africa
Mali,27-01-2020,448331,586,194,448137,Africa
Saint Kitts and Nevis,27-01-2020,42296,204,442,41854,Americas
Canada,27-01-2020,211609,489,558,211051,Americas
Canada,27-01-2020,298129,2076,375,297754,Americas
Kosovo,27-01-2020,274316,2095,1198,273118,Europe
Burma,27-01-2020,445622,1270,729,444893,South-East Asia
United Kingdom,27-01-2020,378423,1614,110,378313,Europe
United Kingdom,27-01-2020,191696,1787,436,191260,Europe
United Kingdom,27-01-2020,15040,388,1045,13995,Europe
Botswana,27-01-2020,152857,1054,456,152401,Africa
Burundi,27-01-2020,22734,1842,1144,21590,Africa
Sierra Leone,27-01-2020,332861,220,499,332362,Africa
Malawi,27-01-2020,47170,546,1145,46025,Africa
United Kingdom,27-01-2020,114387,1613,25,114362,Europe
France,27-01-2020,100671,1972,92,100579,Europe
South Sudan,27-01-2020,151734,552,184,151550,Africa
Western Sahara,27-01-2020,8956,1801,823,8133,Africa
Sao Tome and Principe,27-01-2020,289217,1465,556,288661,Africa
Yemen,27-01-2020,392377,2092,564,391813,Eastern Mediterranean
Comoros,27-01-2020,122840,577,777,122063,Africa
Tajikistan,27-01-2020,422511,23,979,421532,Europe
Lesotho,27-01-2020,307923,1411,369,307554,Africa
Afghanistan,28-01-2020,152859,1484,250,152609,Eastern Mediterranean
Albania,28-01-2020,3182,78,150,3032,Europe
Algeria,28-01-2020,204196,1721,189,204007,Africa
Andorra,28-01-2020,362372,804,45,362327,Europe
Angola,28-01-2020,210345,776,923,209422,Africa
Antigua and Barbuda,28-01-2020,33749,861,562,33187,Americas
Argentina,28-01-2020,272209,1756,476,271733,Americas
Armenia,28-01-2020,277101,1060,173,276928,Europe
Australia,28-01-2020,415070,173,325,414745,Western Pacific
Australia,28-01-2020,392950,1742,589,392361,Western Pacific
Australia,28-01-2020,165705,859,718,164987,Western Pacific
Australia,28-01-2020,28564,107,1168,27396,Western Pacific
Australia,28-01-2020,38825,1794,1181,37644,Western Pacific
Australia,28-01-2020,22586,474,941,21645,Western Pacific
Australia,28-01-2020,35706,1247,1143,34563,Western Pacific
Australia,28-01-2020,159797,2081,678,159119,Western Pacific
Austria,28-01-2020,386511,1403,550,385961,Europe
Azerbaijan,28-01-2020,68154,1619,696,67458,Europe
Bahamas,28-01-2020,215204,1237,89,215115,Americas
Bahrain,28-01-2020,187189,465,875,186314,Eastern Mediterranean
Bangladesh,28-01-2020,274411,488,92,274319,South-East Asia
Barbados,28-01-2020,296447,2311,222,296225,Americas
Belarus,28-01-2020,230226,664,921,229305,Europe
Belgium,28-01-2020,66647,1162,196,66451,Europe
Benin,28-01-2020,174536,2351,1074,173462,Africa
Bhutan,28-01-2020,18624,1163,32,18592,South-East Asia
Bolivia,28-01-2020,282280,668,737,281543,Americas
Bosnia and Herzegovina,28-01-2020,26117,543,876,25241,Europe
Brazil,28-01-2020,358343,1042,1159,357184,Americas
Brunei,28-01-2020,170656,1498,611,170045,Western Pacific
Bulgaria,28-01-2020,338181,801,1250,336931,Europe
Burkina Faso,28-01-2020,265591,52,122,265469,Africa
Cabo Verde,28-01-2020,326345,1196,340,326005,Africa
Cambodia,28-01-2020,56508,368,944,55564,Western Pacific
Cameroon,28-01-2020,77399,643,576,76823,Africa
Canada,28-01-2020,9381,1190,951,8430,Americas
Canada,28-01-2020,250045,1177,1108,248937,Americas
Canada,28-01-2020,262435,1242,561,261874,Americas
Canada,28-01-2020,351143,698,445,350698,Americas
Canada,28-01-2020,255164,2015,399,254765,Americas
Canada,28-01-2020,12157,1811,698,11459,Americas
Canada,28-01-2020,393239,1097,114,393125,Americas
Canada,28-01-2020,272292,1908,86,272206,Americas
Canada,28-01-2020,229264,473,398,228866,Americas
Canada,28-01-2020,447452,2466,927,446525,Americas
Central African Republic,28-01-2020,100197,955,1087,99110,Africa
Chad,28-01-2020,222033,1381,234,221799,Africa
Chile,28-01-2020,337072,358,897,336175,Americas
China,28-01-2020,68009,1974,473,67536,Western Pacific
China,28-01-2020,244298,664,542,243756,Western Pacific
China,28-01-2020,252399,1346,389,252010,Western Pacific
China,28-01-2020,86139,523,997,85142,Western Pacific
China,28-01-2020,349424,457,1120,348304,Western Pacific
China,28-01-2020,205838,1074,5,205833,Western Pacific
China,28-01-2020,347926,2015,349,347577,Western Pacific
China,28-01-2020,202056,353,302,201754,Western Pacific
China,28-01-2020,176971,512,1039,175932,Western Pacific
China,28-01-2020,254344,2109,890,253454,Western Pacific
China,28-01-2020,133175,2362,398,132777,Western Pacific
China,28-01-2020,298511,887,1160,297351,Western Pacific
China,28-01-2020,174913,1365,967,173946,Western Pacific
China,28-01-2020,418878,1115,584,418294,Western Pacific
China,28-01-2020,346444,1692,882,345562,Western Pacific
China,28-01-2020,364339,1825,795,363544,Western Pacific
China,28-01-2020,188606,1034,1090,187516,Western Pacific
China,28-01-2020,268772,2410,536,268236,Western Pacific
China,28-01-2020,313183,1466,47,313136,Western Pacific
China,28-01-2020,316289,930,77,316212,Western Pacific
China,28-01-2020,32741,1232,505,32236,Western Pacific
China,28-01-2020,425243,1069,545,424698,Western Pacific
China,28-01-2020,75733,286,415,75318,Western Pacific
China,28-01-2020,389031,834,1175,387856,Western Pacific
China,28-01-2020,265489,1563,847,264642,Western Pacific
China,28-01-2020,397739,769,974,396765,Western Pacific
China,28-01-2020,58294,624,531,57763,Western Pacific
China,28-01-2020,350368,2187,932,349436,Western Pacific
China,28-01-2020,124933,1731,325,124608,Western Pacific
China,28-01-2020,141228,1259,924,140304,Western Pacific
China,28-01-2020,205909,705,244,205665,Western Pacific
China,28-01-2020,119517,1411,636,118881,Western Pacific
China,28-01-2020,195293,1628,901,194392,Western Pacific
Colombia,28-01-2020,310353,2250,758,309595,Americas
Congo (Brazzaville),28-01-2020,294999,1835,728,294271,Africa
Congo (Kinshasa),28-01-2020,311866,1275,1151,310715,Africa
Costa Rica,28-01-2020,435813,2018,845,434968,Americas
Cote d'Ivoire,28-01-2020,295582,2114,293,295289,Africa
Croatia,28-01-2020,272108,2343,541,271567,Europe
Cuba,28-01-2020,306115,1069,879,305236,Americas
Cyprus,28-01-2020,154620,2287,87,154533,Europe
Czechia,28-01-2020,100997,971,890,100107,Europe
Denmark,28-01-2020,173031,2030,103,172928,Europe
Greenland,28-01-2020,7608,882,963,6645,Europe
Denmark,28-01-2020,140786,80,719,140067,Europe
Djibouti,28-01-2020,261973,1820,1114,260859,Eastern Mediterranean
Dominican Republic,28-01-2020,36758,1855,1075,35683,Americas
Ecuador,28-01-2020,373580,2158,158,373422,Americas
Egypt,28-01-2020,213099,332,1030,212069,Eastern Mediterranean
El Salvador,28-01-2020,370044,1623,708,369336,Americas
Equatorial Guinea,28-01-2020,36156,564,905,35251,Africa
Eritrea,28-01-2020,122166,1198,1217,120949,Africa
Estonia,28-01-2020,337988,2307,948,337040,Europe
Eswatini,28-01-2020,222100,1401,198,221902,Africa
Ethiopia,28-01-2020,269578,437,347,269231,Africa
Fiji,28-01-2020,359442,663,513,358929,Western Pacific
Finland,28-01-2020,263885,1614,872,263013,Europe
France,28-01-2020,439915,37,918,438997,Europe
France,28-01-2020,436947,1169,428,436519,Europe
France,28-01-2020,119442,714,1241,118201,Europe
France,28-01-2020,27391,1065,513,26878,Europe
France,28-01-2020,41883,2408,1025,40858,Europe
France,28-01-2020,198676,1041,888,197788,Europe
France,28-01-2020,320340,707,992,319348,Europe
France,28-01-2020,124531,2436,729,123802,Europe
France,28-01-2020,340539,1048,160,340379,Europe
France,28-01-2020,9363,2101,514,8849,Europe
Gabon,28-01-2020,125962,505,854,125108,Africa
Gambia,28-01-2020,257377,2202,1231,256146,Africa
Georgia,28-01-2020,384394,1082,344,384050,Europe
Germany,28-01-2020,447688,1076,734,446954,Europe
Ghana,28-01-2020,441127,433,740,440387,Africa
Greece,28-01-2020,351884,2304,143,351741,Europe
Guatemala,28-01-2020,302292,435,1207,301085,Americas
Guinea,28-01-2020,203690,1680,179,203511,Africa
Guyana,28-01-2020,449778,281,371,449407,Americas
Haiti,28-01-2020,143231,1899,1137,142094,Americas
Holy See,28-01-2020,202523,1784,1059,201464,Europe
Honduras,28-01-2020,390610,984,42,390568,Americas
Hungary,28-01-2020,154125,2379,787,153338,Europe
Iceland,28-01-2020,344955,2302,592,344363,Europe
India,28-01-2020,232891,1165,475,232416,South-East Asia
Indonesia,28-01-2020,230580,2349,420,230160,South-East Asia
Iran,28-01-2020,328979,1089,150,328829,Eastern Mediterranean
Iraq,28-01-2020,318003,1120,1098,316905,Eastern Mediterranean
Ireland,28-01-2020,301043,223,954,300089,Europe
Israel,28-01-2020,107674,2376,983,106691,Europe
Italy,28-01-2020,50254,611,770,49484,Europe
Jamaica,28-01-2020,54661,88,270,54391,Americas
Japan,28-01-2020,252720,985,1172,251548,Western Pacific
Jordan,28-01-2020,61965,461,632,61333,Eastern Mediterranean
Kazakhstan,28-01-2020,384058,216,338,383720,Europe
Kenya,28-01-2020,442007,652,1133,440874,Africa
South Korea,28-01-2020,426361,1253,597,425764,Western Pacific
Kuwait,28-01-2020,354045,2185,337,353708,Eastern Mediterranean
Kyrgyzstan,28-01-2020,110052,1416,739,109313,Europe
Latvia,28-01-2020,206130,612,1115,205015,Europe
Lebanon,28-01-2020,71240,575,778,70462,Eastern Mediterranean
Liberia,28-01-2020,114590,136,530,114060,Africa
Liechtenstein,28-01-2020,222896,1463,77,222819,Europe
Lithuania,28-01-2020,351913,1798,749,351164,Europe
Luxembourg,28-01-2020,106689,954,672,106017,Europe
Madagascar,28-01-2020,389654,2357,568,389086,Africa
Malaysia,28-01-2020,376150,748,730,375420,Western Pacific
Maldives,28-01-2020,390376,1287,359,390017,South-East Asia
Malta,28-01-2020,352575,1577,614,351961,Europe
Mauritania,28-01-2020,344277,910,642,343635,Africa
Mauritius,28-01-2020,72868,2310,472,72396,Africa
Mexico,28-01-2020,431375,1911,151,431224,Americas
Moldova,28-01-2020,56254,926,318,55936,Europe
Monaco,28-01-2020,124406,468,349,124057,Europe
Mongolia,28-01-2020,436371,687,202,436169,Western Pacific
Montenegro,28-01-2020,335265,160,1243,334022,Europe
Morocco,28-01-2020,245325,266,906,244419,Eastern Mediterranean
Namibia,28-01-2020,82118,508,468,81650,Africa
Nepal,28-01-2020,65024,1683,387,64637,South-East Asia
Netherlands,28-01-2020,77827,2058,902,76925,Europe
Netherlands,28-01-2020,271517,606,690,270827,Europe
Netherlands,28-01-2020,218278,830,242,218036,Europe
Netherlands,28-01-2020,406906,347,0,406906,Europe
New Zealand,28-01-2020,56430,1792,646,55784,Western Pacific
Nicaragua,28-01-2020,141076,1670,380,140696,Americas
Niger,28-01-2020,228884,190,1024,227860,Africa
Nigeria,28-01-2020,415834,594,881,414953,Africa
North Macedonia,28-01-2020,142979,526,773,142206,Europe
Norway,28-01-2020,164603,265,48,164555,Europe
Oman,28-01-2020,7649,1721,82,7567,Eastern Mediterranean
Pakistan,28-01-2020,283568,842,260,283308,Eastern Mediterranean
Panama,28-01-2020,148670,810,65,148605,Americas
Papua New Guinea,28-01-2020,395057,1519,182,394875,Western Pacific
Paraguay,28-01-2020,331164,62,263,330901,Americas
Peru,28-01-2020,161295,2299,795,160500,Americas
Philippines,28-01-2020,122026,323,1205,120821,Western Pacific
Poland,28-01-2020,68491,1859,1132,67359,Europe
Portugal,28-01-2020,214767,2381,917,213850,Europe
Qatar,28-01-2020,17956,838,291,17665,Eastern Mediterranean
Romania,28-01-2020,165603,283,1039,164564,Europe
Russia,28-01-2020,86249,2044,101,86148,Europe
Rwanda,28-01-2020,123338,243,823,122515,Africa
Saint Lucia,28-01-2020,349028,1100,790,348238,Americas
Saint Vincent and the Grenadines,28-01-2020,169398,267,345,169053,Americas
San Marino,28-01-2020,147309,607,24,147285,Europe
Saudi Arabia,28-01-2020,391443,1537,687,390756,Eastern Mediterranean
Senegal,28-01-2020,186288,1841,1022,185266,Africa
Serbia,28-01-2020,333708,1744,105,333603,Europe
Seychelles,28-01-2020,230051,1172,1192,228859,Africa
Singapore,28-01-2020,384060,1063,1224,382836,Western Pacific
Slovakia,28-01-2020,9166,781,1187,7979,Europe
Slovenia,28-01-2020,99155,57,460,98695,Europe
Somalia,28-01-2020,1442,715,662,780,Eastern Mediterranean
South Africa,28-01-2020,135462,758,1209,134253,Africa
Spain,28-01-2020,320409,382,590,319819,Europe
Sri Lanka,28-01-2020,23971,1302,219,23752,South-East Asia
Sudan,28-01-2020,330971,2298,958,330013,Eastern Mediterranean
Suriname,28-01-2020,210341,1091,542,209799,Americas
Sweden,28-01-2020,201699,1698,537,201162,Europe
Switzerland,28-01-2020,309588,2414,807,308781,Europe
Taiwan*,28-01-2020,303243,1162,745,302498,Western Pacific
Tanzania,28-01-2020,326557,280,765,325792,Africa
Thailand,28-01-2020,164000,679,439,163561,South-East Asia
Togo,28-01-2020,261107,2481,714,260393,Africa
Trinidad and Tobago,28-01-2020,307042,2344,1073,305969,Americas
Tunisia,28-01-2020,213058,2396,2,213056,Eastern Mediterranean
Turkey,28-01-2020,420658,56,237,420421,Europe
Uganda,28-01-2020,311788,874,83,311705,Africa
Ukraine,28-01-2020,277747,2370,24,277723,Europe
United Arab Emirates,28-01-2020,429707,1949,326,429381,Eastern Mediterranean
United Kingdom,28-01-2020,182813,2252,1160,181653,Europe
United Kingdom,28-01-2020,279384,263,1098,278286,Europe
United Kingdom,28-01-2020,409809,1524,815,408994,Europe
United Kingdom,28-01-2020,164338,1471,678,163660,Europe
United Kingdom,28-01-2020,41829,49,332,41497,Europe
United Kingdom,28-01-2020,356186,2043,1097,355089,Europe
United Kingdom,28-01-2020,158939,1705,609,158330,Europe
Uruguay,28-01-2020,325728,215,609,325119,Americas
US,28-01-2020,324889,702,594,324295,Americas
Uzbekistan,28-01-2020,397330,493,640,396690,Europe
Venezuela,28-01-2020,364776,1647,946,363830,Americas
Vietnam,28-01-2020,73644,2390,488,73156,Western Pacific
Zambia,28-01-2020,282737,2179,949,281788,Africa
Zimbabwe,28-01-2020,426059,2489,855,425204,Africa
Dominica,28-01-2020,106742,1703,1204,105538,Americas
Grenada,28-01-2020,296036,1989,1221,294815,Americas
Mozambique,28-01-2020,403898,1972,1179,402719,Africa
Syria,28-01-2020,278458,1972,372,278086,Eastern Mediterranean
Timor-Leste,28-01-2020,128557,1750,978,127579,South-East Asia
Belize,28-01-2020,60147,971,24,60123,Americas
Laos,28-01-2020,330826,1387,174,330652,Western Pacific
Libya,28-01-2020,255540,2379,244,255296,Eastern Mediterranean
West Bank and Gaza,28-01-2020,318049,35,25,318024,Eastern Mediterranean
Guinea-Bissau,28-01-2020,175049,1714,201,174848,Africa
Mali,28-01-2020,425695,739,854,424841,Africa
Saint Kitts and Nevis,28-01-2020,218867,2098,647,218220,Americas
Canada,28-01-2020,70891,77,84,70807,Americas
Canada,28-01-2020,366460,194,1099,365361,Americas
Kosovo,28-01-2020,253378,2293,1059,252319,Europe
Burma,28-01-2020,15154,1735,1183,13971,South-East Asia
United Kingdom,28-01-2020,331244,2405,724,330520,Europe
United Kingdom,28-01-2020,267891,493,670,267221,Europe
United Kingdom,28-01-2020,50354,1809,908,49446,Europe
Botswana,28-01-2020,277706,959,560,277146,Africa
Burundi,28-01-2020,50098,251,1216,48882,Africa
Sierra Leone,28-01-2020,162019,1183,751,161268,Africa
Malawi,28-01-2020,360417,1634,255,360162,Africa
United Kingdom,28-01-2020,237859,2191,353,237506,Europe
France,28-01-2020,449725,0,114,449611,Europe
South Sudan,28-01-2020,390881,818,370,390511,Africa
Western Sahara,28-01-2020,224926,2331,876,224050,Africa
Sao Tome and Principe,28-01-2020,403786,216,137,403649,Africa
Yemen,28-01-2020,231753,1516,33,231720,Eastern Mediterranean
Comoros,28-01-2020,314809,1849,669,314140,Africa
Tajikistan,28-01-2020,130647,133,281,130366,Europe
Lesotho,28-01-2020,230878,94,470,230408,Africa
Afghanistan,29-01-2020,239936,892,224,239712,Eastern Mediterranean
Albania,29-01-2020,133838,47,1204,132634,Europe
Algeria,29-01-2020,399986,448,311,399675,Africa
Andorra,29-01-2020,416018,804,902,415116,Europe
Angola,29-01-2020,97775,1048,764,97011,Africa
Antigua and Barbuda,29-01-2020,124620,297,748,123872,Americas
Argentina,29-01-2020,48555,1866,665,47890,Americas
Armenia,29-01-2020,394549,1115,1083,393466,Europe
Australia,29-01-2020,395756,2011,1029,394727,Western Pacific
Australia,29-01-2020,51620,1335,484,51136,Western Pacific
Australia,29-01-2020,25125,1378,176,24949,Western Pacific
Australia,29-01-2020,379377,930,784,378593,Western Pacific
Australia,29-01-2020,360496,1945,529,359967,Western Pacific
Australia,29-01-2020,233285,594,727,232558,Western Pacific
Australia,29-01-2020,135667,1021,946,134721,Western Pacific
Australia,29-01-2020,328944,635,698,328246,Western Pacific
Austria,29-01-2020,76924,2095,779,76145,Europe
Azerbaijan,29-01-2020,395488,532,313,395175,Europe
Bahamas,29-01-2020,1633,1201,638,995,Americas
Bahrain,29-01-2020,313260,1355,328,312932,Eastern Mediterranean
Bangladesh,29-01-2020,38226,907,1044,37182,South-East Asia
Barbados,29-01-2020,21825,2203,1178,20647,Americas
Belarus,29-01-2020,427385,155,313,427072,Europe
Belgium,29-01-2020,354806,2018,40,354766,Europe
Benin,29-01-2020,302253,1683,1247,301006,Africa
Bhutan,29-01-2020,225046,154,990,224056,South-East Asia
Bolivia,29-01-2020,19449,2323,499,18950,Americas
Bosnia and Herzegovina,29-01-2020,293452,1667,22,293430,Europe
Brazil,29-01-2020,172367,870,1199,171168,Americas
Brunei,29-01-2020,191659,1739,458,191201,Western Pacific
Bulgaria,29-01-2020,291891,716,135,291756,Europe
Burkina Faso,29-01-2020,367039,2321,1174,365865,Africa
Cabo Verde,29-01-2020,278100,958,313,277787,Africa
Cambodia,29-01-2020,415081,1788,1208,413873,Western Pacific
Cameroon,29-01-2020,41774,1455,1119,40655,Africa
Canada,29-01-2020,107146,1104,914,106232,Americas
Canada,29-01-2020,26093,1499,219,25874,Americas
Canada,29-01-2020,165485,582,288,165197,Americas
Canada,29-01-2020,85135,2089,774,84361,Americas
Canada,29-01-2020,353736,956,153,353583,Americas
Canada,29-01-2020,423875,2441,482,423393,Americas
Canada,29-01-2020,240902,203,881,240021,Americas
Canada,29-01-2020,27337,175,329,27008,Americas
Canada,29-01-2020,224536,1033,502,224034,Americas
Canada,29-01-2020,54309,2271,596,53713,Americas
Central African Republic,29-01-2020,427624,1352,683,426941,Africa
Chad,29-01-2020,246644,652,476,246168,Africa
Chile,29-01-2020,276179,888,700,275479,Americas
China,29-01-2020,368189,2034,1226,366963,Western Pacific
China,29-01-2020,358741,2004,526,358215,Western Pacific
China,29-01-2020,50594,1613,238,50356,Western Pacific
China,29-01-2020,405872,2242,355,405517,Western Pacific
China,29-01-2020,410836,1242,86,410750,Western Pacific
China,29-01-2020,178617,926,508,178109,Western Pacific
China,29-01-2020,449965,2361,792,449173,Western Pacific
China,29-01-2020,70124,612,674,69450,Western Pacific
China,29-01-2020,380249,306,755,379494,Western Pacific
China,29-01-2020,432362,669,1105,431257,Western Pacific
China,29-01-2020,38546,1749,648,37898,Western Pacific
China,29-01-2020,286069,1687,876,285193,Western Pacific
China,29-01-2020,105189,1153,1017,104172,Western Pacific
China,29-01-2020,227831,2487,500,227331,Western Pacific
China,29-01-2020,215897,1,87,215810,Western Pacific
China,29-01-2020,152495,373,28,152467,Western Pacific
China,29-01-2020,290149,1254,493,289656,Western Pacific
China,29-01-2020,221403,1734,642,220761,Western Pacific
China,29-01-2020,211060,365,871,210189,Western Pacific
China,29-01-2020,85381,1091,577,84804,Western Pacific
China,29-01-2020,19482,150,1046,18436,Western Pacific
China,29-01-2020,374573,843,203,374370,Western Pacific
China,29-01-2020,382605,201,849,381756,Western Pacific
China,29-01-2020,38831,85,88,38743,Western Pacific
China,29-01-2020,374464,1704,113,374351,Western Pacific
China,29-01-2020,341529,1068,1214,340315,Western Pacific
China,29-01-2020,408492,732,1145,407347,Western Pacific
China,29-01-2020,270530,1492,430,270100,Western Pacific
China,29-01-2020,321541,782,894,320647,Western Pacific
China,29-01-2020,165779,1362,702,165077,Western Pacific
China,29-01-2020,185418,1440,835,184583,Western Pacific
China,29-01-2020,264443,2400,296,264147,Western Pacific
China,29-01-2020,389594,552,51,389543,Western Pacific
Colombia,29-01-2020,234114,1286,685,233429,Americas
Congo (Brazzaville),29-01-2020,178299,2322,529,177770,Africa
Congo (Kinshasa),29-01-2020,177164,951,367,176797,Africa
Costa Rica,29-01-2020,421986,1011,65,421921,Americas
Cote d'Ivoire,29-01-2020,405370,1755,842,404528,Africa
Croatia,29-01-2020,288661,2425,670,287991,Europe
Cuba,29-01-2020,323568,318,891,322677,Americas
Cyprus,29-01-2020,236947,1265,18,236929,Europe
Czechia,29-01-2020,50642,2498,1019,49623,Europe
Denmark,29-01-2020,10925,2448,112,10813,Europe
Greenland,29-01-2020,240464,1562,1044,239420,Europe
Denmark,29-01-2020,18664,570,301,18363,Europe
Djibouti,29-01-2020,417065,1429,13,417052,Eastern Mediterranean
Dominican Republic,29-01-2020,289863,1351,14,289849,Americas
Ecuador,29-01-2020,344447,135,1081,343366,Americas
Egypt,29-01-2020,95802,1297,473,95329,Eastern Mediterranean
El Salvador,29-01-2020,71566,1742,633,70933,Americas
Equatorial Guinea,29-01-2020,117377,1358,123,117254,Africa
Eritrea,29-01-2020,330582,1230,1183,329399,Africa
Estonia,29-01-2020,291726,1545,907,290819,Europe
Eswatini,29-01-2020,315607,1616,301,315306,Africa
Ethiopia,29-01-2020,382364,1289,934,381430,Africa
Fiji,29-01-2020,191895,520,105,191790,Western Pacific
Finland,29-01-2020,293510,2430,239,293271,Europe
France,29-01-2020,449129,1328,763,448366,Europe
France,29-01-2020,389569,1544,301,389268,Europe
France,29-01-2020,405167,368,1036,404131,Europe
France,29-01-2020,213793,1980,442,213351,Europe
France,29-01-2020,243167,1281,698,242469,Europe
France,29-01-2020,43809,946,959,42850,Europe
France,29-01-2020,437430,479,508,436922,Europe
France,29-01-2020,169572,222,538,169034,Europe
France,29-01-2020,74613,2446,1150,73463,Europe
France,29-01-2020,142332,1500,1228,141104,Europe
Gabon,29-01-2020,65536,1333,1160,64376,Africa
Gambia,29-01-2020,120822,221,954,119868,Africa
Georgia,29-01-2020,321853,2324,563,321290,Europe
Germany,29-01-2020,175717,14,127,175590,Europe
Ghana,29-01-2020,429056,1455,429,428627,Africa
Greece,29-01-2020,149821,733,379,149442,Europe
Guatemala,29-01-2020,292053,1624,143,291910,Americas
Guinea,29-01-2020,145760,328,1140,144620,Africa
Guyana,29-01-2020,227929,838,847,227082,Americas
Haiti,29-01-2020,181156,1962,560,180596,Americas
Holy See,29-01-2020,196604,1722,851,195753,Europe
Honduras,29-01-2020,298187,1157,843,297344,Americas
Hungary,29-01-2020,313064,1727,914,312150,Europe
Iceland,29-01-2020,217298,2304,694,216604,Europe
India,29-01-2020,242735,275,1113,241622,South-East Asia
Indonesia,29-01-2020,166626,1011,262,166364,South-East Asia
Iran,29-01-2020,369158,349,495,368663,Eastern Mediterranean
Iraq,29-01-2020,104097,2486,880,103217,Eastern Mediterranean
Ireland,29-01-2020,20012,1743,606,19406,Europe
Israel,29-01-2020,81301,1806,628,80673,Europe
Italy,29-01-2020,437853,870,375,437478,Europe
Jamaica,29-01-2020,422918,1036,258,422660,Americas
Japan,29-01-2020,176165,1500,389,175776,Western Pacific
Jordan,29-01-2020,1206,525,696,510,Eastern Mediterranean
Kazakhstan,29-01-2020,95458,1370,844,94614,Europe
Kenya,29-01-2020,265008,406,779,264229,Africa
South Korea,29-01-2020,113806,1934,370,113436,Western Pacific
Kuwait,29-01-2020,331444,1368,717,330727,Eastern Mediterranean
Kyrgyzstan,29-01-2020,332104,130,22,332082,Europe
Latvia,29-01-2020,89909,2365,613,89296,Europe
Lebanon,29-01-2020,280914,397,825,280089,Eastern Mediterranean
Liberia,29-01-2020,429193,996,1157,428036,Africa
Liechtenstein,29-01-2020,435226,947,214,435012,Europe
Lithuania,29-01-2020,280304,2275,913,279391,Europe
Luxembourg,29-01-2020,277478,1912,86,277392,Europe
Madagascar,29-01-2020,264138,1957,232,263906,Africa
Malaysia,29-01-2020,195370,359,336,195034,Western Pacific
Maldives,29-01-2020,325135,1087,1082,324053,South-East Asia
Malta,29-01-2020,42659,1586,769,41890,Europe
Mauritania,29-01-2020,258678,2039,543,258135,Africa
Mauritius,29-01-2020,310724,1538,849,309875,Africa
Mexico,29-01-2020,188822,2191,124,188698,Americas
Moldova,29-01-2020,142489,1131,428,142061,Europe
Monaco,29-01-2020,110330,2114,169,110161,Europe
Mongolia,29-01-2020,271347,1487,275,271072,Western Pacific
Montenegro,29-01-2020,310980,1637,689,310291,Europe
Morocco,29-01-2020,322580,11,995,321585,Eastern Mediterranean
Namibia,29-01-2020,53987,70,918,53069,Africa
Nepal,29-01-2020,285683,657,1133,284550,South-East Asia
Netherlands,29-01-2020,323080,1848,970,322110,Europe
Netherlands,29-01-2020,214466,15,332,214134,Europe
Netherlands,29-01-2020,85507,766,620,84887,Europe
Netherlands,29-01-2020,418021,1779,806,417215,Europe
New Zealand,29-01-2020,106864,369,601,106263,Western Pacific
Nicaragua,29-01-2020,181427,1390,345,181082,Americas
Niger,29-01-2020,376249,713,1085,375164,Africa
Nigeria,29-01-2020,367785,1062,1233,366552,Africa
North Macedonia,29-01-2020,63972,259,1061,62911,Europe
Norway,29-01-2020,55755,41,1069,54686,Europe
Oman,29-01-2020,339111,424,586,338525,Eastern Mediterranean
Pakistan,29-01-2020,423231,1801,1105,422126,Eastern Mediterranean
Panama,29-01-2020,442380,858,734,441646,Americas
Papua New Guinea,29-01-2020,212636,990,122,212514,Western Pacific
Paraguay,29-01-2020,345882,2014,476,345406,Americas
Peru,29-01-2020,294939,188,809,294130,Americas
Philippines,29-01-2020,416580,826,769,415811,Western Pacific
Poland,29-01-2020,133642,952,71,133571,Europe
Portugal,29-01-2020,190483,1147,132,190351,Europe
Qatar,29-01-2020,409813,1238,167,409646,Eastern Mediterranean
Romania,29-01-2020,177592,1112,274,177318,Europe
Russia,29-01-2020,381622,295,686,380936,Europe
Rwanda,29-01-2020,177347,673,909,176438,Africa
Saint Lucia,29-01-2020,233036,1352,537,232499,Americas
Saint Vincent and the Grenadines,29-01-2020,339807,982,191,339616,Americas
San Marino,29-01-2020,242692,58,698,241994,Europe
Saudi Arabia,29-01-2020,8203,636,875,7328,Eastern Mediterranean
Senegal,29-01-2020,331244,1559,51,331193,Africa
Serbia,29-01-2020,23378,528,498,22880,Europe
Seychelles,29-01-2020,96523,2284,454,96069,Africa
Singapore,29-01-2020,322378,1622,94,322284,Western Pacific
Slovakia,29-01-2020,373237,1195,986,372251,Europe
Slovenia,29-01-2020,322511,1154,1010,321501,Europe
Somalia,29-01-2020,280738,1224,1129,279609,Eastern Mediterranean
South Africa,29-01-2020,248733,454,1111,247622,Africa
Spain,29-01-2020,30471,752,4,30467,Europe
Sri Lanka,29-01-2020,431216,60,120,431096,South-East Asia
Sudan,29-01-2020,19692,499,119,19573,Eastern Mediterranean
Suriname,29-01-2020,83021,1609,252,82769,Americas
Sweden,29-01-2020,266781,1320,407,266374,Europe
Switzerland,29-01-2020,265935,2072,551,265384,Europe
Taiwan*,29-01-2020,283981,1328,78,283903,Western Pacific
Tanzania,29-01-2020,291161,1912,723,290438,Africa
Thailand,29-01-2020,266851,1333,98,266753,South-East Asia
Togo,29-01-2020,76552,2327,173,76379,Africa
Trinidad and Tobago,29-01-2020,399554,1962,149,399405,Americas
Tunisia,29-01-2020,317595,363,514,317081,Eastern Mediterranean
Turkey,29-01-2020,338164,300,1239,336925,Europe
Uganda,29-01-2020,289105,1965,356,288749,Africa
Ukraine,29-01-2020,108686,183,519,108167,Europe
United Arab Emirates,29-01-2020,423726,2140,1057,422669,Eastern Mediterranean
United Kingdom,29-01-2020,434064,2027,1074,432990,Europe
United Kingdom,29-01-2020,286467,1189,183,286284,Europe
United Kingdom,29-01-2020,163667,358,1068,162599,Europe
United Kingdom,29-01-2020,190516,1751,191,190325,Europe
United Kingdom,29-01-2020,99007,2365,147,98860,Europe
United Kingdom,29-01-2020,353511,2203,604,352907,Europe
United Kingdom,29-01-2020,337798,767,510,337288,Europe
Uruguay,29-01-2020,300497,2160,405,300092,Americas
US,29-01-2020,294166,2077,17,294149,Americas
Uzbekistan,29-01-2020,23986,2428,221,23765,Europe
Venezuela,29-01-2020,219627,980,361,219266,Americas
Vietnam,29-01-2020,433023,1401,698,432325,Western Pacific
Zambia,29-01-2020,429122,1784,276,428846,Africa
Zimbabwe,29-01-2020,278112,2423,1039,277073,Africa
Dominica,29-01-2020,142974,707,380,142594,Americas
Grenada,29-01-2020,203612,2069,262,203350,Americas
Mozambique,29-01-2020,163653,683,1176,162477,Africa
Syria,29-01-2020,24680,1336,1113,23567,Eastern Mediterranean
Timor-Leste,29-01-2020,48070,1958,514,47556,South-East Asia
Belize,29-01-2020,286874,332,825,286049,Americas
Laos,29-01-2020,320618,1812,887,319731,Western Pacific
Libya,29-01-2020,305633,178,1086,304547,Eastern Mediterranean
West Bank and Gaza,29-01-2020,404429,792,854,403575,Eastern Mediterranean
Guinea-Bissau,29-01-2020,167772,128,138,167634,Africa
Mali,29-01-2020,249776,2469,901,248875,Africa
Saint Kitts and Nevis,29-01-2020,275865,1273,60,275805,Americas
Canada,29-01-2020,320802,2377,324,320478,Americas
Canada,29-01-2020,242565,1373,955,241610,Americas
Kosovo,29-01-2020,54269,1166,615,53654,Europe
Burma,29-01-2020,243578,2298,1028,242550,South-East Asia
United Kingdom,29-01-2020,103743,798,838,102905,Europe
United Kingdom,29-01-2020,323047,2321,1171,321876,Europe
United Kingdom,29-01-2020,82769,727,1112,81657,Europe
Botswana,29-01-2020,96033,1717,834,95199,Africa
Burundi,29-01-2020,174859,1745,371,174488,Africa
Sierra Leone,29-01-2020,363145,2253,597,362548,Africa
Malawi,29-01-2020,35812,789,152,35660,Africa
United Kingdom,29-01-2020,21295,1697,808,20487,Europe
France,29-01-2020,153717,199,949,152768,Europe
South Sudan,29-01-2020,415378,825,810,414568,Africa
Western Sahara,29-01-2020,353783,1106,644,353139,Africa
Sao Tome and Principe,29-01-2020,40899,2094,898,40001,Africa
Yemen,29-01-2020,366571,1998,83,366488,Eastern Mediterranean
Comoros,29-01-2020,166390,1438,428,165962,Africa
Tajikistan,29-01-2020,42578,2352,751,41827,Europe
Lesotho,29-01-2020,79575,555,749,78826,Africa
Afghanistan,30-01-2020,414308,1986,207,414101,Eastern Mediterranean
Albania,30-01-2020,189310,2243,670,188640,Europe
Algeria,30-01-2020,395870,2415,797,395073,Africa
Andorra,30-01-2020,370036,1728,1102,368934,Europe
Angola,30-01-2020,390179,2038,287,389892,Africa
Antigua and Barbuda,30-01-2020,67915,1185,732,67183,Americas
Argentina,30-01-2020,172995,2212,620,172375,Americas
Armenia,30-01-2020,383294,2245,1066,382228,Europe
Australia,30-01-2020,174265,1030,637,173628,Western Pacific
Australia,30-01-2020,400135,1277,938,399197,Western Pacific
Australia,30-01-2020,285880,1525,254,285626,Western Pacific
Australia,30-01-2020,317852,1213,978,316874,Western Pacific
Australia,30-01-2020,221691,2484,216,221475,Western Pacific
Australia,30-01-2020,227028,291,309,226719,Western Pacific
Australia,30-01-2020,73923,2287,622,73301,Western Pacific
Australia,30-01-2020,303468,1272,24,303444,Western Pacific
Austria,30-01-2020,287741,1171,880,286861,Europe
Azerbaijan,30-01-2020,27699,216,571,27128,Europe
Bahamas,30-01-2020,319248,942,160,319088,Americas
Bahrain,30-01-2020,119990,2462,699,119291,Eastern Mediterranean
Bangladesh,30-01-2020,423195,1105,1161,422034,South-East Asia
Barbados,30-01-2020,92396,2187,771,91625,Americas
Belarus,30-01-2020,372339,2061,573,371766,Europe
Belgium,30-01-2020,22294,1929,599,21695,Europe
Benin,30-01-2020,349181,1294,65,349116,Africa
Bhutan,30-01-2020,242369,884,964,241405,South-East Asia
Bolivia,30-01-2020,368265,446,1119,367146,Americas
Bosnia and Herzegovina,30-01-2020,231348,468,832,230516,Europe
Brazil,30-01-2020,220406,2350,213,220193,Americas
Brunei,30-01-2020,175756,393,1121,174635,Western Pacific
Bulgaria,30-01-2020,424875,390,1218,423657,Europe
Burkina Faso,30-01-2020,430867,2160,753,430114,Africa
Cabo Verde,30-01-2020,273279,138,987,272292,Africa
Cambodia,30-01-2020,365837,946,430,365407,Western Pacific
Cameroon,30-01-2020,256818,701,1047,255771,Africa
Canada,30-01-2020,393462,2175,1047,392415,Americas
Canada,30-01-2020,252538,1108,181,252357,Americas
Canada,30-01-2020,145725,1900,556,145169,Americas
Canada,30-01-2020,379401,631,92,379309,Americas
Canada,30-01-2020,179075,1163,935,178140,Americas
Canada,30-01-2020,188254,2172,1135,187119,Americas
Canada,30-01-2020,140778,913,1243,139535,Americas
Canada,30-01-2020,409058,2247,424,408634,Americas
Canada,30-01-2020,346289,1832,862,345427,Americas
Canada,30-01-2020,290447,247,802,289645,Americas
Central African Republic,30-01-2020,88988,1946,74,88914,Africa
Chad,30-01-2020,434619,277,911,433708,Africa
Chile,30-01-2020,273182,852,365,272817,Americas
China,30-01-2020,388284,1993,1232,387052,Western Pacific
China,30-01-2020,379960,2181,235,379725,Western Pacific
China,30-01-2020,95710,1753,1130,94580,Western Pacific
China,30-01-2020,81553,723,793,80760,Western Pacific
China,30-01-2020,357610,745,345,357265,Western Pacific
China,30-01-2020,434428,980,743,433685,Western Pacific
China,30-01-2020,433003,52,1053,431950,Western Pacific
China,30-01-2020,70972,808,58,70914,Western Pacific
China,30-01-2020,406252,1818,753,405499,Western Pacific
China,30-01-2020,284605,1536,1134,283471,Western Pacific
China,30-01-2020,224953,2376,403,224550,Western Pacific
China,30-01-2020,32373,524,833,31540,Western Pacific
China,30-01-2020,61550,956,516,61034,Western Pacific
China,30-01-2020,253181,2257,807,252374,Western Pacific
China,30-01-2020,393286,1878,587,392699,Western Pacific
China,30-01-2020,66982,1358,942,66040,Western Pacific
China,30-01-2020,14584,1638,339,14245,Western Pacific
China,30-01-2020,411713,1122,725,410988,Western Pacific
China,30-01-2020,209124,891,1176,207948,Western Pacific
China,30-01-2020,89285,2157,81,89204,Western Pacific
China,30-01-2020,115100,88,205,114895,Western Pacific
China,30-01-2020,321145,1885,299,320846,Western Pacific
China,30-01-2020,410100,695,543,409557,Western Pacific
China,30-01-2020,368022,787,1142,366880,Western Pacific
China,30-01-2020,276537,2481,330,276207,Western Pacific
China,30-01-2020,390781,1746,746,390035,Western Pacific
China,30-01-2020,166323,2259,1200,165123,Western Pacific
China,30-01-2020,195420,2300,543,194877,Western Pacific
China,30-01-2020,127407,1586,154,127253,Western Pacific
China,30-01-2020,284496,216,213,284283,Western Pacific
China,30-01-2020,342548,517,234,342314,Western Pacific
China,30-01-2020,276987,1542,335,276652,Western Pacific
China,30-01-2020,367351,2274,624,366727,Western Pacific
Colombia,30-01-2020,224425,1468,1140,223285,Americas
Congo (Brazzaville),30-01-2020,68585,1674,537,68048,Africa
Congo (Kinshasa),30-01-2020,122932,1949,495,122437,Africa
Costa Rica,30-01-2020,373251,1415,283,372968,Americas
Cote d'Ivoire,30-01-2020,62506,507,572,61934,Africa
Croatia,30-01-2020,400705,235,174,400531,Europe
Cuba,30-01-2020,382248,1464,870,381378,Americas
Cyprus,30-01-2020,410858,123,729,410129,Europe
Czechia,30-01-2020,82082,1760,926,81156,Europe
Denmark,30-01-2020,127889,1386,360,127529,Europe
Greenland,30-01-2020,311537,1312,490,311047,Europe
Denmark,30-01-2020,190238,1677,1042,189196,Europe
Djibouti,30-01-2020,327086,2208,64,327022,Eastern Mediterranean
Dominican Republic,30-01-2020,20034,1781,931,19103,Americas
Ecuador,30-01-2020,442001,1355,373,441628,Americas
Egypt,30-01-2020,205657,1669,168,205489,Eastern Mediterranean
El Salvador,30-01-2020,314087,2139,330,313757,Americas
Equatorial Guinea,30-01-2020,258140,1982,72,258068,Africa
Eritrea,30-01-2020,102374,826,738,101636,Africa
Estonia,30-01-2020,9901,1093,169,9732,Europe
Eswatini,30-01-2020,149285,5,1070,148215,Africa
Ethiopia,30-01-2020,183076,1134,878,182198,Africa
Fiji,30-01-2020,51264,65,375,50889,Western Pacific
Finland,30-01-2020,88838,1969,740,88098,Europe
France,30-01-2020,181738,82,235,181503,Europe
France,30-01-2020,129177,1569,238,128939,Europe
France,30-01-2020,294141,1295,155,293986,Europe
France,30-01-2020,369207,1708,1193,368014,Europe
France,30-01-2020,267697,57,1240,266457,Europe
France,30-01-2020,47042,1779,1147,45895,Europe
France,30-01-2020,38545,523,241,38304,Europe
France,30-01-2020,158227,2217,607,157620,Europe
France,30-01-2020,444321,136,149,444172,Europe
France,30-01-2020,209052,443,248,208804,Europe
Gabon,30-01-2020,213356,1388,967,212389,Africa
Gambia,30-01-2020,18185,2153,173,18012,Africa
Georgia,30-01-2020,116865,244,691,116174,Europe
Germany,30-01-2020,218697,300,66,218631,Europe
Ghana,30-01-2020,99006,2123,712,98294,Africa
Greece,30-01-2020,304464,2207,660,303804,Europe
Guatemala,30-01-2020,116339,1684,1121,115218,Americas
Guinea,30-01-2020,248438,1349,574,247864,Africa
Guyana,30-01-2020,158199,2198,631,157568,Americas
Haiti,30-01-2020,371346,1737,225,371121,Americas
Holy See,30-01-2020,366584,933,663,365921,Europe
Honduras,30-01-2020,33680,2381,671,33009,Americas
Hungary,30-01-2020,287233,1132,961,286272,Europe
Iceland,30-01-2020,227723,2400,71,227652,Europe
India,30-01-2020,129504,1502,581,128923,South-East Asia
Indonesia,30-01-2020,32065,1604,922,31143,South-East Asia
Iran,30-01-2020,423698,1052,413,423285,Eastern Mediterranean
Iraq,30-01-2020,174204,2133,385,173819,Eastern Mediterranean
Ireland,30-01-2020,181734,310,698,181036,Europe
Israel,30-01-2020,193890,1210,1247,192643,Europe
Italy,30-01-2020,257099,573,141,256958,Europe
Jamaica,30-01-2020,346418,2264,839,345579,Americas
Japan,30-01-2020,256986,1422,295,256691,Western Pacific
Jordan,30-01-2020,268124,78,846,267278,Eastern Mediterranean
Kazakhstan,30-01-2020,299990,1182,486,299504,Europe
Kenya,30-01-2020,444457,1333,641,443816,Africa
South Korea,30-01-2020,11218,24,1053,10165,Western Pacific
Kuwait,30-01-2020,429292,409,1055,428237,Eastern Mediterranean
Kyrgyzstan,30-01-2020,365294,1600,893,364401,Europe
Latvia,30-01-2020,58884,2181,786,58098,Europe
Lebanon,30-01-2020,372271,1801,636,371635,Eastern Mediterranean
Liberia,30-01-2020,26336,2158,248,26088,Africa
Liechtenstein,30-01-2020,44429,1754,95,44334,Europe
Lithuania,30-01-2020,230324,622,328,229996,Europe
Luxembourg,30-01-2020,342072,261,693,341379,Europe
Madagascar,30-01-2020,137733,571,790,136943,Africa
Malaysia,30-01-2020,382671,470,89,382582,Western Pacific
Maldives,30-01-2020,66925,14,239,66686,South-East Asia
Malta,30-01-2020,370537,645,1168,369369,Europe
Mauritania,30-01-2020,106882,231,827,106055,Africa
Mauritius,30-01-2020,159250,513,1029,158221,Africa
Mexico,30-01-2020,35091,331,502,34589,Americas
Moldova,30-01-2020,389907,1735,169,389738,Europe
Monaco,30-01-2020,185001,1762,567,184434,Europe
Mongolia,30-01-2020,389162,78,851,388311,Western Pacific
Montenegro,30-01-2020,219084,2091,489,218595,Europe
Morocco,30-01-2020,206765,733,481,206284,Eastern Mediterranean
Namibia,30-01-2020,325733,1293,776,324957,Africa
Nepal,30-01-2020,16143,1684,163,15980,South-East Asia
Netherlands,30-01-2020,192741,1649,810,191931,Europe
Netherlands,30-01-2020,266367,234,1245,265122,Europe
Netherlands,30-01-2020,274179,291,81,274098,Europe
Netherlands,30-01-2020,249360,2316,869,248491,Europe
New Zealand,30-01-2020,129352,1316,457,128895,Western Pacific
Nicaragua,30-01-2020,282094,2033,403,281691,Americas
Niger,30-01-2020,307936,1033,476,307460,Africa
Nigeria,30-01-2020,170455,498,53,170402,Africa
North Macedonia,30-01-2020,202547,2405,1072,201475,Europe
Norway,30-01-2020,308611,50,499,308112,Europe
Oman,30-01-2020,447764,1038,1119,446645,Eastern Mediterranean
Pakistan,30-01-2020,341704,2279,267,341437,Eastern Mediterranean
Panama,30-01-2020,30433,2145,353,30080,Americas
Papua New Guinea,30-01-2020,323294,2056,875,322419,Western Pacific
Paraguay,30-01-2020,422324,167,1155,421169,Americas
Peru,30-01-2020,302366,2059,814,301552,Americas
Philippines,30-01-2020,319711,1708,1202,318509,Western Pacific
Poland,30-01-2020,41044,1073,39,41005,Europe
Portugal,30-01-2020,201986,1931,565,201421,Europe
Qatar,30-01-2020,406540,2438,1024,405516,Eastern Mediterranean
Romania,30-01-2020,254629,2171,991,253638,Europe
Russia,30-01-2020,266905,976,759,266146,Europe
Rwanda,30-01-2020,417923,1476,48,417875,Africa
Saint Lucia,30-01-2020,371287,2463,700,370587,Americas
Saint Vincent and the Grenadines,30-01-2020,300485,2125,1182,299303,Americas
San Marino,30-01-2020,247902,897,299,247603,Europe
Saudi Arabia,30-01-2020,365366,1128,1154,364212,Eastern Mediterranean
Senegal,30-01-2020,144038,915,795,143243,Africa
Serbia,30-01-2020,388133,2337,1221,386912,Europe
Seychelles,30-01-2020,353515,725,1100,352415,Africa
Singapore,30-01-2020,34339,1959,1038,33301,Western Pacific
Slovakia,30-01-2020,3,1869,322,-319,Europe
Slovenia,30-01-2020,273714,1739,1123,272591,Europe
Somalia,30-01-2020,333116,1177,742,332374,Eastern Mediterranean
South Africa,30-01-2020,62029,1755,1148,60881,Africa
Spain,30-01-2020,1913,1018,36,1877,Europe
Sri Lanka,30-01-2020,356782,691,925,355857,South-East Asia
Sudan,30-01-2020,169526,357,1033,168493,Eastern Mediterranean
Suriname,30-01-2020,197800,1603,1195,196605,Americas
Sweden,30-01-2020,373774,977,1180,372594,Europe
Switzerland,30-01-2020,224048,1253,386,223662,Europe
Taiwan*,30-01-2020,341153,1158,705,340448,Western Pacific
Tanzania,30-01-2020,339338,1017,702,338636,Africa
Thailand,30-01-2020,258147,501,425,257722,South-East Asia
Togo,30-01-2020,31633,949,18,31615,Africa
Trinidad and Tobago,30-01-2020,393863,284,384,393479,Americas
Tunisia,30-01-2020,376493,2352,880,375613,Eastern Mediterranean
Turkey,30-01-2020,217859,1752,532,217327,Europe
Uganda,30-01-2020,425216,1848,332,424884,Africa
Ukraine,30-01-2020,398308,857,559,397749,Europe
United Arab Emirates,30-01-2020,244412,305,502,243910,Eastern Mediterranean
United Kingdom,30-01-2020,310799,2339,682,310117,Europe
United Kingdom,30-01-2020,58293,1785,312,57981,Europe
United Kingdom,30-01-2020,4326,2182,14,4312,Europe
United Kingdom,30-01-2020,217737,344,481,217256,Europe
United Kingdom,30-01-2020,397547,654,723,396824,Europe
United Kingdom,30-01-2020,427614,2414,865,426749,Europe
United Kingdom,30-01-2020,63532,1371,1103,62429,Europe
Uruguay,30-01-2020,231118,1087,579,230539,Americas
US,30-01-2020,349887,459,1104,348783,Americas
Uzbekistan,30-01-2020,103757,2385,1136,102621,Europe
Venezuela,30-01-2020,254279,1779,630,253649,Americas
Vietnam,30-01-2020,308043,2482,1181,306862,Western Pacific
Zambia,30-01-2020,302267,1245,740,301527,Africa
Zimbabwe,30-01-2020,265732,1014,992,264740,Africa
Dominica,30-01-2020,242962,1945,884,242078,Americas
Grenada,30-01-2020,422478,1894,74,422404,Americas
Mozambique,30-01-2020,443495,2169,298,443197,Africa
Syria,30-01-2020,94732,387,695,94037,Eastern Mediterranean
Timor-Leste,30-01-2020,400359,503,945,399414,South-East Asia
Belize,30-01-2020,15776,1800,783,14993,Americas
Laos,30-01-2020,144503,2379,17,144486,Western Pacific
Libya,30-01-2020,80030,745,1225,78805,Eastern Mediterranean
West Bank and Gaza,30-01-2020,130771,1094,36,130735,Eastern Mediterranean
Guinea-Bissau,30-01-2020,426990,2405,152,426838,Africa
Mali,30-01-2020,257864,336,896,256968,Africa
Saint Kitts and Nevis,30-01-2020,153158,1415,989,152169,Americas
Canada,30-01-2020,132762,991,148,132614,Americas
Canada,30-01-2020,126023,1971,1170,124853,Americas
Kosovo,30-01-2020,141745,2366,326,141419,Europe
Burma,30-01-2020,292474,690,228,292246,South-East Asia
United Kingdom,30-01-2020,430966,1953,355,430611,Europe
United Kingdom,30-01-2020,55605,1671,1062,54543,Europe
United Kingdom,30-01-2020,261410,1726,78,261332,Europe
Botswana,30-01-2020,110683,1102,653,110030,Africa
Burundi,30-01-2020,31433,2288,860,30573,Africa
Sierra Leone,30-01-2020,147588,1075,119,147469,Africa
Malawi,30-01-2020,154421,1058,840,153581,Africa
United Kingdom,30-01-2020,174914,167,307,174607,Europe
France,30-01-2020,48865,2389,1198,47667,Europe
South Sudan,30-01-2020,216910,1967,1095,215815,Africa
Western Sahara,30-01-2020,43534,1466,965,42569,Africa
Sao Tome and Principe,30-01-2020,423024,2284,986,422038,Africa
Yemen,30-01-2020,365070,2415,476,364594,Eastern Mediterranean
Comoros,30-01-2020,152955,540,1168,151787,Africa
Tajikistan,30-01-2020,169780,1348,242,169538,Europe
Lesotho,30-01-2020,370358,926,554,369804,Africa
Afghanistan,31-01-2020,206602,1344,981,205621,Eastern Mediterranean
Albania,31-01-2020,387893,825,214,387679,Europe
Algeria,31-01-2020,156757,1646,606,156151,Africa
Andorra,31-01-2020,334201,1298,786,333415,Europe
Angola,31-01-2020,116349,1095,540,115809,Africa
Antigua and Barbuda,31-01-2020,324461,2239,202,324259,Americas
Argentina,31-01-2020,208676,797,1177,207499,Americas
Armenia,31-01-2020,14939,1209,470,14469,Europe
Australia,31-01-2020,404443,34,333,404110,Western Pacific
Australia,31-01-2020,176887,738,994,175893,Western Pacific
Australia,31-01-2020,369306,1167,523,368783,Western Pacific
Australia,31-01-2020,356985,1426,342,356643,Western Pacific
Australia,31-01-2020,428354,296,991,427363,Western Pacific
Australia,31-01-2020,69891,850,1201,68690,Western Pacific
Australia,31-01-2020,395367,443,772,394595,Western Pacific
Australia,31-01-2020,408613,2206,504,408109,Western Pacific
Austria,31-01-2020,126804,1989,560,126244,Europe
Azerbaijan,31-01-2020,182984,617,604,182380,Europe
Bahamas,31-01-2020,351599,1621,188,351411,Americas
Bahrain,31-01-2020,315549,1561,806,314743,Eastern Mediterranean
Bangladesh,31-01-2020,252353,17,242,252111,South-East Asia
Barbados,31-01-2020,408364,343,917,407447,Americas
Belarus,31-01-2020,254296,2108,205,254091,Europe
Belgium,31-01-2020,444342,603,1093,443249,Europe
Benin,31-01-2020,132113,2140,1013,131100,Africa
Bhutan,31-01-2020,177339,334,1099,176240,South-East Asia
Bolivia,31-01-2020,50443,2236,166,50277,Americas
Bosnia and Herzegovina,31-01-2020,102511,1459,82,102429,Europe
Brazil,31-01-2020,180135,9,464,179671,Americas
Brunei,31-01-2020,263737,648,1127,262610,Western Pacific
Bulgaria,31-01-2020,346948,1036,726,346222,Europe
Burkina Faso,31-01-2020,160251,518,790,159461,Africa
Cabo Verde,31-01-2020,146513,453,591,145922,Africa
Cambodia,31-01-2020,61703,415,211,61492,Western Pacific
Cameroon,31-01-2020,352144,832,813,351331,Africa
Canada,31-01-2020,233533,167,740,232793,Americas
Canada,31-01-2020,46616,932,49,46567,Americas
Canada,31-01-2020,92418,1486,1201,91217,Americas
Canada,31-01-2020,16898,1711,221,16677,Americas
Canada,31-01-2020,96920,110,102,96818,Americas
Canada,31-01-2020,403251,1700,1146,402105,Americas
Canada,31-01-2020,104118,1102,372,103746,Americas
Canada,31-01-2020,286153,435,439,285714,Americas
Canada,31-01-2020,22571,2188,829,21742,Americas
Canada,31-01-2020,284663,1143,661,284002,Americas
Central African Republic,31-01-2020,407784,1777,1153,406631,Africa
Chad,31-01-2020,45778,2308,782,44996,Africa
Chile,31-01-2020,173664,815,663,173001,Americas
China,31-01-2020,139379,1450,372,139007,Western Pacific
China,31-01-2020,412393,26,13,412380,Western Pacific
China,31-01-2020,69075,1530,345,68730,Western Pacific
China,31-01-2020,445943,669,422,445521,Western Pacific
China,31-01-2020,392357,16,1123,391234,Western Pacific
China,31-01-2020,333149,1679,1153,331996,Western Pacific
China,31-01-2020,198928,2214,1096,197832,Western Pacific
China,31-01-2020,210707,919,387,210320,Western Pacific
China,31-01-2020,295467,1074,1165,294302,Western Pacific
China,31-01-2020,272289,481,295,271994,Western Pacific
China,31-01-2020,311692,2215,637,311055,Western Pacific
China,31-01-2020,114236,765,713,113523,Western Pacific
China,31-01-2020,405823,624,542,405281,Western Pacific
China,31-01-2020,130307,488,237,130070,Western Pacific
China,31-01-2020,13767,1634,578,13189,Western Pacific
China,31-01-2020,50922,1238,1215,49707,Western Pacific
China,31-01-2020,279497,738,1242,278255,Western Pacific
China,31-01-2020,165621,432,1156,164465,Western Pacific
China,31-01-2020,430,2485,1146,-716,Western Pacific
China,31-01-2020,109349,510,167,109182,Western Pacific
China,31-01-2020,69848,2277,452,69396,Western Pacific
China,31-01-2020,206815,730,435,206380,Western Pacific
China,31-01-2020,196077,2364,793,195284,Western Pacific
China,31-01-2020,142913,1286,229,142684,Western Pacific
China,31-01-2020,253805,2191,244,253561,Western Pacific
China,31-01-2020,167412,246,129,167283,Western Pacific
China,31-01-2020,117753,1515,620,117133,Western Pacific
China,31-01-2020,242522,2141,232,242290,Western Pacific
China,31-01-2020,69905,2127,364,69541,Western Pacific
China,31-01-2020,41554,1631,287,41267,Western Pacific
China,31-01-2020,386329,1363,382,385947,Western Pacific
China,31-01-2020,24820,394,290,24530,Western Pacific
China,31-01-2020,330089,1493,63,330026,Western Pacific
Colombia,31-01-2020,132444,2306,609,131835,Americas
Congo (Brazzaville),31-01-2020,351441,916,820,350621,Africa
Congo (Kinshasa),31-01-2020,176628,846,1006,175622,Africa
Costa Rica,31-01-2020,271679,1352,141,271538,Americas
Cote d'Ivoire,31-01-2020,423015,2388,955,422060,Africa
Croatia,31-01-2020,215606,1064,547,215059,Europe
Cuba,31-01-2020,88599,2088,697,87902,Americas
Cyprus,31-01-2020,441830,1158,866,440964,Europe
Czechia,31-01-2020,292927,1715,369,292558,Europe
Denmark,31-01-2020,198999,329,139,198860,Europe
Greenland,31-01-2020,417524,1445,349,417175,Europe
Denmark,31-01-2020,264270,1845,1169,263101,Europe
Djibouti,31-01-2020,249771,2246,1146,248625,Eastern Mediterranean
Dominican Republic,31-01-2020,208343,2361,265,208078,Americas
Ecuador,31-01-2020,341130,827,553,340577,Americas
Egypt,31-01-2020,397782,571,31,397751,Eastern Mediterranean
El Salvador,31-01-2020,2380,726,80,2300,Americas
Equatorial Guinea,31-01-2020,220757,14,503,220254,Africa
Eritrea,31-01-2020,84936,2382,504,84432,Africa
Estonia,31-01-2020,377209,2109,711,376498,Europe
Eswatini,31-01-2020,443150,2129,218,442932,Africa
Ethiopia,31-01-2020,440500,2373,741,439759,Africa
Fiji,31-01-2020,75712,2052,734,74978,Western Pacific
Finland,31-01-2020,435764,2405,836,434928,Europe
France,31-01-2020,236321,1196,610,235711,Europe
France,31-01-2020,181559,291,480,181079,Europe
France,31-01-2020,203825,2413,932,202893,Europe
France,31-01-2020,233545,1290,849,232696,Europe
France,31-01-2020,435281,487,1007,434274,Europe
France,31-01-2020,367047,1315,1221,365826,Europe
France,31-01-2020,432273,732,1153,431120,Europe
France,31-01-2020,332490,1646,952,331538,Europe
France,31-01-2020,345940,39,669,345271,Europe
France,31-01-2020,225486,857,126,225360,Europe
Gabon,31-01-2020,65678,1450,138,65540,Africa
Gambia,31-01-2020,105035,1823,851,104184,Africa
Georgia,31-01-2020,67861,1127,969,66892,Europe
Germany,31-01-2020,196219,2286,1007,195212,Europe
Ghana,31-01-2020,127148,1360,775,126373,Africa
Greece,31-01-2020,393958,1437,871,393087,Europe
Guatemala,31-01-2020,97334,944,913,96421,Americas
Guinea,31-01-2020,46423,1820,789,45634,Africa
Guyana,31-01-2020,365946,852,76,365870,Americas
Haiti,31-01-2020,417656,269,871,416785,Americas
Holy See,31-01-2020,398090,1771,982,397108,Europe
Honduras,31-01-2020,123423,2084,96,123327,Americas
Hungary,31-01-2020,147534,1956,470,147064,Europe
Iceland,31-01-2020,158619,1144,738,157881,Europe
India,31-01-2020,129555,233,901,128654,South-East Asia
Indonesia,31-01-2020,144381,1642,734,143647,South-East Asia
Iran,31-01-2020,127835,2182,805,127030,Eastern Mediterranean
Iraq,31-01-2020,446669,2282,685,445984,Eastern Mediterranean
Ireland,31-01-2020,304465,1884,955,303510,Europe
Israel,31-01-2020,158390,1412,760,157630,Europe
Italy,31-01-2020,359326,87,330,358996,Europe
Jamaica,31-01-2020,218875,837,1099,217776,Americas
Japan,31-01-2020,49306,82,671,48635,Western Pacific
Jordan,31-01-2020,397737,2186,4,397733,Eastern Mediterranean
Kazakhstan,31-01-2020,287523,1167,232,287291,Europe
Kenya,31-01-2020,358302,89,743,357559,Africa
South Korea,31-01-2020,248939,525,453,248486,Western Pacific
Kuwait,31-01-2020,210444,1026,1001,209443,Eastern Mediterranean
Kyrgyzstan,31-01-2020,24579,968,1111,23468,Europe
Latvia,31-01-2020,8995,73,417,8578,Europe
Lebanon,31-01-2020,235125,764,1248,233877,Eastern Mediterranean
Liberia,31-01-2020,326336,1620,729,325607,Africa
Liechtenstein,31-01-2020,406777,1090,491,406286,Europe
Lithuania,31-01-2020,62826,1562,295,62531,Europe
Luxembourg,31-01-2020,298263,2321,346,297917,Europe
Madagascar,31-01-2020,336220,685,926,335294,Africa
Malaysia,31-01-2020,436212,1518,380,435832,Western Pacific
Maldives,31-01-2020,43325,892,965,42360,South-East Asia
Malta,31-01-2020,340657,2443,890,339767,Europe
Mauritania,31-01-2020,334182,1724,1132,333050,Africa
Mauritius,31-01-2020,317569,684,49,317520,Africa
Mexico,31-01-2020,352171,1104,392,351779,Americas
Moldova,31-01-2020,288415,694,1125,287290,Europe
Monaco,31-01-2020,412988,897,60,412928,Europe
Mongolia,31-01-2020,193757,113,182,193575,Western Pacific
Montenegro,31-01-2020,144663,619,962,143701,Europe
Morocco,31-01-2020,105487,700,514,104973,Eastern Mediterranean
Namibia,31-01-2020,43134,433,787,42347,Africa
Nepal,31-01-2020,175782,338,614,175168,South-East Asia
Netherlands,31-01-2020,244826,1744,802,244024,Europe
Netherlands,31-01-2020,10281,2247,1212,9069,Europe
Netherlands,31-01-2020,101585,1729,193,101392,Europe
Netherlands,31-01-2020,409760,1127,1015,408745,Europe
New Zealand,31-01-2020,102977,1637,768,102209,Western Pacific
Nicaragua,31-01-2020,343921,2466,232,343689,Americas
Niger,31-01-2020,398300,973,14,398286,Africa
Nigeria,31-01-2020,20122,1593,184,19938,Africa
North Macedonia,31-01-2020,233711,467,1181,232530,Europe
Norway,31-01-2020,93114,1351,836,92278,Europe
Oman,31-01-2020,217444,348,49,217395,Eastern Mediterranean
Pakistan,31-01-2020,212691,425,21,212670,Eastern Mediterranean
Panama,31-01-2020,136536,2155,1047,135489,Americas
Papua New Guinea,31-01-2020,181084,257,909,180175,Western Pacific
Paraguay,31-01-2020,220060,80,145,219915,Americas
Peru,31-01-2020,166722,2465,1102,165620,Americas
Philippines,31-01-2020,78381,898,683,77698,Western Pacific
Poland,31-01-2020,253359,2303,655,252704,Europe
Portugal,31-01-2020,181094,2140,8,181086,Europe
Qatar,31-01-2020,243898,1666,401,243497,Eastern Mediterranean
Romania,31-01-2020,67197,1218,398,66799,Europe
Russia,31-01-2020,400457,1247,586,399871,Europe
Rwanda,31-01-2020,123873,343,467,123406,Africa
Saint Lucia,31-01-2020,140507,985,522,139985,Americas
Saint Vincent and the Grenadines,31-01-2020,285613,515,1004,284609,Americas
San Marino,31-01-2020,23952,1138,917,23035,Europe
Saudi Arabia,31-01-2020,424842,1960,512,424330,Eastern Mediterranean
Senegal,31-01-2020,332096,1430,381,331715,Africa
Serbia,31-01-2020,351928,2056,890,351038,Europe
Seychelles,31-01-2020,303261,2032,514,302747,Africa
Singapore,31-01-2020,118964,2457,1180,117784,Western Pacific
Slovakia,31-01-2020,311263,350,842,310421,Europe
Slovenia,31-01-2020,308855,128,755,308100,Europe
Somalia,31-01-2020,400385,1013,246,400139,Eastern Mediterranean
South Africa,31-01-2020,380836,1484,854,379982,Africa
Spain,31-01-2020,152531,1488,13,152518,Europe
Sri Lanka,31-01-2020,4192,344,1169,3023,South-East Asia
Sudan,31-01-2020,377855,129,859,376996,Eastern Mediterranean
Suriname,31-01-2020,339715,1929,58,339657,Americas
Sweden,31-01-2020,57277,2280,842,56435,Europe
Switzerland,31-01-2020,166825,2008,28,166797,Europe
Taiwan*,31-01-2020,317604,1413,1062,316542,Western Pacific
Tanzania,31-01-2020,268449,1519,832,267617,Africa
Thailand,31-01-2020,135228,616,1203,134025,South-East Asia
Togo,31-01-2020,253109,1788,631,252478,Africa
Trinidad and Tobago,31-01-2020,358242,1905,861,357381,Americas
Tunisia,31-01-2020,427125,1592,793,426332,Eastern Mediterranean
Turkey,31-01-2020,265838,2010,531,265307,Europe
Uganda,31-01-2020,138332,2117,297,138035,Africa
Ukraine,31-01-2020,322786,630,752,322034,Europe
United Arab Emirates,31-01-2020,250202,1037,1244,248958,Eastern Mediterranean
United Kingdom,31-01-2020,97713,2353,818,96895,Europe
United Kingdom,31-01-2020,198035,2219,510,197525,Europe
United Kingdom,31-01-2020,331116,2026,799,330317,Europe
United Kingdom,31-01-2020,195439,2438,1087,194352,Europe
United Kingdom,31-01-2020,152933,1865,1135,151798,Europe
United Kingdom,31-01-2020,17490,932,1028,16462,Europe
United Kingdom,31-01-2020,369956,519,398,369558,Europe
Uruguay,31-01-2020,340076,1967,813,339263,Americas
US,31-01-2020,255233,75,386,254847,Americas
Uzbekistan,31-01-2020,434868,1320,781,434087,Europe
Venezuela,31-01-2020,14855,310,431,14424,Americas
Vietnam,31-01-2020,207316,2226,1012,206304,Western Pacific
Zambia,31-01-2020,317834,1644,496,317338,Africa
Zimbabwe,31-01-2020,381090,684,920,380170,Africa
Dominica,31-01-2020,430952,1436,905,430047,Americas
Grenada,31-01-2020,180304,2181,198,180106,Americas
Mozambique,31-01-2020,204120,2484,289,203831,Africa
Syria,31-01-2020,386528,466,488,386040,Eastern Mediterranean
Timor-Leste,31-01-2020,243049,2490,1234,241815,South-East Asia
Belize,31-01-2020,177297,1183,102,177195,Americas
Laos,31-01-2020,181730,2443,625,181105,Western Pacific
Libya,31-01-2020,399967,365,1115,398852,Eastern Mediterranean
West Bank and Gaza,31-01-2020,265574,754,1085,264489,Eastern Mediterranean
Guinea-Bissau,31-01-2020,423738,1617,989,422749,Africa
Mali,31-01-2020,63110,250,213,62897,Africa
Saint Kitts and Nevis,31-01-2020,369037,2303,304,368733,Americas
Canada,31-01-2020,100895,2351,619,100276,Americas
Canada,31-01-2020,307572,88,1031,306541,Americas
Kosovo,31-01-2020,244724,1751,259,244465,Europe
Burma,31-01-2020,80987,839,1086,79901,South-East Asia
United Kingdom,31-01-2020,405463,1052,773,404690,Europe
United Kingdom,31-01-2020,265162,2170,152,265010,Europe
United Kingdom,31-01-2020,341270,467,188,341082,Europe
Botswana,31-01-2020,298178,1330,572,297606,Africa
Burundi,31-01-2020,8184,711,97,8087,Africa
Sierra Leone,31-01-2020,134341,2488,1111,133230,Africa
Malawi,31-01-2020,40702,462,753,39949,Africa
United Kingdom,31-01-2020,163874,605,963,162911,Europe
France,31-01-2020,178495,294,437,178058,Europe
South Sudan,31-01-2020,361315,813,91,361224,Africa
Western Sahara,31-01-2020,193240,1202,1066,192174,Africa
Sao Tome and Principe,31-01-2020,436071,147,390,435681,Africa
Yemen,31-01-2020,388640,1238,797,387843,Eastern Mediterranean
Comoros,31-01-2020,214990,1597,1170,213820,Africa
Tajikistan,31-01-2020,235890,1695,329,235561,Europe
Lesotho,31-01-2020,31409,1631,1082,30327,Africa
Afghanistan,01-02-2020,404624,601,106,404518,Eastern Mediterranean
Albania,01-02-2020,261305,1570,1181,260124,Europe
Algeria,01-02-2020,431780,1437,161,431619,Africa
Andorra,01-02-2020,213489,1054,593,212896,Europe
Angola,01-02-2020,228571,2414,1033,227538,Africa
Antigua and Barbuda,01-02-2020,386299,834,6,386293,Americas
Argentina,01-02-2020,427031,1464,294,426737,Americas
Armenia,01-02-2020,395281,1198,832,394449,Europe
Australia,01-02-2020,374450,1660,1150,373300,Western Pacific
Australia,01-02-2020,334603,254,538,334065,Western Pacific
Australia,01-02-2020,134848,897,559,134289,Western Pacific
Australia,01-02-2020,383680,2460,399,383281,Western Pacific
Australia,01-02-2020,187613,230,445,187168,Western Pacific
Australia,01-02-2020,343733,2323,778,342955,Western Pacific
Australia,01-02-2020,378050,1426,1102,376948,Western Pacific
Australia,01-02-2020,196397,1743,279,196118,Western Pacific
Austria,01-02-2020,234433,2232,899,233534,Europe
Azerbaijan,01-02-2020,386252,771,742,385510,Europe
Bahamas,01-02-2020,87769,1766,670,87099,Americas
Bahrain,01-02-2020,146073,1593,1002,145071,Eastern Mediterranean
Bangladesh,01-02-2020,301945,231,469,301476,South-East Asia
Barbados,01-02-2020,325054,1732,1128,323926,Americas
Belarus,01-02-2020,226516,2172,995,225521,Europe
Belgium,01-02-2020,250839,2332,399,250440,Europe
Benin,01-02-2020,145840,94,1249,144591,Africa
Bhutan,01-02-2020,126798,627,90,126708,South-East Asia
Bolivia,01-02-2020,379891,955,1097,378794,Americas
Bosnia and Herzegovina,01-02-2020,88576,731,417,88159,Europe
Brazil,01-02-2020,71878,1039,466,71412,Americas
Brunei,01-02-2020,389311,1967,816,388495,Western Pacific
Bulgaria,01-02-2020,113035,504,162,112873,Europe
Burkina Faso,01-02-2020,311668,917,235,311433,Africa
Cabo Verde,01-02-2020,358360,2295,385,357975,Africa
Cambodia,01-02-2020,114796,1755,685,114111,Western Pacific
Cameroon,01-02-2020,169040,512,1154,167886,Africa
Canada,01-02-2020,286587,2022,673,285914,Americas
Canada,01-02-2020,154737,394,1133,153604,Americas
Canada,01-02-2020,243652,1039,938,242714,Americas
Canada,01-02-2020,67101,160,1193,65908,Americas
Canada,01-02-2020,249,2082,542,-293,Americas
Canada,01-02-2020,51683,1498,822,50861,Americas
Canada,01-02-2020,144069,433,1007,143062,Americas
Canada,01-02-2020,335736,775,1063,334673,Americas
Canada,01-02-2020,200302,118,244,200058,Americas
Canada,01-02-2020,263620,1887,171,263449,Americas
Central African Republic,01-02-2020,105477,133,1227,104250,Africa
Chad,01-02-2020,432725,13,394,432331,Africa
Chile,01-02-2020,419774,436,728,419046,Americas
China,01-02-2020,9881,431,850,9031,Western Pacific
China,01-02-2020,229245,117,573,228672,Western Pacific
China,01-02-2020,25353,126,840,24513,Western Pacific
China,01-02-2020,9990,560,904,9086,Western Pacific
China,01-02-2020,241260,2231,385,240875,Western Pacific
China,01-02-2020,202753,1395,135,202618,Western Pacific
China,01-02-2020,187558,289,155,187403,Western Pacific
China,01-02-2020,247228,345,197,247031,Western Pacific
China,01-02-2020,290972,2402,1247,289725,Western Pacific
China,01-02-2020,422247,1024,1237,421010,Western Pacific
China,01-02-2020,75512,643,867,74645,Western Pacific
China,01-02-2020,26816,1411,88,26728,Western Pacific
China,01-02-2020,11322,1355,52,11270,Western Pacific
China,01-02-2020,12910,289,715,12195,Western Pacific
China,01-02-2020,368988,132,433,368555,Western Pacific
China,01-02-2020,435984,1831,124,435860,Western Pacific
China,01-02-2020,161616,1369,1215,160401,Western Pacific
China,01-02-2020,160991,1617,463,160528,Western Pacific
China,01-02-2020,260763,1203,1070,259693,Western Pacific
China,01-02-2020,331999,298,508,331491,Western Pacific
China,01-02-2020,422271,1183,1128,421143,Western Pacific
China,01-02-2020,403117,1880,947,402170,Western Pacific
China,01-02-2020,255535,980,114,255421,Western Pacific
China,01-02-2020,236960,2373,340,236620,Western Pacific
China,01-02-2020,375734,2016,473,375261,Western Pacific
China,01-02-2020,443895,2233,805,443090,Western Pacific
China,01-02-2020,174451,2036,195,174256,Western Pacific
China,01-02-2020,197701,1942,508,197193,Western Pacific
China,01-02-2020,108413,50,932,107481,Western Pacific
China,01-02-2020,214725,26,760,213965,Western Pacific
China,01-02-2020,432506,2493,1238,431268,Western Pacific
China,01-02-2020,406096,1509,623,405473,Western Pacific
China,01-02-2020,234782,511,535,234247,Western Pacific
Colombia,01-02-2020,347210,505,601,346609,Americas
Congo (Brazzaville),01-02-2020,16603,49,675,15928,Africa
Congo (Kinshasa),01-02-2020,240614,262,1163,239451,Africa
Costa Rica,01-02-2020,208780,1969,649,208131,Americas
Cote d'Ivoire,01-02-2020,290372,345,304,290068,Africa
Croatia,01-02-2020,136478,1413,885,135593,Europe
Cuba,01-02-2020,352059,762,555,351504,Americas
Cyprus,01-02-2020,214261,1858,1071,213190,Europe
Czechia,01-02-2020,407279,1064,1023,406256,Europe
Denmark,01-02-2020,292069,213,131,291938,Europe
Greenland,01-02-2020,101605,1378,601,101004,Europe
Denmark,01-02-2020,73149,1309,368,72781,Europe
Djibouti,01-02-2020,314042,2277,601,313441,Eastern Mediterranean
Dominican Republic,01-02-2020,295601,1207,28,295573,Americas
Ecuador,01-02-2020,371018,243,355,370663,Americas
Egypt,01-02-2020,368791,903,836,367955,Eastern Mediterranean
El Salvador,01-02-2020,45747,1143,870,44877,Americas
Equatorial Guinea,01-02-2020,66006,708,1129,64877,Africa
Eritrea,01-02-2020,122561,1653,607,121954,Africa
Estonia,01-02-2020,211978,5,1123,210855,Europe
Eswatini,01-02-2020,384386,2243,801,383585,Africa
Ethiopia,01-02-2020,251957,684,503,251454,Africa
Fiji,01-02-2020,74856,2112,167,74689,Western Pacific
Finland,01-02-2020,182232,2397,427,181805,Europe
France,01-02-2020,284184,187,835,283349,Europe
France,01-02-2020,240043,359,499,239544,Europe
France,01-02-2020,266474,2459,785,265689,Europe
France,01-02-2020,227745,2027,4,227741,Europe
France,01-02-2020,363127,2472,298,362829,Europe
France,01-02-2020,226897,2468,747,226150,Europe
France,01-02-2020,93869,818,75,93794,Europe
France,01-02-2020,37378,579,917,36461,Europe
France,01-02-2020,309213,867,1130,308083,Europe
France,01-02-2020,141536,2119,406,141130,Europe
Gabon,01-02-2020,424266,366,446,423820,Africa
Gambia,01-02-2020,431343,1043,980,430363,Africa
Georgia,01-02-2020,434252,1748,493,433759,Europe
Germany,01-02-2020,129761,333,626,129135,Europe
Ghana,01-02-2020,301302,1912,570,300732,Africa
Greece,01-02-2020,252113,1851,981,251132,Europe
Guatemala,01-02-2020,111895,1947,918,110977,Americas
Guinea,01-02-2020,69848,845,328,69520,Africa
Guyana,01-02-2020,353279,2305,968,352311,Americas
Haiti,01-02-2020,160106,480,370,159736,Americas
Holy See,01-02-2020,251168,207,839,250329,Europe
Honduras,01-02-2020,176554,1311,207,176347,Americas
Hungary,01-02-2020,308325,2189,912,307413,Europe
Iceland,01-02-2020,148600,448,488,148112,Europe
India,01-02-2020,77164,1486,834,76330,South-East Asia
Indonesia,01-02-2020,444592,1327,935,443657,South-East Asia
Iran,01-02-2020,201706,134,1242,200464,Eastern Mediterranean
Iraq,01-02-2020,302269,1443,793,301476,Eastern Mediterranean
Ireland,01-02-2020,121552,744,697,120855,Europe
Israel,01-02-2020,175994,2375,1038,174956,Europe
Italy,01-02-2020,61907,1015,405,61502,Europe
Jamaica,01-02-2020,437700,932,309,437391,Americas
Japan,01-02-2020,268620,545,993,267627,Western Pacific
Jordan,01-02-2020,374276,811,391,373885,Eastern Mediterranean
Kazakhstan,01-02-2020,397580,1505,1057,396523,Europe
Kenya,01-02-2020,196871,2289,538,196333,Africa
South Korea,01-02-2020,357956,2335,742,357214,Western Pacific
Kuwait,01-02-2020,252590,1863,35,252555,Eastern Mediterranean
Kyrgyzstan,01-02-2020,272239,585,85,272154,Europe
Latvia,01-02-2020,279757,1845,608,279149,Europe
Lebanon,01-02-2020,87381,680,1230,86151,Eastern Mediterranean
Liberia,01-02-2020,360235,1563,470,359765,Africa
Liechtenstein,01-02-2020,317886,1928,379,317507,Europe
Lithuania,01-02-2020,202415,1524,179,202236,Europe
Luxembourg,01-02-2020,84593,969,438,84155,Europe
Madagascar,01-02-2020,229815,198,1165,228650,Africa
Malaysia,01-02-2020,45897,1709,753,45144,Western Pacific
Maldives,01-02-2020,347386,1202,654,346732,South-East Asia
Malta,01-02-2020,332167,1651,1019,331148,Europe
Mauritania,01-02-2020,97725,1472,1058,96667,Africa
Mauritius,01-02-2020,20299,2347,995,19304,Africa
Mexico,01-02-2020,447755,620,988,446767,Americas
Moldova,01-02-2020,171113,1595,497,170616,Europe
Monaco,01-02-2020,165684,2063,1144,164540,Europe
Mongolia,01-02-2020,426903,1460,1004,425899,Western Pacific
Montenegro,01-02-2020,23423,1883,996,22427,Europe
Morocco,01-02-2020,308449,700,621,307828,Eastern Mediterranean
Namibia,01-02-2020,431572,1863,1248,430324,Africa
Nepal,01-02-2020,237470,571,838,236632,South-East Asia
Netherlands,01-02-2020,49236,1836,21,49215,Europe
Netherlands,01-02-2020,415342,1368,680,414662,Europe
Netherlands,01-02-2020,109876,704,106,109770,Europe
Netherlands,01-02-2020,265444,1103,631,264813,Europe
New Zealand,01-02-2020,241546,2386,702,240844,Western Pacific
Nicaragua,01-02-2020,39479,760,878,38601,Americas
Niger,01-02-2020,288237,2212,549,287688,Africa
Nigeria,01-02-2020,449087,1020,195,448892,Africa
North Macedonia,01-02-2020,17881,934,594,17287,Europe
Norway,01-02-2020,61160,2245,225,60935,Europe
Oman,01-02-2020,326973,736,1250,325723,Eastern Mediterranean
Pakistan,01-02-2020,72465,1992,650,71815,Eastern Mediterranean
Panama,01-02-2020,342078,249,542,341536,Americas
Papua New Guinea,01-02-2020,432015,191,593,431422,Western Pacific
Paraguay,01-02-2020,151131,2388,642,150489,Americas
Peru,01-02-2020,361180,575,514,360666,Americas
Philippines,01-02-2020,84455,2127,979,83476,Western Pacific
Poland,01-02-2020,44395,1298,871,43524,Europe
Portugal,01-02-2020,273461,1752,1064,272397,Europe
Qatar,01-02-2020,254721,941,857,253864,Eastern Mediterranean
Romania,01-02-2020,350991,85,5,350986,Europe
Russia,01-02-2020,224379,830,132,224247,Europe
Rwanda,01-02-2020,391125,333,398,390727,Africa
Saint Lucia,01-02-2020,14808,1051,1061,13747,Americas
Saint Vincent and the Grenadines,01-02-2020,123182,1658,559,122623,Americas
San Marino,01-02-2020,296186,1960,953,295233,Europe
Saudi Arabia,01-02-2020,168001,1366,1112,166889,Eastern Mediterranean
Senegal,01-02-2020,331190,979,1158,330032,Africa
Serbia,01-02-2020,448994,326,1046,447948,Europe
Seychelles,01-02-2020,96905,582,9,96896,Africa
Singapore,01-02-2020,331912,1335,541,331371,Western Pacific
Slovakia,01-02-2020,117115,1075,771,116344,Europe
Slovenia,01-02-2020,268371,623,367,268004,Europe
Somalia,01-02-2020,10792,667,1159,9633,Eastern Mediterranean
South Africa,01-02-2020,115083,1974,323,114760,Africa
Spain,01-02-2020,328855,871,592,328263,Europe
Sri Lanka,01-02-2020,235681,806,318,235363,South-East Asia
Sudan,01-02-2020,59873,2183,939,58934,Eastern Mediterranean
Suriname,01-02-2020,343183,2321,483,342700,Americas
Sweden,01-02-2020,315166,730,27,315139,Europe
Switzerland,01-02-2020,303682,47,351,303331,Europe
Taiwan*,01-02-2020,1664,342,617,1047,Western Pacific
Tanzania,01-02-2020,304931,344,1236,303695,Africa
Thailand,01-02-2020,139614,476,964,138650,South-East Asia
Togo,01-02-2020,266495,283,527,265968,Africa
Trinidad and Tobago,01-02-2020,307544,832,717,306827,Americas
Tunisia,01-02-2020,28582,2293,182,28400,Eastern Mediterranean
Turkey,01-02-2020,103327,1958,1080,102247,Europe
Uganda,01-02-2020,357012,1486,610,356402,Africa
Ukraine,01-02-2020,284933,2358,757,284176,Europe
United Arab Emirates,01-02-2020,50764,1398,322,50442,Eastern Mediterranean
United Kingdom,01-02-2020,308322,1723,722,307600,Europe
United Kingdom,01-02-2020,74161,194,755,73406,Europe
United Kingdom,01-02-2020,192998,1241,512,192486,Europe
United Kingdom,01-02-2020,351267,1195,261,351006,Europe
United Kingdom,01-02-2020,1784,1670,467,1317,Europe
United Kingdom,01-02-2020,94187,1155,335,93852,Europe
United Kingdom,01-02-2020,435139,264,733,434406,Europe
Uruguay,01-02-2020,245859,2482,781,245078,Americas
US,01-02-2020,407960,1353,525,407435,Americas
Uzbekistan,01-02-2020,86052,965,512,85540,Europe
Venezuela,01-02-2020,165298,2000,815,164483,Americas
Vietnam,01-02-2020,95786,2189,849,94937,Western Pacific
Zambia,01-02-2020,291238,1224,442,290796,Africa
Zimbabwe,01-02-2020,443100,2479,473,442627,Africa
Dominica,01-02-2020,405737,1562,973,404764,Americas
Grenada,01-02-2020,236187,567,139,236048,Americas
Mozambique,01-02-2020,291673,2021,139,291534,Africa
Syria,01-02-2020,275692,1785,1041,274651,Eastern Mediterranean
Timor-Leste,01-02-2020,78881,2474,321,78560,South-East Asia
Belize,01-02-2020,107103,2378,208,106895,Americas
Laos,01-02-2020,129467,1323,107,129360,Western Pacific
Libya,01-02-2020,261830,2412,830,261000,Eastern Mediterranean
West Bank and Gaza,01-02-2020,429090,101,1015,428075,Eastern Mediterranean
Guinea-Bissau,01-02-2020,302645,808,1048,301597,Africa
Mali,01-02-2020,252926,1536,714,252212,Africa
Saint Kitts and Nevis,01-02-2020,180054,735,463,179591,Americas
Canada,01-02-2020,18819,303,216,18603,Americas
Canada,01-02-2020,136483,1852,1034,135449,Americas
Kosovo,01-02-2020,165327,180,818,164509,Europe
Burma,01-02-2020,146679,1315,451,146228,South-East Asia
United Kingdom,01-02-2020,260015,2290,1056,258959,Europe
United Kingdom,01-02-2020,176855,1045,309,176546,Europe
United Kingdom,01-02-2020,272828,2020,232,272596,Europe
Botswana,01-02-2020,86112,831,634,85478,Africa
Burundi,01-02-2020,130802,2008,203,130599,Africa
Sierra Leone,01-02-2020,144242,196,1053,143189,Africa
Malawi,01-02-2020,194751,570,1171,193580,Africa
United Kingdom,01-02-2020,268207,2323,882,267325,Europe
France,01-02-2020,170010,972,850,169160,Europe
South Sudan,01-02-2020,3795,1472,634,3161,Africa
Western Sahara,01-02-2020,153049,1630,634,152415,Africa
Sao Tome and Principe,01-02-2020,144665,455,424,144241,Africa
Yemen,01-02-2020,231509,1281,792,230717,Eastern Mediterranean
Comoros,01-02-2020,319151,1299,453,318698,Africa
Tajikistan,01-02-2020,333934,275,382,333552,Europe
Lesotho,01-02-2020,331980,715,1245,330735,Africa
Afghanistan,02-02-2020,254422,79,496,253926,Eastern Mediterranean
Albania,02-02-2020,53574,1169,116,53458,Europe
Algeria,02-02-2020,3877,1133,1119,2758,Africa
Andorra,02-02-2020,331179,458,410,330769,Europe
Angola,02-02-2020,23762,293,866,22896,Africa
Antigua and Barbuda,02-02-2020,418885,1532,1150,417735,Americas
Argentina,02-02-2020,443937,187,348,443589,Americas
Armenia,02-02-2020,164823,423,707,164116,Europe
Australia,02-02-2020,348887,1833,1218,347669,Western Pacific
Australia,02-02-2020,429395,852,768,428627,Western Pacific
Australia,02-02-2020,446827,862,752,446075,Western Pacific
Australia,02-02-2020,185162,2357,617,184545,Western Pacific
Australia,02-02-2020,288846,2452,23,288823,Western Pacific
Australia,02-02-2020,62248,1938,871,61377,Western Pacific
Australia,02-02-2020,16990,859,589,16401,Western Pacific
Australia,02-02-2020,222944,2115,1078,221866,Western Pacific
Austria,02-02-2020,200169,2286,100,200069,Europe
Azerbaijan,02-02-2020,7253,993,224,7029,Europe
Bahamas,02-02-2020,53857,2292,1084,52773,Americas
Bahrain,02-02-2020,147153,338,1058,146095,Eastern Mediterranean
Bangladesh,02-02-2020,223588,1772,322,223266,South-East Asia
Barbados,02-02-2020,93674,752,530,93144,Americas
Belarus,02-02-2020,266124,2159,1013,265111,Europe
Belgium,02-02-2020,201908,1905,108,201800,Europe
Benin,02-02-2020,169108,2119,367,168741,Africa
Bhutan,02-02-2020,409557,1580,1070,408487,South-East Asia
Bolivia,02-02-2020,301119,789,19,301100,Americas
Bosnia and Herzegovina,02-02-2020,416558,2159,952,415606,Europe
Brazil,02-02-2020,278585,1039,1202,277383,Americas
Brunei,02-02-2020,180547,637,833,179714,Western Pacific
Bulgaria,02-02-2020,448589,1432,314,448275,Europe
Burkina Faso,02-02-2020,382548,270,84,382464,Africa
Cabo Verde,02-02-2020,112107,2283,801,111306,Africa
Cambodia,02-02-2020,284562,224,1012,283550,Western Pacific
Cameroon,02-02-2020,286906,1774,173,286733,Africa
Canada,02-02-2020,417928,418,968,416960,Americas
Canada,02-02-2020,133059,306,188,132871,Americas
Canada,02-02-2020,284287,741,610,283677,Americas
Canada,02-02-2020,65881,1497,232,65649,Americas
Canada,02-02-2020,61543,1749,1004,60539,Americas
Canada,02-02-2020,232215,1702,782,231433,Americas
Canada,02-02-2020,103397,260,526,102871,Americas
Canada,02-02-2020,289724,1615,544,289180,Americas
Canada,02-02-2020,328184,1032,1198,326986,Americas
Canada,02-02-2020,67542,2274,353,67189,Americas
Central African Republic,02-02-2020,239206,1980,411,238795,Africa
Chad,02-02-2020,84864,1740,661,84203,Africa
Chile,02-02-2020,339085,2085,681,338404,Americas
China,02-02-2020,188520,755,811,187709,Western Pacific
China,02-02-2020,159246,1004,781,158465,Western Pacific
China,02-02-2020,362140,1854,876,361264,Western Pacific
China,02-02-2020,331539,2037,324,331215,Western Pacific
China,02-02-2020,62414,2161,1144,61270,Western Pacific
China,02-02-2020,332321,1805,930,331391,Western Pacific
China,02-02-2020,244485,2351,950,243535,Western Pacific
China,02-02-2020,440774,5,1154,439620,Western Pacific
China,02-02-2020,389479,1736,503,388976,Western Pacific
China,02-02-2020,40819,1548,208,40611,Western Pacific
China,02-02-2020,337843,572,405,337438,Western Pacific
China,02-02-2020,67584,31,634,66950,Western Pacific
China,02-02-2020,309836,1935,583,309253,Western Pacific
China,02-02-2020,59849,1762,1167,58682,Western Pacific
China,02-02-2020,294120,590,582,293538,Western Pacific
China,02-02-2020,167399,2375,193,167206,Western Pacific
China,02-02-2020,34750,916,812,33938,Western Pacific
China,02-02-2020,182123,1160,370,181753,Western Pacific
China,02-02-2020,357093,578,886,356207,Western Pacific
China,02-02-2020,277084,1997,852,276232,Western Pacific
China,02-02-2020,371901,2461,455,371446,Western Pacific
China,02-02-2020,370179,1356,50,370129,Western Pacific
China,02-02-2020,18238,585,518,17720,Western Pacific
China,02-02-2020,33458,2500,572,32886,Western Pacific
China,02-02-2020,241509,508,178,241331,Western Pacific
China,02-02-2020,161490,936,749,160741,Western Pacific
China,02-02-2020,80389,470,792,79597,Western Pacific
China,02-02-2020,171050,2283,172,170878,Western Pacific
China,02-02-2020,96592,2398,251,96341,Western Pacific
China,02-02-2020,316444,448,472,315972,Western Pacific
China,02-02-2020,48495,2185,605,47890,Western Pacific
China,02-02-2020,379885,2226,603,379282,Western Pacific
China,02-02-2020,122173,802,549,121624,Western Pacific
Colombia,02-02-2020,250857,1417,1241,249616,Americas
Congo (Brazzaville),02-02-2020,295898,2312,1221,294677,Africa
Congo (Kinshasa),02-02-2020,340600,533,985,339615,Africa
Costa Rica,02-02-2020,379604,1499,1227,378377,Americas
Cote d'Ivoire,02-02-2020,160666,387,339,160327,Africa
Croatia,02-02-2020,195450,274,1001,194449,Europe
Cuba,02-02-2020,324314,301,905,323409,Americas
Cyprus,02-02-2020,383433,875,704,382729,Europe
Czechia,02-02-2020,387051,1879,334,386717,Europe
Denmark,02-02-2020,146283,165,686,145597,Europe
Greenland,02-02-2020,282742,1680,268,282474,Europe
Denmark,02-02-2020,188359,1824,714,187645,Europe
Djibouti,02-02-2020,446588,47,1186,445402,Eastern Mediterranean
Dominican Republic,02-02-2020,217163,1607,331,216832,Americas
Ecuador,02-02-2020,395880,241,781,395099,Americas
Egypt,02-02-2020,296245,475,531,295714,Eastern Mediterranean
El Salvador,02-02-2020,441801,1830,127,441674,Americas
Equatorial Guinea,02-02-2020,63221,1221,1248,61973,Africa
Eritrea,02-02-2020,415265,769,427,414838,Africa
Estonia,02-02-2020,303009,1954,1068,301941,Europe
Eswatini,02-02-2020,253030,761,1220,251810,Africa
Ethiopia,02-02-2020,306660,158,282,306378,Africa
Fiji,02-02-2020,266737,1270,56,266681,Western Pacific
Finland,02-02-2020,33081,717,415,32666,Europe
France,02-02-2020,426206,1102,918,425288,Europe
France,02-02-2020,184533,1494,490,184043,Europe
France,02-02-2020,362951,1894,428,362523,Europe
France,02-02-2020,202111,1116,131,201980,Europe
France,02-02-2020,117912,204,495,117417,Europe
France,02-02-2020,371674,214,186,371488,Europe
France,02-02-2020,94007,1112,335,93672,Europe
France,02-02-2020,151888,2327,812,151076,Europe
France,02-02-2020,256554,1796,740,255814,Europe
France,02-02-2020,37073,2217,60,37013,Europe
Gabon,02-02-2020,242450,2187,623,241827,Africa
Gambia,02-02-2020,340419,652,1180,339239,Africa
Georgia,02-02-2020,36155,198,586,35569,Europe
Germany,02-02-2020,87441,1175,1053,86388,Europe
Ghana,02-02-2020,262141,1628,58,262083,Africa
Greece,02-02-2020,14226,2309,1085,13141,Europe
Guatemala,02-02-2020,105540,202,677,104863,Americas
Guinea,02-02-2020,229429,1913,1125,228304,Africa
Guyana,02-02-2020,186662,2392,1008,185654,Americas
Haiti,02-02-2020,437071,1407,794,436277,Americas
Holy See,02-02-2020,181972,448,1131,180841,Europe
Honduras,02-02-2020,341764,2453,837,340927,Americas
Hungary,02-02-2020,60099,216,1099,59000,Europe
Iceland,02-02-2020,198718,2011,492,198226,Europe
India,02-02-2020,119194,1789,266,118928,South-East Asia
Indonesia,02-02-2020,195803,667,806,194997,South-East Asia
Iran,02-02-2020,251098,1856,217,250881,Eastern Mediterranean
Iraq,02-02-2020,270968,1064,326,270642,Eastern Mediterranean
Ireland,02-02-2020,173995,2249,72,173923,Europe
Israel,02-02-2020,209579,2363,775,208804,Europe
Italy,02-02-2020,345244,793,375,344869,Europe
Jamaica,02-02-2020,12122,1037,404,11718,Americas
Japan,02-02-2020,153781,2139,462,153319,Western Pacific
Jordan,02-02-2020,291698,356,568,291130,Eastern Mediterranean
Kazakhstan,02-02-2020,353094,1594,134,352960,Europe
Kenya,02-02-2020,442702,2402,1205,441497,Africa
South Korea,02-02-2020,390458,795,1041,389417,Western Pacific
Kuwait,02-02-2020,225899,1584,462,225437,Eastern Mediterranean
Kyrgyzstan,02-02-2020,101232,2143,45,101187,Europe
Latvia,02-02-2020,304379,625,470,303909,Europe
Lebanon,02-02-2020,282080,566,929,281151,Eastern Mediterranean
Liberia,02-02-2020,315336,345,472,314864,Africa
Liechtenstein,02-02-2020,178911,1186,891,178020,Europe
Lithuania,02-02-2020,303678,684,442,303236,Europe
Luxembourg,02-02-2020,14183,1752,1084,13099,Europe
Madagascar,02-02-2020,9619,1904,669,8950,Africa
Malaysia,02-02-2020,68529,1004,1173,67356,Western Pacific
Maldives,02-02-2020,108531,2274,194,108337,South-East Asia
Malta,02-02-2020,266380,2464,469,265911,Europe
Mauritania,02-02-2020,427169,2468,740,426429,Africa
Mauritius,02-02-2020,163127,2013,621,162506,Africa
Mexico,02-02-2020,400822,1663,650,400172,Americas
Moldova,02-02-2020,404369,468,322,404047,Europe
Monaco,02-02-2020,108623,107,943,107680,Europe
Mongolia,02-02-2020,100263,543,501,99762,Western Pacific
Montenegro,02-02-2020,407851,2098,246,407605,Europe
Morocco,02-02-2020,26939,2020,126,26813,Eastern Mediterranean
Namibia,02-02-2020,239509,118,1131,238378,Africa
Nepal,02-02-2020,221332,1740,670,220662,South-East Asia
Netherlands,02-02-2020,249592,2409,792,248800,Europe
Netherlands,02-02-2020,157355,65,665,156690,Europe
Netherlands,02-02-2020,326392,1340,1199,325193,Europe
Netherlands,02-02-2020,211423,1833,227,211196,Europe
New Zealand,02-02-2020,399543,2404,41,399502,Western Pacific
Nicaragua,02-02-2020,91124,216,17,91107,Americas
Niger,02-02-2020,168621,139,735,167886,Africa
Nigeria,02-02-2020,237913,2293,672,237241,Africa
North Macedonia,02-02-2020,18887,45,639,18248,Europe
Norway,02-02-2020,139444,208,131,139313,Europe
Oman,02-02-2020,329070,1268,916,328154,Eastern Mediterranean
Pakistan,02-02-2020,143802,2258,414,143388,Eastern Mediterranean
Panama,02-02-2020,138384,2306,1141,137243,Americas
Papua New Guinea,02-02-2020,317131,1273,441,316690,Western Pacific
Paraguay,02-02-2020,399923,9,1205,398718,Americas
Peru,02-02-2020,24130,782,1202,22928,Americas
Philippines,02-02-2020,101596,890,727,100869,Western Pacific
Poland,02-02-2020,324875,1373,70,324805,Europe
Portugal,02-02-2020,19431,2213,552,18879,Europe
Qatar,02-02-2020,48862,431,250,48612,Eastern Mediterranean
Romania,02-02-2020,395477,1064,1207,394270,Europe
Russia,02-02-2020,147026,2296,848,146178,Europe
Rwanda,02-02-2020,150586,2358,215,150371,Africa
Saint Lucia,02-02-2020,250664,420,512,250152,Americas
Saint Vincent and the Grenadines,02-02-2020,313812,961,999,312813,Americas
San Marino,02-02-2020,427424,680,974,426450,Europe
Saudi Arabia,02-02-2020,445384,2097,949,444435,Eastern Mediterranean
Senegal,02-02-2020,396502,2234,1139,395363,Africa
Serbia,02-02-2020,404038,365,1182,402856,Europe
Seychelles,02-02-2020,367575,1211,193,367382,Africa
Singapore,02-02-2020,26876,1458,661,26215,Western Pacific
Slovakia,02-02-2020,156327,1484,476,155851,Europe
Slovenia,02-02-2020,325566,2365,1215,324351,Europe
Somalia,02-02-2020,45099,288,1095,44004,Eastern Mediterranean
South Africa,02-02-2020,240864,354,1050,239814,Africa
Spain,02-02-2020,129512,1368,192,129320,Europe
Sri Lanka,02-02-2020,300676,1989,1135,299541,South-East Asia
Sudan,02-02-2020,193637,527,702,192935,Eastern Mediterranean
Suriname,02-02-2020,8927,208,666,8261,Americas
Sweden,02-02-2020,436709,52,397,436312,Europe
Switzerland,02-02-2020,79344,2372,890,78454,Europe
Taiwan*,02-02-2020,11465,1394,1077,10388,Western Pacific
Tanzania,02-02-2020,234991,1956,902,234089,Africa
Thailand,02-02-2020,321585,1344,839,320746,South-East Asia
Togo,02-02-2020,116079,1437,500,115579,Africa
Trinidad and Tobago,02-02-2020,28260,1751,728,27532,Americas
Tunisia,02-02-2020,100978,666,622,100356,Eastern Mediterranean
Turkey,02-02-2020,310853,1613,719,310134,Europe
Uganda,02-02-2020,186014,2330,297,185717,Africa
Ukraine,02-02-2020,43966,1596,1226,42740,Europe
United Arab Emirates,02-02-2020,440331,1078,59,440272,Eastern Mediterranean
United Kingdom,02-02-2020,181302,1280,468,180834,Europe
United Kingdom,02-02-2020,235399,1660,1250,234149,Europe
United Kingdom,02-02-2020,436233,1293,153,436080,Europe
United Kingdom,02-02-2020,429413,1070,601,428812,Europe
United Kingdom,02-02-2020,279123,1737,471,278652,Europe
United Kingdom,02-02-2020,74613,153,253,74360,Europe
United Kingdom,02-02-2020,447428,2243,16,447412,Europe
Uruguay,02-02-2020,91751,1857,1068,90683,Americas
US,02-02-2020,94662,910,0,94662,Americas
Uzbekistan,02-02-2020,403749,262,1113,402636,Europe
Venezuela,02-02-2020,433586,1630,762,432824,Americas
Vietnam,02-02-2020,65504,188,271,65233,Western Pacific
Zambia,02-02-2020,37228,458,543,36685,Africa
Zimbabwe,02-02-2020,171135,436,402,170733,Africa
Dominica,02-02-2020,10281,940,492,9789,Americas
Grenada,02-02-2020,261385,2310,204,261181,Americas
Mozambique,02-02-2020,88095,2083,874,87221,Africa
Syria,02-02-2020,327814,2325,494,327320,Eastern Mediterranean
Timor-Leste,02-02-2020,325071,2214,652,324419,South-East Asia
Belize,02-02-2020,441327,1337,573,440754,Americas
Laos,02-02-2020,148066,336,867,147199,Western Pacific
Libya,02-02-2020,302412,57,699,301713,Eastern Mediterranean
West Bank and Gaza,02-02-2020,272361,988,1167,271194,Eastern Mediterranean
Guinea-Bissau,02-02-2020,291844,1420,1179,290665,Africa
Mali,02-02-2020,8573,1215,747,7826,Africa
Saint Kitts and Nevis,02-02-2020,386254,2106,764,385490,Americas
Canada,02-02-2020,279181,1361,741,278440,Americas
Canada,02-02-2020,337834,2140,930,336904,Americas
Kosovo,02-02-2020,414180,1146,1109,413071,Europe
Burma,02-02-2020,243916,19,827,243089,South-East Asia
United Kingdom,02-02-2020,336878,815,1041,335837,Europe
United Kingdom,02-02-2020,118761,1767,541,118220,Europe
United Kingdom,02-02-2020,15314,1057,597,14717,Europe
Botswana,02-02-2020,359532,132,60,359472,Africa
Burundi,02-02-2020,219100,1159,121,218979,Africa
Sierra Leone,02-02-2020,134578,694,1071,133507,Africa
Malawi,02-02-2020,121768,2414,2,121766,Africa
United Kingdom,02-02-2020,36223,205,1149,35074,Europe
France,02-02-2020,297399,2165,863,296536,Europe
South Sudan,02-02-2020,375047,606,280,374767,Africa
Western Sahara,02-02-2020,259980,1218,427,259553,Africa
Sao Tome and Principe,02-02-2020,284328,464,82,284246,Africa
Yemen,02-02-2020,78243,442,92,78151,Eastern Mediterranean
Comoros,02-02-2020,54944,1984,945,53999,Africa
Tajikistan,02-02-2020,442290,487,922,441368,Europe
Lesotho,02-02-2020,90433,207,331,90102,Africa
Afghanistan,03-02-2020,150949,432,145,150804,Eastern Mediterranean
Albania,03-02-2020,76516,1401,950,75566,Europe
Algeria,03-02-2020,349292,1194,102,349190,Africa
Andorra,03-02-2020,292091,94,442,291649,Europe
Angola,03-02-2020,271614,266,245,271369,Africa
Antigua and Barbuda,03-02-2020,219824,182,319,219505,Americas
Argentina,03-02-2020,38158,1944,983,37175,Americas
Armenia,03-02-2020,237955,1899,426,237529,Europe
Australia,03-02-2020,401895,1588,853,401042,Western Pacific
Australia,03-02-2020,422176,1456,331,421845,Western Pacific
Australia,03-02-2020,106545,714,605,105940,Western Pacific
Australia,03-02-2020,10691,847,980,9711,Western Pacific
Australia,03-02-2020,287287,1028,605,286682,Western Pacific
Australia,03-02-2020,11419,1966,824,10595,Western Pacific
Australia,03-02-2020,278229,760,214,278015,Western Pacific
Australia,03-02-2020,396526,1905,750,395776,Western Pacific
Austria,03-02-2020,336287,205,522,335765,Europe
Azerbaijan,03-02-2020,9177,923,287,8890,Europe
Bahamas,03-02-2020,401920,386,1064,400856,Americas
Bahrain,03-02-2020,319077,289,1065,318012,Eastern Mediterranean
Bangladesh,03-02-2020,16326,1634,1042,15284,South-East Asia
Barbados,03-02-2020,388130,1258,358,387772,Americas
Belarus,03-02-2020,254962,2240,629,254333,Europe
Belgium,03-02-2020,382304,1834,149,382155,Europe
Benin,03-02-2020,249874,1016,1178,248696,Africa
Bhutan,03-02-2020,290399,9,1039,289360,South-East Asia
Bolivia,03-02-2020,303192,2431,1127,302065,Americas
Bosnia and Herzegovina,03-02-2020,213452,1478,776,212676,Europe
Brazil,03-02-2020,253217,493,696,252521,Americas
Brunei,03-02-2020,437987,1543,845,437142,Western Pacific
Bulgaria,03-02-2020,203375,257,1026,202349,Europe
Burkina Faso,03-02-2020,142520,2480,437,142083,Africa
Cabo Verde,03-02-2020,364380,883,946,363434,Africa
Cambodia,03-02-2020,335532,669,1240,334292,Western Pacific
Cameroon,03-02-2020,76724,1226,109,76615,Africa
Canada,03-02-2020,387775,1634,568,387207,Americas
Canada,03-02-2020,317149,1458,369,316780,Americas
Canada,03-02-2020,33850,2097,217,33633,Americas
Canada,03-02-2020,403110,205,325,402785,Americas
Canada,03-02-2020,279853,1821,119,279734,Americas
Canada,03-02-2020,186002,183,923,185079,Americas
Canada,03-02-2020,155869,886,416,155453,Americas
Canada,03-02-2020,442132,531,952,441180,Americas
Canada,03-02-2020,377174,439,275,376899,Americas
Canada,03-02-2020,165764,2414,16,165748,Americas
Central African Republic,03-02-2020,137087,1565,1077,136010,Africa
Chad,03-02-2020,41693,526,18,41675,Africa
Chile,03-02-2020,343110,1428,1204,341906,Americas
China,03-02-2020,74392,326,52,74340,Western Pacific
China,03-02-2020,265536,173,137,265399,Western Pacific
China,03-02-2020,80983,830,981,80002,Western Pacific
China,03-02-2020,2853,438,765,2088,Western Pacific
China,03-02-2020,186749,1954,956,185793,Western Pacific
China,03-02-2020,163395,2200,981,162414,Western Pacific
China,03-02-2020,290468,1093,1229,289239,Western Pacific
China,03-02-2020,445638,2394,638,445000,Western Pacific
China,03-02-2020,269520,1442,221,269299,Western Pacific
China,03-02-2020,267643,500,118,267525,Western Pacific
China,03-02-2020,316157,827,529,315628,Western Pacific
China,03-02-2020,314577,1803,414,314163,Western Pacific
China,03-02-2020,370298,2280,1118,369180,Western Pacific
China,03-02-2020,111476,1512,645,110831,Western Pacific
China,03-02-2020,78217,124,749,77468,Western Pacific
China,03-02-2020,315556,94,783,314773,Western Pacific
China,03-02-2020,202161,540,953,201208,Western Pacific
China,03-02-2020,427701,1817,895,426806,Western Pacific
China,03-02-2020,119496,941,651,118845,Western Pacific
China,03-02-2020,115153,51,147,115006,Western Pacific
China,03-02-2020,101256,1445,1043,100213,Western Pacific
China,03-02-2020,257692,2482,213,257479,Western Pacific
China,03-02-2020,296502,720,1087,295415,Western Pacific
China,03-02-2020,368585,1501,694,367891,Western Pacific
China,03-02-2020,357664,1361,1207,356457,Western Pacific
China,03-02-2020,103808,1192,1208,102600,Western Pacific
China,03-02-2020,360054,2338,434,359620,Western Pacific
China,03-02-2020,410911,1819,8,410903,Western Pacific
China,03-02-2020,388497,1501,902,387595,Western Pacific
China,03-02-2020,107057,166,821,106236,Western Pacific
China,03-02-2020,341547,2481,931,340616,Western Pacific
China,03-02-2020,279045,117,63,278982,Western Pacific
China,03-02-2020,176890,865,1020,175870,Western Pacific
Colombia,03-02-2020,125368,190,731,124637,Americas
Congo (Brazzaville),03-02-2020,245012,849,61,244951,Africa
Congo (Kinshasa),03-02-2020,43790,363,186,43604,Africa
Costa Rica,03-02-2020,167860,2062,1077,166783,Americas
Cote d'Ivoire,03-02-2020,243236,789,862,242374,Africa
Croatia,03-02-2020,151511,1344,251,151260,Europe
Cuba,03-02-2020,257153,626,1191,255962,Americas
Cyprus,03-02-2020,14626,149,645,13981,Europe
Czechia,03-02-2020,109512,439,167,109345,Europe
Denmark,03-02-2020,433820,409,1175,432645,Europe
Greenland,03-02-2020,221517,1595,1226,220291,Europe
Denmark,03-02-2020,59687,2271,103,59584,Europe
Djibouti,03-02-2020,250451,2392,869,249582,Eastern Mediterranean
Dominican Republic,03-02-2020,295887,647,1219,294668,Americas
Ecuador,03-02-2020,282200,625,1154,281046,Americas
Egypt,03-02-2020,101508,1515,565,100943,Eastern Mediterranean
El Salvador,03-02-2020,382638,1632,479,382159,Americas
Equatorial Guinea,03-02-2020,343414,710,668,342746,Africa
Eritrea,03-02-2020,270670,890,561,270109,Africa
Estonia,03-02-2020,321386,1619,745,320641,Europe
Eswatini,03-02-2020,406412,615,488,405924,Africa
Ethiopia,03-02-2020,268666,2048,614,268052,Africa
Fiji,03-02-2020,183517,821,716,182801,Western Pacific
Finland,03-02-2020,380971,1167,497,380474,Europe
France,03-02-2020,166895,2160,960,165935,Europe
France,03-02-2020,74403,953,386,74017,Europe
France,03-02-2020,143885,1217,691,143194,Europe
France,03-02-2020,331764,161,340,331424,Europe
France,03-02-2020,435262,1791,597,434665,Europe
France,03-02-2020,310032,744,540,309492,Europe
France,03-02-2020,300329,814,781,299548,Europe
France,03-02-2020,196554,1715,43,196511,Europe
France,03-02-2020,181963,2151,116,181847,Europe
France,03-02-2020,322163,1130,356,321807,Europe
Gabon,03-02-2020,166333,171,58,166275,Africa
Gambia,03-02-2020,86527,1538,486,86041,Africa
Georgia,03-02-2020,405816,770,846,404970,Europe
Germany,03-02-2020,205124,2284,912,204212,Europe
Ghana,03-02-2020,383020,372,422,382598,Africa
Greece,03-02-2020,261476,10,174,261302,Europe
Guatemala,03-02-2020,127244,672,172,127072,Americas
Guinea,03-02-2020,20744,1755,1069,19675,Africa
Guyana,03-02-2020,85,574,920,-835,Americas
Haiti,03-02-2020,76812,1447,443,76369,Americas
Holy See,03-02-2020,180675,1722,125,180550,Europe
Honduras,03-02-2020,12178,309,470,11708,Americas
Hungary,03-02-2020,292309,1792,353,291956,Europe
Iceland,03-02-2020,219090,2291,116,218974,Europe
India,03-02-2020,271115,1702,591,270524,South-East Asia
Indonesia,03-02-2020,391029,2460,848,390181,South-East Asia
Iran,03-02-2020,370758,1108,1102,369656,Eastern Mediterranean
Iraq,03-02-2020,323450,1494,122,323328,Eastern Mediterranean
Ireland,03-02-2020,265022,347,159,264863,Europe
Israel,03-02-2020,12986,1298,8,12978,Europe
Italy,03-02-2020,187572,2284,266,187306,Europe
Jamaica,03-02-2020,13573,1051,24,13549,Americas
Japan,03-02-2020,5363,176,686,4677,Western Pacific
Jordan,03-02-2020,182325,1914,591,181734,Eastern Mediterranean
Kazakhstan,03-02-2020,1157,717,1136,21,Europe
Kenya,03-02-2020,205663,2354,972,204691,Africa
South Korea,03-02-2020,311695,378,628,311067,Western Pacific
Kuwait,03-02-2020,264129,2011,140,263989,Eastern Mediterranean
Kyrgyzstan,03-02-2020,191270,437,698,190572,Europe
Latvia,03-02-2020,300170,2435,778,299392,Europe
Lebanon,03-02-2020,200635,2354,302,200333,Eastern Mediterranean
Liberia,03-02-2020,166784,1014,987,165797,Africa
Liechtenstein,03-02-2020,341077,1323,622,340455,Europe
Lithuania,03-02-2020,149164,2371,920,148244,Europe
Luxembourg,03-02-2020,133001,105,661,132340,Europe
Madagascar,03-02-2020,233750,1895,1021,232729,Africa
Malaysia,03-02-2020,168091,928,1237,166854,Western Pacific
Maldives,03-02-2020,51857,2415,865,50992,South-East Asia
Malta,03-02-2020,79374,1677,457,78917,Europe
Mauritania,03-02-2020,398057,617,1165,396892,Africa
Mauritius,03-02-2020,409043,1988,897,408146,Africa
Mexico,03-02-2020,62837,2301,363,62474,Americas
Moldova,03-02-2020,8360,2137,1250,7110,Europe
Monaco,03-02-2020,210475,1988,239,210236,Europe
Mongolia,03-02-2020,38425,596,894,37531,Western Pacific
Montenegro,03-02-2020,323481,2445,588,322893,Europe
Morocco,03-02-2020,86634,825,256,86378,Eastern Mediterranean
Namibia,03-02-2020,231371,2225,362,231009,Africa
Nepal,03-02-2020,97338,1180,818,96520,South-East Asia
Netherlands,03-02-2020,432907,1210,431,432476,Europe
Netherlands,03-02-2020,389057,747,37,389020,Europe
Netherlands,03-02-2020,39618,165,1088,38530,Europe
Netherlands,03-02-2020,99382,492,362,99020,Europe
New Zealand,03-02-2020,366080,800,1068,365012,Western Pacific
Nicaragua,03-02-2020,135491,2097,235,135256,Americas
Niger,03-02-2020,108810,472,542,108268,Africa
Nigeria,03-02-2020,286843,735,594,286249,Africa
North Macedonia,03-02-2020,68427,415,609,67818,Europe
Norway,03-02-2020,372507,845,523,371984,Europe
Oman,03-02-2020,329993,796,849,329144,Eastern Mediterranean
Pakistan,03-02-2020,306278,1439,725,305553,Eastern Mediterranean
Panama,03-02-2020,163958,1638,1221,162737,Americas
Papua New Guinea,03-02-2020,364779,1196,121,364658,Western Pacific
Paraguay,03-02-2020,46077,1771,498,45579,Americas
Peru,03-02-2020,50472,1032,1085,49387,Americas
Philippines,03-02-2020,172630,1446,20,172610,Western Pacific
Poland,03-02-2020,392131,1069,98,392033,Europe
Portugal,03-02-2020,406920,376,529,406391,Europe
Qatar,03-02-2020,116738,136,69,116669,Eastern Mediterranean
Romania,03-02-2020,211504,1965,921,210583,Europe
Russia,03-02-2020,16897,1777,279,16618,Europe
Rwanda,03-02-2020,440436,1799,869,439567,Africa
Saint Lucia,03-02-2020,191903,294,338,191565,Americas
Saint Vincent and the Grenadines,03-02-2020,93439,2175,276,93163,Americas
San Marino,03-02-2020,419357,1202,872,418485,Europe
Saudi Arabia,03-02-2020,325043,902,1000,324043,Eastern Mediterranean
Senegal,03-02-2020,127075,589,651,126424,Africa
Serbia,03-02-2020,47282,2138,807,46475,Europe
Seychelles,03-02-2020,441719,495,534,441185,Africa
Singapore,03-02-2020,97305,2306,410,96895,Western Pacific
Slovakia,03-02-2020,403647,2299,1052,402595,Europe
Slovenia,03-02-2020,351592,814,888,350704,Europe
Somalia,03-02-2020,347674,1096,277,347397,Eastern Mediterranean
South Africa,03-02-2020,390082,755,318,389764,Africa
Spain,03-02-2020,76906,1952,1109,75797,Europe
Sri Lanka,03-02-2020,430197,838,907,429290,South-East Asia
Sudan,03-02-2020,172867,692,158,172709,Eastern Mediterranean
Suriname,03-02-2020,142135,2034,1007,141128,Americas
Sweden,03-02-2020,434037,74,211,433826,Europe
Switzerland,03-02-2020,140425,2240,556,139869,Europe
Taiwan*,03-02-2020,91020,856,488,90532,Western Pacific
Tanzania,03-02-2020,243873,951,418,243455,Africa
Thailand,03-02-2020,87742,201,865,86877,South-East Asia
Togo,03-02-2020,75427,2200,1141,74286,Africa
Trinidad and Tobago,03-02-2020,283289,124,836,282453,Americas
Tunisia,03-02-2020,131227,266,896,130331,Eastern Mediterranean
Turkey,03-02-2020,387139,295,561,386578,Europe
Uganda,03-02-2020,29644,1691,415,29229,Africa
Ukraine,03-02-2020,384309,1769,265,384044,Europe
United Arab Emirates,03-02-2020,266612,2421,1094,265518,Eastern Mediterranean
United Kingdom,03-02-2020,8074,70,1179,6895,Europe
United Kingdom,03-02-2020,354446,1039,858,353588,Europe
United Kingdom,03-02-2020,409375,1283,313,409062,Europe
United Kingdom,03-02-2020,340736,2289,584,340152,Europe
United Kingdom,03-02-2020,392062,2340,470,391592,Europe
United Kingdom,03-02-2020,305666,24,468,305198,Europe
United Kingdom,03-02-2020,273118,1231,946,272172,Europe
Uruguay,03-02-2020,407513,2215,123,407390,Americas
US,03-02-2020,179071,1419,1053,178018,Americas
Uzbekistan,03-02-2020,306767,528,1108,305659,Europe
Venezuela,03-02-2020,381892,2295,81,381811,Americas
Vietnam,03-02-2020,260785,64,237,260548,Western Pacific
Zambia,03-02-2020,259716,895,382,259334,Africa
Zimbabwe,03-02-2020,429020,912,267,428753,Africa
Dominica,03-02-2020,365682,2357,364,365318,Americas
Grenada,03-02-2020,434344,1833,525,433819,Americas
Mozambique,03-02-2020,187830,79,224,187606,Africa
Syria,03-02-2020,91750,810,604,91146,Eastern Mediterranean
Timor-Leste,03-02-2020,85009,520,999,84010,South-East Asia
Belize,03-02-2020,257179,2043,97,257082,Americas
Laos,03-02-2020,400262,1745,1119,399143,Western Pacific
Libya,03-02-2020,180112,1604,505,179607,Eastern Mediterranean
West Bank and Gaza,03-02-2020,439224,2065,201,439023,Eastern Mediterranean
Guinea-Bissau,03-02-2020,111534,1393,18,111516,Africa
Mali,03-02-2020,95872,1692,856,95016,Africa
Saint Kitts and Nevis,03-02-2020,189498,2159,20,189478,Americas
Canada,03-02-2020,258637,2438,956,257681,Americas
Canada,03-02-2020,108681,1241,272,108409,Americas
Kosovo,03-02-2020,67755,1784,727,67028,Europe
Burma,03-02-2020,76188,1928,13,76175,South-East Asia
United Kingdom,03-02-2020,135108,2477,1132,133976,Europe
United Kingdom,03-02-2020,378146,430,1109,377037,Europe
United Kingdom,03-02-2020,304999,879,594,304405,Europe
Botswana,03-02-2020,446846,1091,902,445944,Africa
Burundi,03-02-2020,238806,45,441,238365,Africa
Sierra Leone,03-02-2020,439507,348,1211,438296,Africa
Malawi,03-02-2020,113497,1707,826,112671,Africa
United Kingdom,03-02-2020,358940,1619,315,358625,Europe
France,03-02-2020,209977,1660,285,209692,Europe
South Sudan,03-02-2020,352987,2105,850,352137,Africa
Western Sahara,03-02-2020,101665,465,610,101055,Africa
Sao Tome and Principe,03-02-2020,168869,2000,1040,167829,Africa
Yemen,03-02-2020,229129,349,636,228493,Eastern Mediterranean
Comoros,03-02-2020,337181,970,186,336995,Africa
Tajikistan,03-02-2020,17409,1823,914,16495,Europe
Lesotho,03-02-2020,323833,38,583,323250,Africa
Afghanistan,04-02-2020,323268,1869,685,322583,Eastern Mediterranean
Albania,04-02-2020,124095,217,810,123285,Europe
Algeria,04-02-2020,27161,572,719,26442,Africa
Andorra,04-02-2020,80923,934,663,80260,Europe
Angola,04-02-2020,91716,1003,442,91274,Africa
Antigua and Barbuda,04-02-2020,197061,1894,659,196402,Americas
Argentina,04-02-2020,154762,1236,1215,153547,Americas
Armenia,04-02-2020,198626,1159,1182,197444,Europe
Australia,04-02-2020,431041,2416,593,430448,Western Pacific
Australia,04-02-2020,426242,783,395,425847,Western Pacific
Australia,04-02-2020,119023,898,160,118863,Western Pacific
Australia,04-02-2020,42570,590,248,42322,Western Pacific
Australia,04-02-2020,399890,2008,323,399567,Western Pacific
Australia,04-02-2020,360355,848,1047,359308,Western Pacific
Australia,04-02-2020,173176,597,142,173034,Western Pacific
Australia,04-02-2020,373368,1918,908,372460,Western Pacific
Austria,04-02-2020,75232,397,36,75196,Europe
Azerbaijan,04-02-2020,381627,28,166,381461,Europe
Bahamas,04-02-2020,310999,831,690,310309,Americas
Bahrain,04-02-2020,322898,19,843,322055,Eastern Mediterranean
Bangladesh,04-02-2020,214227,1913,283,213944,South-East Asia
Barbados,04-02-2020,347550,1305,1055,346495,Americas
Belarus,04-02-2020,405455,1609,714,404741,Europe
Belgium,04-02-2020,380643,780,318,380325,Europe
Benin,04-02-2020,381186,636,121,381065,Africa
Bhutan,04-02-2020,40412,1985,690,39722,South-East Asia
Bolivia,04-02-2020,102377,894,1061,101316,Americas
Bosnia and Herzegovina,04-02-2020,37664,320,753,36911,Europe
Brazil,04-02-2020,105047,565,553,104494,Americas
Brunei,04-02-2020,22582,1952,1014,21568,Western Pacific
Bulgaria,04-02-2020,55285,2059,523,54762,Europe
Burkina Faso,04-02-2020,220386,516,301,220085,Africa
Cabo Verde,04-02-2020,124649,2222,1059,123590,Africa
Cambodia,04-02-2020,426895,434,834,426061,Western Pacific
Cameroon,04-02-2020,353608,1903,321,353287,Africa
Canada,04-02-2020,295861,1180,95,295766,Americas
Canada,04-02-2020,449255,877,1053,448202,Americas
Canada,04-02-2020,83500,2473,432,83068,Americas
Canada,04-02-2020,395615,894,104,395511,Americas
Canada,04-02-2020,100336,1218,1172,99164,Americas
Canada,04-02-2020,42385,403,1151,41234,Americas
Canada,04-02-2020,377372,158,279,377093,Americas
Canada,04-02-2020,103475,2294,778,102697,Americas
Canada,04-02-2020,385207,1931,1203,384004,Americas
Canada,04-02-2020,200613,472,306,200307,Americas
Central African Republic,04-02-2020,17508,2073,21,17487,Africa
Chad,04-02-2020,358407,2132,1021,357386,Africa
Chile,04-02-2020,247449,626,717,246732,Americas
China,04-02-2020,183904,49,573,183331,Western Pacific
China,04-02-2020,169606,1881,1167,168439,Western Pacific
China,04-02-2020,63291,374,798,62493,Western Pacific
China,04-02-2020,262652,471,675,261977,Western Pacific
China,04-02-2020,385753,463,16,385737,Western Pacific
China,04-02-2020,131960,1893,536,131424,Western Pacific
China,04-02-2020,202904,1805,464,202440,Western Pacific
China,04-02-2020,255541,797,1091,254450,Western Pacific
China,04-02-2020,13904,967,964,12940,Western Pacific
China,04-02-2020,378879,1047,256,378623,Western Pacific
China,04-02-2020,194333,2042,1136,193197,Western Pacific
China,04-02-2020,385200,1858,1000,384200,Western Pacific
China,04-02-2020,18632,1239,894,17738,Western Pacific
China,04-02-2020,218891,546,718,218173,Western Pacific
China,04-02-2020,361823,2162,211,361612,Western Pacific
China,04-02-2020,277698,992,931,276767,Western Pacific
China,04-02-2020,162533,354,1058,161475,Western Pacific
China,04-02-2020,85864,1997,325,85539,Western Pacific
China,04-02-2020,132774,1367,491,132283,Western Pacific
China,04-02-2020,179568,2185,355,179213,Western Pacific
China,04-02-2020,172435,2426,400,172035,Western Pacific
China,04-02-2020,431710,195,442,431268,Western Pacific
China,04-02-2020,31992,900,187,31805,Western Pacific
China,04-02-2020,326632,1320,1154,325478,Western Pacific
China,04-02-2020,228959,2369,828,228131,Western Pacific
China,04-02-2020,253066,609,1142,251924,Western Pacific
China,04-02-2020,13095,1639,1075,12020,Western Pacific
China,04-02-2020,160827,1690,317,160510,Western Pacific
China,04-02-2020,107862,2178,269,107593,Western Pacific
China,04-02-2020,364724,1094,655,364069,Western Pacific
China,04-02-2020,196805,663,259,196546,Western Pacific
China,04-02-2020,88455,139,667,87788,Western Pacific
China,04-02-2020,449762,1031,43,449719,Western Pacific
Colombia,04-02-2020,32126,2372,586,31540,Americas
Congo (Brazzaville),04-02-2020,275796,1922,50,275746,Africa
Congo (Kinshasa),04-02-2020,192968,252,691,192277,Africa
Costa Rica,04-02-2020,319294,2029,416,318878,Americas
Cote d'Ivoire,04-02-2020,218357,2386,464,217893,Africa
Croatia,04-02-2020,79665,935,268,79397,Europe
Cuba,04-02-2020,104252,86,687,103565,Americas
Cyprus,04-02-2020,216019,1673,950,215069,Europe
Czechia,04-02-2020,323330,903,41,323289,Europe
Denmark,04-02-2020,287706,2253,700,287006,Europe
Greenland,04-02-2020,253606,685,761,252845,Europe
Denmark,04-02-2020,164011,954,19,163992,Europe
Djibouti,04-02-2020,144807,1557,347,144460,Eastern Mediterranean
Dominican Republic,04-02-2020,418071,467,1123,416948,Americas
Ecuador,04-02-2020,406490,654,506,405984,Americas
Egypt,04-02-2020,369242,516,181,369061,Eastern Mediterranean
El Salvador,04-02-2020,255103,247,1175,253928,Americas
Equatorial Guinea,04-02-2020,67078,2241,1170,65908,Africa
Eritrea,04-02-2020,78436,967,802,77634,Africa
Estonia,04-02-2020,403896,756,1174,402722,Europe
Eswatini,04-02-2020,44485,182,1186,43299,Africa
Ethiopia,04-02-2020,228011,253,347,227664,Africa
Fiji,04-02-2020,428528,1343,1243,427285,Western Pacific
Finland,04-02-2020,175083,2276,558,174525,Europe
France,04-02-2020,157987,525,989,156998,Europe
France,04-02-2020,43831,1444,186,43645,Europe
France,04-02-2020,351130,1169,509,350621,Europe
France,04-02-2020,187325,557,552,186773,Europe
France,04-02-2020,146114,218,93,146021,Europe
France,04-02-2020,369192,2014,53,369139,Europe
France,04-02-2020,204446,1326,76,204370,Europe
France,04-02-2020,280320,805,402,279918,Europe
France,04-02-2020,412500,2255,677,411823,Europe
France,04-02-2020,333714,1318,347,333367,Europe
Gabon,04-02-2020,384268,852,696,383572,Africa
Gambia,04-02-2020,331889,2292,1245,330644,Africa
Georgia,04-02-2020,295641,795,838,294803,Europe
Germany,04-02-2020,241043,1362,397,240646,Europe
Ghana,04-02-2020,238474,325,794,237680,Africa
Greece,04-02-2020,259257,266,1118,258139,Europe
Guatemala,04-02-2020,269644,518,715,268929,Americas
Guinea,04-02-2020,122463,806,773,121690,Africa
Guyana,04-02-2020,273519,147,190,273329,Americas
Haiti,04-02-2020,207639,1610,764,206875,Americas
Holy See,04-02-2020,380837,201,396,380441,Europe
Honduras,04-02-2020,366921,219,1011,365910,Americas
Hungary,04-02-2020,331546,618,557,330989,Europe
Iceland,04-02-2020,232892,2162,366,232526,Europe
India,04-02-2020,120160,1806,946,119214,South-East Asia
Indonesia,04-02-2020,437993,1386,811,437182,South-East Asia
Iran,04-02-2020,414791,423,913,413878,Eastern Mediterranean
Iraq,04-02-2020,172689,135,686,172003,Eastern Mediterranean
Ireland,04-02-2020,416031,2062,392,415639,Europe
Israel,04-02-2020,231566,1357,233,231333,Europe
Italy,04-02-2020,39501,1238,1011,38490,Europe
Jamaica,04-02-2020,202436,754,974,201462,Americas
Japan,04-02-2020,32011,1227,1068,30943,Western Pacific
Jordan,04-02-2020,356877,2336,108,356769,Eastern Mediterranean
Kazakhstan,04-02-2020,397550,217,264,397286,Europe
Kenya,04-02-2020,357845,1127,1080,356765,Africa
South Korea,04-02-2020,5935,1073,926,5009,Western Pacific
Kuwait,04-02-2020,292190,562,933,291257,Eastern Mediterranean
Kyrgyzstan,04-02-2020,408210,642,634,407576,Europe
Latvia,04-02-2020,338435,2086,1159,337276,Europe
Lebanon,04-02-2020,421379,1790,51,421328,Eastern Mediterranean
Liberia,04-02-2020,405145,115,745,404400,Africa
Liechtenstein,04-02-2020,103958,2288,805,103153,Europe
Lithuania,04-02-2020,269456,586,805,268651,Europe
Luxembourg,04-02-2020,265562,2034,116,265446,Europe
Madagascar,04-02-2020,101768,2488,967,100801,Africa
Malaysia,04-02-2020,123839,920,9,123830,Western Pacific
Maldives,04-02-2020,447331,34,1058,446273,South-East Asia
Malta,04-02-2020,3986,1201,1009,2977,Europe
Mauritania,04-02-2020,419157,2035,880,418277,Africa
Mauritius,04-02-2020,132347,2186,1141,131206,Africa
Mexico,04-02-2020,24316,2434,307,24009,Americas
Moldova,04-02-2020,292767,2365,149,292618,Europe
Monaco,04-02-2020,257138,1386,187,256951,Europe
Mongolia,04-02-2020,51105,1422,1215,49890,Western Pacific
Montenegro,04-02-2020,200845,1964,497,200348,Europe
Morocco,04-02-2020,350217,518,589,349628,Eastern Mediterranean
Namibia,04-02-2020,429591,1045,411,429180,Africa
Nepal,04-02-2020,80486,1172,805,79681,South-East Asia
Netherlands,04-02-2020,401685,1269,345,401340,Europe
Netherlands,04-02-2020,168086,8,488,167598,Europe
Netherlands,04-02-2020,64956,733,501,64455,Europe
Netherlands,04-02-2020,102543,1727,317,102226,Europe
New Zealand,04-02-2020,317334,2073,890,316444,Western Pacific
Nicaragua,04-02-2020,169449,2090,1139,168310,Americas
Niger,04-02-2020,344007,2204,345,343662,Africa
Nigeria,04-02-2020,188802,634,985,187817,Africa
North Macedonia,04-02-2020,130554,647,625,129929,Europe
Norway,04-02-2020,444670,390,1211,443459,Europe
Oman,04-02-2020,269619,128,699,268920,Eastern Mediterranean
Pakistan,04-02-2020,371333,2247,1237,370096,Eastern Mediterranean
Panama,04-02-2020,160003,2199,1182,158821,Americas
Papua New Guinea,04-02-2020,44341,1902,6,44335,Western Pacific
Paraguay,04-02-2020,415748,141,663,415085,Americas
Peru,04-02-2020,125833,1225,918,124915,Americas
Philippines,04-02-2020,284648,2352,209,284439,Western Pacific
Poland,04-02-2020,225692,354,679,225013,Europe
Portugal,04-02-2020,18414,790,326,18088,Europe
Qatar,04-02-2020,35840,1359,27,35813,Eastern Mediterranean
Romania,04-02-2020,302248,1973,256,301992,Europe
Russia,04-02-2020,326155,286,813,325342,Europe
Rwanda,04-02-2020,212514,1913,1167,211347,Africa
Saint Lucia,04-02-2020,449907,790,35,449872,Americas
Saint Vincent and the Grenadines,04-02-2020,355814,1786,182,355632,Americas
San Marino,04-02-2020,390173,1441,54,390119,Europe
Saudi Arabia,04-02-2020,362942,1630,697,362245,Eastern Mediterranean
Senegal,04-02-2020,90255,566,421,89834,Africa
Serbia,04-02-2020,322244,392,95,322149,Europe
Seychelles,04-02-2020,68688,1552,233,68455,Africa
Singapore,04-02-2020,375112,2265,363,374749,Western Pacific
Slovakia,04-02-2020,240246,685,1100,239146,Europe
Slovenia,04-02-2020,192966,1118,903,192063,Europe
Somalia,04-02-2020,107930,981,651,107279,Eastern Mediterranean
South Africa,04-02-2020,270233,1410,830,269403,Africa
Spain,04-02-2020,252516,1778,992,251524,Europe
Sri Lanka,04-02-2020,357632,140,617,357015,South-East Asia
Sudan,04-02-2020,93595,2227,1229,92366,Eastern Mediterranean
Suriname,04-02-2020,241861,226,1163,240698,Americas
Sweden,04-02-2020,13015,144,690,12325,Europe
Switzerland,04-02-2020,162803,1924,425,162378,Europe
Taiwan*,04-02-2020,368870,2409,244,368626,Western Pacific
Tanzania,04-02-2020,121080,1759,546,120534,Africa
Thailand,04-02-2020,412055,327,550,411505,South-East Asia
Togo,04-02-2020,238582,461,598,237984,Africa
Trinidad and Tobago,04-02-2020,406411,750,486,405925,Americas
Tunisia,04-02-2020,162924,1211,110,162814,Eastern Mediterranean
Turkey,04-02-2020,370892,1031,669,370223,Europe
Uganda,04-02-2020,89989,721,281,89708,Africa
Ukraine,04-02-2020,383411,2195,150,383261,Europe
United Arab Emirates,04-02-2020,448357,37,1102,447255,Eastern Mediterranean
United Kingdom,04-02-2020,167161,172,659,166502,Europe
United Kingdom,04-02-2020,290284,44,424,289860,Europe
United Kingdom,04-02-2020,75935,1890,820,75115,Europe
United Kingdom,04-02-2020,93080,2076,875,92205,Europe
United Kingdom,04-02-2020,201255,785,742,200513,Europe
United Kingdom,04-02-2020,420189,1631,458,419731,Europe
United Kingdom,04-02-2020,26441,1786,543,25898,Europe
Uruguay,04-02-2020,235627,169,156,235471,Americas
US,04-02-2020,325621,751,287,325334,Americas
Uzbekistan,04-02-2020,404105,81,755,403350,Europe
Venezuela,04-02-2020,83598,1136,92,83506,Americas
Vietnam,04-02-2020,255137,211,812,254325,Western Pacific
Zambia,04-02-2020,228708,659,742,227966,Africa
Zimbabwe,04-02-2020,128166,2217,288,127878,Africa
Dominica,04-02-2020,140523,2066,907,139616,Americas
Grenada,04-02-2020,139690,2083,731,138959,Americas
Mozambique,04-02-2020,199905,45,166,199739,Africa
Syria,04-02-2020,254664,1060,175,254489,Eastern Mediterranean
Timor-Leste,04-02-2020,186217,1454,464,185753,South-East Asia
Belize,04-02-2020,340035,1789,1214,338821,Americas
Laos,04-02-2020,149880,1913,669,149211,Western Pacific
Libya,04-02-2020,266711,1034,1002,265709,Eastern Mediterranean
West Bank and Gaza,04-02-2020,215589,397,9,215580,Eastern Mediterranean
Guinea-Bissau,04-02-2020,263550,1797,141,263409,Africa
Mali,04-02-2020,17852,1655,335,17517,Africa
Saint Kitts and Nevis,04-02-2020,214967,700,508,214459,Americas
Canada,04-02-2020,31895,486,604,31291,Americas
Canada,04-02-2020,174626,1101,250,174376,Americas
Kosovo,04-02-2020,171893,2449,467,171426,Europe
Burma,04-02-2020,15792,939,420,15372,South-East Asia
United Kingdom,04-02-2020,92219,328,54,92165,Europe
United Kingdom,04-02-2020,444228,1857,175,444053,Europe
United Kingdom,04-02-2020,228316,878,270,228046,Europe
Botswana,04-02-2020,262445,2176,1102,261343,Africa
Burundi,04-02-2020,46786,500,1031,45755,Africa
Sierra Leone,04-02-2020,286102,2066,1212,284890,Africa
Malawi,04-02-2020,164132,335,1047,163085,Africa
United Kingdom,04-02-2020,365177,1701,255,364922,Europe
France,04-02-2020,139960,249,476,139484,Europe
South Sudan,04-02-2020,120759,1496,517,120242,Africa
Western Sahara,04-02-2020,418010,310,1006,417004,Africa
Sao Tome and Principe,04-02-2020,179463,2341,555,178908,Africa
Yemen,04-02-2020,278254,1174,1027,277227,Eastern Mediterranean
Comoros,04-02-2020,138451,2218,1236,137215,Africa
Tajikistan,04-02-2020,130081,641,235,129846,Europe
Lesotho,04-02-2020,313861,947,400,313461,Africa
Afghanistan,05-02-2020,352597,985,121,352476,Eastern Mediterranean
Albania,05-02-2020,79642,1093,1151,78491,Europe
Algeria,05-02-2020,311677,901,629,311048,Africa
Andorra,05-02-2020,359717,314,1032,358685,Europe
Angola,05-02-2020,169739,1948,312,169427,Africa
Antigua and Barbuda,05-02-2020,145786,338,168,145618,Americas
Argentina,05-02-2020,432677,2470,464,432213,Americas
Armenia,05-02-2020,300721,2289,987,299734,Europe
Australia,05-02-2020,157318,1954,292,157026,Western Pacific
Australia,05-02-2020,417259,599,763,416496,Western Pacific
Australia,05-02-2020,336097,931,924,335173,Western Pacific
Australia,05-02-2020,141003,1291,497,140506,Western Pacific
Australia,05-02-2020,72089,2009,1034,71055,Western Pacific
Australia,05-02-2020,31751,804,441,31310,Western Pacific
Australia,05-02-2020,256455,696,494,255961,Western Pacific
Australia,05-02-2020,287844,667,109,287735,Western Pacific
Austria,05-02-2020,24763,22,337,24426,Europe
Azerbaijan,05-02-2020,423963,1648,263,423700,Europe
Bahamas,05-02-2020,23656,1746,571,23085,Americas
Bahrain,05-02-2020,447848,1287,261,447587,Eastern Mediterranean
Bangladesh,05-02-2020,101904,2157,97,101807,South-East Asia
Barbados,05-02-2020,183230,2258,1108,182122,Americas
Belarus,05-02-2020,264212,2366,53,264159,Europe
Belgium,05-02-2020,129223,1702,1203,128020,Europe
Benin,05-02-2020,341913,592,1199,340714,Africa
Bhutan,05-02-2020,384288,2104,937,383351,South-East Asia
Bolivia,05-02-2020,132447,1984,944,131503,Americas
Bosnia and Herzegovina,05-02-2020,102548,282,524,102024,Europe
Brazil,05-02-2020,112079,1603,716,111363,Americas
Brunei,05-02-2020,202500,2488,5,202495,Western Pacific
Bulgaria,05-02-2020,129108,1183,22,129086,Europe
Burkina Faso,05-02-2020,173648,1586,226,173422,Africa
Cabo Verde,05-02-2020,148247,137,190,148057,Africa
Cambodia,05-02-2020,447107,1696,276,446831,Western Pacific
Cameroon,05-02-2020,21606,651,658,20948,Africa
Canada,05-02-2020,78262,1196,989,77273,Americas
Canada,05-02-2020,40306,844,758,39548,Americas
Canada,05-02-2020,252969,386,374,252595,Americas
Canada,05-02-2020,409528,694,613,408915,Americas
Canada,05-02-2020,217441,1355,597,216844,Americas
Canada,05-02-2020,296071,231,105,295966,Americas
Canada,05-02-2020,367765,1033,757,367008,Americas
Canada,05-02-2020,374690,356,1136,373554,Americas
Canada,05-02-2020,289887,698,989,288898,Americas
Canada,05-02-2020,259560,2149,850,258710,Americas
Central African Republic,05-02-2020,311707,1562,422,311285,Africa
Chad,05-02-2020,438024,1346,563,437461,Africa
Chile,05-02-2020,146003,2362,291,145712,Americas
China,05-02-2020,432079,1963,501,431578,Western Pacific
China,05-02-2020,434628,505,1177,433451,Western Pacific
China,05-02-2020,250877,1026,899,249978,Western Pacific
China,05-02-2020,192813,2054,248,192565,Western Pacific
China,05-02-2020,19029,981,944,18085,Western Pacific
China,05-02-2020,87623,1173,702,86921,Western Pacific
China,05-02-2020,171461,1547,708,170753,Western Pacific
China,05-02-2020,405988,2281,907,405081,Western Pacific
China,05-02-2020,307867,930,208,307659,Western Pacific
China,05-02-2020,333251,1368,220,333031,Western Pacific
China,05-02-2020,296966,862,872,296094,Western Pacific
China,05-02-2020,430876,745,742,430134,Western Pacific
China,05-02-2020,99786,1734,50,99736,Western Pacific
China,05-02-2020,69719,209,518,69201,Western Pacific
China,05-02-2020,93248,809,515,92733,Western Pacific
China,05-02-2020,148027,1985,1035,146992,Western Pacific
China,05-02-2020,409020,1700,1186,407834,Western Pacific
China,05-02-2020,182866,1573,1214,181652,Western Pacific
China,05-02-2020,499,2312,1188,-689,Western Pacific
China,05-02-2020,188060,2269,1160,186900,Western Pacific
China,05-02-2020,287459,2484,75,287384,Western Pacific
China,05-02-2020,264,216,886,-622,Western Pacific
China,05-02-2020,422140,533,802,421338,Western Pacific
China,05-02-2020,155475,1051,942,154533,Western Pacific
China,05-02-2020,98717,1352,868,97849,Western Pacific
China,05-02-2020,172819,419,40,172779,Western Pacific
China,05-02-2020,310603,1122,846,309757,Western Pacific
China,05-02-2020,129352,1080,352,129000,Western Pacific
China,05-02-2020,332660,862,816,331844,Western Pacific
China,05-02-2020,267853,201,89,267764,Western Pacific
China,05-02-2020,240227,1993,288,239939,Western Pacific
China,05-02-2020,373396,1845,26,373370,Western Pacific
China,05-02-2020,353050,132,753,352297,Western Pacific
Colombia,05-02-2020,200026,984,1153,198873,Americas
Congo (Brazzaville),05-02-2020,298819,801,1171,297648,Africa
Congo (Kinshasa),05-02-2020,210893,805,146,210747,Africa
Costa Rica,05-02-2020,386621,2337,933,385688,Americas
Cote d'Ivoire,05-02-2020,230571,445,800,229771,Africa
Croatia,05-02-2020,375303,169,573,374730,Europe
Cuba,05-02-2020,13472,1531,788,12684,Americas
Cyprus,05-02-2020,364014,2443,911,363103,Europe
Czechia,05-02-2020,44,445,1152,-1108,Europe
Denmark,05-02-2020,68631,135,1015,67616,Europe
Greenland,05-02-2020,374439,1146,1211,373228,Europe
Denmark,05-02-2020,135510,2447,1025,134485,Europe
Djibouti,05-02-2020,329038,308,753,328285,Eastern Mediterranean
Dominican Republic,05-02-2020,34932,505,1009,33923,Americas
Ecuador,05-02-2020,296503,1284,851,295652,Americas
Egypt,05-02-2020,71733,1704,32,71701,Eastern Mediterranean
El Salvador,05-02-2020,83967,252,1007,82960,Americas
Equatorial Guinea,05-02-2020,54164,804,1242,52922,Africa
Eritrea,05-02-2020,357039,2192,543,356496,Africa
Estonia,05-02-2020,68411,284,256,68155,Europe
Eswatini,05-02-2020,367142,1097,1103,366039,Africa
Ethiopia,05-02-2020,131029,2379,80,130949,Africa
Fiji,05-02-2020,369445,1829,939,368506,Western Pacific
Finland,05-02-2020,323400,534,850,322550,Europe
France,05-02-2020,327599,238,1059,326540,Europe
France,05-02-2020,214785,657,985,213800,Europe
France,05-02-2020,41074,2224,342,40732,Europe
France,05-02-2020,320262,2428,1152,319110,Europe
France,05-02-2020,324093,400,720,323373,Europe
France,05-02-2020,97132,950,858,96274,Europe
France,05-02-2020,85068,2176,702,84366,Europe
France,05-02-2020,24970,940,140,24830,Europe
France,05-02-2020,100221,644,950,99271,Europe
France,05-02-2020,344825,2225,1199,343626,Europe
Gabon,05-02-2020,184976,856,1113,183863,Africa
Gambia,05-02-2020,29768,2492,896,28872,Africa
Georgia,05-02-2020,229585,640,580,229005,Europe
Germany,05-02-2020,11134,128,157,10977,Europe
Ghana,05-02-2020,150621,791,330,150291,Africa
Greece,05-02-2020,191959,1387,1004,190955,Europe
Guatemala,05-02-2020,162322,2123,774,161548,Americas
Guinea,05-02-2020,272326,359,632,271694,Africa
Guyana,05-02-2020,132878,502,891,131987,Americas
Haiti,05-02-2020,294335,443,94,294241,Americas
Holy See,05-02-2020,376867,1260,229,376638,Europe
Honduras,05-02-2020,288693,1863,858,287835,Americas
Hungary,05-02-2020,97506,1798,156,97350,Europe
Iceland,05-02-2020,385860,554,465,385395,Europe
India,05-02-2020,281591,1175,989,280602,South-East Asia
Indonesia,05-02-2020,339936,2262,567,339369,South-East Asia
Iran,05-02-2020,145825,236,1027,144798,Eastern Mediterranean
Iraq,05-02-2020,435493,1657,840,434653,Eastern Mediterranean
Ireland,05-02-2020,201502,597,818,200684,Europe
Israel,05-02-2020,176877,1984,637,176240,Europe
Italy,05-02-2020,57835,945,215,57620,Europe
Jamaica,05-02-2020,227469,2307,150,227319,Americas
Japan,05-02-2020,391353,235,456,390897,Western Pacific
Jordan,05-02-2020,326135,1130,803,325332,Eastern Mediterranean
Kazakhstan,05-02-2020,2205,2276,878,1327,Europe
Kenya,05-02-2020,29906,1548,1087,28819,Africa
South Korea,05-02-2020,314144,1855,979,313165,Western Pacific
Kuwait,05-02-2020,46541,394,1066,45475,Eastern Mediterranean
Kyrgyzstan,05-02-2020,366005,1490,420,365585,Europe
Latvia,05-02-2020,141730,2269,1036,140694,Europe
Lebanon,05-02-2020,161591,2012,396,161195,Eastern Mediterranean
Liberia,05-02-2020,381126,2469,731,380395,Africa
Liechtenstein,05-02-2020,46041,138,316,45725,Europe
Lithuania,05-02-2020,407347,2088,420,406927,Europe
Luxembourg,05-02-2020,126092,168,352,125740,Europe
Madagascar,05-02-2020,102645,1808,176,102469,Africa
Malaysia,05-02-2020,156564,1857,1211,155353,Western Pacific
Maldives,05-02-2020,133960,1720,733,133227,South-East Asia
Malta,05-02-2020,187974,2332,489,187485,Europe
Mauritania,05-02-2020,286476,139,373,286103,Africa
Mauritius,05-02-2020,204419,559,540,203879,Africa
Mexico,05-02-2020,219524,489,1248,218276,Americas
Moldova,05-02-2020,390001,534,770,389231,Europe
Monaco,05-02-2020,445116,2084,1138,443978,Europe
Mongolia,05-02-2020,171764,2334,688,171076,Western Pacific
Montenegro,05-02-2020,219612,111,1047,218565,Europe
Morocco,05-02-2020,171601,638,1047,170554,Eastern Mediterranean
Namibia,05-02-2020,302981,34,1068,301913,Africa
Nepal,05-02-2020,254039,722,1051,252988,South-East Asia
Netherlands,05-02-2020,230146,1016,259,229887,Europe
Netherlands,05-02-2020,152600,1965,56,152544,Europe
Netherlands,05-02-2020,329581,2026,511,329070,Europe
Netherlands,05-02-2020,268996,1377,313,268683,Europe
New Zealand,05-02-2020,127191,2294,757,126434,Western Pacific
Nicaragua,05-02-2020,71883,691,358,71525,Americas
Niger,05-02-2020,97461,548,894,96567,Africa
Nigeria,05-02-2020,357953,1313,1239,356714,Africa
North Macedonia,05-02-2020,225290,1138,1016,224274,Europe
Norway,05-02-2020,51871,2046,1177,50694,Europe
Oman,05-02-2020,216533,62,944,215589,Eastern Mediterranean
Pakistan,05-02-2020,182647,2005,744,181903,Eastern Mediterranean
Panama,05-02-2020,170014,299,667,169347,Americas
Papua New Guinea,05-02-2020,287567,2340,225,287342,Western Pacific
Paraguay,05-02-2020,430588,877,624,429964,Americas
Peru,05-02-2020,379166,130,280,378886,Americas
Philippines,05-02-2020,11019,356,1205,9814,Western Pacific
Poland,05-02-2020,126261,1145,874,125387,Europe
Portugal,05-02-2020,76763,2215,333,76430,Europe
Qatar,05-02-2020,88237,2152,369,87868,Eastern Mediterranean
Romania,05-02-2020,2279,183,193,2086,Europe
Russia,05-02-2020,35576,283,480,35096,Europe
Rwanda,05-02-2020,302779,851,100,302679,Africa
Saint Lucia,05-02-2020,163166,2076,628,162538,Americas
Saint Vincent and the Grenadines,05-02-2020,271100,1397,886,270214,Americas
San Marino,05-02-2020,9090,1777,704,8386,Europe
Saudi Arabia,05-02-2020,297301,1995,52,297249,Eastern Mediterranean
Senegal,05-02-2020,126655,838,147,126508,Africa
Serbia,05-02-2020,422271,2054,1023,421248,Europe
Seychelles,05-02-2020,257947,231,124,257823,Africa
Singapore,05-02-2020,138157,2295,595,137562,Western Pacific
Slovakia,05-02-2020,76355,44,924,75431,Europe
Slovenia,05-02-2020,161706,268,977,160729,Europe
Somalia,05-02-2020,123929,2198,109,123820,Eastern Mediterranean
South Africa,05-02-2020,394016,1448,1197,392819,Africa
Spain,05-02-2020,371095,432,501,370594,Europe
Sri Lanka,05-02-2020,237651,2126,432,237219,South-East Asia
Sudan,05-02-2020,154129,1161,593,153536,Eastern Mediterranean
Suriname,05-02-2020,311813,2476,764,311049,Americas
Sweden,05-02-2020,105575,555,949,104626,Europe
Switzerland,05-02-2020,43532,1295,658,42874,Europe
Taiwan*,05-02-2020,404014,630,18,403996,Western Pacific
Tanzania,05-02-2020,228291,426,59,228232,Africa
Thailand,05-02-2020,356397,1396,643,355754,South-East Asia
Togo,05-02-2020,344160,1979,1058,343102,Africa
Trinidad and Tobago,05-02-2020,354884,611,1076,353808,Americas
Tunisia,05-02-2020,320241,2428,51,320190,Eastern Mediterranean
Turkey,05-02-2020,281401,1484,455,280946,Europe
Uganda,05-02-2020,238287,1096,287,238000,Africa
Ukraine,05-02-2020,236024,2134,330,235694,Europe
United Arab Emirates,05-02-2020,282498,1898,148,282350,Eastern Mediterranean
United Kingdom,05-02-2020,350383,1571,787,349596,Europe
United Kingdom,05-02-2020,346856,1826,307,346549,Europe
United Kingdom,05-02-2020,54553,2333,692,53861,Europe
United Kingdom,05-02-2020,429548,2092,356,429192,Europe
United Kingdom,05-02-2020,338671,9,149,338522,Europe
United Kingdom,05-02-2020,182427,1178,380,182047,Europe
United Kingdom,05-02-2020,273083,2166,217,272866,Europe
Uruguay,05-02-2020,327411,2191,386,327025,Americas
US,05-02-2020,396515,1714,985,395530,Americas
Uzbekistan,05-02-2020,204556,2483,475,204081,Europe
Venezuela,05-02-2020,422841,896,581,422260,Americas
Vietnam,05-02-2020,280734,2333,771,279963,Western Pacific
Zambia,05-02-2020,444836,667,718,444118,Africa
Zimbabwe,05-02-2020,264462,1181,795,263667,Africa
Dominica,05-02-2020,396397,1488,1108,395289,Americas
Grenada,05-02-2020,269495,440,463,269032,Americas
Mozambique,05-02-2020,199314,496,786,198528,Africa
Syria,05-02-2020,18708,904,222,18486,Eastern Mediterranean
Timor-Leste,05-02-2020,48238,1248,1186,47052,South-East Asia
Belize,05-02-2020,45928,242,678,45250,Americas
Laos,05-02-2020,319116,65,670,318446,Western Pacific
Libya,05-02-2020,313750,1912,18,313732,Eastern Mediterranean
West Bank and Gaza,05-02-2020,71841,1376,502,71339,Eastern Mediterranean
Guinea-Bissau,05-02-2020,20127,625,1190,18937,Africa
Mali,05-02-2020,210520,2094,817,209703,Africa
Saint Kitts and Nevis,05-02-2020,209930,1404,791,209139,Americas
Canada,05-02-2020,281402,2261,302,281100,Americas
Canada,05-02-2020,59443,519,668,58775,Americas
Kosovo,05-02-2020,331364,1542,814,330550,Europe
Burma,05-02-2020,97979,118,99,97880,South-East Asia
United Kingdom,05-02-2020,142550,426,1094,141456,Europe
United Kingdom,05-02-2020,212271,889,588,211683,Europe
United Kingdom,05-02-2020,73100,296,1225,71875,Europe
Botswana,05-02-2020,210008,620,572,209436,Africa
Burundi,05-02-2020,370263,1984,634,369629,Africa
Sierra Leone,05-02-2020,334114,1081,1161,332953,Africa
Malawi,05-02-2020,314041,2279,319,313722,Africa
United Kingdom,05-02-2020,276208,1951,817,275391,Europe
France,05-02-2020,332626,319,722,331904,Europe
South Sudan,05-02-2020,206235,94,7,206228,Africa
Western Sahara,05-02-2020,324629,1614,556,324073,Africa
Sao Tome and Principe,05-02-2020,277406,1804,142,277264,Africa
Yemen,05-02-2020,29305,311,1118,28187,Eastern Mediterranean
Comoros,05-02-2020,166992,1160,247,166745,Africa
Tajikistan,05-02-2020,147924,1101,1231,146693,Europe
Lesotho,05-02-2020,256775,1794,622,256153,Africa
Afghanistan,06-02-2020,122773,1850,134,122639,Eastern Mediterranean
Albania,06-02-2020,166958,178,526,166432,Europe
Algeria,06-02-2020,413337,2338,243,413094,Africa
Andorra,06-02-2020,210557,1660,234,210323,Europe
Angola,06-02-2020,93813,2047,1106,92707,Africa
Antigua and Barbuda,06-02-2020,65963,1293,858,65105,Americas
Argentina,06-02-2020,437392,401,869,436523,Americas
Armenia,06-02-2020,9834,248,61,9773,Europe
Australia,06-02-2020,270406,1819,822,269584,Western Pacific
Australia,06-02-2020,266566,1574,641,265925,Western Pacific
Australia,06-02-2020,40,1497,1233,-1193,Western Pacific
Australia,06-02-2020,435700,145,967,434733,Western Pacific
Australia,06-02-2020,239891,602,90,239801,Western Pacific
Australia,06-02-2020,98801,2417,1147,97654,Western Pacific
Australia,06-02-2020,112946,1960,585,112361,Western Pacific
Australia,06-02-2020,24784,663,260,24524,Western Pacific
Austria,06-02-2020,318903,762,682,318221,Europe
Azerbaijan,06-02-2020,226352,1623,342,226010,Europe
Bahamas,06-02-2020,397493,1018,866,396627,Americas
Bahrain,06-02-2020,40704,926,363,40341,Eastern Mediterranean
Bangladesh,06-02-2020,443200,1065,462,442738,South-East Asia
Barbados,06-02-2020,249311,2287,37,249274,Americas
Belarus,06-02-2020,206202,1617,254,205948,Europe
Belgium,06-02-2020,396040,747,549,395491,Europe
Benin,06-02-2020,405181,2127,550,404631,Africa
Bhutan,06-02-2020,98163,1663,852,97311,South-East Asia
Bolivia,06-02-2020,38885,2117,912,37973,Americas
Bosnia and Herzegovina,06-02-2020,259718,1695,256,259462,Europe
Brazil,06-02-2020,249703,257,473,249230,Americas
Brunei,06-02-2020,273891,551,56,273835,Western Pacific
Bulgaria,06-02-2020,300123,492,574,299549,Europe
Burkina Faso,06-02-2020,155159,652,193,154966,Africa
Cabo Verde,06-02-2020,98617,1644,986,97631,Africa
Cambodia,06-02-2020,238328,67,728,237600,Western Pacific
Cameroon,06-02-2020,179274,706,479,178795,Africa
Canada,06-02-2020,13533,1130,318,13215,Americas
Canada,06-02-2020,186191,487,754,185437,Americas
Canada,06-02-2020,272268,2071,374,271894,Americas
Canada,06-02-2020,115579,1478,181,115398,Americas
Canada,06-02-2020,187414,1786,1009,186405,Americas
Canada,06-02-2020,432255,948,171,432084,Americas
Canada,06-02-2020,391278,1253,505,390773,Americas
Canada,06-02-2020,393335,577,404,392931,Americas
Canada,06-02-2020,98007,1019,1156,96851,Americas
Canada,06-02-2020,50905,1124,414,50491,Americas
Central African Republic,06-02-2020,370116,267,1120,368996,Africa
Chad,06-02-2020,181105,2442,148,180957,Africa
Chile,06-02-2020,431915,1390,1235,430680,Americas
China,06-02-2020,330212,690,889,329323,Western Pacific
China,06-02-2020,399496,1058,629,398867,Western Pacific
China,06-02-2020,350513,2113,555,349958,Western Pacific
China,06-02-2020,362471,512,105,362366,Western Pacific
China,06-02-2020,22106,1868,115,21991,Western Pacific
China,06-02-2020,303526,2238,422,303104,Western Pacific
China,06-02-2020,50946,1916,776,50170,Western Pacific
China,06-02-2020,185315,2250,747,184568,Western Pacific
China,06-02-2020,237810,1213,832,236978,Western Pacific
China,06-02-2020,336324,1597,620,335704,Western Pacific
China,06-02-2020,215990,1483,865,215125,Western Pacific
China,06-02-2020,217159,1914,381,216778,Western Pacific
China,06-02-2020,196757,36,4,196753,Western Pacific
China,06-02-2020,355831,2381,721,355110,Western Pacific
China,06-02-2020,241940,1106,497,241443,Western Pacific
China,06-02-2020,159355,1831,1014,158341,Western Pacific
China,06-02-2020,183592,1096,141,183451,Western Pacific
China,06-02-2020,158408,1053,727,157681,Western Pacific
China,06-02-2020,377829,340,288,377541,Western Pacific
China,06-02-2020,148728,329,469,148259,Western Pacific
China,06-02-2020,132561,1637,843,131718,Western Pacific
China,06-02-2020,282614,1742,894,281720,Western Pacific
China,06-02-2020,397151,891,743,396408,Western Pacific
China,06-02-2020,109144,2360,798,108346,Western Pacific
China,06-02-2020,132326,1372,926,131400,Western Pacific
China,06-02-2020,202749,2369,1171,201578,Western Pacific
China,06-02-2020,76984,699,55,76929,Western Pacific
China,06-02-2020,446099,2297,348,445751,Western Pacific
China,06-02-2020,82478,1748,888,81590,Western Pacific
China,06-02-2020,405699,1406,622,405077,Western Pacific
China,06-02-2020,35257,2016,209,35048,Western Pacific
China,06-02-2020,84421,164,378,84043,Western Pacific
China,06-02-2020,29048,1380,1133,27915,Western Pacific
Colombia,06-02-2020,84047,227,508,83539,Americas
Congo (Brazzaville),06-02-2020,336951,613,57,336894,Africa
Congo (Kinshasa),06-02-2020,316990,268,891,316099,Africa
Costa Rica,06-02-2020,282278,2411,1097,281181,Americas
Cote d'Ivoire,06-02-2020,101996,1312,649,101347,Africa
Croatia,06-02-2020,9459,1665,42,9417,Europe
Cuba,06-02-2020,214748,1918,1226,213522,Americas
Cyprus,06-02-2020,320646,2146,29,320617,Europe
Czechia,06-02-2020,362903,1458,329,362574,Europe
Denmark,06-02-2020,365431,1105,846,364585,Europe
Greenland,06-02-2020,55974,1383,1068,54906,Europe
Denmark,06-02-2020,446677,826,890,445787,Europe
Djibouti,06-02-2020,108845,1166,523,108322,Eastern Mediterranean
Dominican Republic,06-02-2020,387460,2465,332,387128,Americas
Ecuador,06-02-2020,82275,592,711,81564,Americas
Egypt,06-02-2020,63564,1031,639,62925,Eastern Mediterranean
El Salvador,06-02-2020,98678,782,479,98199,Americas
Equatorial Guinea,06-02-2020,72331,1313,613,71718,Africa
Eritrea,06-02-2020,87972,2180,830,87142,Africa
Estonia,06-02-2020,302568,1050,838,301730,Europe
Eswatini,06-02-2020,203854,83,1040,202814,Africa
Ethiopia,06-02-2020,25261,2217,613,24648,Africa
Fiji,06-02-2020,202682,1575,432,202250,Western Pacific
Finland,06-02-2020,112858,1701,195,112663,Europe
France,06-02-2020,118155,723,523,117632,Europe
France,06-02-2020,246487,1369,582,245905,Europe
France,06-02-2020,296411,655,436,295975,Europe
France,06-02-2020,273388,703,884,272504,Europe
France,06-02-2020,321446,1603,876,320570,Europe
France,06-02-2020,145539,547,760,144779,Europe
France,06-02-2020,40559,964,827,39732,Europe
France,06-02-2020,323535,1997,994,322541,Europe
France,06-02-2020,214496,2028,1215,213281,Europe
France,06-02-2020,284785,541,415,284370,Europe
Gabon,06-02-2020,266911,2073,253,266658,Africa
Gambia,06-02-2020,171598,55,43,171555,Africa
Georgia,06-02-2020,406529,440,892,405637,Europe
Germany,06-02-2020,42406,980,769,41637,Europe
Ghana,06-02-2020,225581,425,349,225232,Africa
Greece,06-02-2020,403970,2177,1020,402950,Europe
Guatemala,06-02-2020,415328,2096,120,415208,Americas
Guinea,06-02-2020,308160,391,220,307940,Africa
Guyana,06-02-2020,411450,2310,615,410835,Americas
Haiti,06-02-2020,204739,1519,173,204566,Americas
Holy See,06-02-2020,213687,539,886,212801,Europe
Honduras,06-02-2020,159856,882,36,159820,Americas
Hungary,06-02-2020,242557,1212,644,241913,Europe
Iceland,06-02-2020,211197,682,571,210626,Europe
India,06-02-2020,252905,134,691,252214,South-East Asia
Indonesia,06-02-2020,34638,1803,255,34383,South-East Asia
Iran,06-02-2020,34470,966,1121,33349,Eastern Mediterranean
Iraq,06-02-2020,6775,873,426,6349,Eastern Mediterranean
Ireland,06-02-2020,137092,2176,586,136506,Europe
Israel,06-02-2020,154542,1196,193,154349,Europe
Italy,06-02-2020,250804,2343,58,250746,Europe
Jamaica,06-02-2020,330983,2101,388,330595,Americas
Japan,06-02-2020,139773,240,316,139457,Western Pacific
Jordan,06-02-2020,72165,1125,848,71317,Eastern Mediterranean
Kazakhstan,06-02-2020,399490,975,817,398673,Europe
Kenya,06-02-2020,25247,2255,1196,24051,Africa
South Korea,06-02-2020,221648,1434,152,221496,Western Pacific
Kuwait,06-02-2020,378990,268,699,378291,Eastern Mediterranean
Kyrgyzstan,06-02-2020,445909,96,867,445042,Europe
Latvia,06-02-2020,435150,1513,238,434912,Europe
Lebanon,06-02-2020,244562,486,822,243740,Eastern Mediterranean
Liberia,06-02-2020,83732,381,434,83298,Africa
Liechtenstein,06-02-2020,294760,120,626,294134,Europe
Lithuania,06-02-2020,433414,1872,818,432596,Europe
Luxembourg,06-02-2020,386244,1998,333,385911,Europe
Madagascar,06-02-2020,250872,1406,434,250438,Africa
Malaysia,06-02-2020,427163,2064,1047,426116,Western Pacific
Maldives,06-02-2020,436597,350,142,436455,South-East Asia
Malta,06-02-2020,340042,400,909,339133,Europe
Mauritania,06-02-2020,289336,657,1057,288279,Africa
Mauritius,06-02-2020,145535,1659,293,145242,Africa
Mexico,06-02-2020,255066,474,1055,254011,Americas
Moldova,06-02-2020,255399,2323,333,255066,Europe
Monaco,06-02-2020,35988,1074,1147,34841,Europe
Mongolia,06-02-2020,47020,1928,334,46686,Western Pacific
Montenegro,06-02-2020,217862,1712,759,217103,Europe
Morocco,06-02-2020,243543,2005,171,243372,Eastern Mediterranean
Namibia,06-02-2020,394732,750,731,394001,Africa
Nepal,06-02-2020,153432,1632,244,153188,South-East Asia
Netherlands,06-02-2020,406566,1216,1220,405346,Europe
Netherlands,06-02-2020,281834,1262,683,281151,Europe
Netherlands,06-02-2020,35748,1360,1226,34522,Europe
Netherlands,06-02-2020,85651,785,602,85049,Europe
New Zealand,06-02-2020,126171,1708,782,125389,Western Pacific
Nicaragua,06-02-2020,84680,2088,13,84667,Americas
Niger,06-02-2020,4830,1354,1231,3599,Africa
Nigeria,06-02-2020,334269,1918,981,333288,Africa
North Macedonia,06-02-2020,398498,1453,1139,397359,Europe
Norway,06-02-2020,60428,398,1093,59335,Europe
Oman,06-02-2020,262358,2182,97,262261,Eastern Mediterranean
Pakistan,06-02-2020,400520,170,1183,399337,Eastern Mediterranean
Panama,06-02-2020,279455,2051,1194,278261,Americas
Papua New Guinea,06-02-2020,237053,1294,705,236348,Western Pacific
Paraguay,06-02-2020,400732,1850,903,399829,Americas
Peru,06-02-2020,89158,2238,743,88415,Americas
Philippines,06-02-2020,160524,1198,1034,159490,Western Pacific
Poland,06-02-2020,358301,1306,43,358258,Europe
Portugal,06-02-2020,377355,1462,79,377276,Europe
Qatar,06-02-2020,225668,278,1070,224598,Eastern Mediterranean
Romania,06-02-2020,386947,2126,448,386499,Europe
Russia,06-02-2020,185079,1850,583,184496,Europe
Rwanda,06-02-2020,433835,335,167,433668,Africa
Saint Lucia,06-02-2020,137224,1086,499,136725,Americas
Saint Vincent and the Grenadines,06-02-2020,106485,1863,249,106236,Americas
San Marino,06-02-2020,324746,98,233,324513,Europe
Saudi Arabia,06-02-2020,142344,251,1140,141204,Eastern Mediterranean
Senegal,06-02-2020,139482,1594,1217,138265,Africa
Serbia,06-02-2020,155564,1811,515,155049,Europe
Seychelles,06-02-2020,112064,1780,479,111585,Africa
Singapore,06-02-2020,282955,1597,518,282437,Western Pacific
Slovakia,06-02-2020,84368,296,969,83399,Europe
Slovenia,06-02-2020,287826,51,900,286926,Europe
Somalia,06-02-2020,204811,1350,1170,203641,Eastern Mediterranean
South Africa,06-02-2020,251162,352,357,250805,Africa
Spain,06-02-2020,302375,1984,571,301804,Europe
Sri Lanka,06-02-2020,411047,2071,649,410398,South-East Asia
Sudan,06-02-2020,49305,1421,888,48417,Eastern Mediterranean
Suriname,06-02-2020,111168,1099,300,110868,Americas
Sweden,06-02-2020,3223,953,1157,2066,Europe
Switzerland,06-02-2020,170285,2003,438,169847,Europe
Taiwan*,06-02-2020,381683,2056,1144,380539,Western Pacific
Tanzania,06-02-2020,130796,1835,662,130134,Africa
Thailand,06-02-2020,37336,769,314,37022,South-East Asia
Togo,06-02-2020,58667,1328,35,58632,Africa
Trinidad and Tobago,06-02-2020,233089,1667,914,232175,Americas
Tunisia,06-02-2020,421587,1478,1125,420462,Eastern Mediterranean
Turkey,06-02-2020,159154,2352,304,158850,Europe
Uganda,06-02-2020,379673,1681,560,379113,Africa
Ukraine,06-02-2020,442507,1608,316,442191,Europe
United Arab Emirates,06-02-2020,113825,558,707,113118,Eastern Mediterranean
United Kingdom,06-02-2020,172316,533,567,171749,Europe
United Kingdom,06-02-2020,417711,2420,436,417275,Europe
United Kingdom,06-02-2020,20964,1108,956,20008,Europe
United Kingdom,06-02-2020,12588,333,1145,11443,Europe
United Kingdom,06-02-2020,266342,697,961,265381,Europe
United Kingdom,06-02-2020,413325,2027,704,412621,Europe
United Kingdom,06-02-2020,279593,1912,624,278969,Europe
Uruguay,06-02-2020,100510,1687,1067,99443,Americas
US,06-02-2020,113618,66,776,112842,Americas
Uzbekistan,06-02-2020,429455,1030,422,429033,Europe
Venezuela,06-02-2020,286895,1443,889,286006,Americas
Vietnam,06-02-2020,113640,842,608,113032,Western Pacific
Zambia,06-02-2020,167647,648,377,167270,Africa
Zimbabwe,06-02-2020,308700,2180,1195,307505,Africa
Dominica,06-02-2020,222104,1014,919,221185,Americas
Grenada,06-02-2020,296587,659,679,295908,Americas
Mozambique,06-02-2020,177029,580,96,176933,Africa
Syria,06-02-2020,430879,1097,136,430743,Eastern Mediterranean
Timor-Leste,06-02-2020,168602,495,2,168600,South-East Asia
Belize,06-02-2020,124257,1267,1131,123126,Americas
Laos,06-02-2020,180549,2033,519,180030,Western Pacific
Libya,06-02-2020,365953,2372,750,365203,Eastern Mediterranean
West Bank and Gaza,06-02-2020,337991,1796,406,337585,Eastern Mediterranean
Guinea-Bissau,06-02-2020,114842,1370,1070,113772,Africa
Mali,06-02-2020,1430,969,157,1273,Africa
Saint Kitts and Nevis,06-02-2020,273899,2387,951,272948,Americas
Canada,06-02-2020,35828,75,829,34999,Americas
Canada,06-02-2020,353574,660,699,352875,Americas
Kosovo,06-02-2020,26974,80,475,26499,Europe
Burma,06-02-2020,372764,2413,491,372273,South-East Asia
United Kingdom,06-02-2020,332642,702,326,332316,Europe
United Kingdom,06-02-2020,103490,23,908,102582,Europe
United Kingdom,06-02-2020,80338,533,590,79748,Europe
Botswana,06-02-2020,426756,2103,949,425807,Africa
Burundi,06-02-2020,72557,755,188,72369,Africa
Sierra Leone,06-02-2020,382057,1966,1216,380841,Africa
Malawi,06-02-2020,6772,1920,728,6044,Africa
United Kingdom,06-02-2020,411496,428,799,410697,Europe
France,06-02-2020,81754,1288,798,80956,Europe
South Sudan,06-02-2020,360149,787,1200,358949,Africa
Western Sahara,06-02-2020,327827,1229,881,326946,Africa
Sao Tome and Principe,06-02-2020,448661,308,413,448248,Africa
Yemen,06-02-2020,33434,2413,600,32834,Eastern Mediterranean
Comoros,06-02-2020,210348,1175,218,210130,Africa
Tajikistan,06-02-2020,321795,2340,522,321273,Europe
Lesotho,06-02-2020,123718,940,1214,122504,Africa
Afghanistan,07-02-2020,409177,81,11,409166,Eastern Mediterranean
Albania,07-02-2020,166657,468,36,166621,Europe
Algeria,07-02-2020,179606,311,1031,178575,Africa
Andorra,07-02-2020,191286,276,434,190852,Europe
Angola,07-02-2020,107062,1920,826,106236,Africa
Antigua and Barbuda,07-02-2020,41971,1714,81,41890,Americas
Argentina,07-02-2020,112928,1718,480,112448,Americas
Armenia,07-02-2020,411309,1233,1187,410122,Europe
Australia,07-02-2020,123374,731,163,123211,Western Pacific
Australia,07-02-2020,293953,2476,232,293721,Western Pacific
Australia,07-02-2020,435987,1209,22,435965,Western Pacific
Australia,07-02-2020,315654,1348,1067,314587,Western Pacific
Australia,07-02-2020,315204,802,275,314929,Western Pacific
Australia,07-02-2020,221499,1251,217,221282,Western Pacific
Australia,07-02-2020,425339,1295,818,424521,Western Pacific
Australia,07-02-2020,148569,1069,376,148193,Western Pacific
Austria,07-02-2020,124884,1071,741,124143,Europe
Azerbaijan,07-02-2020,33194,108,366,32828,Europe
Bahamas,07-02-2020,136573,1443,171,136402,Americas
Bahrain,07-02-2020,427596,12,337,427259,Eastern Mediterranean
Bangladesh,07-02-2020,442624,2133,449,442175,South-East Asia
Barbados,07-02-2020,122352,516,301,122051,Americas
Belarus,07-02-2020,355872,2322,795,355077,Europe
Belgium,07-02-2020,359502,2124,919,358583,Europe
Benin,07-02-2020,237102,2118,167,236935,Africa
Bhutan,07-02-2020,391102,1264,868,390234,South-East Asia
Bolivia,07-02-2020,356498,323,598,355900,Americas
Bosnia and Herzegovina,07-02-2020,25732,940,1235,24497,Europe
Brazil,07-02-2020,276223,2355,218,276005,Americas
Brunei,07-02-2020,100726,1972,625,100101,Western Pacific
Bulgaria,07-02-2020,352155,2373,537,351618,Europe
Burkina Faso,07-02-2020,46481,1617,195,46286,Africa
Cabo Verde,07-02-2020,8929,2433,789,8140,Africa
Cambodia,07-02-2020,330484,1737,71,330413,Western Pacific
Cameroon,07-02-2020,320236,185,65,320171,Africa
Canada,07-02-2020,40990,1997,132,40858,Americas
Canada,07-02-2020,385500,2451,80,385420,Americas
Canada,07-02-2020,135279,2285,429,134850,Americas
Canada,07-02-2020,374909,1878,732,374177,Americas
Canada,07-02-2020,21990,877,840,21150,Americas
Canada,07-02-2020,148561,2205,730,147831,Americas
Canada,07-02-2020,181134,57,956,180178,Americas
Canada,07-02-2020,234349,2318,609,233740,Americas
Canada,07-02-2020,25606,442,1188,24418,Americas
Canada,07-02-2020,349515,456,753,348762,Americas
Central African Republic,07-02-2020,49785,469,1071,48714,Africa
Chad,07-02-2020,311791,2148,457,311334,Africa
Chile,07-02-2020,413654,1772,1065,412589,Americas
China,07-02-2020,126867,2318,1062,125805,Western Pacific
China,07-02-2020,71238,877,793,70445,Western Pacific
China,07-02-2020,360987,762,841,360146,Western Pacific
China,07-02-2020,280391,1976,716,279675,Western Pacific
China,07-02-2020,134913,333,700,134213,Western Pacific
China,07-02-2020,286109,693,802,285307,Western Pacific
China,07-02-2020,219054,1332,319,218735,Western Pacific
China,07-02-2020,84903,2025,355,84548,Western Pacific
China,07-02-2020,366194,1819,786,365408,Western Pacific
China,07-02-2020,280662,758,1157,279505,Western Pacific
China,07-02-2020,160081,1148,599,159482,Western Pacific
China,07-02-2020,345054,740,568,344486,Western Pacific
China,07-02-2020,311290,2111,191,311099,Western Pacific
China,07-02-2020,353053,509,400,352653,Western Pacific
China,07-02-2020,376668,1189,836,375832,Western Pacific
China,07-02-2020,100175,2144,264,99911,Western Pacific
China,07-02-2020,66859,13,433,66426,Western Pacific
China,07-02-2020,335380,310,929,334451,Western Pacific
China,07-02-2020,38960,1157,1131,37829,Western Pacific
China,07-02-2020,220415,1422,868,219547,Western Pacific
China,07-02-2020,251964,485,511,251453,Western Pacific
China,07-02-2020,148598,1022,1212,147386,Western Pacific
China,07-02-2020,302898,1679,364,302534,Western Pacific
China,07-02-2020,344135,2239,677,343458,Western Pacific
China,07-02-2020,422490,1359,701,421789,Western Pacific
China,07-02-2020,58010,2420,896,57114,Western Pacific
China,07-02-2020,400618,1842,1126,399492,Western Pacific
China,07-02-2020,179595,2392,1121,178474,Western Pacific
China,07-02-2020,330468,2414,941,329527,Western Pacific
China,07-02-2020,101277,534,962,100315,Western Pacific
China,07-02-2020,166741,1858,419,166322,Western Pacific
China,07-02-2020,235683,1010,340,235343,Western Pacific
China,07-02-2020,425300,1707,1177,424123,Western Pacific
Colombia,07-02-2020,41358,1190,328,41030,Americas
Congo (Brazzaville),07-02-2020,439227,315,581,438646,Africa
Congo (Kinshasa),07-02-2020,125047,1532,313,124734,Africa
Costa Rica,07-02-2020,340761,275,780,339981,Americas
Cote d'Ivoire,07-02-2020,23794,769,623,23171,Africa
Croatia,07-02-2020,374653,304,506,374147,Europe
Cuba,07-02-2020,382476,2340,460,382016,Americas
Cyprus,07-02-2020,110922,1788,1091,109831,Europe
Czechia,07-02-2020,86213,1807,481,85732,Europe
Denmark,07-02-2020,407438,1704,857,406581,Europe
Greenland,07-02-2020,217953,335,764,217189,Europe
Denmark,07-02-2020,368306,909,939,367367,Europe
Djibouti,07-02-2020,335857,753,17,335840,Eastern Mediterranean
Dominican Republic,07-02-2020,198021,2148,1147,196874,Americas
Ecuador,07-02-2020,233760,531,1003,232757,Americas
Egypt,07-02-2020,189131,387,736,188395,Eastern Mediterranean
El Salvador,07-02-2020,142139,729,886,141253,Americas
Equatorial Guinea,07-02-2020,122046,715,581,121465,Africa
Eritrea,07-02-2020,41016,1707,969,40047,Africa
Estonia,07-02-2020,267397,258,1023,266374,Europe
Eswatini,07-02-2020,270139,716,83,270056,Africa
Ethiopia,07-02-2020,138721,1851,1206,137515,Africa
Fiji,07-02-2020,320486,2494,1154,319332,Western Pacific
Finland,07-02-2020,35064,1191,628,34436,Europe
France,07-02-2020,234295,33,403,233892,Europe
France,07-02-2020,161725,2483,545,161180,Europe
France,07-02-2020,161106,2065,1164,159942,Europe
France,07-02-2020,398382,687,1037,397345,Europe
France,07-02-2020,351137,1332,573,350564,Europe
France,07-02-2020,352660,1447,482,352178,Europe
France,07-02-2020,39606,974,770,38836,Europe
France,07-02-2020,137746,1519,164,137582,Europe
France,07-02-2020,260700,2014,1101,259599,Europe
France,07-02-2020,1224,1245,285,939,Europe
Gabon,07-02-2020,208991,2362,107,208884,Africa
Gambia,07-02-2020,212169,1102,1026,211143,Africa
Georgia,07-02-2020,357135,1090,854,356281,Europe
Germany,07-02-2020,446496,864,387,446109,Europe
Ghana,07-02-2020,383193,1299,1154,382039,Africa
Greece,07-02-2020,378170,470,675,377495,Europe
Guatemala,07-02-2020,89633,609,187,89446,Americas
Guinea,07-02-2020,384545,1193,291,384254,Africa
Guyana,07-02-2020,170574,2248,540,170034,Americas
Haiti,07-02-2020,51196,1911,21,51175,Americas
Holy See,07-02-2020,409294,370,1118,408176,Europe
Honduras,07-02-2020,33908,361,832,33076,Americas
Hungary,07-02-2020,229764,692,465,229299,Europe
Iceland,07-02-2020,64066,952,576,63490,Europe
India,07-02-2020,448448,2471,135,448313,South-East Asia
Indonesia,07-02-2020,69579,315,709,68870,South-East Asia
Iran,07-02-2020,31956,532,390,31566,Eastern Mediterranean
Iraq,07-02-2020,106623,775,630,105993,Eastern Mediterranean
Ireland,07-02-2020,79671,2399,35,79636,Europe
Israel,07-02-2020,410622,1981,537,410085,Europe
Italy,07-02-2020,101595,2220,583,101012,Europe
Jamaica,07-02-2020,158192,1478,284,157908,Americas
Japan,07-02-2020,228814,1797,106,228708,Western Pacific
Jordan,07-02-2020,390677,2095,1120,389557,Eastern Mediterranean
Kazakhstan,07-02-2020,352734,2114,547,352187,Europe
Kenya,07-02-2020,41983,658,399,41584,Africa
South Korea,07-02-2020,73247,2278,590,72657,Western Pacific
Kuwait,07-02-2020,288462,1035,1196,287266,Eastern Mediterranean
Kyrgyzstan,07-02-2020,382931,1041,1041,381890,Europe
Latvia,07-02-2020,256321,471,953,255368,Europe
Lebanon,07-02-2020,370730,1727,757,369973,Eastern Mediterranean
Liberia,07-02-2020,155233,1273,318,154915,Africa
Liechtenstein,07-02-2020,332410,800,558,331852,Europe
Lithuania,07-02-2020,115961,160,711,115250,Europe
Luxembourg,07-02-2020,283233,1444,47,283186,Europe
Madagascar,07-02-2020,219310,2100,804,218506,Africa
Malaysia,07-02-2020,13294,833,1193,12101,Western Pacific
Maldives,07-02-2020,311075,2140,958,310117,South-East Asia
Malta,07-02-2020,449919,700,723,449196,Europe
Mauritania,07-02-2020,248464,1107,617,247847,Africa
Mauritius,07-02-2020,388253,714,529,387724,Africa
Mexico,07-02-2020,171494,2008,634,170860,Americas
Moldova,07-02-2020,300939,177,1043,299896,Europe
Monaco,07-02-2020,263827,1597,871,262956,Europe
Mongolia,07-02-2020,433108,133,48,433060,Western Pacific
Montenegro,07-02-2020,220989,200,224,220765,Europe
Morocco,07-02-2020,343215,926,1017,342198,Eastern Mediterranean
Namibia,07-02-2020,284585,1623,799,283786,Africa
Nepal,07-02-2020,118524,1829,1089,117435,South-East Asia
Netherlands,07-02-2020,261781,1271,54,261727,Europe
Netherlands,07-02-2020,381514,2338,1000,380514,Europe
Netherlands,07-02-2020,104522,599,664,103858,Europe
Netherlands,07-02-2020,388532,1671,334,388198,Europe
New Zealand,07-02-2020,365731,1999,1088,364643,Western Pacific
Nicaragua,07-02-2020,137848,2009,1087,136761,Americas
Niger,07-02-2020,275765,2231,424,275341,Africa
Nigeria,07-02-2020,323002,1403,958,322044,Africa
North Macedonia,07-02-2020,340536,712,769,339767,Europe
Norway,07-02-2020,29344,110,990,28354,Europe
Oman,07-02-2020,40518,2255,607,39911,Eastern Mediterranean
Pakistan,07-02-2020,286865,413,1232,285633,Eastern Mediterranean
Panama,07-02-2020,338572,1026,835,337737,Americas
Papua New Guinea,07-02-2020,423845,2145,421,423424,Western Pacific
Paraguay,07-02-2020,294648,1552,431,294217,Americas
Peru,07-02-2020,203717,1498,792,202925,Americas
Philippines,07-02-2020,134622,2385,520,134102,Western Pacific
Poland,07-02-2020,151298,1113,200,151098,Europe
Portugal,07-02-2020,199947,506,1039,198908,Europe
Qatar,07-02-2020,189896,1385,171,189725,Eastern Mediterranean
Romania,07-02-2020,318813,935,1035,317778,Europe
Russia,07-02-2020,161828,1490,695,161133,Europe
Rwanda,07-02-2020,131063,1144,791,130272,Africa
Saint Lucia,07-02-2020,180336,893,825,179511,Americas
Saint Vincent and the Grenadines,07-02-2020,282838,773,667,282171,Americas
San Marino,07-02-2020,81084,524,824,80260,Europe
Saudi Arabia,07-02-2020,347555,1944,584,346971,Eastern Mediterranean
Senegal,07-02-2020,40803,1759,335,40468,Africa
Serbia,07-02-2020,45389,698,1156,44233,Europe
Seychelles,07-02-2020,306709,1605,598,306111,Africa
Singapore,07-02-2020,385870,652,958,384912,Western Pacific
Slovakia,07-02-2020,108999,1109,235,108764,Europe
Slovenia,07-02-2020,209508,519,239,209269,Europe
Somalia,07-02-2020,7365,125,800,6565,Eastern Mediterranean
South Africa,07-02-2020,149722,2205,1244,148478,Africa
Spain,07-02-2020,291109,228,699,290410,Europe
Sri Lanka,07-02-2020,84774,2177,98,84676,South-East Asia
Sudan,07-02-2020,252338,1435,614,251724,Eastern Mediterranean
Suriname,07-02-2020,196132,560,391,195741,Americas
Sweden,07-02-2020,143760,326,863,142897,Europe
Switzerland,07-02-2020,302469,1765,306,302163,Europe
Taiwan*,07-02-2020,335229,2078,707,334522,Western Pacific
Tanzania,07-02-2020,340701,71,711,339990,Africa
Thailand,07-02-2020,366595,1900,452,366143,South-East Asia
Togo,07-02-2020,158790,2367,258,158532,Africa
Trinidad and Tobago,07-02-2020,271267,2427,44,271223,Americas
Tunisia,07-02-2020,386795,1997,1073,385722,Eastern Mediterranean
Turkey,07-02-2020,226937,1030,657,226280,Europe
Uganda,07-02-2020,257512,1716,924,256588,Africa
Ukraine,07-02-2020,105844,517,264,105580,Europe
United Arab Emirates,07-02-2020,286803,2149,400,286403,Eastern Mediterranean
United Kingdom,07-02-2020,969,1263,889,80,Europe
United Kingdom,07-02-2020,270815,2149,945,269870,Europe
United Kingdom,07-02-2020,362380,690,810,361570,Europe
United Kingdom,07-02-2020,414798,2064,493,414305,Europe
United Kingdom,07-02-2020,132098,363,328,131770,Europe
United Kingdom,07-02-2020,321258,861,98,321160,Europe
United Kingdom,07-02-2020,417253,1001,1142,416111,Europe
Uruguay,07-02-2020,56790,2094,898,55892,Americas
US,07-02-2020,45921,1534,90,45831,Americas
Uzbekistan,07-02-2020,162635,2150,81,162554,Europe
Venezuela,07-02-2020,152064,1693,1202,150862,Americas
Vietnam,07-02-2020,270259,116,0,270259,Western Pacific
Zambia,07-02-2020,202770,1931,1193,201577,Africa
Zimbabwe,07-02-2020,373341,1187,1131,372210,Africa
Dominica,07-02-2020,84069,2088,958,83111,Americas
Grenada,07-02-2020,16403,1679,417,15986,Americas
Mozambique,07-02-2020,406324,1785,1107,405217,Africa
Syria,07-02-2020,88147,1661,854,87293,Eastern Mediterranean
Timor-Leste,07-02-2020,122574,719,321,122253,South-East Asia
Belize,07-02-2020,187389,775,72,187317,Americas
Laos,07-02-2020,429184,676,488,428696,Western Pacific
Libya,07-02-2020,290037,2372,818,289219,Eastern Mediterranean
West Bank and Gaza,07-02-2020,247428,124,1000,246428,Eastern Mediterranean
Guinea-Bissau,07-02-2020,121821,810,255,121566,Africa
Mali,07-02-2020,124857,1253,140,124717,Africa
Saint Kitts and Nevis,07-02-2020,449062,1721,1062,448000,Americas
Canada,07-02-2020,435935,1764,897,435038,Americas
Canada,07-02-2020,99712,1500,825,98887,Americas
Kosovo,07-02-2020,192933,483,34,192899,Europe
Burma,07-02-2020,269181,801,356,268825,South-East Asia
United Kingdom,07-02-2020,205722,190,469,205253,Europe
United Kingdom,07-02-2020,154460,372,340,154120,Europe
United Kingdom,07-02-2020,104962,379,697,104265,Europe
Botswana,07-02-2020,161694,482,951,160743,Africa
Burundi,07-02-2020,424677,1198,697,423980,Africa
Sierra Leone,07-02-2020,172361,1165,536,171825,Africa
Malawi,07-02-2020,116033,1779,281,115752,Africa
United Kingdom,07-02-2020,329239,2210,797,328442,Europe
France,07-02-2020,29694,1229,856,28838,Europe
South Sudan,07-02-2020,417993,229,733,417260,Africa
Western Sahara,07-02-2020,208187,794,220,207967,Africa
Sao Tome and Principe,07-02-2020,135792,2284,609,135183,Africa
Yemen,07-02-2020,101606,2107,180,101426,Eastern Mediterranean
Comoros,07-02-2020,343420,623,1065,342355,Africa
Tajikistan,07-02-2020,304012,789,1087,302925,Europe
Lesotho,07-02-2020,42752,2462,483,42269,Africa
Afghanistan,08-02-2020,153958,331,527,153431,Eastern Mediterranean
Albania,08-02-2020,119199,1228,1070,118129,Europe
Algeria,08-02-2020,347162,1959,49,347113,Africa
Andorra,08-02-2020,420494,746,664,419830,Europe
Angola,08-02-2020,116756,177,948,115808,Africa
Antigua and Barbuda,08-02-2020,404689,2285,216,404473,Americas
Argentina,08-02-2020,72629,1606,187,72442,Americas
Armenia,08-02-2020,226016,1795,289,225727,Europe
Australia,08-02-2020,29052,298,868,28184,Western Pacific
Australia,08-02-2020,424394,1897,423,423971,Western Pacific
Australia,08-02-2020,301172,1634,927,300245,Western Pacific
Australia,08-02-2020,64692,606,792,63900,Western Pacific
Australia,08-02-2020,224264,2475,162,224102,Western Pacific
Australia,08-02-2020,299968,551,1183,298785,Western Pacific
Australia,08-02-2020,262239,791,387,261852,Western Pacific
Australia,08-02-2020,408001,1055,292,407709,Western Pacific
Austria,08-02-2020,152932,1957,129,152803,Europe
Azerbaijan,08-02-2020,432519,2014,655,431864,Europe
Bahamas,08-02-2020,282629,527,352,282277,Americas
Bahrain,08-02-2020,267780,1106,841,266939,Eastern Mediterranean
Bangladesh,08-02-2020,196459,167,361,196098,South-East Asia
Barbados,08-02-2020,369616,1539,330,369286,Americas
Belarus,08-02-2020,103139,771,1152,101987,Europe
Belgium,08-02-2020,256010,1613,901,255109,Europe
Benin,08-02-2020,9033,1941,415,8618,Africa
Bhutan,08-02-2020,231677,1039,93,231584,South-East Asia
Bolivia,08-02-2020,298331,2492,310,298021,Americas
Bosnia and Herzegovina,08-02-2020,4903,1521,98,4805,Europe
Brazil,08-02-2020,99951,1542,1128,98823,Americas
Brunei,08-02-2020,400296,1210,1070,399226,Western Pacific
Bulgaria,08-02-2020,190017,2099,826,189191,Europe
Burkina Faso,08-02-2020,350410,2186,438,349972,Africa
Cabo Verde,08-02-2020,324741,351,143,324598,Africa
Cambodia,08-02-2020,257800,1160,742,257058,Western Pacific
Cameroon,08-02-2020,302363,384,1139,301224,Africa
Canada,08-02-2020,175151,174,715,174436,Americas
Canada,08-02-2020,254986,2216,754,254232,Americas
Canada,08-02-2020,207477,1934,719,206758,Americas
Canada,08-02-2020,242951,733,189,242762,Americas
Canada,08-02-2020,313087,2215,961,312126,Americas
Canada,08-02-2020,2794,1496,412,2382,Americas
Canada,08-02-2020,326088,937,365,325723,Americas
Canada,08-02-2020,169888,1713,635,169253,Americas
Canada,08-02-2020,46924,2224,687,46237,Americas
Canada,08-02-2020,156065,880,310,155755,Americas
Central African Republic,08-02-2020,18933,294,202,18731,Africa
Chad,08-02-2020,346819,1388,435,346384,Africa
Chile,08-02-2020,333989,1841,537,333452,Americas
China,08-02-2020,321608,1043,927,320681,Western Pacific
China,08-02-2020,247179,1064,33,247146,Western Pacific
China,08-02-2020,390153,506,743,389410,Western Pacific
China,08-02-2020,150341,533,66,150275,Western Pacific
China,08-02-2020,417695,1165,43,417652,Western Pacific
China,08-02-2020,256778,1067,597,256181,Western Pacific
China,08-02-2020,377189,2213,405,376784,Western Pacific
China,08-02-2020,184717,311,696,184021,Western Pacific
China,08-02-2020,210719,2341,967,209752,Western Pacific
China,08-02-2020,378608,1586,724,377884,Western Pacific
China,08-02-2020,337670,1522,908,336762,Western Pacific
China,08-02-2020,335911,292,924,334987,Western Pacific
China,08-02-2020,373262,1667,240,373022,Western Pacific
China,08-02-2020,384926,1630,55,384871,Western Pacific
China,08-02-2020,354544,2164,1249,353295,Western Pacific
China,08-02-2020,162762,2114,966,161796,Western Pacific
China,08-02-2020,306687,709,864,305823,Western Pacific
China,08-02-2020,389611,554,885,388726,Western Pacific
China,08-02-2020,238056,1986,620,237436,Western Pacific
China,08-02-2020,51414,95,479,50935,Western Pacific
China,08-02-2020,176380,1838,830,175550,Western Pacific
China,08-02-2020,1519,1321,505,1014,Western Pacific
China,08-02-2020,444656,1607,638,444018,Western Pacific
China,08-02-2020,395875,729,1244,394631,Western Pacific
China,08-02-2020,430741,2246,953,429788,Western Pacific
China,08-02-2020,443435,335,361,443074,Western Pacific
China,08-02-2020,265903,404,1057,264846,Western Pacific
China,08-02-2020,407393,1426,221,407172,Western Pacific
China,08-02-2020,337728,1149,262,337466,Western Pacific
China,08-02-2020,420571,231,819,419752,Western Pacific
China,08-02-2020,422630,1946,843,421787,Western Pacific
China,08-02-2020,121940,1903,1117,120823,Western Pacific
China,08-02-2020,196518,668,912,195606,Western Pacific
Colombia,08-02-2020,425611,857,1181,424430,Americas
Congo (Brazzaville),08-02-2020,102631,1330,84,102547,Africa
Congo (Kinshasa),08-02-2020,146592,437,419,146173,Africa
Costa Rica,08-02-2020,315703,1813,10,315693,Americas
Cote d'Ivoire,08-02-2020,9098,252,1089,8009,Africa
Croatia,08-02-2020,107915,2192,1239,106676,Europe
Cuba,08-02-2020,244339,209,348,243991,Americas
Cyprus,08-02-2020,338307,2469,256,338051,Europe
Czechia,08-02-2020,402741,1567,659,402082,Europe
Denmark,08-02-2020,245712,1711,403,245309,Europe
Greenland,08-02-2020,293715,891,186,293529,Europe
Denmark,08-02-2020,228586,522,537,228049,Europe
Djibouti,08-02-2020,28240,2337,524,27716,Eastern Mediterranean
Dominican Republic,08-02-2020,199957,238,405,199552,Americas
Ecuador,08-02-2020,388299,2307,183,388116,Americas
Egypt,08-02-2020,437578,2004,9,437569,Eastern Mediterranean
El Salvador,08-02-2020,198358,2134,1239,197119,Americas
Equatorial Guinea,08-02-2020,164595,2407,125,164470,Africa
Eritrea,08-02-2020,157417,1153,501,156916,Africa
Estonia,08-02-2020,282082,301,1215,280867,Europe
Eswatini,08-02-2020,70769,2468,692,70077,Africa
Ethiopia,08-02-2020,230782,2034,154,230628,Africa
Fiji,08-02-2020,361102,2359,558,360544,Western Pacific
Finland,08-02-2020,40836,1208,967,39869,Europe
France,08-02-2020,141228,2032,966,140262,Europe
France,08-02-2020,47500,630,589,46911,Europe
France,08-02-2020,101473,1773,421,101052,Europe
France,08-02-2020,106880,400,1060,105820,Europe
France,08-02-2020,132023,1957,1068,130955,Europe
France,08-02-2020,378440,2487,5,378435,Europe
France,08-02-2020,294213,1167,855,293358,Europe
France,08-02-2020,188578,756,24,188554,Europe
France,08-02-2020,258509,1370,420,258089,Europe
France,08-02-2020,108046,1501,1241,106805,Europe
Gabon,08-02-2020,343371,77,667,342704,Africa
Gambia,08-02-2020,368996,1411,172,368824,Africa
Georgia,08-02-2020,19952,1948,365,19587,Europe
Germany,08-02-2020,248896,38,711,248185,Europe
Ghana,08-02-2020,45669,798,865,44804,Africa
Greece,08-02-2020,110984,926,89,110895,Europe
Guatemala,08-02-2020,375576,1350,568,375008,Americas
Guinea,08-02-2020,99292,2269,11,99281,Africa
Guyana,08-02-2020,436873,1819,938,435935,Americas
Haiti,08-02-2020,380459,882,197,380262,Americas
Holy See,08-02-2020,186795,306,716,186079,Europe
Honduras,08-02-2020,19607,1118,482,19125,Americas
Hungary,08-02-2020,446173,533,543,445630,Europe
Iceland,08-02-2020,328512,1566,710,327802,Europe
India,08-02-2020,39249,14,269,38980,South-East Asia
Indonesia,08-02-2020,7130,1425,1176,5954,South-East Asia
Iran,08-02-2020,275860,533,560,275300,Eastern Mediterranean
Iraq,08-02-2020,196516,1591,712,195804,Eastern Mediterranean
Ireland,08-02-2020,428680,89,907,427773,Europe
Israel,08-02-2020,231709,1865,1099,230610,Europe
Italy,08-02-2020,168310,63,933,167377,Europe
Jamaica,08-02-2020,27832,2120,260,27572,Americas
Japan,08-02-2020,444698,1946,1162,443536,Western Pacific
Jordan,08-02-2020,244011,1819,970,243041,Eastern Mediterranean
Kazakhstan,08-02-2020,396163,1231,453,395710,Europe
Kenya,08-02-2020,97614,2310,1241,96373,Africa
South Korea,08-02-2020,280502,630,1063,279439,Western Pacific
Kuwait,08-02-2020,234511,654,565,233946,Eastern Mediterranean
Kyrgyzstan,08-02-2020,136507,2112,14,136493,Europe
Latvia,08-02-2020,419984,133,59,419925,Europe
Lebanon,08-02-2020,244380,2039,668,243712,Eastern Mediterranean
Liberia,08-02-2020,358202,1075,577,357625,Africa
Liechtenstein,08-02-2020,120162,421,931,119231,Europe
Lithuania,08-02-2020,50405,2386,848,49557,Europe
Luxembourg,08-02-2020,301329,1195,1148,300181,Europe
Madagascar,08-02-2020,137805,1490,662,137143,Africa
Malaysia,08-02-2020,124604,259,590,124014,Western Pacific
Maldives,08-02-2020,388875,518,1070,387805,South-East Asia
Malta,08-02-2020,149471,1726,1102,148369,Europe
Mauritania,08-02-2020,341150,1499,1000,340150,Africa
Mauritius,08-02-2020,28706,315,21,28685,Africa
Mexico,08-02-2020,435329,331,577,434752,Americas
Moldova,08-02-2020,95899,482,400,95499,Europe
Monaco,08-02-2020,318642,399,30,318612,Europe
Mongolia,08-02-2020,275462,1489,378,275084,Western Pacific
Montenegro,08-02-2020,239965,822,1235,238730,Europe
Morocco,08-02-2020,347713,507,86,347627,Eastern Mediterranean
Namibia,08-02-2020,33060,921,793,32267,Africa
Nepal,08-02-2020,327029,520,800,326229,South-East Asia
Netherlands,08-02-2020,358261,1792,225,358036,Europe
Netherlands,08-02-2020,44133,1254,504,43629,Europe
Netherlands,08-02-2020,12689,1296,1169,11520,Europe
Netherlands,08-02-2020,128730,2132,158,128572,Europe
New Zealand,08-02-2020,22357,2172,566,21791,Western Pacific
Nicaragua,08-02-2020,360304,2308,1156,359148,Americas
Niger,08-02-2020,38378,136,1197,37181,Africa
Nigeria,08-02-2020,302458,2018,940,301518,Africa
North Macedonia,08-02-2020,33416,2389,587,32829,Europe
Norway,08-02-2020,278828,375,529,278299,Europe
Oman,08-02-2020,53085,802,291,52794,Eastern Mediterranean
Pakistan,08-02-2020,45779,2434,245,45534,Eastern Mediterranean
Panama,08-02-2020,355945,1755,502,355443,Americas
Papua New Guinea,08-02-2020,141616,392,485,141131,Western Pacific
Paraguay,08-02-2020,437349,2440,404,436945,Americas
Peru,08-02-2020,409199,2260,56,409143,Americas
Philippines,08-02-2020,286184,2260,857,285327,Western Pacific
Poland,08-02-2020,291997,1739,1091,290906,Europe
Portugal,08-02-2020,344554,251,523,344031,Europe
Qatar,08-02-2020,383438,735,246,383192,Eastern Mediterranean
Romania,08-02-2020,314978,98,1057,313921,Europe
Russia,08-02-2020,204431,1822,489,203942,Europe
Rwanda,08-02-2020,330283,434,704,329579,Africa
Saint Lucia,08-02-2020,251355,169,853,250502,Americas
Saint Vincent and the Grenadines,08-02-2020,33978,1808,321,33657,Americas
San Marino,08-02-2020,219612,1581,681,218931,Europe
Saudi Arabia,08-02-2020,291718,682,277,291441,Eastern Mediterranean
Senegal,08-02-2020,43856,1754,228,43628,Africa
Serbia,08-02-2020,339135,847,1225,337910,Europe
Seychelles,08-02-2020,221916,2404,797,221119,Africa
Singapore,08-02-2020,32950,658,1247,31703,Western Pacific
Slovakia,08-02-2020,172543,1105,881,171662,Europe
Slovenia,08-02-2020,115439,1442,1149,114290,Europe
Somalia,08-02-2020,97331,1969,1152,96179,Eastern Mediterranean
South Africa,08-02-2020,9374,2451,301,9073,Africa
Spain,08-02-2020,300541,846,354,300187,Europe
Sri Lanka,08-02-2020,295999,1385,778,295221,South-East Asia
Sudan,08-02-2020,254991,2432,1021,253970,Eastern Mediterranean
Suriname,08-02-2020,205435,2428,1028,204407,Americas
Sweden,08-02-2020,403323,895,996,402327,Europe
Switzerland,08-02-2020,77744,211,599,77145,Europe
Taiwan*,08-02-2020,394097,2014,436,393661,Western Pacific
Tanzania,08-02-2020,426845,1359,936,425909,Africa
Thailand,08-02-2020,309176,48,931,308245,South-East Asia
Togo,08-02-2020,415151,292,391,414760,Africa
Trinidad and Tobago,08-02-2020,96747,1040,1080,95667,Americas
Tunisia,08-02-2020,167557,1454,224,167333,Eastern Mediterranean
Turkey,08-02-2020,199275,1171,1081,198194,Europe
Uganda,08-02-2020,292378,965,644,291734,Africa
Ukraine,08-02-2020,174809,836,186,174623,Europe
United Arab Emirates,08-02-2020,230741,60,502,230239,Eastern Mediterranean
United Kingdom,08-02-2020,29046,1718,115,28931,Europe
United Kingdom,08-02-2020,201602,2002,442,201160,Europe
United Kingdom,08-02-2020,393066,2157,545,392521,Europe
United Kingdom,08-02-2020,238486,320,480,238006,Europe
United Kingdom,08-02-2020,291398,726,253,291145,Europe
United Kingdom,08-02-2020,411930,231,139,411791,Europe
United Kingdom,08-02-2020,380941,2305,899,380042,Europe
Uruguay,08-02-2020,115812,2183,730,115082,Americas
US,08-02-2020,249141,2411,847,248294,Americas
Uzbekistan,08-02-2020,166242,953,147,166095,Europe
Venezuela,08-02-2020,191025,2023,1220,189805,Americas
Vietnam,08-02-2020,331698,2288,49,331649,Western Pacific
Zambia,08-02-2020,381740,1499,876,380864,Africa
Zimbabwe,08-02-2020,29240,1962,95,29145,Africa
Dominica,08-02-2020,95998,2311,614,95384,Americas
Grenada,08-02-2020,329196,1769,82,329114,Americas
Mozambique,08-02-2020,50955,1306,440,50515,Africa
Syria,08-02-2020,190621,22,172,190449,Eastern Mediterranean
Timor-Leste,08-02-2020,84543,2449,1158,83385,South-East Asia
Belize,08-02-2020,276649,98,210,276439,Americas
Laos,08-02-2020,197357,1098,1201,196156,Western Pacific
Libya,08-02-2020,414329,207,784,413545,Eastern Mediterranean
West Bank and Gaza,08-02-2020,403682,1308,613,403069,Eastern Mediterranean
Guinea-Bissau,08-02-2020,400814,1647,534,400280,Africa
Mali,08-02-2020,445748,214,819,444929,Africa
Saint Kitts and Nevis,08-02-2020,82019,2385,265,81754,Americas
Canada,08-02-2020,233595,14,1149,232446,Americas
Canada,08-02-2020,255293,2243,996,254297,Americas
Kosovo,08-02-2020,443622,768,1,443621,Europe
Burma,08-02-2020,37579,850,1105,36474,South-East Asia
United Kingdom,08-02-2020,191360,28,424,190936,Europe
United Kingdom,08-02-2020,219770,2276,498,219272,Europe
United Kingdom,08-02-2020,43931,381,371,43560,Europe
Botswana,08-02-2020,860,883,1097,-237,Africa
Burundi,08-02-2020,154629,916,378,154251,Africa
Sierra Leone,08-02-2020,214538,17,401,214137,Africa
Malawi,08-02-2020,386988,426,184,386804,Africa
United Kingdom,08-02-2020,336204,307,97,336107,Europe
France,08-02-2020,172730,4,619,172111,Europe
South Sudan,08-02-2020,191066,1505,705,190361,Africa
Western Sahara,08-02-2020,8841,1838,161,8680,Africa
Sao Tome and Principe,08-02-2020,258207,432,212,257995,Africa
Yemen,08-02-2020,177029,1956,229,176800,Eastern Mediterranean
Comoros,08-02-2020,12386,1923,1116,11270,Africa
Tajikistan,08-02-2020,63027,2129,325,62702,Europe
Lesotho,08-02-2020,218576,2001,252,218324,Africa
Afghanistan,09-02-2020,241612,153,389,241223,Eastern Mediterranean
Albania,09-02-2020,250603,2422,505,250098,Europe
Algeria,09-02-2020,63815,625,1039,62776,Africa
Andorra,09-02-2020,106507,1924,949,105558,Europe
Angola,09-02-2020,179565,483,79,179486,Africa
Antigua and Barbuda,09-02-2020,434102,2244,474,433628,Americas
Argentina,09-02-2020,193418,1273,101,193317,Americas
Armenia,09-02-2020,160939,1009,507,160432,Europe
Australia,09-02-2020,178937,2452,1072,177865,Western Pacific
Australia,09-02-2020,382082,1344,686,381396,Western Pacific
Australia,09-02-2020,267653,1361,121,267532,Western Pacific
Australia,09-02-2020,239153,2161,652,238501,Western Pacific
Australia,09-02-2020,253987,1818,668,253319,Western Pacific
Australia,09-02-2020,173034,2014,1226,171808,Western Pacific
Australia,09-02-2020,206579,376,191,206388,Western Pacific
Australia,09-02-2020,93141,1451,379,92762,Western Pacific
Austria,09-02-2020,433764,2438,359,433405,Europe
Azerbaijan,09-02-2020,393768,741,798,392970,Europe
Bahamas,09-02-2020,416767,1979,19,416748,Americas
Bahrain,09-02-2020,39058,1670,454,38604,Eastern Mediterranean
Bangladesh,09-02-2020,413438,1303,1221,412217,South-East Asia
Barbados,09-02-2020,126940,1388,370,126570,Americas
Belarus,09-02-2020,160457,2025,219,160238,Europe
Belgium,09-02-2020,265673,1454,1121,264552,Europe
Benin,09-02-2020,4654,2249,985,3669,Africa
Bhutan,09-02-2020,416202,1708,877,415325,South-East Asia
Bolivia,09-02-2020,316923,381,583,316340,Americas
Bosnia and Herzegovina,09-02-2020,209668,1000,928,208740,Europe
Brazil,09-02-2020,141184,1499,676,140508,Americas
Brunei,09-02-2020,432001,1749,666,431335,Western Pacific
Bulgaria,09-02-2020,72728,516,782,71946,Europe
Burkina Faso,09-02-2020,190207,2185,319,189888,Africa
Cabo Verde,09-02-2020,270907,1957,768,270139,Africa
Cambodia,09-02-2020,16811,2227,1040,15771,Western Pacific
Cameroon,09-02-2020,264420,535,1160,263260,Africa
Canada,09-02-2020,166061,54,637,165424,Americas
Canada,09-02-2020,348387,2274,653,347734,Americas
Canada,09-02-2020,330251,1875,813,329438,Americas
Canada,09-02-2020,168286,267,241,168045,Americas
Canada,09-02-2020,162010,741,481,161529,Americas
Canada,09-02-2020,390155,1726,781,389374,Americas
Canada,09-02-2020,296752,738,284,296468,Americas
Canada,09-02-2020,300910,2430,281,300629,Americas
Canada,09-02-2020,274315,705,750,273565,Americas
Canada,09-02-2020,438608,2164,309,438299,Americas
Central African Republic,09-02-2020,8555,237,233,8322,Africa
Chad,09-02-2020,420906,2217,750,420156,Africa
Chile,09-02-2020,179274,554,1131,178143,Americas
China,09-02-2020,86907,245,667,86240,Western Pacific
China,09-02-2020,244359,572,980,243379,Western Pacific
China,09-02-2020,202176,400,1110,201066,Western Pacific
China,09-02-2020,350635,73,122,350513,Western Pacific
China,09-02-2020,43465,1929,881,42584,Western Pacific
China,09-02-2020,57924,1700,846,57078,Western Pacific
China,09-02-2020,89290,1921,697,88593,Western Pacific
China,09-02-2020,373537,2031,135,373402,Western Pacific
China,09-02-2020,23226,1345,990,22236,Western Pacific
China,09-02-2020,420330,271,1152,419178,Western Pacific
China,09-02-2020,75382,617,436,74946,Western Pacific
China,09-02-2020,310265,289,1069,309196,Western Pacific
China,09-02-2020,132392,1021,864,131528,Western Pacific
China,09-02-2020,115470,695,244,115226,Western Pacific
China,09-02-2020,160400,200,965,159435,Western Pacific
China,09-02-2020,383228,2493,1,383227,Western Pacific
China,09-02-2020,427956,1259,936,427020,Western Pacific
China,09-02-2020,336210,791,813,335397,Western Pacific
China,09-02-2020,33143,985,367,32776,Western Pacific
China,09-02-2020,315809,2172,757,315052,Western Pacific
China,09-02-2020,301601,1962,604,300997,Western Pacific
China,09-02-2020,277210,235,970,276240,Western Pacific
China,09-02-2020,165188,757,1249,163939,Western Pacific
China,09-02-2020,212097,1701,1106,210991,Western Pacific
China,09-02-2020,141093,444,236,140857,Western Pacific
China,09-02-2020,95338,36,606,94732,Western Pacific
China,09-02-2020,12046,655,338,11708,Western Pacific
China,09-02-2020,15127,1617,1,15126,Western Pacific
China,09-02-2020,23474,141,1098,22376,Western Pacific
China,09-02-2020,36014,1481,500,35514,Western Pacific
China,09-02-2020,142118,2011,690,141428,Western Pacific
China,09-02-2020,117958,1562,854,117104,Western Pacific
China,09-02-2020,159105,1268,1092,158013,Western Pacific
Colombia,09-02-2020,177993,1317,831,177162,Americas
Congo (Brazzaville),09-02-2020,94260,2245,633,93627,Africa
Congo (Kinshasa),09-02-2020,194365,1672,896,193469,Africa
Costa Rica,09-02-2020,212443,1132,1126,211317,Americas
Cote d'Ivoire,09-02-2020,134924,1338,427,134497,Africa
Croatia,09-02-2020,215375,258,60,215315,Europe
Cuba,09-02-2020,437664,711,234,437430,Americas
Cyprus,09-02-2020,307974,1795,1166,306808,Europe
Czechia,09-02-2020,201411,1910,632,200779,Europe
Denmark,09-02-2020,241151,1750,860,240291,Europe
Greenland,09-02-2020,197385,497,1236,196149,Europe
Denmark,09-02-2020,281099,1359,872,280227,Europe
Djibouti,09-02-2020,425736,180,674,425062,Eastern Mediterranean
Dominican Republic,09-02-2020,10162,2384,197,9965,Americas
Ecuador,09-02-2020,419345,231,318,419027,Americas
Egypt,09-02-2020,228998,357,485,228513,Eastern Mediterranean
El Salvador,09-02-2020,217049,567,1012,216037,Americas
Equatorial Guinea,09-02-2020,393200,464,754,392446,Africa
Eritrea,09-02-2020,354854,2057,409,354445,Africa
Estonia,09-02-2020,295130,1699,1111,294019,Europe
Eswatini,09-02-2020,18769,2427,121,18648,Africa
Ethiopia,09-02-2020,334585,4,911,333674,Africa
Fiji,09-02-2020,411645,940,684,410961,Western Pacific
Finland,09-02-2020,284338,1287,949,283389,Europe
France,09-02-2020,283877,1462,271,283606,Europe
France,09-02-2020,282697,2212,1063,281634,Europe
France,09-02-2020,12181,1944,1060,11121,Europe
France,09-02-2020,121062,812,964,120098,Europe
France,09-02-2020,218464,935,39,218425,Europe
France,09-02-2020,187361,1394,119,187242,Europe
France,09-02-2020,287524,467,1138,286386,Europe
France,09-02-2020,18994,1501,115,18879,Europe
France,09-02-2020,393055,1484,290,392765,Europe
France,09-02-2020,183960,690,501,183459,Europe
Gabon,09-02-2020,213747,1509,1048,212699,Africa
Gambia,09-02-2020,292450,830,847,291603,Africa
Georgia,09-02-2020,369013,976,459,368554,Europe
Germany,09-02-2020,53580,1552,429,53151,Europe
Ghana,09-02-2020,269096,1906,912,268184,Africa
Greece,09-02-2020,5010,2340,675,4335,Europe
Guatemala,09-02-2020,434094,1889,1242,432852,Americas
Guinea,09-02-2020,92221,2371,703,91518,Africa
Guyana,09-02-2020,63159,2434,138,63021,Americas
Haiti,09-02-2020,416314,530,749,415565,Americas
Holy See,09-02-2020,55756,970,607,55149,Europe
Honduras,09-02-2020,445980,296,943,445037,Americas
Hungary,09-02-2020,342588,735,1079,341509,Europe
Iceland,09-02-2020,283762,1505,1178,282584,Europe
India,09-02-2020,154558,1350,254,154304,South-East Asia
Indonesia,09-02-2020,286018,1234,125,285893,South-East Asia
Iran,09-02-2020,83278,1543,275,83003,Eastern Mediterranean
Iraq,09-02-2020,131174,553,558,130616,Eastern Mediterranean
Ireland,09-02-2020,257695,1037,579,257116,Europe
Israel,09-02-2020,405042,1565,534,404508,Europe
Italy,09-02-2020,340587,536,1213,339374,Europe
Jamaica,09-02-2020,200797,780,949,199848,Americas
Japan,09-02-2020,250193,2293,514,249679,Western Pacific
Jordan,09-02-2020,105629,654,812,104817,Eastern Mediterranean
Kazakhstan,09-02-2020,21458,1301,1217,20241,Europe
Kenya,09-02-2020,443596,1674,311,443285,Africa
South Korea,09-02-2020,303484,53,1105,302379,Western Pacific
Kuwait,09-02-2020,325363,606,339,325024,Eastern Mediterranean
Kyrgyzstan,09-02-2020,32405,2417,742,31663,Europe
Latvia,09-02-2020,446642,1330,669,445973,Europe
Lebanon,09-02-2020,320043,471,635,319408,Eastern Mediterranean
Liberia,09-02-2020,48173,1286,1130,47043,Africa
Liechtenstein,09-02-2020,330254,2179,240,330014,Europe
Lithuania,09-02-2020,273109,119,207,272902,Europe
Luxembourg,09-02-2020,427238,391,158,427080,Europe
Madagascar,09-02-2020,162481,1394,1143,161338,Africa
Malaysia,09-02-2020,6045,395,121,5924,Western Pacific
Maldives,09-02-2020,226722,1586,977,225745,South-East Asia
Malta,09-02-2020,90354,2036,757,89597,Europe
Mauritania,09-02-2020,161920,309,324,161596,Africa
Mauritius,09-02-2020,334307,222,762,333545,Africa
Mexico,09-02-2020,252776,749,364,252412,Americas
Moldova,09-02-2020,182620,2040,973,181647,Europe
Monaco,09-02-2020,138336,643,635,137701,Europe
Mongolia,09-02-2020,424605,738,361,424244,Western Pacific
Montenegro,09-02-2020,241160,128,107,241053,Europe
Morocco,09-02-2020,58431,235,539,57892,Eastern Mediterranean
Namibia,09-02-2020,13742,1496,701,13041,Africa
Nepal,09-02-2020,385347,757,918,384429,South-East Asia
Netherlands,09-02-2020,242797,8,717,242080,Europe
Netherlands,09-02-2020,228061,1339,448,227613,Europe
Netherlands,09-02-2020,165675,2374,80,165595,Europe
Netherlands,09-02-2020,36682,1387,1056,35626,Europe
New Zealand,09-02-2020,233800,1786,768,233032,Western Pacific
Nicaragua,09-02-2020,215729,646,1137,214592,Americas
Niger,09-02-2020,358034,1787,986,357048,Africa
Nigeria,09-02-2020,376086,766,217,375869,Africa
North Macedonia,09-02-2020,140284,1774,820,139464,Europe
Norway,09-02-2020,447734,1723,605,447129,Europe
Oman,09-02-2020,85631,2245,660,84971,Eastern Mediterranean
Pakistan,09-02-2020,19776,573,34,19742,Eastern Mediterranean
Panama,09-02-2020,240727,2320,782,239945,Americas
Papua New Guinea,09-02-2020,411646,1559,840,410806,Western Pacific
Paraguay,09-02-2020,192456,8,1217,191239,Americas
Peru,09-02-2020,414576,1031,212,414364,Americas
Philippines,09-02-2020,81962,2288,632,81330,Western Pacific
Poland,09-02-2020,43588,1598,916,42672,Europe
Portugal,09-02-2020,318824,1823,1096,317728,Europe
Qatar,09-02-2020,148555,812,869,147686,Eastern Mediterranean
Romania,09-02-2020,130983,863,595,130388,Europe
Russia,09-02-2020,146673,377,440,146233,Europe
Rwanda,09-02-2020,231761,162,204,231557,Africa
Saint Lucia,09-02-2020,296318,1620,949,295369,Americas
Saint Vincent and the Grenadines,09-02-2020,297368,2383,682,296686,Americas
San Marino,09-02-2020,205426,80,1092,204334,Europe
Saudi Arabia,09-02-2020,406705,1167,694,406011,Eastern Mediterranean
Senegal,09-02-2020,358307,2100,1115,357192,Africa
Serbia,09-02-2020,108126,556,815,107311,Europe
Seychelles,09-02-2020,54813,150,831,53982,Africa
Singapore,09-02-2020,69105,282,480,68625,Western Pacific
Slovakia,09-02-2020,339682,1706,1035,338647,Europe
Slovenia,09-02-2020,416058,883,525,415533,Europe
Somalia,09-02-2020,170754,1648,897,169857,Eastern Mediterranean
South Africa,09-02-2020,194742,404,930,193812,Africa
Spain,09-02-2020,41030,1477,1209,39821,Europe
Sri Lanka,09-02-2020,256116,998,817,255299,South-East Asia
Sudan,09-02-2020,45455,1435,106,45349,Eastern Mediterranean
Suriname,09-02-2020,269582,699,898,268684,Americas
Sweden,09-02-2020,95240,18,845,94395,Europe
Switzerland,09-02-2020,387368,1665,903,386465,Europe
Taiwan*,09-02-2020,306287,1568,967,305320,Western Pacific
Tanzania,09-02-2020,190642,1910,733,189909,Africa
Thailand,09-02-2020,129350,1337,914,128436,South-East Asia
Togo,09-02-2020,371406,995,60,371346,Africa
Trinidad and Tobago,09-02-2020,236336,2027,1044,235292,Americas
Tunisia,09-02-2020,182018,2326,1056,180962,Eastern Mediterranean
Turkey,09-02-2020,124774,510,921,123853,Europe
Uganda,09-02-2020,420266,2458,482,419784,Africa
Ukraine,09-02-2020,279440,1481,1109,278331,Europe
United Arab Emirates,09-02-2020,37031,747,1096,35935,Eastern Mediterranean
United Kingdom,09-02-2020,162504,1859,320,162184,Europe
United Kingdom,09-02-2020,446611,688,750,445861,Europe
United Kingdom,09-02-2020,342508,1307,1146,341362,Europe
United Kingdom,09-02-2020,122971,2024,1087,121884,Europe
United Kingdom,09-02-2020,13183,2132,464,12719,Europe
United Kingdom,09-02-2020,175761,1146,645,175116,Europe
United Kingdom,09-02-2020,276532,1309,492,276040,Europe
Uruguay,09-02-2020,184437,2374,672,183765,Americas
US,09-02-2020,190668,1277,947,189721,Americas
Uzbekistan,09-02-2020,392726,1839,798,391928,Europe
Venezuela,09-02-2020,94106,1356,253,93853,Americas
Vietnam,09-02-2020,334444,192,1233,333211,Western Pacific
Zambia,09-02-2020,290262,1489,1065,289197,Africa
Zimbabwe,09-02-2020,370108,444,741,369367,Africa
Dominica,09-02-2020,73309,2375,1058,72251,Americas
Grenada,09-02-2020,119359,1635,196,119163,Americas
Mozambique,09-02-2020,388055,414,1240,386815,Africa
Syria,09-02-2020,299567,78,166,299401,Eastern Mediterranean
Timor-Leste,09-02-2020,280109,1895,800,279309,South-East Asia
Belize,09-02-2020,114609,344,546,114063,Americas
Laos,09-02-2020,67781,2423,844,66937,Western Pacific
Libya,09-02-2020,16185,27,841,15344,Eastern Mediterranean
West Bank and Gaza,09-02-2020,203502,342,133,203369,Eastern Mediterranean
Guinea-Bissau,09-02-2020,38192,1381,1171,37021,Africa
Mali,09-02-2020,367649,2490,1053,366596,Africa
Saint Kitts and Nevis,09-02-2020,156392,934,130,156262,Americas
Canada,09-02-2020,167622,713,917,166705,Americas
Canada,09-02-2020,381598,1442,447,381151,Americas
Kosovo,09-02-2020,102568,805,1117,101451,Europe
Burma,09-02-2020,254960,1305,654,254306,South-East Asia
United Kingdom,09-02-2020,258015,2431,1079,256936,Europe
United Kingdom,09-02-2020,115196,2411,731,114465,Europe
United Kingdom,09-02-2020,236431,1846,317,236114,Europe
Botswana,09-02-2020,287849,1458,194,287655,Africa
Burundi,09-02-2020,75241,2114,1151,74090,Africa
Sierra Leone,09-02-2020,284506,1593,67,284439,Africa
Malawi,09-02-2020,194495,2297,678,193817,Africa
United Kingdom,09-02-2020,127888,1980,382,127506,Europe
France,09-02-2020,443272,823,699,442573,Europe
South Sudan,09-02-2020,27695,554,991,26704,Africa
Western Sahara,09-02-2020,362678,888,363,362315,Africa
Sao Tome and Principe,09-02-2020,166586,1142,430,166156,Africa
Yemen,09-02-2020,162567,994,664,161903,Eastern Mediterranean
Comoros,09-02-2020,196989,357,705,196284,Africa
Tajikistan,09-02-2020,259827,605,831,258996,Europe
Lesotho,09-02-2020,429092,1822,494,428598,Africa
Afghanistan,10-02-2020,278707,1226,981,277726,Eastern Mediterranean
Albania,10-02-2020,442220,872,522,441698,Europe
Algeria,10-02-2020,14548,323,513,14035,Africa
Andorra,10-02-2020,5289,2007,8,5281,Europe
Angola,10-02-2020,28545,1063,913,27632,Africa
Antigua and Barbuda,10-02-2020,259901,378,1125,258776,Americas
Argentina,10-02-2020,158186,249,599,157587,Americas
Armenia,10-02-2020,244429,907,422,244007,Europe
Australia,10-02-2020,4332,606,172,4160,Western Pacific
Australia,10-02-2020,275016,1362,1074,273942,Western Pacific
Australia,10-02-2020,396097,2009,73,396024,Western Pacific
Australia,10-02-2020,340175,1172,527,339648,Western Pacific
Australia,10-02-2020,276651,83,851,275800,Western Pacific
Australia,10-02-2020,58126,831,302,57824,Western Pacific
Australia,10-02-2020,443859,772,1121,442738,Western Pacific
Australia,10-02-2020,82884,2085,251,82633,Western Pacific
Austria,10-02-2020,321052,2006,1039,320013,Europe
Azerbaijan,10-02-2020,274772,520,1148,273624,Europe
Bahamas,10-02-2020,197493,1437,529,196964,Americas
Bahrain,10-02-2020,126037,670,368,125669,Eastern Mediterranean
Bangladesh,10-02-2020,434604,67,1203,433401,South-East Asia
Barbados,10-02-2020,139095,914,112,138983,Americas
Belarus,10-02-2020,273114,1880,1096,272018,Europe
Belgium,10-02-2020,205857,1900,38,205819,Europe
Benin,10-02-2020,331039,379,593,330446,Africa
Bhutan,10-02-2020,262797,758,339,262458,South-East Asia
Bolivia,10-02-2020,259904,1012,1092,258812,Americas
Bosnia and Herzegovina,10-02-2020,235441,1633,575,234866,Europe
Brazil,10-02-2020,185666,1607,1203,184463,Americas
Brunei,10-02-2020,145588,2171,114,145474,Western Pacific
Bulgaria,10-02-2020,315432,193,666,314766,Europe
Burkina Faso,10-02-2020,187595,1870,89,187506,Africa
Cabo Verde,10-02-2020,414174,1852,948,413226,Africa
Cambodia,10-02-2020,326028,894,700,325328,Western Pacific
Cameroon,10-02-2020,250691,841,725,249966,Africa
Canada,10-02-2020,336083,1139,1065,335018,Americas
Canada,10-02-2020,134873,1442,461,134412,Americas
Canada,10-02-2020,147045,669,893,146152,Americas
Canada,10-02-2020,347876,2158,563,347313,Americas
Canada,10-02-2020,88462,1852,42,88420,Americas
Canada,10-02-2020,124805,1366,510,124295,Americas
Canada,10-02-2020,155118,1496,617,154501,Americas
Canada,10-02-2020,273596,1497,20,273576,Americas
Canada,10-02-2020,13566,2204,569,12997,Americas
Canada,10-02-2020,324490,2288,779,323711,Americas
Central African Republic,10-02-2020,47332,2148,87,47245,Africa
Chad,10-02-2020,189806,1427,990,188816,Africa
Chile,10-02-2020,25543,689,918,24625,Americas
China,10-02-2020,145624,2312,931,144693,Western Pacific
China,10-02-2020,4151,704,815,3336,Western Pacific
China,10-02-2020,163492,231,84,163408,Western Pacific
China,10-02-2020,71948,519,1134,70814,Western Pacific
China,10-02-2020,402341,789,61,402280,Western Pacific
China,10-02-2020,440289,1457,269,440020,Western Pacific
China,10-02-2020,364733,1956,1010,363723,Western Pacific
China,10-02-2020,62531,1799,1039,61492,Western Pacific
China,10-02-2020,147941,2345,1134,146807,Western Pacific
China,10-02-2020,256401,495,1112,255289,Western Pacific
China,10-02-2020,349638,899,832,348806,Western Pacific
China,10-02-2020,58563,2216,796,57767,Western Pacific
China,10-02-2020,272834,824,840,271994,Western Pacific
China,10-02-2020,277009,97,1242,275767,Western Pacific
China,10-02-2020,57746,2140,536,57210,Western Pacific
China,10-02-2020,278880,273,643,278237,Western Pacific
China,10-02-2020,435219,901,614,434605,Western Pacific
China,10-02-2020,16795,1137,884,15911,Western Pacific
China,10-02-2020,189057,619,1026,188031,Western Pacific
China,10-02-2020,260722,2454,366,260356,Western Pacific
China,10-02-2020,71776,1651,937,70839,Western Pacific
China,10-02-2020,147185,2170,214,146971,Western Pacific
China,10-02-2020,23878,2483,310,23568,Western Pacific
China,10-02-2020,330264,1093,941,329323,Western Pacific
China,10-02-2020,441011,2446,966,440045,Western Pacific
China,10-02-2020,334445,2347,68,334377,Western Pacific
China,10-02-2020,69333,212,1098,68235,Western Pacific
China,10-02-2020,418889,783,202,418687,Western Pacific
China,10-02-2020,350982,787,552,350430,Western Pacific
China,10-02-2020,325604,457,939,324665,Western Pacific
China,10-02-2020,382443,1250,246,382197,Western Pacific
China,10-02-2020,62193,2191,455,61738,Western Pacific
China,10-02-2020,194370,444,1079,193291,Western Pacific
Colombia,10-02-2020,16235,191,320,15915,Americas
Congo (Brazzaville),10-02-2020,128937,281,581,128356,Africa
Congo (Kinshasa),10-02-2020,434441,1370,1097,433344,Africa
Costa Rica,10-02-2020,274379,1165,412,273967,Americas
Cote d'Ivoire,10-02-2020,164355,1625,632,163723,Africa
Croatia,10-02-2020,134316,1630,162,134154,Europe
Cuba,10-02-2020,125115,1827,339,124776,Americas
Cyprus,10-02-2020,153044,2043,47,152997,Europe
Czechia,10-02-2020,234032,1799,862,233170,Europe
Denmark,10-02-2020,260102,1597,167,259935,Europe
Greenland,10-02-2020,9454,1509,280,9174,Europe
Denmark,10-02-2020,214002,366,572,213430,Europe
Djibouti,10-02-2020,410414,1621,230,410184,Eastern Mediterranean
Dominican Republic,10-02-2020,173574,2364,359,173215,Americas
Ecuador,10-02-2020,176679,2101,47,176632,Americas
Egypt,10-02-2020,59539,2264,1170,58369,Eastern Mediterranean
El Salvador,10-02-2020,331218,640,3,331215,Americas
Equatorial Guinea,10-02-2020,59588,2016,265,59323,Africa
Eritrea,10-02-2020,448912,251,97,448815,Africa
Estonia,10-02-2020,262590,732,265,262325,Europe
Eswatini,10-02-2020,299246,3,1069,298177,Africa
Ethiopia,10-02-2020,408898,1493,99,408799,Africa
Fiji,10-02-2020,124278,1257,34,124244,Western Pacific
Finland,10-02-2020,293958,2403,877,293081,Europe
France,10-02-2020,347511,1698,276,347235,Europe
France,10-02-2020,145344,1163,293,145051,Europe
France,10-02-2020,115952,64,89,115863,Europe
France,10-02-2020,171501,444,692,170809,Europe
France,10-02-2020,254780,635,749,254031,Europe
France,10-02-2020,5908,2024,164,5744,Europe
France,10-02-2020,116903,945,1156,115747,Europe
France,10-02-2020,340734,153,1075,339659,Europe
France,10-02-2020,194739,1953,974,193765,Europe
France,10-02-2020,385359,1247,671,384688,Europe
Gabon,10-02-2020,155528,1298,440,155088,Africa
Gambia,10-02-2020,167609,2484,1126,166483,Africa
Georgia,10-02-2020,381979,1521,900,381079,Europe
Germany,10-02-2020,260990,2195,151,260839,Europe
Ghana,10-02-2020,179919,965,771,179148,Africa
Greece,10-02-2020,333024,273,726,332298,Europe
Guatemala,10-02-2020,378082,1437,106,377976,Americas
Guinea,10-02-2020,46278,51,223,46055,Africa
Guyana,10-02-2020,388753,413,1240,387513,Americas
Haiti,10-02-2020,390307,2495,452,389855,Americas
Holy See,10-02-2020,9106,1939,1201,7905,Europe
Honduras,10-02-2020,8433,385,1044,7389,Americas
Hungary,10-02-2020,66398,2079,627,65771,Europe
Iceland,10-02-2020,54863,1730,211,54652,Europe
India,10-02-2020,25959,458,93,25866,South-East Asia
Indonesia,10-02-2020,351310,421,88,351222,South-East Asia
Iran,10-02-2020,96552,1275,764,95788,Eastern Mediterranean
Iraq,10-02-2020,241627,1238,347,241280,Eastern Mediterranean
Ireland,10-02-2020,118442,1372,1055,117387,Europe
Israel,10-02-2020,321613,1358,732,320881,Europe
Italy,10-02-2020,57176,318,399,56777,Europe
Jamaica,10-02-2020,28059,230,336,27723,Americas
Japan,10-02-2020,60622,1084,679,59943,Western Pacific
Jordan,10-02-2020,99350,614,669,98681,Eastern Mediterranean
Kazakhstan,10-02-2020,300577,1453,1009,299568,Europe
Kenya,10-02-2020,388584,617,1061,387523,Africa
South Korea,10-02-2020,300690,747,511,300179,Western Pacific
Kuwait,10-02-2020,241151,1681,237,240914,Eastern Mediterranean
Kyrgyzstan,10-02-2020,142419,2240,504,141915,Europe
Latvia,10-02-2020,259653,79,967,258686,Europe
Lebanon,10-02-2020,99348,991,683,98665,Eastern Mediterranean
Liberia,10-02-2020,259364,2116,196,259168,Africa
Liechtenstein,10-02-2020,103374,848,14,103360,Europe
Lithuania,10-02-2020,377352,1188,118,377234,Europe
Luxembourg,10-02-2020,23323,2308,683,22640,Europe
Madagascar,10-02-2020,37843,1791,266,37577,Africa
Malaysia,10-02-2020,210023,663,609,209414,Western Pacific
Maldives,10-02-2020,206057,1276,14,206043,South-East Asia
Malta,10-02-2020,266496,769,587,265909,Europe
Mauritania,10-02-2020,222001,66,1199,220802,Africa
Mauritius,10-02-2020,318812,642,398,318414,Africa
Mexico,10-02-2020,354203,563,864,353339,Americas
Moldova,10-02-2020,14163,1606,1218,12945,Europe
Monaco,10-02-2020,248385,2127,447,247938,Europe
Mongolia,10-02-2020,154975,1416,547,154428,Western Pacific
Montenegro,10-02-2020,240890,1222,1167,239723,Europe
Morocco,10-02-2020,278657,2255,1223,277434,Eastern Mediterranean
Namibia,10-02-2020,425639,275,665,424974,Africa
Nepal,10-02-2020,369629,740,559,369070,South-East Asia
Netherlands,10-02-2020,87500,1309,442,87058,Europe
Netherlands,10-02-2020,32190,957,442,31748,Europe
Netherlands,10-02-2020,448129,514,553,447576,Europe
Netherlands,10-02-2020,367692,585,1171,366521,Europe
New Zealand,10-02-2020,310538,2062,387,310151,Western Pacific
Nicaragua,10-02-2020,345349,6,1192,344157,Americas
Niger,10-02-2020,377693,482,975,376718,Africa
Nigeria,10-02-2020,129628,191,156,129472,Africa
North Macedonia,10-02-2020,33873,825,678,33195,Europe
Norway,10-02-2020,359083,2431,411,358672,Europe
Oman,10-02-2020,441704,585,1085,440619,Eastern Mediterranean
Pakistan,10-02-2020,304203,515,153,304050,Eastern Mediterranean
Panama,10-02-2020,327904,2130,273,327631,Americas
Papua New Guinea,10-02-2020,30,1190,709,-679,Western Pacific
Paraguay,10-02-2020,449953,2070,335,449618,Americas
Peru,10-02-2020,97550,979,738,96812,Americas
Philippines,10-02-2020,238923,382,160,238763,Western Pacific
Poland,10-02-2020,248023,1427,978,247045,Europe
Portugal,10-02-2020,370011,1316,207,369804,Europe
Qatar,10-02-2020,348573,1041,960,347613,Eastern Mediterranean
Romania,10-02-2020,322771,1641,508,322263,Europe
Russia,10-02-2020,45620,690,369,45251,Europe
Rwanda,10-02-2020,314867,312,405,314462,Africa
Saint Lucia,10-02-2020,91717,227,891,90826,Americas
Saint Vincent and the Grenadines,10-02-2020,314151,1969,193,313958,Americas
San Marino,10-02-2020,363904,775,1040,362864,Europe
Saudi Arabia,10-02-2020,178214,139,249,177965,Eastern Mediterranean
Senegal,10-02-2020,5666,1151,305,5361,Africa
Serbia,10-02-2020,386001,1171,172,385829,Europe
Seychelles,10-02-2020,124857,1035,378,124479,Africa
Singapore,10-02-2020,47138,1656,1225,45913,Western Pacific
Slovakia,10-02-2020,280005,2463,779,279226,Europe
Slovenia,10-02-2020,402804,956,632,402172,Europe
Somalia,10-02-2020,389764,2047,871,388893,Eastern Mediterranean
South Africa,10-02-2020,100728,1764,419,100309,Africa
Spain,10-02-2020,335376,833,183,335193,Europe
Sri Lanka,10-02-2020,145495,521,223,145272,South-East Asia
Sudan,10-02-2020,271757,792,889,270868,Eastern Mediterranean
Suriname,10-02-2020,333394,2367,562,332832,Americas
Sweden,10-02-2020,108335,865,176,108159,Europe
Switzerland,10-02-2020,256950,513,100,256850,Europe
Taiwan*,10-02-2020,126224,2293,325,125899,Western Pacific
Tanzania,10-02-2020,156020,2476,54,155966,Africa
Thailand,10-02-2020,359198,238,1168,358030,South-East Asia
Togo,10-02-2020,351591,1209,1180,350411,Africa
Trinidad and Tobago,10-02-2020,97715,433,338,97377,Americas
Tunisia,10-02-2020,285294,2296,575,284719,Eastern Mediterranean
Turkey,10-02-2020,263602,183,1162,262440,Europe
Uganda,10-02-2020,432602,1822,896,431706,Africa
Ukraine,10-02-2020,301805,503,270,301535,Europe
United Arab Emirates,10-02-2020,370801,1620,857,369944,Eastern Mediterranean
United Kingdom,10-02-2020,350523,1772,622,349901,Europe
United Kingdom,10-02-2020,38763,365,1201,37562,Europe
United Kingdom,10-02-2020,78333,1569,567,77766,Europe
United Kingdom,10-02-2020,18838,2077,268,18570,Europe
United Kingdom,10-02-2020,173663,1903,757,172906,Europe
United Kingdom,10-02-2020,212589,1783,1027,211562,Europe
United Kingdom,10-02-2020,5173,2348,528,4645,Europe
Uruguay,10-02-2020,276074,2370,204,275870,Americas
US,10-02-2020,151006,146,859,150147,Americas
Uzbekistan,10-02-2020,163125,597,406,162719,Europe
Venezuela,10-02-2020,392908,626,4,392904,Americas
Vietnam,10-02-2020,100916,144,157,100759,Western Pacific
Zambia,10-02-2020,322591,1745,109,322482,Africa
Zimbabwe,10-02-2020,389463,326,541,388922,Africa
Dominica,10-02-2020,365921,363,385,365536,Americas
Grenada,10-02-2020,431559,2034,487,431072,Americas
Mozambique,10-02-2020,74347,2433,1105,73242,Africa
Syria,10-02-2020,158570,1747,273,158297,Eastern Mediterranean
Timor-Leste,10-02-2020,13561,1441,672,12889,South-East Asia
Belize,10-02-2020,274460,1547,926,273534,Americas
Laos,10-02-2020,6030,168,231,5799,Western Pacific
Libya,10-02-2020,139241,845,1026,138215,Eastern Mediterranean
West Bank and Gaza,10-02-2020,149037,1472,1128,147909,Eastern Mediterranean
Guinea-Bissau,10-02-2020,52290,889,1233,51057,Africa
Mali,10-02-2020,315676,971,1171,314505,Africa
Saint Kitts and Nevis,10-02-2020,416142,854,41,416101,Americas
Canada,10-02-2020,55273,902,305,54968,Americas
Canada,10-02-2020,292038,1920,805,291233,Americas
Kosovo,10-02-2020,292748,2410,1075,291673,Europe
Burma,10-02-2020,75131,1545,596,74535,South-East Asia
United Kingdom,10-02-2020,431376,1981,1103,430273,Europe
United Kingdom,10-02-2020,343259,1231,391,342868,Europe
United Kingdom,10-02-2020,73693,54,935,72758,Europe
Botswana,10-02-2020,338713,412,315,338398,Africa
Burundi,10-02-2020,202958,1339,971,201987,Africa
Sierra Leone,10-02-2020,127822,2394,12,127810,Africa
Malawi,10-02-2020,330794,829,213,330581,Africa
United Kingdom,10-02-2020,250536,2353,148,250388,Europe
France,10-02-2020,265980,186,511,265469,Europe
South Sudan,10-02-2020,276792,1788,888,275904,Africa
Western Sahara,10-02-2020,388521,1802,521,388000,Africa
Sao Tome and Principe,10-02-2020,4308,46,657,3651,Africa
Yemen,10-02-2020,257548,2426,959,256589,Eastern Mediterranean
Comoros,10-02-2020,418138,431,208,417930,Africa
Tajikistan,10-02-2020,389370,828,160,389210,Europe
Lesotho,10-02-2020,60378,1125,41,60337,Africa
Afghanistan,11-02-2020,256558,242,665,255893,Eastern Mediterranean
Albania,11-02-2020,443952,920,604,443348,Europe
Algeria,11-02-2020,352607,424,1040,351567,Africa
Andorra,11-02-2020,316615,1802,490,316125,Europe
Angola,11-02-2020,27557,1399,748,26809,Africa
Antigua and Barbuda,11-02-2020,262329,407,235,262094,Americas
Argentina,11-02-2020,105613,943,727,104886,Americas
Armenia,11-02-2020,283435,1179,1173,282262,Europe
Australia,11-02-2020,98220,515,225,97995,Western Pacific
Australia,11-02-2020,83010,1451,380,82630,Western Pacific
Australia,11-02-2020,289726,1850,708,289018,Western Pacific
Australia,11-02-2020,21932,33,738,21194,Western Pacific
Australia,11-02-2020,219727,1117,660,219067,Western Pacific
Australia,11-02-2020,26839,2255,179,26660,Western Pacific
Australia,11-02-2020,168193,2282,581,167612,Western Pacific
Australia,11-02-2020,12042,380,1249,10793,Western Pacific
Austria,11-02-2020,131402,1938,1191,130211,Europe
Azerbaijan,11-02-2020,77452,936,267,77185,Europe
Bahamas,11-02-2020,370649,1109,230,370419,Americas
Bahrain,11-02-2020,433700,1253,1008,432692,Eastern Mediterranean
Bangladesh,11-02-2020,36733,28,964,35769,South-East Asia
Barbados,11-02-2020,146770,774,709,146061,Americas
Belarus,11-02-2020,21848,620,1083,20765,Europe
Belgium,11-02-2020,418266,1249,573,417693,Europe
Benin,11-02-2020,441916,224,425,441491,Africa
Bhutan,11-02-2020,356227,2254,467,355760,South-East Asia
Bolivia,11-02-2020,422068,265,911,421157,Americas
Bosnia and Herzegovina,11-02-2020,284535,1071,665,283870,Europe
Brazil,11-02-2020,270969,1757,761,270208,Americas
Brunei,11-02-2020,269640,729,1239,268401,Western Pacific
Bulgaria,11-02-2020,430983,2112,215,430768,Europe
Burkina Faso,11-02-2020,67707,2377,126,67581,Africa
Cabo Verde,11-02-2020,5322,962,332,4990,Africa
Cambodia,11-02-2020,422851,504,690,422161,Western Pacific
Cameroon,11-02-2020,46123,1410,183,45940,Africa
Canada,11-02-2020,72210,2152,57,72153,Americas
Canada,11-02-2020,194748,943,522,194226,Americas
Canada,11-02-2020,140633,1156,28,140605,Americas
Canada,11-02-2020,37806,2329,241,37565,Americas
Canada,11-02-2020,314575,1823,321,314254,Americas
Canada,11-02-2020,112123,2153,613,111510,Americas
Canada,11-02-2020,212796,1025,953,211843,Americas
Canada,11-02-2020,64445,1799,262,64183,Americas
Canada,11-02-2020,204208,1112,824,203384,Americas
Canada,11-02-2020,225928,1871,880,225048,Americas
Central African Republic,11-02-2020,444027,1604,1131,442896,Africa
Chad,11-02-2020,135445,1835,908,134537,Africa
Chile,11-02-2020,403328,951,49,403279,Americas
China,11-02-2020,18018,922,552,17466,Western Pacific
China,11-02-2020,182467,399,662,181805,Western Pacific
China,11-02-2020,73561,139,842,72719,Western Pacific
China,11-02-2020,53169,446,37,53132,Western Pacific
China,11-02-2020,269516,2234,278,269238,Western Pacific
China,11-02-2020,15227,1110,67,15160,Western Pacific
China,11-02-2020,354770,268,446,354324,Western Pacific
China,11-02-2020,436384,846,1065,435319,Western Pacific
China,11-02-2020,83298,1990,122,83176,Western Pacific
China,11-02-2020,238544,1916,980,237564,Western Pacific
China,11-02-2020,382869,222,390,382479,Western Pacific
China,11-02-2020,52113,2492,1005,51108,Western Pacific
China,11-02-2020,322124,771,155,321969,Western Pacific
China,11-02-2020,306221,604,493,305728,Western Pacific
China,11-02-2020,207566,641,1056,206510,Western Pacific
China,11-02-2020,291616,2387,900,290716,Western Pacific
China,11-02-2020,39090,885,262,38828,Western Pacific
China,11-02-2020,384052,2437,775,383277,Western Pacific
China,11-02-2020,429506,2325,556,428950,Western Pacific
China,11-02-2020,11605,2039,1168,10437,Western Pacific
China,11-02-2020,364913,877,781,364132,Western Pacific
China,11-02-2020,84109,2435,515,83594,Western Pacific
China,11-02-2020,181254,1558,670,180584,Western Pacific
China,11-02-2020,442470,527,204,442266,Western Pacific
China,11-02-2020,335940,1455,863,335077,Western Pacific
China,11-02-2020,193945,1004,418,193527,Western Pacific
China,11-02-2020,220327,1423,465,219862,Western Pacific
China,11-02-2020,194635,1567,685,193950,Western Pacific
China,11-02-2020,213167,2138,15,213152,Western Pacific
China,11-02-2020,6807,1735,696,6111,Western Pacific
China,11-02-2020,424704,1837,759,423945,Western Pacific
China,11-02-2020,259698,2064,340,259358,Western Pacific
China,11-02-2020,347649,1218,390,347259,Western Pacific
Colombia,11-02-2020,202796,1613,952,201844,Americas
Congo (Brazzaville),11-02-2020,103276,144,986,102290,Africa
Congo (Kinshasa),11-02-2020,125282,1006,1134,124148,Africa
Costa Rica,11-02-2020,439496,1039,496,439000,Americas
Cote d'Ivoire,11-02-2020,12325,1868,676,11649,Africa
Croatia,11-02-2020,355417,583,1219,354198,Europe
Cuba,11-02-2020,424779,1131,1046,423733,Americas
Cyprus,11-02-2020,434978,592,1158,433820,Europe
Czechia,11-02-2020,293952,1571,809,293143,Europe
Denmark,11-02-2020,193224,1415,1106,192118,Europe
Greenland,11-02-2020,262046,399,997,261049,Europe
Denmark,11-02-2020,203932,1470,1173,202759,Europe
Djibouti,11-02-2020,264508,804,1159,263349,Eastern Mediterranean
Dominican Republic,11-02-2020,107077,1279,233,106844,Americas
Ecuador,11-02-2020,145584,782,1204,144380,Americas
Egypt,11-02-2020,315858,2036,312,315546,Eastern Mediterranean
El Salvador,11-02-2020,243451,223,564,242887,Americas
Equatorial Guinea,11-02-2020,406694,1796,522,406172,Africa
Eritrea,11-02-2020,220109,472,278,219831,Africa
Estonia,11-02-2020,49817,1781,886,48931,Europe
Eswatini,11-02-2020,13161,676,583,12578,Africa
Ethiopia,11-02-2020,142919,85,995,141924,Africa
Fiji,11-02-2020,20848,2469,35,20813,Western Pacific
Finland,11-02-2020,77567,132,111,77456,Europe
France,11-02-2020,57579,872,1183,56396,Europe
France,11-02-2020,293386,1437,399,292987,Europe
France,11-02-2020,40023,640,1214,38809,Europe
France,11-02-2020,12982,56,75,12907,Europe
France,11-02-2020,44652,219,95,44557,Europe
France,11-02-2020,31807,1030,979,30828,Europe
France,11-02-2020,43772,1952,89,43683,Europe
France,11-02-2020,276628,914,1247,275381,Europe
France,11-02-2020,103738,1363,504,103234,Europe
France,11-02-2020,391147,1900,651,390496,Europe
Gabon,11-02-2020,9852,1484,818,9034,Africa
Gambia,11-02-2020,349919,2245,171,349748,Africa
Georgia,11-02-2020,161439,1879,418,161021,Europe
Germany,11-02-2020,290015,773,365,289650,Europe
Ghana,11-02-2020,206182,1811,402,205780,Africa
Greece,11-02-2020,262669,1966,165,262504,Europe
Guatemala,11-02-2020,53109,2412,1062,52047,Americas
Guinea,11-02-2020,399058,2465,1102,397956,Africa
Guyana,11-02-2020,110047,2029,467,109580,Americas
Haiti,11-02-2020,279798,523,214,279584,Americas
Holy See,11-02-2020,126198,2228,233,125965,Europe
Honduras,11-02-2020,175303,487,112,175191,Americas
Hungary,11-02-2020,285526,447,86,285440,Europe
Iceland,11-02-2020,135572,2020,728,134844,Europe
India,11-02-2020,52371,1958,785,51586,South-East Asia
Indonesia,11-02-2020,194835,1206,251,194584,South-East Asia
Iran,11-02-2020,410329,2469,1135,409194,Eastern Mediterranean
Iraq,11-02-2020,374529,287,1045,373484,Eastern Mediterranean
Ireland,11-02-2020,176180,1086,457,175723,Europe
Israel,11-02-2020,337950,1615,1138,336812,Europe
Italy,11-02-2020,183448,1451,310,183138,Europe
Jamaica,11-02-2020,110526,542,656,109870,Americas
Japan,11-02-2020,379173,219,556,378617,Western Pacific
Jordan,11-02-2020,53897,1150,931,52966,Eastern Mediterranean
Kazakhstan,11-02-2020,426019,1162,324,425695,Europe
Kenya,11-02-2020,175245,2345,341,174904,Africa
South Korea,11-02-2020,268755,264,489,268266,Western Pacific
Kuwait,11-02-2020,96456,395,215,96241,Eastern Mediterranean
Kyrgyzstan,11-02-2020,132772,497,216,132556,Europe
Latvia,11-02-2020,368852,240,895,367957,Europe
Lebanon,11-02-2020,327831,922,628,327203,Eastern Mediterranean
Liberia,11-02-2020,269723,2408,384,269339,Africa
Liechtenstein,11-02-2020,137787,1737,1055,136732,Europe
Lithuania,11-02-2020,289429,788,921,288508,Europe
Luxembourg,11-02-2020,74486,1774,1005,73481,Europe
Madagascar,11-02-2020,129755,2272,891,128864,Africa
Malaysia,11-02-2020,412944,817,1179,411765,Western Pacific
Maldives,11-02-2020,174233,648,939,173294,South-East Asia
Malta,11-02-2020,156105,1389,200,155905,Europe
Mauritania,11-02-2020,314895,459,1102,313793,Africa
Mauritius,11-02-2020,372150,550,656,371494,Africa
Mexico,11-02-2020,76011,726,212,75799,Americas
Moldova,11-02-2020,186122,425,729,185393,Europe
Monaco,11-02-2020,408484,1049,508,407976,Europe
Mongolia,11-02-2020,95758,370,282,95476,Western Pacific
Montenegro,11-02-2020,7051,2127,1039,6012,Europe
Morocco,11-02-2020,88568,1235,1147,87421,Eastern Mediterranean
Namibia,11-02-2020,121409,1613,345,121064,Africa
Nepal,11-02-2020,419806,339,745,419061,South-East Asia
Netherlands,11-02-2020,408759,59,588,408171,Europe
Netherlands,11-02-2020,60738,687,983,59755,Europe
Netherlands,11-02-2020,82243,1766,488,81755,Europe
Netherlands,11-02-2020,157812,844,547,157265,Europe
New Zealand,11-02-2020,104806,580,867,103939,Western Pacific
Nicaragua,11-02-2020,261133,275,577,260556,Americas
Niger,11-02-2020,287969,393,271,287698,Africa
Nigeria,11-02-2020,268022,1415,555,267467,Africa
North Macedonia,11-02-2020,388037,2379,1144,386893,Europe
Norway,11-02-2020,245410,2421,459,244951,Europe
Oman,11-02-2020,106132,1907,266,105866,Eastern Mediterranean
Pakistan,11-02-2020,445849,1202,766,445083,Eastern Mediterranean
Panama,11-02-2020,431791,110,1158,430633,Americas
Papua New Guinea,11-02-2020,251366,645,491,250875,Western Pacific
Paraguay,11-02-2020,368268,501,492,367776,Americas
Peru,11-02-2020,111601,682,1042,110559,Americas
Philippines,11-02-2020,138895,803,989,137906,Western Pacific
Poland,11-02-2020,74361,368,523,73838,Europe
Portugal,11-02-2020,357568,1690,1106,356462,Europe
Qatar,11-02-2020,37161,1486,566,36595,Eastern Mediterranean
Romania,11-02-2020,294989,1834,561,294428,Europe
Russia,11-02-2020,430363,1083,1176,429187,Europe
Rwanda,11-02-2020,64930,1309,895,64035,Africa
Saint Lucia,11-02-2020,263990,1525,1019,262971,Americas
Saint Vincent and the Grenadines,11-02-2020,83583,1886,558,83025,Americas
San Marino,11-02-2020,174333,237,645,173688,Europe
Saudi Arabia,11-02-2020,274176,2163,136,274040,Eastern Mediterranean
Senegal,11-02-2020,311004,1895,721,310283,Africa
Serbia,11-02-2020,196983,2461,479,196504,Europe
Seychelles,11-02-2020,201099,2290,1126,199973,Africa
Singapore,11-02-2020,427077,1426,389,426688,Western Pacific
Slovakia,11-02-2020,182981,1846,369,182612,Europe
Slovenia,11-02-2020,120363,1617,527,119836,Europe
Somalia,11-02-2020,313224,786,586,312638,Eastern Mediterranean
South Africa,11-02-2020,359024,562,173,358851,Africa
Spain,11-02-2020,363605,1151,386,363219,Europe
Sri Lanka,11-02-2020,129682,600,930,128752,South-East Asia
Sudan,11-02-2020,445309,1950,1132,444177,Eastern Mediterranean
Suriname,11-02-2020,136083,1044,173,135910,Americas
Sweden,11-02-2020,343870,996,1129,342741,Europe
Switzerland,11-02-2020,382145,274,564,381581,Europe
Taiwan*,11-02-2020,194566,1750,965,193601,Western Pacific
Tanzania,11-02-2020,261871,2090,78,261793,Africa
Thailand,11-02-2020,2106,2387,649,1457,South-East Asia
Togo,11-02-2020,264473,825,1079,263394,Africa
Trinidad and Tobago,11-02-2020,78648,999,1143,77505,Americas
Tunisia,11-02-2020,228095,162,359,227736,Eastern Mediterranean
Turkey,11-02-2020,152259,22,892,151367,Europe
Uganda,11-02-2020,340940,949,26,340914,Africa
Ukraine,11-02-2020,188268,2037,6,188262,Europe
United Arab Emirates,11-02-2020,252246,509,689,251557,Eastern Mediterranean
United Kingdom,11-02-2020,267376,827,386,266990,Europe
United Kingdom,11-02-2020,18487,2421,684,17803,Europe
United Kingdom,11-02-2020,293353,2398,770,292583,Europe
United Kingdom,11-02-2020,162886,2009,438,162448,Europe
United Kingdom,11-02-2020,251233,2018,875,250358,Europe
United Kingdom,11-02-2020,61449,1282,467,60982,Europe
United Kingdom,11-02-2020,316799,2051,594,316205,Europe
Uruguay,11-02-2020,82362,2425,801,81561,Americas
US,11-02-2020,14156,462,1235,12921,Americas
Uzbekistan,11-02-2020,370157,2447,237,369920,Europe
Venezuela,11-02-2020,200420,348,195,200225,Americas
Vietnam,11-02-2020,228224,286,602,227622,Western Pacific
Zambia,11-02-2020,267067,2070,286,266781,Africa
Zimbabwe,11-02-2020,216066,2443,252,215814,Africa
Dominica,11-02-2020,364530,2295,563,363967,Americas
Grenada,11-02-2020,283586,1214,600,282986,Americas
Mozambique,11-02-2020,286951,1989,495,286456,Africa
Syria,11-02-2020,335827,795,1217,334610,Eastern Mediterranean
Timor-Leste,11-02-2020,113834,2368,679,113155,South-East Asia
Belize,11-02-2020,162343,392,232,162111,Americas
Laos,11-02-2020,246408,1532,177,246231,Western Pacific
Libya,11-02-2020,186165,1019,861,185304,Eastern Mediterranean
West Bank and Gaza,11-02-2020,152227,108,393,151834,Eastern Mediterranean
Guinea-Bissau,11-02-2020,158967,2373,617,158350,Africa
Mali,11-02-2020,224107,741,629,223478,Africa
Saint Kitts and Nevis,11-02-2020,99089,368,4,99085,Americas
Canada,11-02-2020,154607,338,1131,153476,Americas
Canada,11-02-2020,164017,504,742,163275,Americas
Kosovo,11-02-2020,289312,1490,1239,288073,Europe
Burma,11-02-2020,46255,504,780,45475,South-East Asia
United Kingdom,11-02-2020,77177,1700,1123,76054,Europe
United Kingdom,11-02-2020,114180,2436,1116,113064,Europe
United Kingdom,11-02-2020,253416,1524,324,253092,Europe
Botswana,11-02-2020,194960,952,48,194912,Africa
Burundi,11-02-2020,444956,1640,914,444042,Africa
Sierra Leone,11-02-2020,244264,536,1245,243019,Africa
Malawi,11-02-2020,396055,1342,570,395485,Africa
United Kingdom,11-02-2020,383801,2410,1045,382756,Europe
France,11-02-2020,386421,878,1055,385366,Europe
South Sudan,11-02-2020,33639,700,99,33540,Africa
Western Sahara,11-02-2020,154177,2061,367,153810,Africa
Sao Tome and Principe,11-02-2020,370447,1313,821,369626,Africa
Yemen,11-02-2020,176981,1969,846,176135,Eastern Mediterranean
Comoros,11-02-2020,146329,928,784,145545,Africa
Tajikistan,11-02-2020,203313,852,617,202696,Europe
Lesotho,11-02-2020,314585,504,1175,313410,Africa
Afghanistan,12-02-2020,234886,2193,236,234650,Eastern Mediterranean
Albania,12-02-2020,67386,88,690,66696,Europe
Algeria,12-02-2020,351705,852,91,351614,Africa
Andorra,12-02-2020,39790,1312,759,39031,Europe
Angola,12-02-2020,203097,1574,816,202281,Africa
Antigua and Barbuda,12-02-2020,426871,1780,1077,425794,Americas
Argentina,12-02-2020,417727,869,227,417500,Americas
Armenia,12-02-2020,50644,1743,1033,49611,Europe
Australia,12-02-2020,300353,1306,764,299589,Western Pacific
Australia,12-02-2020,429516,415,1187,428329,Western Pacific
Australia,12-02-2020,262124,1628,10,262114,Western Pacific
Australia,12-02-2020,130080,1250,209,129871,Western Pacific
Australia,12-02-2020,412601,1588,3,412598,Western Pacific
Australia,12-02-2020,253516,1687,1211,252305,Western Pacific
Australia,12-02-2020,192007,1612,387,191620,Western Pacific
Australia,12-02-2020,41881,1489,522,41359,Western Pacific
Austria,12-02-2020,145070,1793,436,144634,Europe
Azerbaijan,12-02-2020,68526,1326,511,68015,Europe
Bahamas,12-02-2020,207871,2017,969,206902,Americas
Bahrain,12-02-2020,265925,1730,148,265777,Eastern Mediterranean
Bangladesh,12-02-2020,398442,1858,410,398032,South-East Asia
Barbados,12-02-2020,136675,542,352,136323,Americas
Belarus,12-02-2020,138053,677,970,137083,Europe
Belgium,12-02-2020,291881,1310,70,291811,Europe
Benin,12-02-2020,239697,2214,545,239152,Africa
Bhutan,12-02-2020,17187,1144,861,16326,South-East Asia
Bolivia,12-02-2020,31337,2354,629,30708,Americas
Bosnia and Herzegovina,12-02-2020,20413,981,545,19868,Europe
Brazil,12-02-2020,204565,2007,98,204467,Americas
Brunei,12-02-2020,347090,2271,668,346422,Western Pacific
Bulgaria,12-02-2020,67701,889,369,67332,Europe
Burkina Faso,12-02-2020,192720,1299,164,192556,Africa
Cabo Verde,12-02-2020,9014,280,709,8305,Africa
Cambodia,12-02-2020,14894,486,255,14639,Western Pacific
Cameroon,12-02-2020,252013,1619,94,251919,Africa
Canada,12-02-2020,295030,2281,1237,293793,Americas
Canada,12-02-2020,234402,1404,1171,233231,Americas
Canada,12-02-2020,213120,1226,755,212365,Americas
Canada,12-02-2020,240650,1101,742,239908,Americas
Canada,12-02-2020,435336,816,339,434997,Americas
Canada,12-02-2020,435664,2286,420,435244,Americas
Canada,12-02-2020,99537,1496,1094,98443,Americas
Canada,12-02-2020,441703,693,1202,440501,Americas
Canada,12-02-2020,369926,1011,301,369625,Americas
Canada,12-02-2020,166624,676,393,166231,Americas
Central African Republic,12-02-2020,62936,1470,530,62406,Africa
Chad,12-02-2020,122836,313,1171,121665,Africa
Chile,12-02-2020,69886,181,56,69830,Americas
China,12-02-2020,289339,593,1205,288134,Western Pacific
China,12-02-2020,259956,2121,313,259643,Western Pacific
China,12-02-2020,11669,832,361,11308,Western Pacific
China,12-02-2020,24978,676,599,24379,Western Pacific
China,12-02-2020,251079,2355,491,250588,Western Pacific
China,12-02-2020,171954,1727,9,171945,Western Pacific
China,12-02-2020,3319,2156,1162,2157,Western Pacific
China,12-02-2020,442260,1033,1004,441256,Western Pacific
China,12-02-2020,130987,607,61,130926,Western Pacific
China,12-02-2020,141719,2365,800,140919,Western Pacific
China,12-02-2020,93233,2054,240,92993,Western Pacific
China,12-02-2020,55271,2352,1191,54080,Western Pacific
China,12-02-2020,330372,2401,1008,329364,Western Pacific
China,12-02-2020,152435,2226,720,151715,Western Pacific
China,12-02-2020,151836,1715,326,151510,Western Pacific
China,12-02-2020,304909,1868,1190,303719,Western Pacific
China,12-02-2020,150949,1221,252,150697,Western Pacific
China,12-02-2020,321127,224,1003,320124,Western Pacific
China,12-02-2020,94692,2443,1099,93593,Western Pacific
China,12-02-2020,338529,725,552,337977,Western Pacific
China,12-02-2020,419585,273,247,419338,Western Pacific
China,12-02-2020,319221,851,223,318998,Western Pacific
China,12-02-2020,241866,1434,33,241833,Western Pacific
China,12-02-2020,150441,872,593,149848,Western Pacific
China,12-02-2020,152201,498,641,151560,Western Pacific
China,12-02-2020,144990,1886,924,144066,Western Pacific
China,12-02-2020,422967,519,1164,421803,Western Pacific
China,12-02-2020,151378,1434,1159,150219,Western Pacific
China,12-02-2020,341998,39,384,341614,Western Pacific
China,12-02-2020,377791,760,517,377274,Western Pacific
China,12-02-2020,332434,777,1,332433,Western Pacific
China,12-02-2020,366071,1851,1221,364850,Western Pacific
China,12-02-2020,342861,1977,1132,341729,Western Pacific
Colombia,12-02-2020,299569,2118,196,299373,Americas
Congo (Brazzaville),12-02-2020,377612,385,1086,376526,Africa
Congo (Kinshasa),12-02-2020,295224,475,1123,294101,Africa
Costa Rica,12-02-2020,127756,305,726,127030,Americas
Cote d'Ivoire,12-02-2020,69611,2445,1190,68421,Africa
Croatia,12-02-2020,449982,375,954,449028,Europe
Cuba,12-02-2020,387879,112,1236,386643,Americas
Cyprus,12-02-2020,161158,2339,833,160325,Europe
Czechia,12-02-2020,257553,928,417,257136,Europe
Denmark,12-02-2020,357649,338,332,357317,Europe
Greenland,12-02-2020,40063,1544,886,39177,Europe
Denmark,12-02-2020,62253,867,1147,61106,Europe
Djibouti,12-02-2020,140203,1869,106,140097,Eastern Mediterranean
Dominican Republic,12-02-2020,348674,1684,940,347734,Americas
Ecuador,12-02-2020,139705,1735,553,139152,Americas
Egypt,12-02-2020,303271,2090,204,303067,Eastern Mediterranean
El Salvador,12-02-2020,236776,1832,1039,235737,Americas
Equatorial Guinea,12-02-2020,176569,1683,764,175805,Africa
Eritrea,12-02-2020,299078,1156,1210,297868,Africa
Estonia,12-02-2020,339693,1,944,338749,Europe
Eswatini,12-02-2020,382055,1641,453,381602,Africa
Ethiopia,12-02-2020,320793,2113,112,320681,Africa
Fiji,12-02-2020,80976,2497,944,80032,Western Pacific
Finland,12-02-2020,83447,914,417,83030,Europe
France,12-02-2020,384275,828,418,383857,Europe
France,12-02-2020,343621,1736,81,343540,Europe
France,12-02-2020,36518,304,310,36208,Europe
France,12-02-2020,237880,833,901,236979,Europe
France,12-02-2020,191408,406,307,191101,Europe
France,12-02-2020,444420,1228,971,443449,Europe
France,12-02-2020,12797,1507,742,12055,Europe
France,12-02-2020,153252,984,1239,152013,Europe
France,12-02-2020,429409,1575,1037,428372,Europe
France,12-02-2020,307326,599,1009,306317,Europe
Gabon,12-02-2020,279075,2096,323,278752,Africa
Gambia,12-02-2020,280443,472,204,280239,Africa
Georgia,12-02-2020,380547,435,31,380516,Europe
Germany,12-02-2020,299876,2352,797,299079,Europe
Ghana,12-02-2020,6446,1370,157,6289,Africa
Greece,12-02-2020,32175,388,134,32041,Europe
Guatemala,12-02-2020,285126,2370,865,284261,Americas
Guinea,12-02-2020,327609,2096,218,327391,Africa
Guyana,12-02-2020,288731,1463,1069,287662,Americas
Haiti,12-02-2020,324852,378,1157,323695,Americas
Holy See,12-02-2020,197242,1228,471,196771,Europe
Honduras,12-02-2020,333407,1362,412,332995,Americas
Hungary,12-02-2020,415818,1067,50,415768,Europe
Iceland,12-02-2020,254114,1061,330,253784,Europe
India,12-02-2020,402542,2266,135,402407,South-East Asia
Indonesia,12-02-2020,324984,706,567,324417,South-East Asia
Iran,12-02-2020,124502,662,677,123825,Eastern Mediterranean
Iraq,12-02-2020,12246,1488,188,12058,Eastern Mediterranean
Ireland,12-02-2020,87493,1603,740,86753,Europe
Israel,12-02-2020,48454,2054,171,48283,Europe
Italy,12-02-2020,144767,2139,541,144226,Europe
Jamaica,12-02-2020,197947,1046,1168,196779,Americas
Japan,12-02-2020,375655,992,544,375111,Western Pacific
Jordan,12-02-2020,388297,757,434,387863,Eastern Mediterranean
Kazakhstan,12-02-2020,69725,202,559,69166,Europe
Kenya,12-02-2020,402509,1948,790,401719,Africa
South Korea,12-02-2020,9025,2211,1174,7851,Western Pacific
Kuwait,12-02-2020,418350,242,319,418031,Eastern Mediterranean
Kyrgyzstan,12-02-2020,316907,375,864,316043,Europe
Latvia,12-02-2020,444333,7,854,443479,Europe
Lebanon,12-02-2020,377106,2458,268,376838,Eastern Mediterranean
Liberia,12-02-2020,151726,118,329,151397,Africa
Liechtenstein,12-02-2020,289601,1750,516,289085,Europe
Lithuania,12-02-2020,4038,932,1124,2914,Europe
Luxembourg,12-02-2020,25095,1188,900,24195,Europe
Madagascar,12-02-2020,385735,1983,65,385670,Africa
Malaysia,12-02-2020,82706,1376,637,82069,Western Pacific
Maldives,12-02-2020,213619,346,1004,212615,South-East Asia
Malta,12-02-2020,88572,1530,1020,87552,Europe
Mauritania,12-02-2020,14182,273,1011,13171,Africa
Mauritius,12-02-2020,31380,1927,1156,30224,Africa
Mexico,12-02-2020,408702,1463,917,407785,Americas
Moldova,12-02-2020,302570,1683,703,301867,Europe
Monaco,12-02-2020,199021,553,792,198229,Europe
Mongolia,12-02-2020,336409,1910,804,335605,Western Pacific
Montenegro,12-02-2020,123522,1819,160,123362,Europe
Morocco,12-02-2020,240797,1222,211,240586,Eastern Mediterranean
Namibia,12-02-2020,234875,1620,232,234643,Africa
Nepal,12-02-2020,208529,2245,1099,207430,South-East Asia
Netherlands,12-02-2020,312264,2026,525,311739,Europe
Netherlands,12-02-2020,237098,2271,822,236276,Europe
Netherlands,12-02-2020,444947,2455,736,444211,Europe
Netherlands,12-02-2020,397253,1858,554,396699,Europe
New Zealand,12-02-2020,429986,2332,103,429883,Western Pacific
Nicaragua,12-02-2020,81141,128,230,80911,Americas
Niger,12-02-2020,307182,1877,1036,306146,Africa
Nigeria,12-02-2020,275156,986,765,274391,Africa
North Macedonia,12-02-2020,276357,1275,142,276215,Europe
Norway,12-02-2020,330338,2388,418,329920,Europe
Oman,12-02-2020,191242,432,225,191017,Eastern Mediterranean
Pakistan,12-02-2020,368480,2103,324,368156,Eastern Mediterranean
Panama,12-02-2020,416674,1624,1093,415581,Americas
Papua New Guinea,12-02-2020,301359,976,461,300898,Western Pacific
Paraguay,12-02-2020,47411,1405,641,46770,Americas
Peru,12-02-2020,113696,1829,1007,112689,Americas
Philippines,12-02-2020,165429,856,232,165197,Western Pacific
Poland,12-02-2020,309813,170,829,308984,Europe
Portugal,12-02-2020,84353,2273,683,83670,Europe
Qatar,12-02-2020,146711,250,51,146660,Eastern Mediterranean
Romania,12-02-2020,286325,236,496,285829,Europe
Russia,12-02-2020,117160,1414,281,116879,Europe
Rwanda,12-02-2020,438240,1738,1006,437234,Africa
Saint Lucia,12-02-2020,238459,444,1132,237327,Americas
Saint Vincent and the Grenadines,12-02-2020,405979,1207,671,405308,Americas
San Marino,12-02-2020,193259,2296,890,192369,Europe
Saudi Arabia,12-02-2020,29504,2302,648,28856,Eastern Mediterranean
Senegal,12-02-2020,219048,301,897,218151,Africa
Serbia,12-02-2020,151206,1983,1125,150081,Europe
Seychelles,12-02-2020,436771,1306,87,436684,Africa
Singapore,12-02-2020,231552,479,517,231035,Western Pacific
Slovakia,12-02-2020,378568,1778,609,377959,Europe
Slovenia,12-02-2020,377954,1918,1142,376812,Europe
Somalia,12-02-2020,124725,187,998,123727,Eastern Mediterranean
South Africa,12-02-2020,354829,646,1249,353580,Africa
Spain,12-02-2020,434979,171,653,434326,Europe
Sri Lanka,12-02-2020,42764,1143,679,42085,South-East Asia
Sudan,12-02-2020,144590,299,884,143706,Eastern Mediterranean
Suriname,12-02-2020,191893,691,1181,190712,Americas
Sweden,12-02-2020,168563,1268,614,167949,Europe
Switzerland,12-02-2020,371847,283,702,371145,Europe
Taiwan*,12-02-2020,85000,29,1053,83947,Western Pacific
Tanzania,12-02-2020,252043,1243,661,251382,Africa
Thailand,12-02-2020,114244,808,450,113794,South-East Asia
Togo,12-02-2020,406202,476,33,406169,Africa
Trinidad and Tobago,12-02-2020,435821,2303,498,435323,Americas
Tunisia,12-02-2020,75806,1546,515,75291,Eastern Mediterranean
Turkey,12-02-2020,437054,750,108,436946,Europe
Uganda,12-02-2020,325535,1372,1129,324406,Africa
Ukraine,12-02-2020,102927,1758,804,102123,Europe
United Arab Emirates,12-02-2020,282461,2298,7,282454,Eastern Mediterranean
United Kingdom,12-02-2020,55209,337,563,54646,Europe
United Kingdom,12-02-2020,251312,1981,779,250533,Europe
United Kingdom,12-02-2020,246264,1051,616,245648,Europe
United Kingdom,12-02-2020,362739,550,1,362738,Europe
United Kingdom,12-02-2020,256843,1307,459,256384,Europe
United Kingdom,12-02-2020,430784,1309,468,430316,Europe
United Kingdom,12-02-2020,91907,658,517,91390,Europe
Uruguay,12-02-2020,273316,2203,1085,272231,Americas
US,12-02-2020,256041,137,873,255168,Americas
Uzbekistan,12-02-2020,332658,152,687,331971,Europe
Venezuela,12-02-2020,49891,2087,372,49519,Americas
Vietnam,12-02-2020,386481,3,673,385808,Western Pacific
Zambia,12-02-2020,240603,1467,617,239986,Africa
Zimbabwe,12-02-2020,292720,551,726,291994,Africa
Dominica,12-02-2020,239100,625,219,238881,Americas
Grenada,12-02-2020,430591,1630,754,429837,Americas
Mozambique,12-02-2020,428374,757,170,428204,Africa
Syria,12-02-2020,288228,470,1242,286986,Eastern Mediterranean
Timor-Leste,12-02-2020,49181,593,701,48480,South-East Asia
Belize,12-02-2020,445849,1989,280,445569,Americas
Laos,12-02-2020,271418,1725,92,271326,Western Pacific
Libya,12-02-2020,23524,1750,674,22850,Eastern Mediterranean
West Bank and Gaza,12-02-2020,352669,1944,1242,351427,Eastern Mediterranean
Guinea-Bissau,12-02-2020,376089,130,44,376045,Africa
Mali,12-02-2020,160675,1691,339,160336,Africa
Saint Kitts and Nevis,12-02-2020,362250,2392,979,361271,Americas
Canada,12-02-2020,320238,833,1164,319074,Americas
Canada,12-02-2020,28885,2478,594,28291,Americas
Kosovo,12-02-2020,423027,951,772,422255,Europe
Burma,12-02-2020,244556,88,447,244109,South-East Asia
United Kingdom,12-02-2020,261350,142,206,261144,Europe
United Kingdom,12-02-2020,196560,1537,1243,195317,Europe
United Kingdom,12-02-2020,99,1492,885,-786,Europe
Botswana,12-02-2020,259054,1643,200,258854,Africa
Burundi,12-02-2020,216922,1461,609,216313,Africa
Sierra Leone,12-02-2020,417497,63,429,417068,Africa
Malawi,12-02-2020,413095,2404,182,412913,Africa
United Kingdom,12-02-2020,299847,2350,921,298926,Europe
France,12-02-2020,241549,173,1065,240484,Europe
South Sudan,12-02-2020,241850,1594,300,241550,Africa
Western Sahara,12-02-2020,218776,2362,42,218734,Africa
Sao Tome and Principe,12-02-2020,251927,1301,543,251384,Africa
Yemen,12-02-2020,324067,2359,940,323127,Eastern Mediterranean
Comoros,12-02-2020,22324,426,41,22283,Africa
Tajikistan,12-02-2020,254482,1649,22,254460,Europe
Lesotho,12-02-2020,431589,1527,932,430657,Africa
Afghanistan,13-02-2020,193838,1003,383,193455,Eastern Mediterranean
Albania,13-02-2020,429570,160,749,428821,Europe
Algeria,13-02-2020,56642,630,912,55730,Africa
Andorra,13-02-2020,195596,940,62,195534,Europe
Angola,13-02-2020,243588,871,714,242874,Africa
Antigua and Barbuda,13-02-2020,213235,259,1140,212095,Americas
Argentina,13-02-2020,378205,1462,257,377948,Americas
Armenia,13-02-2020,115945,119,189,115756,Europe
Australia,13-02-2020,314638,2001,119,314519,Western Pacific
Australia,13-02-2020,330517,900,902,329615,Western Pacific
Australia,13-02-2020,368507,179,13,368494,Western Pacific
Australia,13-02-2020,320167,1687,1044,319123,Western Pacific
Australia,13-02-2020,370950,2175,394,370556,Western Pacific
Australia,13-02-2020,196868,348,1172,195696,Western Pacific
Australia,13-02-2020,206121,1902,1090,205031,Western Pacific
Australia,13-02-2020,240742,1329,119,240623,Western Pacific
Austria,13-02-2020,272452,2487,991,271461,Europe
Azerbaijan,13-02-2020,25960,945,426,25534,Europe
Bahamas,13-02-2020,250883,1666,247,250636,Americas
Bahrain,13-02-2020,378237,2498,179,378058,Eastern Mediterranean
Bangladesh,13-02-2020,448795,58,98,448697,South-East Asia
Barbados,13-02-2020,311833,945,596,311237,Americas
Belarus,13-02-2020,413289,1628,471,412818,Europe
Belgium,13-02-2020,362076,2270,814,361262,Europe
Benin,13-02-2020,447443,2335,1002,446441,Africa
Bhutan,13-02-2020,25987,128,733,25254,South-East Asia
Bolivia,13-02-2020,226722,1367,1098,225624,Americas
Bosnia and Herzegovina,13-02-2020,402609,1383,933,401676,Europe
Brazil,13-02-2020,281227,2067,903,280324,Americas
Brunei,13-02-2020,393726,1535,637,393089,Western Pacific
Bulgaria,13-02-2020,63970,2224,170,63800,Europe
Burkina Faso,13-02-2020,106792,33,489,106303,Africa
Cabo Verde,13-02-2020,150551,2123,1064,149487,Africa
Cambodia,13-02-2020,378,1520,668,-290,Western Pacific
Cameroon,13-02-2020,396009,1188,8,396001,Africa
Canada,13-02-2020,283284,1538,584,282700,Americas
Canada,13-02-2020,103788,1581,980,102808,Americas
Canada,13-02-2020,42215,1970,112,42103,Americas
Canada,13-02-2020,322035,733,183,321852,Americas
Canada,13-02-2020,300275,1421,379,299896,Americas
Canada,13-02-2020,327051,734,1098,325953,Americas
Canada,13-02-2020,73529,1333,924,72605,Americas
Canada,13-02-2020,420183,2021,343,419840,Americas
Canada,13-02-2020,427923,1316,587,427336,Americas
Canada,13-02-2020,410155,813,73,410082,Americas
Central African Republic,13-02-2020,313793,288,758,313035,Africa
Chad,13-02-2020,343777,315,1147,342630,Africa
Chile,13-02-2020,328746,440,19,328727,Americas
China,13-02-2020,252411,1127,130,252281,Western Pacific
China,13-02-2020,251975,1334,322,251653,Western Pacific
China,13-02-2020,206913,2017,1232,205681,Western Pacific
China,13-02-2020,146743,2060,979,145764,Western Pacific
China,13-02-2020,69083,1313,909,68174,Western Pacific
China,13-02-2020,406093,1300,421,405672,Western Pacific
China,13-02-2020,129775,2033,535,129240,Western Pacific
China,13-02-2020,447775,1445,222,447553,Western Pacific
China,13-02-2020,198378,1212,1008,197370,Western Pacific
China,13-02-2020,254406,650,909,253497,Western Pacific
China,13-02-2020,204526,1700,1019,203507,Western Pacific
China,13-02-2020,176423,1454,11,176412,Western Pacific
China,13-02-2020,374483,14,948,373535,Western Pacific
China,13-02-2020,382709,471,923,381786,Western Pacific
China,13-02-2020,341733,366,1091,340642,Western Pacific
China,13-02-2020,172916,978,424,172492,Western Pacific
China,13-02-2020,429545,1046,553,428992,Western Pacific
China,13-02-2020,28833,1180,673,28160,Western Pacific
China,13-02-2020,16111,2246,312,15799,Western Pacific
China,13-02-2020,93607,1789,932,92675,Western Pacific
China,13-02-2020,195517,1313,971,194546,Western Pacific
China,13-02-2020,272219,1292,1204,271015,Western Pacific
China,13-02-2020,180329,1935,8,180321,Western Pacific
China,13-02-2020,359386,1413,797,358589,Western Pacific
China,13-02-2020,276973,1435,837,276136,Western Pacific
China,13-02-2020,135570,2013,1018,134552,Western Pacific
China,13-02-2020,143531,2427,1142,142389,Western Pacific
China,13-02-2020,447932,1085,697,447235,Western Pacific
China,13-02-2020,60485,1132,734,59751,Western Pacific
China,13-02-2020,109723,2164,755,108968,Western Pacific
China,13-02-2020,406489,2275,1033,405456,Western Pacific
China,13-02-2020,418243,685,799,417444,Western Pacific
China,13-02-2020,347767,1171,1066,346701,Western Pacific
Colombia,13-02-2020,48737,14,167,48570,Americas
Congo (Brazzaville),13-02-2020,20963,1468,65,20898,Africa
Congo (Kinshasa),13-02-2020,393059,2213,356,392703,Africa
Costa Rica,13-02-2020,390115,960,766,389349,Americas
Cote d'Ivoire,13-02-2020,440459,1227,1204,439255,Africa
Croatia,13-02-2020,199054,1269,250,198804,Europe
Cuba,13-02-2020,201470,830,1196,200274,Americas
Cyprus,13-02-2020,155206,241,265,154941,Europe
Czechia,13-02-2020,258339,2431,509,257830,Europe
Denmark,13-02-2020,298325,1956,370,297955,Europe
Greenland,13-02-2020,236826,2466,999,235827,Europe
Denmark,13-02-2020,319070,307,108,318962,Europe
Djibouti,13-02-2020,119743,2231,148,119595,Eastern Mediterranean
Dominican Republic,13-02-2020,90306,546,914,89392,Americas
Ecuador,13-02-2020,272748,1390,483,272265,Americas
Egypt,13-02-2020,26250,540,661,25589,Eastern Mediterranean
El Salvador,13-02-2020,248511,1237,998,247513,Americas
Equatorial Guinea,13-02-2020,86159,329,324,85835,Africa
Eritrea,13-02-2020,179307,1996,590,178717,Africa
Estonia,13-02-2020,163244,497,32,163212,Europe
Eswatini,13-02-2020,183464,1757,11,183453,Africa
Ethiopia,13-02-2020,384420,1150,566,383854,Africa
Fiji,13-02-2020,17434,2206,354,17080,Western Pacific
Finland,13-02-2020,136142,654,972,135170,Europe
France,13-02-2020,396567,907,146,396421,Europe
France,13-02-2020,318973,712,1078,317895,Europe
France,13-02-2020,8996,1769,1017,7979,Europe
France,13-02-2020,221971,1046,752,221219,Europe
France,13-02-2020,220006,409,1057,218949,Europe
France,13-02-2020,97482,117,233,97249,Europe
France,13-02-2020,134496,1370,513,133983,Europe
France,13-02-2020,10009,1597,759,9250,Europe
France,13-02-2020,1737,348,607,1130,Europe
France,13-02-2020,199422,2316,38,199384,Europe
Gabon,13-02-2020,283684,489,164,283520,Africa
Gambia,13-02-2020,42797,1569,244,42553,Africa
Georgia,13-02-2020,371766,260,119,371647,Europe
Germany,13-02-2020,133135,1629,230,132905,Europe
Ghana,13-02-2020,62050,392,1091,60959,Africa
Greece,13-02-2020,220473,1210,718,219755,Europe
Guatemala,13-02-2020,9299,650,1003,8296,Americas
Guinea,13-02-2020,231123,1426,424,230699,Africa
Guyana,13-02-2020,157484,1834,831,156653,Americas
Haiti,13-02-2020,398513,131,965,397548,Americas
Holy See,13-02-2020,404439,2073,782,403657,Europe
Honduras,13-02-2020,370204,2001,1195,369009,Americas
Hungary,13-02-2020,246368,784,70,246298,Europe
Iceland,13-02-2020,405300,1848,909,404391,Europe
India,13-02-2020,418195,1411,646,417549,South-East Asia
Indonesia,13-02-2020,43376,1997,649,42727,South-East Asia
Iran,13-02-2020,176542,1868,266,176276,Eastern Mediterranean
Iraq,13-02-2020,92531,1882,376,92155,Eastern Mediterranean
Ireland,13-02-2020,424772,735,681,424091,Europe
Israel,13-02-2020,171605,1430,358,171247,Europe
Italy,13-02-2020,307673,1835,1057,306616,Europe
Jamaica,13-02-2020,208916,357,480,208436,Americas
Japan,13-02-2020,421730,1751,1131,420599,Western Pacific
Jordan,13-02-2020,336301,844,262,336039,Eastern Mediterranean
Kazakhstan,13-02-2020,99207,1955,381,98826,Europe
Kenya,13-02-2020,288429,2462,518,287911,Africa
South Korea,13-02-2020,420560,689,573,419987,Western Pacific
Kuwait,13-02-2020,220464,2440,268,220196,Eastern Mediterranean
Kyrgyzstan,13-02-2020,233207,2290,48,233159,Europe
Latvia,13-02-2020,334277,1811,110,334167,Europe
Lebanon,13-02-2020,38108,698,635,37473,Eastern Mediterranean
Liberia,13-02-2020,212412,1388,300,212112,Africa
Liechtenstein,13-02-2020,94772,1738,499,94273,Europe
Lithuania,13-02-2020,357354,902,1020,356334,Europe
Luxembourg,13-02-2020,197636,2315,477,197159,Europe
Madagascar,13-02-2020,91469,1450,82,91387,Africa
Malaysia,13-02-2020,177413,591,547,176866,Western Pacific
Maldives,13-02-2020,266024,2210,796,265228,South-East Asia
Malta,13-02-2020,387177,1890,1044,386133,Europe
Mauritania,13-02-2020,360012,1015,168,359844,Africa
Mauritius,13-02-2020,363435,2445,519,362916,Africa
Mexico,13-02-2020,16235,963,808,15427,Americas
Moldova,13-02-2020,429302,1913,161,429141,Europe
Monaco,13-02-2020,8132,983,766,7366,Europe
Mongolia,13-02-2020,20424,573,819,19605,Western Pacific
Montenegro,13-02-2020,206577,2194,334,206243,Europe
Morocco,13-02-2020,353884,1705,21,353863,Eastern Mediterranean
Namibia,13-02-2020,177640,250,229,177411,Africa
Nepal,13-02-2020,337797,654,621,337176,South-East Asia
Netherlands,13-02-2020,326768,984,412,326356,Europe
Netherlands,13-02-2020,76882,235,506,76376,Europe
Netherlands,13-02-2020,415613,2437,131,415482,Europe
Netherlands,13-02-2020,241152,840,82,241070,Europe
New Zealand,13-02-2020,122270,46,1036,121234,Western Pacific
Nicaragua,13-02-2020,361888,999,342,361546,Americas
Niger,13-02-2020,381068,2173,505,380563,Africa
Nigeria,13-02-2020,294133,2385,416,293717,Africa
North Macedonia,13-02-2020,341241,916,224,341017,Europe
Norway,13-02-2020,142758,1218,1021,141737,Europe
Oman,13-02-2020,144702,1906,1072,143630,Eastern Mediterranean
Pakistan,13-02-2020,392713,1389,554,392159,Eastern Mediterranean
Panama,13-02-2020,77527,598,775,76752,Americas
Papua New Guinea,13-02-2020,317523,1749,351,317172,Western Pacific
Paraguay,13-02-2020,408797,1272,1080,407717,Americas
Peru,13-02-2020,32678,1628,1134,31544,Americas
Philippines,13-02-2020,338456,657,1021,337435,Western Pacific
Poland,13-02-2020,228331,406,479,227852,Europe
Portugal,13-02-2020,208803,1934,1014,207789,Europe
Qatar,13-02-2020,295665,1240,254,295411,Eastern Mediterranean
Romania,13-02-2020,106877,1939,963,105914,Europe
Russia,13-02-2020,182531,1356,238,182293,Europe
Rwanda,13-02-2020,1648,1949,644,1004,Africa
Saint Lucia,13-02-2020,179158,1672,294,178864,Americas
Saint Vincent and the Grenadines,13-02-2020,273755,2162,261,273494,Americas
San Marino,13-02-2020,235571,2478,8,235563,Europe
Saudi Arabia,13-02-2020,332277,1105,786,331491,Eastern Mediterranean
Senegal,13-02-2020,19582,265,391,19191,Africa
Serbia,13-02-2020,362444,2299,864,361580,Europe
Seychelles,13-02-2020,79865,2096,663,79202,Africa
Singapore,13-02-2020,298609,410,1098,297511,Western Pacific
Slovakia,13-02-2020,427713,366,1197,426516,Europe
Slovenia,13-02-2020,363565,1595,281,363284,Europe
Somalia,13-02-2020,77795,1263,462,77333,Eastern Mediterranean
South Africa,13-02-2020,74315,5,122,74193,Africa
Spain,13-02-2020,303725,2398,206,303519,Europe
Sri Lanka,13-02-2020,52922,1404,887,52035,South-East Asia
Sudan,13-02-2020,97575,2195,978,96597,Eastern Mediterranean
Suriname,13-02-2020,412590,1239,961,411629,Americas
Sweden,13-02-2020,422467,186,67,422400,Europe
Switzerland,13-02-2020,380201,1142,956,379245,Europe
Taiwan*,13-02-2020,377032,1631,1210,375822,Western Pacific
Tanzania,13-02-2020,65967,240,1053,64914,Africa
Thailand,13-02-2020,375880,1578,342,375538,South-East Asia
Togo,13-02-2020,123469,49,552,122917,Africa
Trinidad and Tobago,13-02-2020,154267,1630,1091,153176,Americas
Tunisia,13-02-2020,84505,275,53,84452,Eastern Mediterranean
Turkey,13-02-2020,260013,135,118,259895,Europe
Uganda,13-02-2020,274155,2331,648,273507,Africa
Ukraine,13-02-2020,323651,1934,650,323001,Europe
United Arab Emirates,13-02-2020,100753,2386,200,100553,Eastern Mediterranean
United Kingdom,13-02-2020,252400,333,750,251650,Europe
United Kingdom,13-02-2020,137287,1726,537,136750,Europe
United Kingdom,13-02-2020,218299,158,630,217669,Europe
United Kingdom,13-02-2020,64445,2097,611,63834,Europe
United Kingdom,13-02-2020,47609,1440,711,46898,Europe
United Kingdom,13-02-2020,76096,850,58,76038,Europe
United Kingdom,13-02-2020,220697,1036,1224,219473,Europe
Uruguay,13-02-2020,167434,493,33,167401,Americas
US,13-02-2020,129345,964,654,128691,Americas
Uzbekistan,13-02-2020,212083,1336,956,211127,Europe
Venezuela,13-02-2020,205017,2205,419,204598,Americas
Vietnam,13-02-2020,271446,2051,342,271104,Western Pacific
Zambia,13-02-2020,359614,2034,949,358665,Africa
Zimbabwe,13-02-2020,200013,2329,28,199985,Africa
Dominica,13-02-2020,150321,725,159,150162,Americas
Grenada,13-02-2020,448901,1238,108,448793,Americas
Mozambique,13-02-2020,65026,491,18,65008,Africa
Syria,13-02-2020,150640,1431,998,149642,Eastern Mediterranean
Timor-Leste,13-02-2020,389851,156,1141,388710,South-East Asia
Belize,13-02-2020,333936,2428,124,333812,Americas
Laos,13-02-2020,77664,202,174,77490,Western Pacific
Libya,13-02-2020,396219,644,211,396008,Eastern Mediterranean
West Bank and Gaza,13-02-2020,390244,2284,373,389871,Eastern Mediterranean
Guinea-Bissau,13-02-2020,282258,1014,597,281661,Africa
Mali,13-02-2020,448921,1057,493,448428,Africa
Saint Kitts and Nevis,13-02-2020,258329,1405,985,257344,Americas
Canada,13-02-2020,12650,1334,733,11917,Americas
Canada,13-02-2020,13991,1188,637,13354,Americas
Kosovo,13-02-2020,267718,1374,775,266943,Europe
Burma,13-02-2020,387052,2470,159,386893,South-East Asia
United Kingdom,13-02-2020,350253,294,709,349544,Europe
United Kingdom,13-02-2020,14622,1114,257,14365,Europe
United Kingdom,13-02-2020,306548,858,239,306309,Europe
Botswana,13-02-2020,384034,1849,136,383898,Africa
Burundi,13-02-2020,95492,297,748,94744,Africa
Sierra Leone,13-02-2020,365930,2297,762,365168,Africa
Malawi,13-02-2020,124067,1025,194,123873,Africa
United Kingdom,13-02-2020,356377,2,244,356133,Europe
France,13-02-2020,135953,938,1053,134900,Europe
South Sudan,13-02-2020,224024,1729,1177,222847,Africa
Western Sahara,13-02-2020,15421,1292,909,14512,Africa
Sao Tome and Principe,13-02-2020,307503,1183,198,307305,Africa
Yemen,13-02-2020,216154,2424,954,215200,Eastern Mediterranean
Comoros,13-02-2020,138897,1175,188,138709,Africa
Tajikistan,13-02-2020,57560,276,441,57119,Europe
Lesotho,13-02-2020,268819,1091,971,267848,Africa
Afghanistan,14-02-2020,346306,65,419,345887,Eastern Mediterranean
Albania,14-02-2020,273810,881,326,273484,Europe
Algeria,14-02-2020,288909,220,217,288692,Africa
Andorra,14-02-2020,237042,2007,176,236866,Europe
Angola,14-02-2020,51083,1025,121,50962,Africa
Antigua and Barbuda,14-02-2020,214639,1430,608,214031,Americas
Argentina,14-02-2020,261729,2190,84,261645,Americas
Armenia,14-02-2020,395454,79,690,394764,Europe
Australia,14-02-2020,160205,249,1216,158989,Western Pacific
Australia,14-02-2020,358709,2227,939,357770,Western Pacific
Australia,14-02-2020,420132,1416,578,419554,Western Pacific
Australia,14-02-2020,220598,549,245,220353,Western Pacific
Australia,14-02-2020,255492,190,947,254545,Western Pacific
Australia,14-02-2020,160642,1913,1090,159552,Western Pacific
Australia,14-02-2020,342451,1577,449,342002,Western Pacific
Australia,14-02-2020,158969,2392,528,158441,Western Pacific
Austria,14-02-2020,191293,1244,292,191001,Europe
Azerbaijan,14-02-2020,402914,2048,150,402764,Europe
Bahamas,14-02-2020,248327,2467,729,247598,Americas
Bahrain,14-02-2020,43943,361,1132,42811,Eastern Mediterranean
Bangladesh,14-02-2020,426521,290,201,426320,South-East Asia
Barbados,14-02-2020,384597,1832,346,384251,Americas
Belarus,14-02-2020,162516,2290,822,161694,Europe
Belgium,14-02-2020,210444,52,894,209550,Europe
Benin,14-02-2020,141963,769,1093,140870,Africa
Bhutan,14-02-2020,282588,2347,730,281858,South-East Asia
Bolivia,14-02-2020,144725,1791,797,143928,Americas
Bosnia and Herzegovina,14-02-2020,19764,2355,192,19572,Europe
Brazil,14-02-2020,72730,1393,460,72270,Americas
Brunei,14-02-2020,78074,486,910,77164,Western Pacific
Bulgaria,14-02-2020,352314,1219,80,352234,Europe
Burkina Faso,14-02-2020,157530,20,301,157229,Africa
Cabo Verde,14-02-2020,407235,1316,1049,406186,Africa
Cambodia,14-02-2020,83466,1315,718,82748,Western Pacific
Cameroon,14-02-2020,80097,2246,1014,79083,Africa
Canada,14-02-2020,153254,579,614,152640,Americas
Canada,14-02-2020,34419,2246,128,34291,Americas
Canada,14-02-2020,97804,1635,669,97135,Americas
Canada,14-02-2020,320780,533,498,320282,Americas
Canada,14-02-2020,329813,1094,552,329261,Americas
Canada,14-02-2020,341723,2367,123,341600,Americas
Canada,14-02-2020,367410,675,664,366746,Americas
Canada,14-02-2020,172581,2260,19,172562,Americas
Canada,14-02-2020,193776,1409,976,192800,Americas
Canada,14-02-2020,62508,813,364,62144,Americas
Central African Republic,14-02-2020,120341,1178,204,120137,Africa
Chad,14-02-2020,6139,2238,97,6042,Africa
Chile,14-02-2020,60333,49,700,59633,Americas
China,14-02-2020,335767,1694,1179,334588,Western Pacific
China,14-02-2020,254994,715,789,254205,Western Pacific
China,14-02-2020,245051,163,183,244868,Western Pacific
China,14-02-2020,159528,182,243,159285,Western Pacific
China,14-02-2020,184316,2483,1169,183147,Western Pacific
China,14-02-2020,371355,1269,436,370919,Western Pacific
China,14-02-2020,17336,803,475,16861,Western Pacific
China,14-02-2020,393842,1354,502,393340,Western Pacific
China,14-02-2020,331998,1118,106,331892,Western Pacific
China,14-02-2020,84988,283,558,84430,Western Pacific
China,14-02-2020,117501,2045,364,117137,Western Pacific
China,14-02-2020,32302,1485,290,32012,Western Pacific
China,14-02-2020,68023,1463,78,67945,Western Pacific
China,14-02-2020,180064,509,1063,179001,Western Pacific
China,14-02-2020,273012,1194,1162,271850,Western Pacific
China,14-02-2020,253293,1564,407,252886,Western Pacific
China,14-02-2020,396498,809,349,396149,Western Pacific
China,14-02-2020,349988,2483,473,349515,Western Pacific
China,14-02-2020,344478,1732,375,344103,Western Pacific
China,14-02-2020,282214,620,664,281550,Western Pacific
China,14-02-2020,46354,2038,1227,45127,Western Pacific
China,14-02-2020,32422,59,260,32162,Western Pacific
China,14-02-2020,277908,445,595,277313,Western Pacific
China,14-02-2020,380173,1580,1166,379007,Western Pacific
China,14-02-2020,296440,1848,564,295876,Western Pacific
China,14-02-2020,311559,1109,576,310983,Western Pacific
China,14-02-2020,426993,1189,857,426136,Western Pacific
China,14-02-2020,117758,1153,177,117581,Western Pacific
China,14-02-2020,107264,1845,8,107256,Western Pacific
China,14-02-2020,91596,2437,992,90604,Western Pacific
China,14-02-2020,131208,2320,1088,130120,Western Pacific
China,14-02-2020,352429,475,1110,351319,Western Pacific
China,14-02-2020,127014,1447,837,126177,Western Pacific
Colombia,14-02-2020,95055,1252,434,94621,Americas
Congo (Brazzaville),14-02-2020,331149,2003,969,330180,Africa
Congo (Kinshasa),14-02-2020,442751,1743,939,441812,Africa
Costa Rica,14-02-2020,330449,14,201,330248,Americas
Cote d'Ivoire,14-02-2020,218687,633,285,218402,Africa
Croatia,14-02-2020,26916,2451,982,25934,Europe
Cuba,14-02-2020,340699,623,865,339834,Americas
Cyprus,14-02-2020,375070,1796,769,374301,Europe
Czechia,14-02-2020,131037,2041,984,130053,Europe
Denmark,14-02-2020,91221,2136,1197,90024,Europe
Greenland,14-02-2020,324793,1143,798,323995,Europe
Denmark,14-02-2020,159277,378,120,159157,Europe
Djibouti,14-02-2020,422653,2347,141,422512,Eastern Mediterranean
Dominican Republic,14-02-2020,117135,1381,266,116869,Americas
Ecuador,14-02-2020,306974,1260,1158,305816,Americas
Egypt,14-02-2020,17099,946,598,16501,Eastern Mediterranean
El Salvador,14-02-2020,22850,1981,1239,21611,Americas
Equatorial Guinea,14-02-2020,196741,802,757,195984,Africa
Eritrea,14-02-2020,297699,1429,981,296718,Africa
Estonia,14-02-2020,200722,1768,908,199814,Europe
Eswatini,14-02-2020,178670,106,910,177760,Africa
Ethiopia,14-02-2020,246670,2367,218,246452,Africa
Fiji,14-02-2020,338095,576,883,337212,Western Pacific
Finland,14-02-2020,283489,2115,1092,282397,Europe
France,14-02-2020,324209,2311,187,324022,Europe
France,14-02-2020,17411,2345,1194,16217,Europe
France,14-02-2020,440560,1782,1009,439551,Europe
France,14-02-2020,361197,1797,537,360660,Europe
France,14-02-2020,356706,1354,25,356681,Europe
France,14-02-2020,35770,2303,1109,34661,Europe
France,14-02-2020,218484,1988,746,217738,Europe
France,14-02-2020,408062,605,667,407395,Europe
France,14-02-2020,86457,723,454,86003,Europe
France,14-02-2020,130098,1939,563,129535,Europe
Gabon,14-02-2020,183487,623,207,183280,Africa
Gambia,14-02-2020,196699,1761,648,196051,Africa
Georgia,14-02-2020,374160,1764,401,373759,Europe
Germany,14-02-2020,140438,1198,694,139744,Europe
Ghana,14-02-2020,378071,274,452,377619,Africa
Greece,14-02-2020,228186,1573,38,228148,Europe
Guatemala,14-02-2020,253484,1032,657,252827,Americas
Guinea,14-02-2020,318018,1760,119,317899,Africa
Guyana,14-02-2020,441543,965,809,440734,Americas
Haiti,14-02-2020,85033,2072,257,84776,Americas
Holy See,14-02-2020,129977,10,969,129008,Europe
Honduras,14-02-2020,262871,1494,647,262224,Americas
Hungary,14-02-2020,360780,452,74,360706,Europe
Iceland,14-02-2020,234098,2048,414,233684,Europe
India,14-02-2020,17006,2490,425,16581,South-East Asia
Indonesia,14-02-2020,42503,1715,580,41923,South-East Asia
Iran,14-02-2020,210120,874,591,209529,Eastern Mediterranean
Iraq,14-02-2020,348286,1725,181,348105,Eastern Mediterranean
Ireland,14-02-2020,413505,316,544,412961,Europe
Israel,14-02-2020,369665,514,644,369021,Europe
Italy,14-02-2020,63574,552,633,62941,Europe
Jamaica,14-02-2020,172560,503,457,172103,Americas
Japan,14-02-2020,211232,2443,495,210737,Western Pacific
Jordan,14-02-2020,393141,1415,985,392156,Eastern Mediterranean
Kazakhstan,14-02-2020,321119,1520,585,320534,Europe
Kenya,14-02-2020,185068,1999,338,184730,Africa
South Korea,14-02-2020,417430,1654,295,417135,Western Pacific
Kuwait,14-02-2020,416019,1007,298,415721,Eastern Mediterranean
Kyrgyzstan,14-02-2020,38037,1527,471,37566,Europe
Latvia,14-02-2020,205116,101,707,204409,Europe
Lebanon,14-02-2020,385742,194,204,385538,Eastern Mediterranean
Liberia,14-02-2020,263987,1904,302,263685,Africa
Liechtenstein,14-02-2020,373653,231,586,373067,Europe
Lithuania,14-02-2020,115349,687,399,114950,Europe
Luxembourg,14-02-2020,311598,710,187,311411,Europe
Madagascar,14-02-2020,282173,18,1033,281140,Africa
Malaysia,14-02-2020,130136,1212,1079,129057,Western Pacific
Maldives,14-02-2020,208708,1870,835,207873,South-East Asia
Malta,14-02-2020,158234,216,1154,157080,Europe
Mauritania,14-02-2020,6052,2192,1202,4850,Africa
Mauritius,14-02-2020,333865,555,1062,332803,Africa
Mexico,14-02-2020,377644,172,981,376663,Americas
Moldova,14-02-2020,445404,654,190,445214,Europe
Monaco,14-02-2020,326567,1257,587,325980,Europe
Mongolia,14-02-2020,69085,1468,35,69050,Western Pacific
Montenegro,14-02-2020,224685,2288,739,223946,Europe
Morocco,14-02-2020,220724,2164,374,220350,Eastern Mediterranean
Namibia,14-02-2020,151931,1500,911,151020,Africa
Nepal,14-02-2020,426014,1929,70,425944,South-East Asia
Netherlands,14-02-2020,181049,1110,220,180829,Europe
Netherlands,14-02-2020,277858,27,97,277761,Europe
Netherlands,14-02-2020,118793,1279,107,118686,Europe
Netherlands,14-02-2020,130117,1046,80,130037,Europe
New Zealand,14-02-2020,371772,1543,1123,370649,Western Pacific
Nicaragua,14-02-2020,342893,879,591,342302,Americas
Niger,14-02-2020,303491,583,593,302898,Africa
Nigeria,14-02-2020,267404,1440,616,266788,Africa
North Macedonia,14-02-2020,190428,1780,525,189903,Europe
Norway,14-02-2020,408460,319,767,407693,Europe
Oman,14-02-2020,300558,737,840,299718,Eastern Mediterranean
Pakistan,14-02-2020,331012,2013,997,330015,Eastern Mediterranean
Panama,14-02-2020,26441,1252,330,26111,Americas
Papua New Guinea,14-02-2020,352989,1749,324,352665,Western Pacific
Paraguay,14-02-2020,354148,2291,785,353363,Americas
Peru,14-02-2020,259691,182,355,259336,Americas
Philippines,14-02-2020,323510,1664,1065,322445,Western Pacific
Poland,14-02-2020,203716,566,1161,202555,Europe
Portugal,14-02-2020,336708,1574,406,336302,Europe
Qatar,14-02-2020,19744,2101,432,19312,Eastern Mediterranean
Romania,14-02-2020,187230,1584,80,187150,Europe
Russia,14-02-2020,38011,1984,1129,36882,Europe
Rwanda,14-02-2020,333190,629,1163,332027,Africa
Saint Lucia,14-02-2020,282865,2346,298,282567,Americas
Saint Vincent and the Grenadines,14-02-2020,287464,1425,1103,286361,Americas
San Marino,14-02-2020,214561,1516,325,214236,Europe
Saudi Arabia,14-02-2020,188356,968,1048,187308,Eastern Mediterranean
Senegal,14-02-2020,332871,707,263,332608,Africa
Serbia,14-02-2020,386441,2191,390,386051,Europe
Seychelles,14-02-2020,52985,2388,517,52468,Africa
Singapore,14-02-2020,172403,1938,230,172173,Western Pacific
Slovakia,14-02-2020,172971,1685,1233,171738,Europe
Slovenia,14-02-2020,179535,877,401,179134,Europe
Somalia,14-02-2020,336394,171,906,335488,Eastern Mediterranean
South Africa,14-02-2020,207981,1830,648,207333,Africa
Spain,14-02-2020,158403,577,1219,157184,Europe
Sri Lanka,14-02-2020,233679,1537,855,232824,South-East Asia
Sudan,14-02-2020,325437,468,676,324761,Eastern Mediterranean
Suriname,14-02-2020,307856,984,430,307426,Americas
Sweden,14-02-2020,166686,708,874,165812,Europe
Switzerland,14-02-2020,449519,1200,1214,448305,Europe
Taiwan*,14-02-2020,397042,987,916,396126,Western Pacific
Tanzania,14-02-2020,222780,1050,994,221786,Africa
Thailand,14-02-2020,137213,371,353,136860,South-East Asia
Togo,14-02-2020,245568,30,189,245379,Africa
Trinidad and Tobago,14-02-2020,5217,991,886,4331,Americas
Tunisia,14-02-2020,35129,538,147,34982,Eastern Mediterranean
Turkey,14-02-2020,13687,1474,1098,12589,Europe
Uganda,14-02-2020,171320,2364,250,171070,Africa
Ukraine,14-02-2020,299205,2413,1134,298071,Europe
United Arab Emirates,14-02-2020,139355,1816,1092,138263,Eastern Mediterranean
United Kingdom,14-02-2020,242257,867,30,242227,Europe
United Kingdom,14-02-2020,407123,1710,454,406669,Europe
United Kingdom,14-02-2020,199892,2174,194,199698,Europe
United Kingdom,14-02-2020,40904,2237,834,40070,Europe
United Kingdom,14-02-2020,375453,1172,952,374501,Europe
United Kingdom,14-02-2020,32274,16,530,31744,Europe
United Kingdom,14-02-2020,185149,431,42,185107,Europe
Uruguay,14-02-2020,438780,2272,162,438618,Americas
US,14-02-2020,379312,2347,774,378538,Americas
Uzbekistan,14-02-2020,46316,2163,596,45720,Europe
Venezuela,14-02-2020,419218,706,923,418295,Americas
Vietnam,14-02-2020,318087,566,374,317713,Western Pacific
Zambia,14-02-2020,285570,1166,1186,284384,Africa
Zimbabwe,14-02-2020,331589,103,975,330614,Africa
Dominica,14-02-2020,407131,314,472,406659,Americas
Grenada,14-02-2020,357104,2329,1011,356093,Americas
Mozambique,14-02-2020,277794,1291,289,277505,Africa
Syria,14-02-2020,9030,2110,710,8320,Eastern Mediterranean
Timor-Leste,14-02-2020,231532,419,1105,230427,South-East Asia
Belize,14-02-2020,111492,165,363,111129,Americas
Laos,14-02-2020,30294,1277,184,30110,Western Pacific
Libya,14-02-2020,311916,535,745,311171,Eastern Mediterranean
West Bank and Gaza,14-02-2020,7490,1526,511,6979,Eastern Mediterranean
Guinea-Bissau,14-02-2020,304818,1909,1110,303708,Africa
Mali,14-02-2020,92199,1144,168,92031,Africa
Saint Kitts and Nevis,14-02-2020,414240,607,481,413759,Americas
Canada,14-02-2020,98358,170,1109,97249,Americas
Canada,14-02-2020,81526,1753,550,80976,Americas
Kosovo,14-02-2020,48146,2416,236,47910,Europe
Burma,14-02-2020,372187,2060,858,371329,South-East Asia
United Kingdom,14-02-2020,219900,2487,1028,218872,Europe
United Kingdom,14-02-2020,233019,1396,39,232980,Europe
United Kingdom,14-02-2020,201021,1307,1011,200010,Europe
Botswana,14-02-2020,78939,872,561,78378,Africa
Burundi,14-02-2020,161878,1179,845,161033,Africa
Sierra Leone,14-02-2020,2548,1430,557,1991,Africa
Malawi,14-02-2020,200755,2001,1212,199543,Africa
United Kingdom,14-02-2020,354043,61,742,353301,Europe
France,14-02-2020,244880,1761,502,244378,Europe
South Sudan,14-02-2020,265518,208,1211,264307,Africa
Western Sahara,14-02-2020,131667,2214,881,130786,Africa
Sao Tome and Principe,14-02-2020,344983,583,1195,343788,Africa
Yemen,14-02-2020,22862,381,990,21872,Eastern Mediterranean
Comoros,14-02-2020,72261,2173,929,71332,Africa
Tajikistan,14-02-2020,194189,379,648,193541,Europe
Lesotho,14-02-2020,149046,986,749,148297,Africa
Afghanistan,15-02-2020,175698,34,1005,174693,Eastern Mediterranean
Albania,15-02-2020,286016,1519,911,285105,Europe
Algeria,15-02-2020,402805,1867,688,402117,Africa
Andorra,15-02-2020,112528,1299,30,112498,Europe
Angola,15-02-2020,255499,1604,776,254723,Africa
Antigua and Barbuda,15-02-2020,275516,1324,670,274846,Americas
Argentina,15-02-2020,381083,2343,160,380923,Americas
Armenia,15-02-2020,372863,392,1099,371764,Europe
Australia,15-02-2020,254912,2008,841,254071,Western Pacific
Australia,15-02-2020,267759,84,762,266997,Western Pacific
Australia,15-02-2020,433271,279,426,432845,Western Pacific
Australia,15-02-2020,121018,1240,1110,119908,Western Pacific
Australia,15-02-2020,276861,250,533,276328,Western Pacific
Australia,15-02-2020,274124,955,910,273214,Western Pacific
Australia,15-02-2020,104257,653,301,103956,Western Pacific
Australia,15-02-2020,257895,2018,1228,256667,Western Pacific
Austria,15-02-2020,197410,1810,12,197398,Europe
Azerbaijan,15-02-2020,435604,1761,156,435448,Europe
Bahamas,15-02-2020,148947,1664,386,148561,Americas
Bahrain,15-02-2020,239696,824,1060,238636,Eastern Mediterranean
Bangladesh,15-02-2020,216563,489,408,216155,South-East Asia
Barbados,15-02-2020,291051,1368,214,290837,Americas
Belarus,15-02-2020,50624,660,1090,49534,Europe
Belgium,15-02-2020,321515,2195,1233,320282,Europe
Benin,15-02-2020,36981,1531,697,36284,Africa
Bhutan,15-02-2020,164666,1985,1061,163605,South-East Asia
Bolivia,15-02-2020,423895,894,434,423461,Americas
Bosnia and Herzegovina,15-02-2020,183900,306,674,183226,Europe
Brazil,15-02-2020,434197,1045,27,434170,Americas
Brunei,15-02-2020,339294,2079,277,339017,Western Pacific
Bulgaria,15-02-2020,153085,382,566,152519,Europe
Burkina Faso,15-02-2020,304704,463,670,304034,Africa
Cabo Verde,15-02-2020,311869,1764,1115,310754,Africa
Cambodia,15-02-2020,407688,562,784,406904,Western Pacific
Cameroon,15-02-2020,160449,20,267,160182,Africa
Canada,15-02-2020,71674,2449,368,71306,Americas
Canada,15-02-2020,263313,1240,111,263202,Americas
Canada,15-02-2020,105782,386,463,105319,Americas
Canada,15-02-2020,54867,481,837,54030,Americas
Canada,15-02-2020,205804,542,1133,204671,Americas
Canada,15-02-2020,360312,352,1120,359192,Americas
Canada,15-02-2020,154184,1646,408,153776,Americas
Canada,15-02-2020,142157,7,759,141398,Americas
Canada,15-02-2020,324386,1508,1181,323205,Americas
Canada,15-02-2020,172815,2431,86,172729,Americas
Central African Republic,15-02-2020,139581,2100,1199,138382,Africa
Chad,15-02-2020,304064,851,706,303358,Africa
Chile,15-02-2020,390439,184,85,390354,Americas
China,15-02-2020,242732,1285,260,242472,Western Pacific
China,15-02-2020,109921,1659,474,109447,Western Pacific
China,15-02-2020,16886,2023,750,16136,Western Pacific
China,15-02-2020,124769,87,920,123849,Western Pacific
China,15-02-2020,92663,822,430,92233,Western Pacific
China,15-02-2020,177241,1934,1104,176137,Western Pacific
China,15-02-2020,248307,1641,409,247898,Western Pacific
China,15-02-2020,91735,975,595,91140,Western Pacific
China,15-02-2020,162989,736,710,162279,Western Pacific
China,15-02-2020,202766,1281,303,202463,Western Pacific
China,15-02-2020,205654,1937,511,205143,Western Pacific
China,15-02-2020,439458,1725,632,438826,Western Pacific
China,15-02-2020,294514,590,529,293985,Western Pacific
China,15-02-2020,314635,1040,645,313990,Western Pacific
China,15-02-2020,439807,2482,794,439013,Western Pacific
China,15-02-2020,63646,677,782,62864,Western Pacific
China,15-02-2020,361274,1571,373,360901,Western Pacific
China,15-02-2020,317452,216,1039,316413,Western Pacific
China,15-02-2020,49030,230,23,49007,Western Pacific
China,15-02-2020,440226,710,602,439624,Western Pacific
China,15-02-2020,80533,37,68,80465,Western Pacific
China,15-02-2020,135413,557,247,135166,Western Pacific
China,15-02-2020,300684,67,212,300472,Western Pacific
China,15-02-2020,68861,244,1075,67786,Western Pacific
China,15-02-2020,184700,425,23,184677,Western Pacific
China,15-02-2020,382224,2155,1040,381184,Western Pacific
China,15-02-2020,32855,2419,641,32214,Western Pacific
China,15-02-2020,137815,2481,325,137490,Western Pacific
China,15-02-2020,392359,623,1173,391186,Western Pacific
China,15-02-2020,186657,162,150,186507,Western Pacific
China,15-02-2020,307466,1695,684,306782,Western Pacific
China,15-02-2020,138161,2481,272,137889,Western Pacific
China,15-02-2020,48688,2454,839,47849,Western Pacific
Colombia,15-02-2020,317517,644,1190,316327,Americas
Congo (Brazzaville),15-02-2020,83226,194,374,82852,Africa
Congo (Kinshasa),15-02-2020,105628,865,987,104641,Africa
Costa Rica,15-02-2020,31771,995,1149,30622,Americas
Cote d'Ivoire,15-02-2020,253409,682,76,253333,Africa
Croatia,15-02-2020,196423,52,916,195507,Europe
Cuba,15-02-2020,288096,1524,269,287827,Americas
Cyprus,15-02-2020,48145,1611,1012,47133,Europe
Czechia,15-02-2020,417612,1804,820,416792,Europe
Denmark,15-02-2020,22076,250,706,21370,Europe
Greenland,15-02-2020,56559,1735,990,55569,Europe
Denmark,15-02-2020,32252,1062,461,31791,Europe
Djibouti,15-02-2020,435462,70,681,434781,Eastern Mediterranean
Dominican Republic,15-02-2020,201797,1279,419,201378,Americas
Ecuador,15-02-2020,160062,534,541,159521,Americas
Egypt,15-02-2020,298344,2094,452,297892,Eastern Mediterranean
El Salvador,15-02-2020,400078,178,846,399232,Americas
Equatorial Guinea,15-02-2020,424797,528,615,424182,Africa
Eritrea,15-02-2020,78822,2245,839,77983,Africa
Estonia,15-02-2020,360369,167,233,360136,Europe
Eswatini,15-02-2020,82051,2360,311,81740,Africa
Ethiopia,15-02-2020,63150,1537,720,62430,Africa
Fiji,15-02-2020,293988,223,594,293394,Western Pacific
Finland,15-02-2020,220948,457,1027,219921,Europe
France,15-02-2020,403135,1794,769,402366,Europe
France,15-02-2020,226026,1211,1114,224912,Europe
France,15-02-2020,192808,1739,100,192708,Europe
France,15-02-2020,57020,1455,1023,55997,Europe
France,15-02-2020,35645,1134,378,35267,Europe
France,15-02-2020,178593,2278,163,178430,Europe
France,15-02-2020,373329,1214,862,372467,Europe
France,15-02-2020,85024,2269,470,84554,Europe
France,15-02-2020,180400,520,228,180172,Europe
France,15-02-2020,148121,472,105,148016,Europe
Gabon,15-02-2020,277653,1145,369,277284,Africa
Gambia,15-02-2020,232686,492,174,232512,Africa
Georgia,15-02-2020,147607,1948,821,146786,Europe
Germany,15-02-2020,94082,2350,952,93130,Europe
Ghana,15-02-2020,296767,895,922,295845,Africa
Greece,15-02-2020,125511,655,1206,124305,Europe
Guatemala,15-02-2020,199445,932,291,199154,Americas
Guinea,15-02-2020,178072,953,903,177169,Africa
Guyana,15-02-2020,126768,1804,581,126187,Americas
Haiti,15-02-2020,21414,2166,297,21117,Americas
Holy See,15-02-2020,384357,363,844,383513,Europe
Honduras,15-02-2020,122391,780,345,122046,Americas
Hungary,15-02-2020,149141,606,1110,148031,Europe
Iceland,15-02-2020,8481,323,938,7543,Europe
India,15-02-2020,39967,657,81,39886,South-East Asia
Indonesia,15-02-2020,250030,1979,427,249603,South-East Asia
Iran,15-02-2020,32067,1637,1172,30895,Eastern Mediterranean
Iraq,15-02-2020,67215,173,1140,66075,Eastern Mediterranean
Ireland,15-02-2020,241296,522,239,241057,Europe
Israel,15-02-2020,100729,921,1084,99645,Europe
Italy,15-02-2020,292435,502,133,292302,Europe
Jamaica,15-02-2020,157035,1646,1138,155897,Americas
Japan,15-02-2020,287293,196,540,286753,Western Pacific
Jordan,15-02-2020,129497,574,1148,128349,Eastern Mediterranean
Kazakhstan,15-02-2020,161011,1899,456,160555,Europe
Kenya,15-02-2020,429110,1321,769,428341,Africa
South Korea,15-02-2020,133043,473,409,132634,Western Pacific
Kuwait,15-02-2020,221443,770,1077,220366,Eastern Mediterranean
Kyrgyzstan,15-02-2020,221858,1561,1036,220822,Europe
Latvia,15-02-2020,284050,911,41,284009,Europe
Lebanon,15-02-2020,196778,717,1156,195622,Eastern Mediterranean
Liberia,15-02-2020,72211,1669,362,71849,Africa
Liechtenstein,15-02-2020,18713,715,346,18367,Europe
Lithuania,15-02-2020,150266,1835,631,149635,Europe
Luxembourg,15-02-2020,48482,1780,223,48259,Europe
Madagascar,15-02-2020,36261,1742,484,35777,Africa
Malaysia,15-02-2020,376840,2199,43,376797,Western Pacific
Maldives,15-02-2020,89200,2133,1048,88152,South-East Asia
Malta,15-02-2020,131213,1779,546,130667,Europe
Mauritania,15-02-2020,73028,1960,1089,71939,Africa
Mauritius,15-02-2020,21773,76,821,20952,Africa
Mexico,15-02-2020,29410,2465,1007,28403,Americas
Moldova,15-02-2020,19193,962,168,19025,Europe
Monaco,15-02-2020,270496,973,791,269705,Europe
Mongolia,15-02-2020,349593,1936,130,349463,Western Pacific
Montenegro,15-02-2020,390610,2497,744,389866,Europe
Morocco,15-02-2020,174229,603,208,174021,Eastern Mediterranean
Namibia,15-02-2020,103477,2038,268,103209,Africa
Nepal,15-02-2020,369873,185,269,369604,South-East Asia
Netherlands,15-02-2020,65366,1937,293,65073,Europe
Netherlands,15-02-2020,359375,1015,316,359059,Europe
Netherlands,15-02-2020,745,1843,1019,-274,Europe
Netherlands,15-02-2020,337005,735,283,336722,Europe
New Zealand,15-02-2020,27606,2443,176,27430,Western Pacific
Nicaragua,15-02-2020,159984,1580,330,159654,Americas
Niger,15-02-2020,27863,838,845,27018,Africa
Nigeria,15-02-2020,54241,1583,158,54083,Africa
North Macedonia,15-02-2020,8033,1746,1171,6862,Europe
Norway,15-02-2020,56235,117,1023,55212,Europe
Oman,15-02-2020,246219,665,804,245415,Eastern Mediterranean
Pakistan,15-02-2020,142497,1699,93,142404,Eastern Mediterranean
Panama,15-02-2020,303333,756,1017,302316,Americas
Papua New Guinea,15-02-2020,366916,1957,681,366235,Western Pacific
Paraguay,15-02-2020,83581,1474,695,82886,Americas
Peru,15-02-2020,232741,346,646,232095,Americas
Philippines,15-02-2020,276796,326,795,276001,Western Pacific
Poland,15-02-2020,384855,355,239,384616,Europe
Portugal,15-02-2020,44541,1337,723,43818,Europe
Qatar,15-02-2020,277560,315,73,277487,Eastern Mediterranean
Romania,15-02-2020,218225,381,979,217246,Europe
Russia,15-02-2020,276938,1160,781,276157,Europe
Rwanda,15-02-2020,310506,1077,30,310476,Africa
Saint Lucia,15-02-2020,354756,2439,963,353793,Americas
Saint Vincent and the Grenadines,15-02-2020,336801,225,517,336284,Americas
San Marino,15-02-2020,89013,1725,636,88377,Europe
Saudi Arabia,15-02-2020,372051,917,295,371756,Eastern Mediterranean
Senegal,15-02-2020,403568,2356,1052,402516,Africa
Serbia,15-02-2020,312769,794,1110,311659,Europe
Seychelles,15-02-2020,357694,643,278,357416,Africa
Singapore,15-02-2020,249211,717,269,248942,Western Pacific
Slovakia,15-02-2020,310750,1213,346,310404,Europe
Slovenia,15-02-2020,376690,1404,713,375977,Europe
Somalia,15-02-2020,370785,2396,726,370059,Eastern Mediterranean
South Africa,15-02-2020,312222,969,643,311579,Africa
Spain,15-02-2020,89208,2033,438,88770,Europe
Sri Lanka,15-02-2020,74750,1829,741,74009,South-East Asia
Sudan,15-02-2020,191950,1765,1047,190903,Eastern Mediterranean
Suriname,15-02-2020,322436,1834,191,322245,Americas
Sweden,15-02-2020,185015,1274,858,184157,Europe
Switzerland,15-02-2020,77540,1695,12,77528,Europe
Taiwan*,15-02-2020,262896,1584,28,262868,Western Pacific
Tanzania,15-02-2020,436994,1917,737,436257,Africa
Thailand,15-02-2020,433456,1544,66,433390,South-East Asia
Togo,15-02-2020,202522,559,210,202312,Africa
Trinidad and Tobago,15-02-2020,226348,36,1120,225228,Americas
Tunisia,15-02-2020,71059,1184,678,70381,Eastern Mediterranean
Turkey,15-02-2020,112926,2191,1086,111840,Europe
Uganda,15-02-2020,67262,2221,1197,66065,Africa
Ukraine,15-02-2020,331795,305,702,331093,Europe
United Arab Emirates,15-02-2020,222876,1946,882,221994,Eastern Mediterranean
United Kingdom,15-02-2020,289366,1620,186,289180,Europe
United Kingdom,15-02-2020,114568,786,1211,113357,Europe
United Kingdom,15-02-2020,354642,2340,658,353984,Europe
United Kingdom,15-02-2020,76263,1572,860,75403,Europe
United Kingdom,15-02-2020,443892,322,96,443796,Europe
United Kingdom,15-02-2020,333649,1578,283,333366,Europe
United Kingdom,15-02-2020,276851,1522,464,276387,Europe
Uruguay,15-02-2020,119049,2053,194,118855,Americas
US,15-02-2020,65488,2275,371,65117,Americas
Uzbekistan,15-02-2020,101785,1778,140,101645,Europe
Venezuela,15-02-2020,326546,151,361,326185,Americas
Vietnam,15-02-2020,340024,2466,338,339686,Western Pacific
Zambia,15-02-2020,244669,2103,337,244332,Africa
Zimbabwe,15-02-2020,337728,1366,982,336746,Africa
Dominica,15-02-2020,278602,1760,384,278218,Americas
Grenada,15-02-2020,104953,1176,264,104689,Americas
Mozambique,15-02-2020,303319,1983,586,302733,Africa
Syria,15-02-2020,44379,518,1249,43130,Eastern Mediterranean
Timor-Leste,15-02-2020,423677,1956,306,423371,South-East Asia
Belize,15-02-2020,115950,588,1,115949,Americas
Laos,15-02-2020,195322,860,96,195226,Western Pacific
Libya,15-02-2020,67156,731,557,66599,Eastern Mediterranean
West Bank and Gaza,15-02-2020,2810,2372,237,2573,Eastern Mediterranean
Guinea-Bissau,15-02-2020,34732,782,580,34152,Africa
Mali,15-02-2020,146091,137,395,145696,Africa
Saint Kitts and Nevis,15-02-2020,373752,217,46,373706,Americas
Canada,15-02-2020,38143,1291,338,37805,Americas
Canada,15-02-2020,268720,2211,598,268122,Americas
Kosovo,15-02-2020,67984,344,565,67419,Europe
Burma,15-02-2020,249188,961,979,248209,South-East Asia
United Kingdom,15-02-2020,212799,301,1185,211614,Europe
United Kingdom,15-02-2020,371915,1633,169,371746,Europe
United Kingdom,15-02-2020,96635,2237,1224,95411,Europe
Botswana,15-02-2020,420854,29,378,420476,Africa
Burundi,15-02-2020,131620,178,476,131144,Africa
Sierra Leone,15-02-2020,341563,415,556,341007,Africa
Malawi,15-02-2020,411899,1269,1024,410875,Africa
United Kingdom,15-02-2020,119764,1067,457,119307,Europe
France,15-02-2020,418960,1597,633,418327,Europe
South Sudan,15-02-2020,106172,2026,981,105191,Africa
Western Sahara,15-02-2020,169586,1017,320,169266,Africa
Sao Tome and Principe,15-02-2020,15701,2128,1062,14639,Africa
Yemen,15-02-2020,368383,1651,1194,367189,Eastern Mediterranean
Comoros,15-02-2020,79443,548,1249,78194,Africa
Tajikistan,15-02-2020,347007,473,1209,345798,Europe
Lesotho,15-02-2020,258730,530,326,258404,Africa
Afghanistan,16-02-2020,255755,2070,585,255170,Eastern Mediterranean
Albania,16-02-2020,376335,383,795,375540,Europe
Algeria,16-02-2020,212782,821,639,212143,Africa
Andorra,16-02-2020,111120,643,582,110538,Europe
Angola,16-02-2020,388998,1071,520,388478,Africa
Antigua and Barbuda,16-02-2020,71938,1691,1089,70849,Americas
Argentina,16-02-2020,251694,1894,191,251503,Americas
Armenia,16-02-2020,206825,1751,903,205922,Europe
Australia,16-02-2020,248707,460,839,247868,Western Pacific
Australia,16-02-2020,427122,2383,375,426747,Western Pacific
Australia,16-02-2020,115647,772,873,114774,Western Pacific
Australia,16-02-2020,282766,1672,839,281927,Western Pacific
Australia,16-02-2020,236901,1183,1157,235744,Western Pacific
Australia,16-02-2020,24320,2229,266,24054,Western Pacific
Australia,16-02-2020,285308,842,659,284649,Western Pacific
Australia,16-02-2020,326197,85,525,325672,Western Pacific
Austria,16-02-2020,90056,307,781,89275,Europe
Azerbaijan,16-02-2020,43901,419,1239,42662,Europe
Bahamas,16-02-2020,427746,2414,82,427664,Americas
Bahrain,16-02-2020,325132,528,595,324537,Eastern Mediterranean
Bangladesh,16-02-2020,313881,603,962,312919,South-East Asia
Barbados,16-02-2020,431422,1100,145,431277,Americas
Belarus,16-02-2020,381214,1181,772,380442,Europe
Belgium,16-02-2020,144063,920,1223,142840,Europe
Benin,16-02-2020,111723,391,1180,110543,Africa
Bhutan,16-02-2020,323407,777,415,322992,South-East Asia
Bolivia,16-02-2020,157964,543,160,157804,Americas
Bosnia and Herzegovina,16-02-2020,194182,924,1146,193036,Europe
Brazil,16-02-2020,402308,1205,470,401838,Americas
Brunei,16-02-2020,114731,1398,14,114717,Western Pacific
Bulgaria,16-02-2020,108378,581,869,107509,Europe
Burkina Faso,16-02-2020,253614,369,416,253198,Africa
Cabo Verde,16-02-2020,317773,1111,1092,316681,Africa
Cambodia,16-02-2020,402302,59,884,401418,Western Pacific
Cameroon,16-02-2020,77436,1375,833,76603,Africa
Canada,16-02-2020,349751,215,506,349245,Americas
Canada,16-02-2020,443465,946,1005,442460,Americas
Canada,16-02-2020,334016,1196,657,333359,Americas
Canada,16-02-2020,2560,254,872,1688,Americas
Canada,16-02-2020,313380,1806,255,313125,Americas
Canada,16-02-2020,113186,275,570,112616,Americas
Canada,16-02-2020,400936,724,781,400155,Americas
Canada,16-02-2020,406118,2236,1119,404999,Americas
Canada,16-02-2020,33366,738,787,32579,Americas
Canada,16-02-2020,254440,1697,951,253489,Americas
Central African Republic,16-02-2020,189667,267,1113,188554,Africa
Chad,16-02-2020,111644,517,1099,110545,Africa
Chile,16-02-2020,291534,1421,792,290742,Americas
China,16-02-2020,395160,905,565,394595,Western Pacific
China,16-02-2020,259588,2354,480,259108,Western Pacific
China,16-02-2020,235789,2237,55,235734,Western Pacific
China,16-02-2020,113926,1499,903,113023,Western Pacific
China,16-02-2020,390732,2262,246,390486,Western Pacific
China,16-02-2020,394594,65,1008,393586,Western Pacific
China,16-02-2020,349358,1113,152,349206,Western Pacific
China,16-02-2020,123944,457,670,123274,Western Pacific
China,16-02-2020,363570,1370,671,362899,Western Pacific
China,16-02-2020,387373,1639,438,386935,Western Pacific
China,16-02-2020,118553,272,847,117706,Western Pacific
China,16-02-2020,276324,2327,266,276058,Western Pacific
China,16-02-2020,394927,1751,1113,393814,Western Pacific
China,16-02-2020,424463,1762,1235,423228,Western Pacific
China,16-02-2020,24252,2287,506,23746,Western Pacific
China,16-02-2020,81043,677,354,80689,Western Pacific
China,16-02-2020,4300,1133,789,3511,Western Pacific
China,16-02-2020,402562,929,287,402275,Western Pacific
China,16-02-2020,213707,2418,217,213490,Western Pacific
China,16-02-2020,392405,1096,1109,391296,Western Pacific
China,16-02-2020,190965,1434,266,190699,Western Pacific
China,16-02-2020,288604,856,358,288246,Western Pacific
China,16-02-2020,294059,1860,217,293842,Western Pacific
China,16-02-2020,185547,237,723,184824,Western Pacific
China,16-02-2020,193191,171,923,192268,Western Pacific
China,16-02-2020,89273,1303,392,88881,Western Pacific
China,16-02-2020,132657,1325,424,132233,Western Pacific
China,16-02-2020,418053,2371,609,417444,Western Pacific
China,16-02-2020,447221,1366,998,446223,Western Pacific
China,16-02-2020,272917,2456,130,272787,Western Pacific
China,16-02-2020,163028,1338,245,162783,Western Pacific
China,16-02-2020,271663,532,973,270690,Western Pacific
China,16-02-2020,221414,1034,572,220842,Western Pacific
Colombia,16-02-2020,262134,1403,527,261607,Americas
Congo (Brazzaville),16-02-2020,140009,431,1167,138842,Africa
Congo (Kinshasa),16-02-2020,233509,267,873,232636,Africa
Costa Rica,16-02-2020,367418,1534,29,367389,Americas
Cote d'Ivoire,16-02-2020,325793,640,535,325258,Africa
Croatia,16-02-2020,130741,1053,477,130264,Europe
Cuba,16-02-2020,230147,1797,508,229639,Americas
Cyprus,16-02-2020,9374,2055,1064,8310,Europe
Czechia,16-02-2020,194339,1723,1099,193240,Europe
Denmark,16-02-2020,175968,303,971,174997,Europe
Greenland,16-02-2020,312603,389,1133,311470,Europe
Denmark,16-02-2020,421526,531,203,421323,Europe
Djibouti,16-02-2020,13122,2489,910,12212,Eastern Mediterranean
Dominican Republic,16-02-2020,334305,923,961,333344,Americas
Ecuador,16-02-2020,119763,1897,508,119255,Americas
Egypt,16-02-2020,251342,865,232,251110,Eastern Mediterranean
El Salvador,16-02-2020,157694,1860,619,157075,Americas
Equatorial Guinea,16-02-2020,243218,390,798,242420,Africa
Eritrea,16-02-2020,146370,15,302,146068,Africa
Estonia,16-02-2020,136615,1507,1106,135509,Europe
Eswatini,16-02-2020,134296,746,345,133951,Africa
Ethiopia,16-02-2020,311813,1862,284,311529,Africa
Fiji,16-02-2020,439045,2374,1019,438026,Western Pacific
Finland,16-02-2020,12581,277,760,11821,Europe
France,16-02-2020,79025,541,891,78134,Europe
France,16-02-2020,289065,1992,1056,288009,Europe
France,16-02-2020,204516,36,798,203718,Europe
France,16-02-2020,217039,622,220,216819,Europe
France,16-02-2020,114120,2245,422,113698,Europe
France,16-02-2020,246884,739,565,246319,Europe
France,16-02-2020,41923,1810,1248,40675,Europe
France,16-02-2020,378951,2266,968,377983,Europe
France,16-02-2020,1695,56,300,1395,Europe
France,16-02-2020,324004,954,689,323315,Europe
Gabon,16-02-2020,131553,1373,474,131079,Africa
Gambia,16-02-2020,442351,681,94,442257,Africa
Georgia,16-02-2020,379515,2414,282,379233,Europe
Germany,16-02-2020,41648,1162,146,41502,Europe
Ghana,16-02-2020,212537,246,71,212466,Africa
Greece,16-02-2020,14985,1471,126,14859,Europe
Guatemala,16-02-2020,427433,1141,704,426729,Americas
Guinea,16-02-2020,386508,816,839,385669,Africa
Guyana,16-02-2020,418509,953,593,417916,Americas
Haiti,16-02-2020,66704,1014,786,65918,Americas
Holy See,16-02-2020,141201,99,970,140231,Europe
Honduras,16-02-2020,202185,1713,591,201594,Americas
Hungary,16-02-2020,273496,267,825,272671,Europe
Iceland,16-02-2020,257096,2478,1002,256094,Europe
India,16-02-2020,229556,1562,396,229160,South-East Asia
Indonesia,16-02-2020,372744,2045,603,372141,South-East Asia
Iran,16-02-2020,188309,453,869,187440,Eastern Mediterranean
Iraq,16-02-2020,250290,2000,321,249969,Eastern Mediterranean
Ireland,16-02-2020,302925,2106,743,302182,Europe
Israel,16-02-2020,267867,1696,230,267637,Europe
Italy,16-02-2020,111068,456,750,110318,Europe
Jamaica,16-02-2020,39455,1036,793,38662,Americas
Japan,16-02-2020,176652,1199,904,175748,Western Pacific
Jordan,16-02-2020,168539,348,181,168358,Eastern Mediterranean
Kazakhstan,16-02-2020,326219,1876,1077,325142,Europe
Kenya,16-02-2020,667,1045,472,195,Africa
South Korea,16-02-2020,209598,2096,257,209341,Western Pacific
Kuwait,16-02-2020,424378,1877,1114,423264,Eastern Mediterranean
Kyrgyzstan,16-02-2020,262008,1855,314,261694,Europe
Latvia,16-02-2020,56654,938,1090,55564,Europe
Lebanon,16-02-2020,57369,1816,171,57198,Eastern Mediterranean
Liberia,16-02-2020,24214,2148,1171,23043,Africa
Liechtenstein,16-02-2020,443383,1069,322,443061,Europe
Lithuania,16-02-2020,288803,2040,494,288309,Europe
Luxembourg,16-02-2020,4627,523,330,4297,Europe
Madagascar,16-02-2020,4494,30,343,4151,Africa
Malaysia,16-02-2020,192397,111,987,191410,Western Pacific
Maldives,16-02-2020,344189,1604,5,344184,South-East Asia
Malta,16-02-2020,433253,1334,121,433132,Europe
Mauritania,16-02-2020,110983,1154,522,110461,Africa
Mauritius,16-02-2020,174342,81,595,173747,Africa
Mexico,16-02-2020,42326,372,425,41901,Americas
Moldova,16-02-2020,278237,2307,730,277507,Europe
Monaco,16-02-2020,68572,1364,211,68361,Europe
Mongolia,16-02-2020,360297,1401,443,359854,Western Pacific
Montenegro,16-02-2020,186071,1608,722,185349,Europe
Morocco,16-02-2020,126845,134,1180,125665,Eastern Mediterranean
Namibia,16-02-2020,208022,1314,407,207615,Africa
Nepal,16-02-2020,307420,1923,475,306945,South-East Asia
Netherlands,16-02-2020,417266,2135,557,416709,Europe
Netherlands,16-02-2020,325438,1186,742,324696,Europe
Netherlands,16-02-2020,120716,2186,23,120693,Europe
Netherlands,16-02-2020,82614,1816,301,82313,Europe
New Zealand,16-02-2020,129258,2139,795,128463,Western Pacific
Nicaragua,16-02-2020,87584,2329,327,87257,Americas
Niger,16-02-2020,121217,428,251,120966,Africa
Nigeria,16-02-2020,358582,2379,502,358080,Africa
North Macedonia,16-02-2020,236202,961,265,235937,Europe
Norway,16-02-2020,432989,2218,705,432284,Europe
Oman,16-02-2020,218726,1627,388,218338,Eastern Mediterranean
Pakistan,16-02-2020,353296,2486,456,352840,Eastern Mediterranean
Panama,16-02-2020,405816,2344,180,405636,Americas
Papua New Guinea,16-02-2020,405725,1210,642,405083,Western Pacific
Paraguay,16-02-2020,282653,1510,774,281879,Americas
Peru,16-02-2020,13650,1938,569,13081,Americas
Philippines,16-02-2020,48591,912,673,47918,Western Pacific
Poland,16-02-2020,227154,1610,337,226817,Europe
Portugal,16-02-2020,251348,2442,257,251091,Europe
Qatar,16-02-2020,112115,1453,62,112053,Eastern Mediterranean
Romania,16-02-2020,358783,2456,1086,357697,Europe
Russia,16-02-2020,182423,221,753,181670,Europe
Rwanda,16-02-2020,382599,2280,413,382186,Africa
Saint Lucia,16-02-2020,271886,1332,191,271695,Americas
Saint Vincent and the Grenadines,16-02-2020,201433,1419,326,201107,Americas
San Marino,16-02-2020,211016,775,1018,209998,Europe
Saudi Arabia,16-02-2020,158201,2437,1018,157183,Eastern Mediterranean
Senegal,16-02-2020,44225,266,1176,43049,Africa
Serbia,16-02-2020,33540,2250,862,32678,Europe
Seychelles,16-02-2020,128458,810,616,127842,Africa
Singapore,16-02-2020,103180,2474,1078,102102,Western Pacific
Slovakia,16-02-2020,398019,1516,539,397480,Europe
Slovenia,16-02-2020,192659,871,810,191849,Europe
Somalia,16-02-2020,188069,131,686,187383,Eastern Mediterranean
South Africa,16-02-2020,183203,497,1116,182087,Africa
Spain,16-02-2020,221166,538,147,221019,Europe
Sri Lanka,16-02-2020,346214,1866,1208,345006,South-East Asia
Sudan,16-02-2020,183323,1154,375,182948,Eastern Mediterranean
Suriname,16-02-2020,383365,643,942,382423,Americas
Sweden,16-02-2020,371424,1920,392,371032,Europe
Switzerland,16-02-2020,387259,1011,1043,386216,Europe
Taiwan*,16-02-2020,226223,1002,858,225365,Western Pacific
Tanzania,16-02-2020,166602,1907,363,166239,Africa
Thailand,16-02-2020,69720,1082,492,69228,South-East Asia
Togo,16-02-2020,57677,705,1092,56585,Africa
Trinidad and Tobago,16-02-2020,442566,1018,283,442283,Americas
Tunisia,16-02-2020,388055,2095,878,387177,Eastern Mediterranean
Turkey,16-02-2020,109539,1624,1142,108397,Europe
Uganda,16-02-2020,139207,510,825,138382,Africa
Ukraine,16-02-2020,379287,387,101,379186,Europe
United Arab Emirates,16-02-2020,67365,239,564,66801,Eastern Mediterranean
United Kingdom,16-02-2020,135546,1242,1029,134517,Europe
United Kingdom,16-02-2020,418182,2293,402,417780,Europe
United Kingdom,16-02-2020,195646,453,1104,194542,Europe
United Kingdom,16-02-2020,169011,422,459,168552,Europe
United Kingdom,16-02-2020,95085,1242,645,94440,Europe
United Kingdom,16-02-2020,287824,1901,653,287171,Europe
United Kingdom,16-02-2020,353153,843,494,352659,Europe
Uruguay,16-02-2020,289708,2193,417,289291,Americas
US,16-02-2020,389596,2247,479,389117,Americas
Uzbekistan,16-02-2020,321459,1147,342,321117,Europe
Venezuela,16-02-2020,180040,799,1103,178937,Americas
Vietnam,16-02-2020,194097,2362,1063,193034,Western Pacific
Zambia,16-02-2020,368694,113,1116,367578,Africa
Zimbabwe,16-02-2020,397778,933,1209,396569,Africa
Dominica,16-02-2020,266969,2331,163,266806,Americas
Grenada,16-02-2020,360404,857,1233,359171,Americas
Mozambique,16-02-2020,289007,1221,198,288809,Africa
Syria,16-02-2020,286781,280,975,285806,Eastern Mediterranean
Timor-Leste,16-02-2020,250111,1005,994,249117,South-East Asia
Belize,16-02-2020,95226,925,980,94246,Americas
Laos,16-02-2020,394762,228,1186,393576,Western Pacific
Libya,16-02-2020,25364,1552,201,25163,Eastern Mediterranean
West Bank and Gaza,16-02-2020,208857,824,441,208416,Eastern Mediterranean
Guinea-Bissau,16-02-2020,287176,866,696,286480,Africa
Mali,16-02-2020,52280,2203,657,51623,Africa
Saint Kitts and Nevis,16-02-2020,34170,1831,398,33772,Americas
Canada,16-02-2020,162406,159,981,161425,Americas
Canada,16-02-2020,83948,752,80,83868,Americas
Kosovo,16-02-2020,434028,976,896,433132,Europe
Burma,16-02-2020,36413,1464,817,35596,South-East Asia
United Kingdom,16-02-2020,224420,2412,1019,223401,Europe
United Kingdom,16-02-2020,92038,1114,221,91817,Europe
United Kingdom,16-02-2020,308421,1986,537,307884,Europe
Botswana,16-02-2020,254242,1334,315,253927,Africa
Burundi,16-02-2020,96350,322,438,95912,Africa
Sierra Leone,16-02-2020,80318,2169,310,80008,Africa
Malawi,16-02-2020,2180,1536,436,1744,Africa
United Kingdom,16-02-2020,444830,1710,159,444671,Europe
France,16-02-2020,169920,2076,454,169466,Europe
South Sudan,16-02-2020,282022,808,1031,280991,Africa
Western Sahara,16-02-2020,22169,1066,581,21588,Africa
Sao Tome and Principe,16-02-2020,401136,2324,1202,399934,Africa
Yemen,16-02-2020,240189,1050,645,239544,Eastern Mediterranean
Comoros,16-02-2020,335726,424,219,335507,Africa
Tajikistan,16-02-2020,388992,1089,232,388760,Europe
Lesotho,16-02-2020,214036,1499,1247,212789,Africa
Afghanistan,17-02-2020,341670,1248,621,341049,Eastern Mediterranean
Albania,17-02-2020,335514,1616,210,335304,Europe
Algeria,17-02-2020,119987,1004,437,119550,Africa
Andorra,17-02-2020,163357,403,1091,162266,Europe
Angola,17-02-2020,445151,449,298,444853,Africa
Antigua and Barbuda,17-02-2020,132471,2014,842,131629,Americas
Argentina,17-02-2020,267113,727,974,266139,Americas
Armenia,17-02-2020,441184,954,21,441163,Europe
Australia,17-02-2020,356250,1796,856,355394,Western Pacific
Australia,17-02-2020,170811,765,670,170141,Western Pacific
Australia,17-02-2020,40903,1198,23,40880,Western Pacific
Australia,17-02-2020,149252,1614,814,148438,Western Pacific
Australia,17-02-2020,53606,2445,514,53092,Western Pacific
Australia,17-02-2020,46519,167,252,46267,Western Pacific
Australia,17-02-2020,337774,1711,409,337365,Western Pacific
Australia,17-02-2020,427905,663,82,427823,Western Pacific
Austria,17-02-2020,420342,952,589,419753,Europe
Azerbaijan,17-02-2020,225695,947,1149,224546,Europe
Bahamas,17-02-2020,318064,284,725,317339,Americas
Bahrain,17-02-2020,85029,2318,687,84342,Eastern Mediterranean
Bangladesh,17-02-2020,227509,932,1176,226333,South-East Asia
Barbados,17-02-2020,43792,2040,458,43334,Americas
Belarus,17-02-2020,330373,2382,297,330076,Europe
Belgium,17-02-2020,336075,2173,972,335103,Europe
Benin,17-02-2020,33328,122,471,32857,Africa
Bhutan,17-02-2020,131912,370,144,131768,South-East Asia
Bolivia,17-02-2020,185700,1833,1221,184479,Americas
Bosnia and Herzegovina,17-02-2020,340595,963,871,339724,Europe
Brazil,17-02-2020,177883,2037,557,177326,Americas
Brunei,17-02-2020,380045,1300,27,380018,Western Pacific
Bulgaria,17-02-2020,298863,1328,1172,297691,Europe
Burkina Faso,17-02-2020,70245,2454,629,69616,Africa
Cabo Verde,17-02-2020,339798,555,610,339188,Africa
Cambodia,17-02-2020,379954,1612,1069,378885,Western Pacific
Cameroon,17-02-2020,350273,351,614,349659,Africa
Canada,17-02-2020,109425,301,1021,108404,Americas
Canada,17-02-2020,108847,1870,980,107867,Americas
Canada,17-02-2020,258839,1821,602,258237,Americas
Canada,17-02-2020,30287,1986,940,29347,Americas
Canada,17-02-2020,129290,1680,757,128533,Americas
Canada,17-02-2020,98632,1729,592,98040,Americas
Canada,17-02-2020,371503,746,400,371103,Americas
Canada,17-02-2020,283182,2428,418,282764,Americas
Canada,17-02-2020,201828,1642,456,201372,Americas
Canada,17-02-2020,425193,1805,568,424625,Americas
Central African Republic,17-02-2020,118043,1401,154,117889,Africa
Chad,17-02-2020,277392,2452,131,277261,Africa
Chile,17-02-2020,174265,1533,575,173690,Americas
China,17-02-2020,441528,1847,426,441102,Western Pacific
China,17-02-2020,227276,620,1073,226203,Western Pacific
China,17-02-2020,8068,2222,902,7166,Western Pacific
China,17-02-2020,97457,2,1,97456,Western Pacific
China,17-02-2020,7720,1815,886,6834,Western Pacific
China,17-02-2020,127810,599,372,127438,Western Pacific
China,17-02-2020,66055,2185,202,65853,Western Pacific
China,17-02-2020,37713,1279,370,37343,Western Pacific
China,17-02-2020,138284,415,1242,137042,Western Pacific
China,17-02-2020,123894,1244,739,123155,Western Pacific
China,17-02-2020,427627,1618,560,427067,Western Pacific
China,17-02-2020,209681,1670,749,208932,Western Pacific
China,17-02-2020,329810,729,569,329241,Western Pacific
China,17-02-2020,329686,1743,584,329102,Western Pacific
China,17-02-2020,240124,2149,65,240059,Western Pacific
China,17-02-2020,99675,2398,87,99588,Western Pacific
China,17-02-2020,352456,11,1170,351286,Western Pacific
China,17-02-2020,288041,2404,419,287622,Western Pacific
China,17-02-2020,359119,1856,758,358361,Western Pacific
China,17-02-2020,76118,2107,505,75613,Western Pacific
China,17-02-2020,89639,1932,781,88858,Western Pacific
China,17-02-2020,250207,1030,546,249661,Western Pacific
China,17-02-2020,249021,871,243,248778,Western Pacific
China,17-02-2020,379136,1174,1033,378103,Western Pacific
China,17-02-2020,346202,1201,170,346032,Western Pacific
China,17-02-2020,410079,2486,676,409403,Western Pacific
China,17-02-2020,200307,661,78,200229,Western Pacific
China,17-02-2020,386171,2348,1154,385017,Western Pacific
China,17-02-2020,23755,1891,114,23641,Western Pacific
China,17-02-2020,329143,2192,326,328817,Western Pacific
China,17-02-2020,449146,98,999,448147,Western Pacific
China,17-02-2020,374861,2017,605,374256,Western Pacific
China,17-02-2020,306475,1829,593,305882,Western Pacific
Colombia,17-02-2020,65841,1357,841,65000,Americas
Congo (Brazzaville),17-02-2020,38289,416,1149,37140,Africa
Congo (Kinshasa),17-02-2020,294021,858,452,293569,Africa
Costa Rica,17-02-2020,258551,1309,744,257807,Americas
Cote d'Ivoire,17-02-2020,79272,1410,438,78834,Africa
Croatia,17-02-2020,33058,1408,428,32630,Europe
Cuba,17-02-2020,54192,1880,82,54110,Americas
Cyprus,17-02-2020,83393,509,487,82906,Europe
Czechia,17-02-2020,38803,969,647,38156,Europe
Denmark,17-02-2020,269546,2349,1040,268506,Europe
Greenland,17-02-2020,219419,2326,930,218489,Europe
Denmark,17-02-2020,99078,990,976,98102,Europe
Djibouti,17-02-2020,169890,2029,548,169342,Eastern Mediterranean
Dominican Republic,17-02-2020,80698,903,160,80538,Americas
Ecuador,17-02-2020,276876,1061,629,276247,Americas
Egypt,17-02-2020,326909,1021,174,326735,Eastern Mediterranean
El Salvador,17-02-2020,421372,456,551,420821,Americas
Equatorial Guinea,17-02-2020,385785,11,681,385104,Africa
Eritrea,17-02-2020,449081,468,311,448770,Africa
Estonia,17-02-2020,224547,627,583,223964,Europe
Eswatini,17-02-2020,334910,1450,946,333964,Africa
Ethiopia,17-02-2020,57881,1420,807,57074,Africa
Fiji,17-02-2020,187055,200,1162,185893,Western Pacific
Finland,17-02-2020,435158,1168,430,434728,Europe
France,17-02-2020,173649,1079,579,173070,Europe
France,17-02-2020,134675,871,1195,133480,Europe
France,17-02-2020,173068,663,546,172522,Europe
France,17-02-2020,423380,682,589,422791,Europe
France,17-02-2020,338091,1725,956,337135,Europe
France,17-02-2020,228521,222,371,228150,Europe
France,17-02-2020,192087,1809,478,191609,Europe
France,17-02-2020,273891,422,1100,272791,Europe
France,17-02-2020,225139,2223,672,224467,Europe
France,17-02-2020,158987,2414,329,158658,Europe
Gabon,17-02-2020,142734,2371,1162,141572,Africa
Gambia,17-02-2020,267592,213,884,266708,Africa
Georgia,17-02-2020,63594,2321,199,63395,Europe
Germany,17-02-2020,119384,128,611,118773,Europe
Ghana,17-02-2020,377052,230,976,376076,Africa
Greece,17-02-2020,311546,1722,482,311064,Europe
Guatemala,17-02-2020,418851,1582,769,418082,Americas
Guinea,17-02-2020,267582,1179,1096,266486,Africa
Guyana,17-02-2020,331357,2181,424,330933,Americas
Haiti,17-02-2020,298066,1567,1023,297043,Americas
Holy See,17-02-2020,114031,2113,524,113507,Europe
Honduras,17-02-2020,185779,828,992,184787,Americas
Hungary,17-02-2020,68560,2469,865,67695,Europe
Iceland,17-02-2020,220112,1078,596,219516,Europe
India,17-02-2020,321163,2017,256,320907,South-East Asia
Indonesia,17-02-2020,361193,137,1161,360032,South-East Asia
Iran,17-02-2020,211711,1870,598,211113,Eastern Mediterranean
Iraq,17-02-2020,133832,356,969,132863,Eastern Mediterranean
Ireland,17-02-2020,167679,1675,1240,166439,Europe
Israel,17-02-2020,157618,1262,751,156867,Europe
Italy,17-02-2020,347829,674,781,347048,Europe
Jamaica,17-02-2020,192530,659,193,192337,Americas
Japan,17-02-2020,359022,1764,963,358059,Western Pacific
Jordan,17-02-2020,319772,2196,920,318852,Eastern Mediterranean
Kazakhstan,17-02-2020,436238,162,881,435357,Europe
Kenya,17-02-2020,166912,1642,585,166327,Africa
South Korea,17-02-2020,424169,120,218,423951,Western Pacific
Kuwait,17-02-2020,311882,1127,258,311624,Eastern Mediterranean
Kyrgyzstan,17-02-2020,403340,2159,911,402429,Europe
Latvia,17-02-2020,262042,2181,943,261099,Europe
Lebanon,17-02-2020,238125,1168,68,238057,Eastern Mediterranean
Liberia,17-02-2020,368917,996,540,368377,Africa
Liechtenstein,17-02-2020,21886,898,773,21113,Europe
Lithuania,17-02-2020,403351,1959,1167,402184,Europe
Luxembourg,17-02-2020,360112,1233,991,359121,Europe
Madagascar,17-02-2020,66107,1539,860,65247,Africa
Malaysia,17-02-2020,264203,850,214,263989,Western Pacific
Maldives,17-02-2020,146616,2256,1053,145563,South-East Asia
Malta,17-02-2020,328098,184,13,328085,Europe
Mauritania,17-02-2020,431105,1947,799,430306,Africa
Mauritius,17-02-2020,207763,643,536,207227,Africa
Mexico,17-02-2020,428955,590,1190,427765,Americas
Moldova,17-02-2020,249424,1418,502,248922,Europe
Monaco,17-02-2020,156317,1647,687,155630,Europe
Mongolia,17-02-2020,7772,720,1241,6531,Western Pacific
Montenegro,17-02-2020,424592,388,125,424467,Europe
Morocco,17-02-2020,377109,1509,1031,376078,Eastern Mediterranean
Namibia,17-02-2020,315909,276,69,315840,Africa
Nepal,17-02-2020,421548,2040,1023,420525,South-East Asia
Netherlands,17-02-2020,101595,12,1064,100531,Europe
Netherlands,17-02-2020,146972,599,598,146374,Europe
Netherlands,17-02-2020,289559,1277,840,288719,Europe
Netherlands,17-02-2020,403962,864,433,403529,Europe
New Zealand,17-02-2020,121966,2468,779,121187,Western Pacific
Nicaragua,17-02-2020,393996,1553,147,393849,Americas
Niger,17-02-2020,324332,805,433,323899,Africa
Nigeria,17-02-2020,220590,562,399,220191,Africa
North Macedonia,17-02-2020,224412,1291,627,223785,Europe
Norway,17-02-2020,422350,503,641,421709,Europe
Oman,17-02-2020,94179,407,44,94135,Eastern Mediterranean
Pakistan,17-02-2020,325650,2475,583,325067,Eastern Mediterranean
Panama,17-02-2020,163006,1955,104,162902,Americas
Papua New Guinea,17-02-2020,7942,633,513,7429,Western Pacific
Paraguay,17-02-2020,156418,2492,527,155891,Americas
Peru,17-02-2020,148293,2341,833,147460,Americas
Philippines,17-02-2020,436317,612,864,435453,Western Pacific
Poland,17-02-2020,69439,1223,858,68581,Europe
Portugal,17-02-2020,117681,1554,1150,116531,Europe
Qatar,17-02-2020,141560,1200,349,141211,Eastern Mediterranean
Romania,17-02-2020,47102,380,326,46776,Europe
Russia,17-02-2020,384466,1985,1069,383397,Europe
Rwanda,17-02-2020,188032,323,674,187358,Africa
Saint Lucia,17-02-2020,359468,2474,1169,358299,Americas
Saint Vincent and the Grenadines,17-02-2020,163816,948,746,163070,Americas
San Marino,17-02-2020,239187,585,651,238536,Europe
Saudi Arabia,17-02-2020,362983,1317,27,362956,Eastern Mediterranean
Senegal,17-02-2020,109294,1836,609,108685,Africa
Serbia,17-02-2020,164311,1861,993,163318,Europe
Seychelles,17-02-2020,310365,1681,288,310077,Africa
Singapore,17-02-2020,162596,521,622,161974,Western Pacific
Slovakia,17-02-2020,210537,1812,1197,209340,Europe
Slovenia,17-02-2020,103735,417,662,103073,Europe
Somalia,17-02-2020,93450,1958,318,93132,Eastern Mediterranean
South Africa,17-02-2020,13912,88,409,13503,Africa
Spain,17-02-2020,373408,1131,1207,372201,Europe
Sri Lanka,17-02-2020,35735,1675,96,35639,South-East Asia
Sudan,17-02-2020,250268,241,1100,249168,Eastern Mediterranean
Suriname,17-02-2020,30613,1802,621,29992,Americas
Sweden,17-02-2020,170580,1107,703,169877,Europe
Switzerland,17-02-2020,373129,1473,613,372516,Europe
Taiwan*,17-02-2020,431636,208,639,430997,Western Pacific
Tanzania,17-02-2020,436875,1203,69,436806,Africa
Thailand,17-02-2020,332828,1003,134,332694,South-East Asia
Togo,17-02-2020,318596,258,534,318062,Africa
Trinidad and Tobago,17-02-2020,23878,1028,593,23285,Americas
Tunisia,17-02-2020,251927,2496,780,251147,Eastern Mediterranean
Turkey,17-02-2020,429666,487,497,429169,Europe
Uganda,17-02-2020,190626,2212,1237,189389,Africa
Ukraine,17-02-2020,358693,180,351,358342,Europe
United Arab Emirates,17-02-2020,20724,2081,399,20325,Eastern Mediterranean
United Kingdom,17-02-2020,368180,563,349,367831,Europe
United Kingdom,17-02-2020,217367,1243,987,216380,Europe
United Kingdom,17-02-2020,323522,328,297,323225,Europe
United Kingdom,17-02-2020,331343,1593,292,331051,Europe
United Kingdom,17-02-2020,95047,763,19,95028,Europe
United Kingdom,17-02-2020,279365,1058,674,278691,Europe
United Kingdom,17-02-2020,361780,1083,1022,360758,Europe
Uruguay,17-02-2020,52075,851,896,51179,Americas
US,17-02-2020,130454,2372,744,129710,Americas
Uzbekistan,17-02-2020,2246,902,556,1690,Europe
Venezuela,17-02-2020,363506,2026,754,362752,Americas
Vietnam,17-02-2020,343244,795,1131,342113,Western Pacific
Zambia,17-02-2020,133604,2040,96,133508,Africa
Zimbabwe,17-02-2020,48135,1565,1232,46903,Africa
Dominica,17-02-2020,193409,376,931,192478,Americas
Grenada,17-02-2020,304520,1312,282,304238,Americas
Mozambique,17-02-2020,1910,1355,305,1605,Africa
Syria,17-02-2020,246344,504,640,245704,Eastern Mediterranean
Timor-Leste,17-02-2020,84606,1917,867,83739,South-East Asia
Belize,17-02-2020,68564,22,1061,67503,Americas
Laos,17-02-2020,150813,1938,435,150378,Western Pacific
Libya,17-02-2020,271014,1815,33,270981,Eastern Mediterranean
West Bank and Gaza,17-02-2020,164292,2297,212,164080,Eastern Mediterranean
Guinea-Bissau,17-02-2020,185902,1125,713,185189,Africa
Mali,17-02-2020,246035,553,548,245487,Africa
Saint Kitts and Nevis,17-02-2020,26725,814,68,26657,Americas
Canada,17-02-2020,193503,2135,621,192882,Americas
Canada,17-02-2020,213280,397,526,212754,Americas
Kosovo,17-02-2020,41397,1565,1227,40170,Europe
Burma,17-02-2020,12937,348,347,12590,South-East Asia
United Kingdom,17-02-2020,390968,52,706,390262,Europe
United Kingdom,17-02-2020,129029,140,223,128806,Europe
United Kingdom,17-02-2020,370493,1939,823,369670,Europe
Botswana,17-02-2020,407580,992,221,407359,Africa
Burundi,17-02-2020,78954,767,1189,77765,Africa
Sierra Leone,17-02-2020,438902,721,947,437955,Africa
Malawi,17-02-2020,212006,1064,203,211803,Africa
United Kingdom,17-02-2020,426137,1023,601,425536,Europe
France,17-02-2020,52333,1946,1010,51323,Europe
South Sudan,17-02-2020,211461,229,825,210636,Africa
Western Sahara,17-02-2020,270837,1176,694,270143,Africa
Sao Tome and Principe,17-02-2020,58723,7,579,58144,Africa
Yemen,17-02-2020,87012,1322,1030,85982,Eastern Mediterranean
Comoros,17-02-2020,68735,2489,511,68224,Africa
Tajikistan,17-02-2020,377589,1037,770,376819,Europe
Lesotho,17-02-2020,43859,210,911,42948,Africa
Afghanistan,18-02-2020,334587,2213,187,334400,Eastern Mediterranean
Albania,18-02-2020,56476,110,1205,55271,Europe
Algeria,18-02-2020,429771,614,151,429620,Africa
Andorra,18-02-2020,335568,173,897,334671,Europe
Angola,18-02-2020,110382,205,1090,109292,Africa
Antigua and Barbuda,18-02-2020,443958,1295,33,443925,Americas
Argentina,18-02-2020,265554,930,425,265129,Americas
Armenia,18-02-2020,410606,348,780,409826,Europe
Australia,18-02-2020,16728,444,513,16215,Western Pacific
Australia,18-02-2020,14300,1366,77,14223,Western Pacific
Australia,18-02-2020,92511,1107,1096,91415,Western Pacific
Australia,18-02-2020,18287,1237,585,17702,Western Pacific
Australia,18-02-2020,391113,1140,1,391112,Western Pacific
Australia,18-02-2020,150281,1955,957,149324,Western Pacific
Australia,18-02-2020,282983,872,679,282304,Western Pacific
Australia,18-02-2020,387495,2137,8,387487,Western Pacific
Austria,18-02-2020,176558,1260,814,175744,Europe
Azerbaijan,18-02-2020,243368,2467,872,242496,Europe
Bahamas,18-02-2020,342164,542,606,341558,Americas
Bahrain,18-02-2020,308035,1867,495,307540,Eastern Mediterranean
Bangladesh,18-02-2020,606,1671,361,245,South-East Asia
Barbados,18-02-2020,296049,2083,725,295324,Americas
Belarus,18-02-2020,290417,1674,956,289461,Europe
Belgium,18-02-2020,245786,1215,395,245391,Europe
Benin,18-02-2020,367308,953,994,366314,Africa
Bhutan,18-02-2020,31745,1713,425,31320,South-East Asia
Bolivia,18-02-2020,110423,740,197,110226,Americas
Bosnia and Herzegovina,18-02-2020,178464,1284,851,177613,Europe
Brazil,18-02-2020,318343,702,741,317602,Americas
Brunei,18-02-2020,300020,294,690,299330,Western Pacific
Bulgaria,18-02-2020,246514,1509,849,245665,Europe
Burkina Faso,18-02-2020,327191,169,832,326359,Africa
Cabo Verde,18-02-2020,124820,1532,869,123951,Africa
Cambodia,18-02-2020,140425,1718,1187,139238,Western Pacific
Cameroon,18-02-2020,156987,1238,1060,155927,Africa
Canada,18-02-2020,50039,496,560,49479,Americas
Canada,18-02-2020,417065,1051,516,416549,Americas
Canada,18-02-2020,302338,172,1007,301331,Americas
Canada,18-02-2020,413462,2306,775,412687,Americas
Canada,18-02-2020,308317,544,1084,307233,Americas
Canada,18-02-2020,176965,110,1149,175816,Americas
Canada,18-02-2020,181834,2028,382,181452,Americas
Canada,18-02-2020,120924,1717,1116,119808,Americas
Canada,18-02-2020,288743,1671,375,288368,Americas
Canada,18-02-2020,359787,2156,547,359240,Americas
Central African Republic,18-02-2020,233141,1802,498,232643,Africa
Chad,18-02-2020,425977,74,1116,424861,Africa
Chile,18-02-2020,447265,332,1166,446099,Americas
China,18-02-2020,266366,538,136,266230,Western Pacific
China,18-02-2020,122982,2371,629,122353,Western Pacific
China,18-02-2020,91073,1939,1088,89985,Western Pacific
China,18-02-2020,421907,407,1099,420808,Western Pacific
China,18-02-2020,111174,307,834,110340,Western Pacific
China,18-02-2020,118051,1068,692,117359,Western Pacific
China,18-02-2020,175043,1176,1113,173930,Western Pacific
China,18-02-2020,270214,90,1156,269058,Western Pacific
China,18-02-2020,413575,2221,1106,412469,Western Pacific
China,18-02-2020,12271,2193,507,11764,Western Pacific
China,18-02-2020,46504,1737,678,45826,Western Pacific
China,18-02-2020,167601,352,1230,166371,Western Pacific
China,18-02-2020,297184,705,164,297020,Western Pacific
China,18-02-2020,189130,916,411,188719,Western Pacific
China,18-02-2020,442904,1793,385,442519,Western Pacific
China,18-02-2020,335531,1895,181,335350,Western Pacific
China,18-02-2020,175045,1009,941,174104,Western Pacific
China,18-02-2020,446903,374,752,446151,Western Pacific
China,18-02-2020,350539,2089,484,350055,Western Pacific
China,18-02-2020,29805,462,1041,28764,Western Pacific
China,18-02-2020,211429,2215,378,211051,Western Pacific
China,18-02-2020,287440,2464,37,287403,Western Pacific
China,18-02-2020,1854,991,207,1647,Western Pacific
China,18-02-2020,174075,539,140,173935,Western Pacific
China,18-02-2020,235718,599,1084,234634,Western Pacific
China,18-02-2020,307304,1491,1142,306162,Western Pacific
China,18-02-2020,423515,2201,1244,422271,Western Pacific
China,18-02-2020,407150,1543,848,406302,Western Pacific
China,18-02-2020,302843,1464,51,302792,Western Pacific
China,18-02-2020,109137,210,1029,108108,Western Pacific
China,18-02-2020,166429,893,501,165928,Western Pacific
China,18-02-2020,181074,2410,245,180829,Western Pacific
China,18-02-2020,102568,1201,569,101999,Western Pacific
Colombia,18-02-2020,297137,1611,794,296343,Americas
Congo (Brazzaville),18-02-2020,230337,2461,148,230189,Africa
Congo (Kinshasa),18-02-2020,90053,1660,507,89546,Africa
Costa Rica,18-02-2020,47114,1621,644,46470,Americas
Cote d'Ivoire,18-02-2020,376497,1093,896,375601,Africa
Croatia,18-02-2020,265032,232,156,264876,Europe
Cuba,18-02-2020,429228,1190,328,428900,Americas
Cyprus,18-02-2020,124906,298,403,124503,Europe
Czechia,18-02-2020,300791,965,994,299797,Europe
Denmark,18-02-2020,77732,1867,240,77492,Europe
Greenland,18-02-2020,96820,150,238,96582,Europe
Denmark,18-02-2020,211264,1337,1160,210104,Europe
Djibouti,18-02-2020,176933,2090,162,176771,Eastern Mediterranean
Dominican Republic,18-02-2020,284010,1809,168,283842,Americas
Ecuador,18-02-2020,283549,1803,289,283260,Americas
Egypt,18-02-2020,143518,704,762,142756,Eastern Mediterranean
El Salvador,18-02-2020,130662,2471,272,130390,Americas
Equatorial Guinea,18-02-2020,409817,892,1248,408569,Africa
Eritrea,18-02-2020,213603,1001,1038,212565,Africa
Estonia,18-02-2020,193069,1635,815,192254,Europe
Eswatini,18-02-2020,136832,1595,743,136089,Africa
Ethiopia,18-02-2020,444159,1198,704,443455,Africa
Fiji,18-02-2020,159920,1134,923,158997,Western Pacific
Finland,18-02-2020,446115,493,518,445597,Europe
France,18-02-2020,425978,1372,295,425683,Europe
France,18-02-2020,290808,1796,987,289821,Europe
France,18-02-2020,145084,1857,61,145023,Europe
France,18-02-2020,177569,1231,981,176588,Europe
France,18-02-2020,391160,623,897,390263,Europe
France,18-02-2020,263429,2282,101,263328,Europe
France,18-02-2020,106487,1540,21,106466,Europe
France,18-02-2020,195167,2025,339,194828,Europe
France,18-02-2020,181639,2068,931,180708,Europe
France,18-02-2020,411221,926,464,410757,Europe
Gabon,18-02-2020,374275,819,712,373563,Africa
Gambia,18-02-2020,191113,1043,638,190475,Africa
Georgia,18-02-2020,398741,1663,180,398561,Europe
Germany,18-02-2020,12565,142,110,12455,Europe
Ghana,18-02-2020,357817,2181,958,356859,Africa
Greece,18-02-2020,392985,2233,1056,391929,Europe
Guatemala,18-02-2020,126253,1895,466,125787,Americas
Guinea,18-02-2020,381144,2071,288,380856,Africa
Guyana,18-02-2020,20452,2263,607,19845,Americas
Haiti,18-02-2020,363020,565,171,362849,Americas
Holy See,18-02-2020,449819,1178,678,449141,Europe
Honduras,18-02-2020,160,575,805,-645,Americas
Hungary,18-02-2020,253083,1288,459,252624,Europe
Iceland,18-02-2020,310311,1822,595,309716,Europe
India,18-02-2020,213740,189,157,213583,South-East Asia
Indonesia,18-02-2020,123908,416,847,123061,South-East Asia
Iran,18-02-2020,96653,2283,212,96441,Eastern Mediterranean
Iraq,18-02-2020,328589,2116,253,328336,Eastern Mediterranean
Ireland,18-02-2020,447033,1837,1246,445787,Europe
Israel,18-02-2020,250911,1531,1048,249863,Europe
Italy,18-02-2020,374006,1389,316,373690,Europe
Jamaica,18-02-2020,423706,1167,908,422798,Americas
Japan,18-02-2020,167157,1150,134,167023,Western Pacific
Jordan,18-02-2020,306944,808,568,306376,Eastern Mediterranean
Kazakhstan,18-02-2020,397391,580,130,397261,Europe
Kenya,18-02-2020,229576,607,360,229216,Africa
South Korea,18-02-2020,445914,2386,1191,444723,Western Pacific
Kuwait,18-02-2020,189854,784,318,189536,Eastern Mediterranean
Kyrgyzstan,18-02-2020,135640,734,141,135499,Europe
Latvia,18-02-2020,54449,1302,844,53605,Europe
Lebanon,18-02-2020,59986,1906,675,59311,Eastern Mediterranean
Liberia,18-02-2020,146654,2192,1194,145460,Africa
Liechtenstein,18-02-2020,6494,874,1064,5430,Europe
Lithuania,18-02-2020,396240,1010,554,395686,Europe
Luxembourg,18-02-2020,298707,1369,1092,297615,Europe
Madagascar,18-02-2020,188088,1719,960,187128,Africa
Malaysia,18-02-2020,347755,722,1076,346679,Western Pacific
Maldives,18-02-2020,324287,609,1067,323220,South-East Asia
Malta,18-02-2020,168733,423,867,167866,Europe
Mauritania,18-02-2020,112629,2420,738,111891,Africa
Mauritius,18-02-2020,243420,845,69,243351,Africa
Mexico,18-02-2020,70364,1228,243,70121,Americas
Moldova,18-02-2020,221991,2385,691,221300,Europe
Monaco,18-02-2020,417544,420,820,416724,Europe
Mongolia,18-02-2020,137084,1766,1181,135903,Western Pacific
Montenegro,18-02-2020,170599,232,248,170351,Europe
Morocco,18-02-2020,83751,1937,571,83180,Eastern Mediterranean
Namibia,18-02-2020,318291,1248,224,318067,Africa
Nepal,18-02-2020,231156,771,505,230651,South-East Asia
Netherlands,18-02-2020,380411,764,1030,379381,Europe
Netherlands,18-02-2020,271468,1434,215,271253,Europe
Netherlands,18-02-2020,102089,1669,1064,101025,Europe
Netherlands,18-02-2020,425934,1289,70,425864,Europe
New Zealand,18-02-2020,346138,1078,432,345706,Western Pacific
Nicaragua,18-02-2020,107335,1720,513,106822,Americas
Niger,18-02-2020,211172,1163,948,210224,Africa
Nigeria,18-02-2020,309298,124,498,308800,Africa
North Macedonia,18-02-2020,214977,927,1149,213828,Europe
Norway,18-02-2020,369540,287,873,368667,Europe
Oman,18-02-2020,132707,1901,362,132345,Eastern Mediterranean
Pakistan,18-02-2020,334394,174,919,333475,Eastern Mediterranean
Panama,18-02-2020,45116,1874,752,44364,Americas
Papua New Guinea,18-02-2020,135891,1413,523,135368,Western Pacific
Paraguay,18-02-2020,389485,124,30,389455,Americas
Peru,18-02-2020,33819,2229,1088,32731,Americas
Philippines,18-02-2020,164546,569,935,163611,Western Pacific
Poland,18-02-2020,360015,876,1170,358845,Europe
Portugal,18-02-2020,331084,1224,647,330437,Europe
Qatar,18-02-2020,322938,1682,1250,321688,Eastern Mediterranean
Romania,18-02-2020,215655,1029,693,214962,Europe
Russia,18-02-2020,357794,1218,183,357611,Europe
Rwanda,18-02-2020,329758,1586,518,329240,Africa
Saint Lucia,18-02-2020,298408,467,57,298351,Americas
Saint Vincent and the Grenadines,18-02-2020,191986,1791,714,191272,Americas
San Marino,18-02-2020,165638,2235,878,164760,Europe
Saudi Arabia,18-02-2020,434307,2121,285,434022,Eastern Mediterranean
Senegal,18-02-2020,138500,1547,626,137874,Africa
Serbia,18-02-2020,81032,2319,95,80937,Europe
Seychelles,18-02-2020,266506,1214,65,266441,Africa
Singapore,18-02-2020,225121,2309,1098,224023,Western Pacific
Slovakia,18-02-2020,9614,2201,362,9252,Europe
Slovenia,18-02-2020,322789,2208,1059,321730,Europe
Somalia,18-02-2020,150796,1587,495,150301,Eastern Mediterranean
South Africa,18-02-2020,204582,874,746,203836,Africa
Spain,18-02-2020,399175,2142,56,399119,Europe
Sri Lanka,18-02-2020,44682,162,1247,43435,South-East Asia
Sudan,18-02-2020,7573,821,66,7507,Eastern Mediterranean
Suriname,18-02-2020,419068,416,336,418732,Americas
Sweden,18-02-2020,40029,1256,962,39067,Europe
Switzerland,18-02-2020,257544,1160,825,256719,Europe
Taiwan*,18-02-2020,351647,2315,1162,350485,Western Pacific
Tanzania,18-02-2020,285285,1070,986,284299,Africa
Thailand,18-02-2020,449588,419,170,449418,South-East Asia
Togo,18-02-2020,321959,1744,229,321730,Africa
Trinidad and Tobago,18-02-2020,139611,1859,850,138761,Americas
Tunisia,18-02-2020,396127,62,757,395370,Eastern Mediterranean
Turkey,18-02-2020,432258,1537,149,432109,Europe
Uganda,18-02-2020,208179,364,453,207726,Africa
Ukraine,18-02-2020,37105,2442,721,36384,Europe
United Arab Emirates,18-02-2020,127498,29,521,126977,Eastern Mediterranean
United Kingdom,18-02-2020,183026,1444,241,182785,Europe
United Kingdom,18-02-2020,110833,105,1146,109687,Europe
United Kingdom,18-02-2020,265679,558,184,265495,Europe
United Kingdom,18-02-2020,78552,1772,1063,77489,Europe
United Kingdom,18-02-2020,261939,2220,227,261712,Europe
United Kingdom,18-02-2020,133631,452,450,133181,Europe
United Kingdom,18-02-2020,205461,395,247,205214,Europe
Uruguay,18-02-2020,323509,348,1027,322482,Americas
US,18-02-2020,100718,1805,1131,99587,Americas
Uzbekistan,18-02-2020,125079,1092,888,124191,Europe
Venezuela,18-02-2020,444967,1650,403,444564,Americas
Vietnam,18-02-2020,190545,321,1011,189534,Western Pacific
Zambia,18-02-2020,255843,299,200,255643,Africa
Zimbabwe,18-02-2020,262539,1101,466,262073,Africa
Dominica,18-02-2020,156556,673,1024,155532,Americas
Grenada,18-02-2020,34036,1548,1226,32810,Americas
Mozambique,18-02-2020,255684,840,210,255474,Africa
Syria,18-02-2020,434248,1818,678,433570,Eastern Mediterranean
Timor-Leste,18-02-2020,397839,2437,1003,396836,South-East Asia
Belize,18-02-2020,326333,2365,1015,325318,Americas
Laos,18-02-2020,76567,636,329,76238,Western Pacific
Libya,18-02-2020,86203,97,750,85453,Eastern Mediterranean
West Bank and Gaza,18-02-2020,152132,1069,873,151259,Eastern Mediterranean
Guinea-Bissau,18-02-2020,31261,68,260,31001,Africa
Mali,18-02-2020,344594,94,755,343839,Africa
Saint Kitts and Nevis,18-02-2020,114537,436,939,113598,Americas
Canada,18-02-2020,211956,1228,354,211602,Americas
Canada,18-02-2020,50999,1759,564,50435,Americas
Kosovo,18-02-2020,317047,1321,999,316048,Europe
Burma,18-02-2020,303033,630,860,302173,South-East Asia
United Kingdom,18-02-2020,234194,2247,90,234104,Europe
United Kingdom,18-02-2020,203186,1150,1090,202096,Europe
United Kingdom,18-02-2020,46303,522,429,45874,Europe
Botswana,18-02-2020,65403,1221,1193,64210,Africa
Burundi,18-02-2020,36323,252,13,36310,Africa
Sierra Leone,18-02-2020,35668,1419,181,35487,Africa
Malawi,18-02-2020,165034,487,413,164621,Africa
United Kingdom,18-02-2020,187285,2204,984,186301,Europe
France,18-02-2020,271547,36,383,271164,Europe
South Sudan,18-02-2020,149895,590,176,149719,Africa
Western Sahara,18-02-2020,405893,140,1150,404743,Africa
Sao Tome and Principe,18-02-2020,205334,1741,776,204558,Africa
Yemen,18-02-2020,184321,1738,976,183345,Eastern Mediterranean
Comoros,18-02-2020,53500,1359,1160,52340,Africa
Tajikistan,18-02-2020,232013,443,104,231909,Europe
Lesotho,18-02-2020,379018,1550,546,378472,Africa
Afghanistan,19-02-2020,270542,1734,99,270443,Eastern Mediterranean
Albania,19-02-2020,162379,1192,583,161796,Europe
Algeria,19-02-2020,124727,1192,279,124448,Africa
Andorra,19-02-2020,401732,2299,333,401399,Europe
Angola,19-02-2020,204732,1586,1197,203535,Africa
Antigua and Barbuda,19-02-2020,165649,1842,259,165390,Americas
Argentina,19-02-2020,445273,2072,463,444810,Americas
Armenia,19-02-2020,313463,1801,79,313384,Europe
Australia,19-02-2020,169094,2458,1139,167955,Western Pacific
Australia,19-02-2020,174,680,922,-748,Western Pacific
Australia,19-02-2020,414595,868,102,414493,Western Pacific
Australia,19-02-2020,240744,1480,700,240044,Western Pacific
Australia,19-02-2020,382971,1024,972,381999,Western Pacific
Australia,19-02-2020,114469,847,582,113887,Western Pacific
Australia,19-02-2020,413704,2177,1138,412566,Western Pacific
Australia,19-02-2020,223470,44,1123,222347,Western Pacific
Austria,19-02-2020,75106,445,1145,73961,Europe
Azerbaijan,19-02-2020,441132,1162,204,440928,Europe
Bahamas,19-02-2020,243780,1864,119,243661,Americas
Bahrain,19-02-2020,426165,2173,1052,425113,Eastern Mediterranean
Bangladesh,19-02-2020,137068,713,557,136511,South-East Asia
Barbados,19-02-2020,207326,113,411,206915,Americas
Belarus,19-02-2020,19208,177,193,19015,Europe
Belgium,19-02-2020,216133,1157,1134,214999,Europe
Benin,19-02-2020,178928,2267,1115,177813,Africa
Bhutan,19-02-2020,381666,2458,1028,380638,South-East Asia
Bolivia,19-02-2020,101436,933,3,101433,Americas
Bosnia and Herzegovina,19-02-2020,104699,676,218,104481,Europe
Brazil,19-02-2020,392186,518,1129,391057,Americas
Brunei,19-02-2020,178384,2423,971,177413,Western Pacific
Bulgaria,19-02-2020,131163,368,719,130444,Europe
Burkina Faso,19-02-2020,102582,2233,383,102199,Africa
Cabo Verde,19-02-2020,174877,658,748,174129,Africa
Cambodia,19-02-2020,404876,383,1233,403643,Western Pacific
Cameroon,19-02-2020,444491,1716,366,444125,Africa
Canada,19-02-2020,22178,1270,595,21583,Americas
Canada,19-02-2020,96794,1186,494,96300,Americas
Canada,19-02-2020,427668,315,589,427079,Americas
Canada,19-02-2020,370535,2106,519,370016,Americas
Canada,19-02-2020,64296,1581,272,64024,Americas
Canada,19-02-2020,253451,1463,915,252536,Americas
Canada,19-02-2020,163156,172,946,162210,Americas
Canada,19-02-2020,28426,501,31,28395,Americas
Canada,19-02-2020,112218,576,528,111690,Americas
Canada,19-02-2020,202956,1287,630,202326,Americas
Central African Republic,19-02-2020,449766,291,937,448829,Africa
Chad,19-02-2020,338714,600,504,338210,Africa
Chile,19-02-2020,332884,2492,1060,331824,Americas
China,19-02-2020,308087,1185,490,307597,Western Pacific
China,19-02-2020,423918,1041,9,423909,Western Pacific
China,19-02-2020,141521,1722,642,140879,Western Pacific
China,19-02-2020,50726,1324,54,50672,Western Pacific
China,19-02-2020,386913,1963,170,386743,Western Pacific
China,19-02-2020,392473,920,939,391534,Western Pacific
China,19-02-2020,276197,399,1083,275114,Western Pacific
China,19-02-2020,87604,2135,1055,86549,Western Pacific
China,19-02-2020,301920,1038,104,301816,Western Pacific
China,19-02-2020,398884,1647,232,398652,Western Pacific
China,19-02-2020,188611,1425,499,188112,Western Pacific
China,19-02-2020,226295,517,380,225915,Western Pacific
China,19-02-2020,23240,938,693,22547,Western Pacific
China,19-02-2020,157144,43,283,156861,Western Pacific
China,19-02-2020,288077,2067,875,287202,Western Pacific
China,19-02-2020,385805,861,451,385354,Western Pacific
China,19-02-2020,184415,1502,335,184080,Western Pacific
China,19-02-2020,169763,560,584,169179,Western Pacific
China,19-02-2020,339383,1457,750,338633,Western Pacific
China,19-02-2020,227055,27,415,226640,Western Pacific
China,19-02-2020,26871,2105,395,26476,Western Pacific
China,19-02-2020,409483,1054,461,409022,Western Pacific
China,19-02-2020,3046,414,1208,1838,Western Pacific
China,19-02-2020,440244,895,306,439938,Western Pacific
China,19-02-2020,48557,705,896,47661,Western Pacific
China,19-02-2020,149097,2193,99,148998,Western Pacific
China,19-02-2020,31145,1960,1045,30100,Western Pacific
China,19-02-2020,281711,956,444,281267,Western Pacific
China,19-02-2020,50934,2178,1154,49780,Western Pacific
China,19-02-2020,120696,694,235,120461,Western Pacific
China,19-02-2020,363624,985,657,362967,Western Pacific
China,19-02-2020,138717,866,703,138014,Western Pacific
China,19-02-2020,369944,674,1156,368788,Western Pacific
Colombia,19-02-2020,8591,1525,819,7772,Americas
Congo (Brazzaville),19-02-2020,306846,865,183,306663,Africa
Congo (Kinshasa),19-02-2020,59160,678,220,58940,Africa
Costa Rica,19-02-2020,116105,1853,312,115793,Americas
Cote d'Ivoire,19-02-2020,136785,225,878,135907,Africa
Croatia,19-02-2020,176829,2273,829,176000,Europe
Cuba,19-02-2020,151347,1933,316,151031,Americas
Cyprus,19-02-2020,382345,611,70,382275,Europe
Czechia,19-02-2020,403741,1553,127,403614,Europe
Denmark,19-02-2020,407089,2274,547,406542,Europe
Greenland,19-02-2020,98832,119,271,98561,Europe
Denmark,19-02-2020,229688,843,235,229453,Europe
Djibouti,19-02-2020,43098,1856,1002,42096,Eastern Mediterranean
Dominican Republic,19-02-2020,156202,72,1081,155121,Americas
Ecuador,19-02-2020,109523,2484,1061,108462,Americas
Egypt,19-02-2020,309368,601,659,308709,Eastern Mediterranean
El Salvador,19-02-2020,414818,2061,469,414349,Americas
Equatorial Guinea,19-02-2020,109107,1516,1096,108011,Africa
Eritrea,19-02-2020,433326,936,7,433319,Africa
Estonia,19-02-2020,170632,2311,113,170519,Europe
Eswatini,19-02-2020,277722,1225,87,277635,Africa
Ethiopia,19-02-2020,143139,1320,461,142678,Africa
Fiji,19-02-2020,386918,212,297,386621,Western Pacific
Finland,19-02-2020,416199,974,944,415255,Europe
France,19-02-2020,419512,597,144,419368,Europe
France,19-02-2020,98210,2077,778,97432,Europe
France,19-02-2020,82720,1828,1195,81525,Europe
France,19-02-2020,70732,618,835,69897,Europe
France,19-02-2020,392557,461,562,391995,Europe
France,19-02-2020,397533,2231,90,397443,Europe
France,19-02-2020,365842,1815,706,365136,Europe
France,19-02-2020,263331,358,359,262972,Europe
France,19-02-2020,150513,1239,443,150070,Europe
France,19-02-2020,393049,1712,498,392551,Europe
Gabon,19-02-2020,279683,1925,796,278887,Africa
Gambia,19-02-2020,213612,1269,285,213327,Africa
Georgia,19-02-2020,251859,1289,599,251260,Europe
Germany,19-02-2020,414240,1035,321,413919,Europe
Ghana,19-02-2020,195048,718,505,194543,Africa
Greece,19-02-2020,167273,1145,1007,166266,Europe
Guatemala,19-02-2020,98550,1217,170,98380,Americas
Guinea,19-02-2020,400517,309,968,399549,Africa
Guyana,19-02-2020,220608,2193,1172,219436,Americas
Haiti,19-02-2020,191798,1317,1167,190631,Americas
Holy See,19-02-2020,127097,384,76,127021,Europe
Honduras,19-02-2020,167561,1800,1168,166393,Americas
Hungary,19-02-2020,178480,2126,124,178356,Europe
Iceland,19-02-2020,244811,1421,802,244009,Europe
India,19-02-2020,45113,1345,710,44403,South-East Asia
Indonesia,19-02-2020,210045,783,278,209767,South-East Asia
Iran,19-02-2020,139297,2101,702,138595,Eastern Mediterranean
Iraq,19-02-2020,326544,2297,117,326427,Eastern Mediterranean
Ireland,19-02-2020,436996,44,206,436790,Europe
Israel,19-02-2020,7316,1597,280,7036,Europe
Italy,19-02-2020,363313,1852,624,362689,Europe
Jamaica,19-02-2020,33904,2268,993,32911,Americas
Japan,19-02-2020,22621,2403,469,22152,Western Pacific
Jordan,19-02-2020,432825,910,1184,431641,Eastern Mediterranean
Kazakhstan,19-02-2020,297967,1743,359,297608,Europe
Kenya,19-02-2020,325642,1238,1054,324588,Africa
South Korea,19-02-2020,322441,1050,701,321740,Western Pacific
Kuwait,19-02-2020,108072,2253,1186,106886,Eastern Mediterranean
Kyrgyzstan,19-02-2020,172770,1409,14,172756,Europe
Latvia,19-02-2020,100814,636,476,100338,Europe
Lebanon,19-02-2020,433131,313,550,432581,Eastern Mediterranean
Liberia,19-02-2020,310091,1262,50,310041,Africa
Liechtenstein,19-02-2020,404166,1302,1026,403140,Europe
Lithuania,19-02-2020,132475,310,620,131855,Europe
Luxembourg,19-02-2020,5613,1244,774,4839,Europe
Madagascar,19-02-2020,294780,1112,933,293847,Africa
Malaysia,19-02-2020,98977,729,878,98099,Western Pacific
Maldives,19-02-2020,179354,1116,967,178387,South-East Asia
Malta,19-02-2020,426315,153,326,425989,Europe
Mauritania,19-02-2020,93350,2066,378,92972,Africa
Mauritius,19-02-2020,436452,661,368,436084,Africa
Mexico,19-02-2020,343678,2176,537,343141,Americas
Moldova,19-02-2020,281684,2241,548,281136,Europe
Monaco,19-02-2020,240821,618,274,240547,Europe
Mongolia,19-02-2020,284927,1854,528,284399,Western Pacific
Montenegro,19-02-2020,329478,655,125,329353,Europe
Morocco,19-02-2020,56093,1590,1053,55040,Eastern Mediterranean
Namibia,19-02-2020,330255,770,368,329887,Africa
Nepal,19-02-2020,173166,62,94,173072,South-East Asia
Netherlands,19-02-2020,246730,1552,1249,245481,Europe
Netherlands,19-02-2020,170963,2442,1206,169757,Europe
Netherlands,19-02-2020,350717,1865,714,350003,Europe
Netherlands,19-02-2020,324393,893,242,324151,Europe
New Zealand,19-02-2020,231635,798,1232,230403,Western Pacific
Nicaragua,19-02-2020,45020,2429,272,44748,Americas
Niger,19-02-2020,209204,391,1165,208039,Africa
Nigeria,19-02-2020,61329,2045,345,60984,Africa
North Macedonia,19-02-2020,414396,225,182,414214,Europe
Norway,19-02-2020,262682,186,457,262225,Europe
Oman,19-02-2020,135672,975,406,135266,Eastern Mediterranean
Pakistan,19-02-2020,96711,1974,842,95869,Eastern Mediterranean
Panama,19-02-2020,50500,1778,613,49887,Americas
Papua New Guinea,19-02-2020,273365,702,810,272555,Western Pacific
Paraguay,19-02-2020,225124,1224,673,224451,Americas
Peru,19-02-2020,349670,2340,301,349369,Americas
Philippines,19-02-2020,237925,808,753,237172,Western Pacific
Poland,19-02-2020,308767,1777,639,308128,Europe
Portugal,19-02-2020,330806,817,243,330563,Europe
Qatar,19-02-2020,89236,1339,1142,88094,Eastern Mediterranean
Romania,19-02-2020,374690,211,953,373737,Europe
Russia,19-02-2020,213729,404,141,213588,Europe
Rwanda,19-02-2020,409403,2281,166,409237,Africa
Saint Lucia,19-02-2020,128666,1690,495,128171,Americas
Saint Vincent and the Grenadines,19-02-2020,125966,2062,997,124969,Americas
San Marino,19-02-2020,102825,62,172,102653,Europe
Saudi Arabia,19-02-2020,36556,418,44,36512,Eastern Mediterranean
Senegal,19-02-2020,129370,2059,921,128449,Africa
Serbia,19-02-2020,192754,1067,962,191792,Europe
Seychelles,19-02-2020,16936,1150,822,16114,Africa
Singapore,19-02-2020,110742,1735,1085,109657,Western Pacific
Slovakia,19-02-2020,143162,1006,979,142183,Europe
Slovenia,19-02-2020,400731,2224,1185,399546,Europe
Somalia,19-02-2020,152253,852,43,152210,Eastern Mediterranean
South Africa,19-02-2020,432486,1638,28,432458,Africa
Spain,19-02-2020,404603,289,823,403780,Europe
Sri Lanka,19-02-2020,427422,2159,1035,426387,South-East Asia
Sudan,19-02-2020,280309,607,1112,279197,Eastern Mediterranean
Suriname,19-02-2020,339907,976,1174,338733,Americas
Sweden,19-02-2020,437015,2321,1150,435865,Europe
Switzerland,19-02-2020,331601,290,745,330856,Europe
Taiwan*,19-02-2020,131642,1193,1244,130398,Western Pacific
Tanzania,19-02-2020,449593,960,1046,448547,Africa
Thailand,19-02-2020,321180,2447,20,321160,South-East Asia
Togo,19-02-2020,129415,1268,536,128879,Africa
Trinidad and Tobago,19-02-2020,260649,427,1201,259448,Americas
Tunisia,19-02-2020,239926,1248,1236,238690,Eastern Mediterranean
Turkey,19-02-2020,321710,1893,1008,320702,Europe
Uganda,19-02-2020,105660,1615,206,105454,Africa
Ukraine,19-02-2020,240745,1770,301,240444,Europe
United Arab Emirates,19-02-2020,282063,2348,1229,280834,Eastern Mediterranean
United Kingdom,19-02-2020,266525,368,127,266398,Europe
United Kingdom,19-02-2020,19295,1494,13,19282,Europe
United Kingdom,19-02-2020,264323,259,263,264060,Europe
United Kingdom,19-02-2020,346893,1032,406,346487,Europe
United Kingdom,19-02-2020,87104,2172,807,86297,Europe
United Kingdom,19-02-2020,16054,1167,1008,15046,Europe
United Kingdom,19-02-2020,299975,2002,1047,298928,Europe
Uruguay,19-02-2020,446175,761,510,445665,Americas
US,19-02-2020,363939,773,1096,362843,Americas
Uzbekistan,19-02-2020,98294,912,138,98156,Europe
Venezuela,19-02-2020,43909,1716,1150,42759,Americas
Vietnam,19-02-2020,38037,1532,597,37440,Western Pacific
Zambia,19-02-2020,105880,1937,997,104883,Africa
Zimbabwe,19-02-2020,121385,329,512,120873,Africa
Dominica,19-02-2020,263761,2039,604,263157,Americas
Grenada,19-02-2020,394815,669,887,393928,Americas
Mozambique,19-02-2020,341544,1796,466,341078,Africa
Syria,19-02-2020,314606,2421,545,314061,Eastern Mediterranean
Timor-Leste,19-02-2020,48729,1094,324,48405,South-East Asia
Belize,19-02-2020,204012,1492,194,203818,Americas
Laos,19-02-2020,120437,558,872,119565,Western Pacific
Libya,19-02-2020,28640,695,1117,27523,Eastern Mediterranean
West Bank and Gaza,19-02-2020,274788,1995,878,273910,Eastern Mediterranean
Guinea-Bissau,19-02-2020,243725,135,842,242883,Africa
Mali,19-02-2020,319503,687,1162,318341,Africa
Saint Kitts and Nevis,19-02-2020,383932,1695,213,383719,Americas
Canada,19-02-2020,231040,1269,279,230761,Americas
Canada,19-02-2020,264165,463,707,263458,Americas
Kosovo,19-02-2020,392708,1950,287,392421,Europe
Burma,19-02-2020,388895,1505,325,388570,South-East Asia
United Kingdom,19-02-2020,402305,1618,643,401662,Europe
United Kingdom,19-02-2020,321355,1191,12,321343,Europe
United Kingdom,19-02-2020,202950,1921,1085,201865,Europe
Botswana,19-02-2020,245567,1778,921,244646,Africa
Burundi,19-02-2020,73066,812,1198,71868,Africa
Sierra Leone,19-02-2020,297318,1464,922,296396,Africa
Malawi,19-02-2020,171580,2396,118,171462,Africa
United Kingdom,19-02-2020,94781,1384,476,94305,Europe
France,19-02-2020,233765,1752,450,233315,Europe
South Sudan,19-02-2020,281590,1083,1036,280554,Africa
Western Sahara,19-02-2020,608,683,850,-242,Africa
Sao Tome and Principe,19-02-2020,278785,1402,148,278637,Africa
Yemen,19-02-2020,423767,1345,661,423106,Eastern Mediterranean
Comoros,19-02-2020,104959,1307,897,104062,Africa
Tajikistan,19-02-2020,95236,616,171,95065,Europe
Lesotho,19-02-2020,54355,1823,284,54071,Africa
Afghanistan,20-02-2020,288132,1609,891,287241,Eastern Mediterranean
Albania,20-02-2020,72914,231,44,72870,Europe
Algeria,20-02-2020,320338,39,905,319433,Africa
Andorra,20-02-2020,329777,2210,631,329146,Europe
Angola,20-02-2020,7960,167,1207,6753,Africa
Antigua and Barbuda,20-02-2020,443500,384,1159,442341,Americas
Argentina,20-02-2020,106047,2011,1104,104943,Americas
Armenia,20-02-2020,244694,1831,438,244256,Europe
Australia,20-02-2020,184836,319,630,184206,Western Pacific
Australia,20-02-2020,102488,427,476,102012,Western Pacific
Australia,20-02-2020,104456,2214,1046,103410,Western Pacific
Australia,20-02-2020,70294,1159,976,69318,Western Pacific
Australia,20-02-2020,428138,1587,317,427821,Western Pacific
Australia,20-02-2020,197107,1962,1020,196087,Western Pacific
Australia,20-02-2020,364728,1172,96,364632,Western Pacific
Australia,20-02-2020,222613,1737,822,221791,Western Pacific
Austria,20-02-2020,108254,588,573,107681,Europe
Azerbaijan,20-02-2020,16895,1261,292,16603,Europe
Bahamas,20-02-2020,30920,1159,773,30147,Americas
Bahrain,20-02-2020,275584,1558,457,275127,Eastern Mediterranean
Bangladesh,20-02-2020,257615,382,653,256962,South-East Asia
Barbados,20-02-2020,88855,381,42,88813,Americas
Belarus,20-02-2020,131072,484,1147,129925,Europe
Belgium,20-02-2020,332319,2034,881,331438,Europe
Benin,20-02-2020,343772,784,150,343622,Africa
Bhutan,20-02-2020,116067,2203,846,115221,South-East Asia
Bolivia,20-02-2020,301300,1000,111,301189,Americas
Bosnia and Herzegovina,20-02-2020,361784,224,738,361046,Europe
Brazil,20-02-2020,121547,758,165,121382,Americas
Brunei,20-02-2020,256591,2281,694,255897,Western Pacific
Bulgaria,20-02-2020,36271,2455,778,35493,Europe
Burkina Faso,20-02-2020,77762,823,440,77322,Africa
Cabo Verde,20-02-2020,342422,2099,69,342353,Africa
Cambodia,20-02-2020,305570,2226,234,305336,Western Pacific
Cameroon,20-02-2020,240272,734,797,239475,Africa
Canada,20-02-2020,31318,1607,1182,30136,Americas
Canada,20-02-2020,246629,590,726,245903,Americas
Canada,20-02-2020,95818,357,867,94951,Americas
Canada,20-02-2020,166058,399,552,165506,Americas
Canada,20-02-2020,293363,266,1111,292252,Americas
Canada,20-02-2020,169327,1422,845,168482,Americas
Canada,20-02-2020,37636,1058,666,36970,Americas
Canada,20-02-2020,374096,1968,1077,373019,Americas
Canada,20-02-2020,178430,333,1029,177401,Americas
Canada,20-02-2020,305948,477,803,305145,Americas
Central African Republic,20-02-2020,64340,2144,220,64120,Africa
Chad,20-02-2020,7443,2414,6,7437,Africa
Chile,20-02-2020,429291,876,1139,428152,Americas
China,20-02-2020,402344,663,521,401823,Western Pacific
China,20-02-2020,213188,2387,967,212221,Western Pacific
China,20-02-2020,332955,1154,491,332464,Western Pacific
China,20-02-2020,401195,474,829,400366,Western Pacific
China,20-02-2020,92722,524,1199,91523,Western Pacific
China,20-02-2020,134844,712,1102,133742,Western Pacific
China,20-02-2020,359497,1381,631,358866,Western Pacific
China,20-02-2020,354239,1807,364,353875,Western Pacific
China,20-02-2020,353913,335,69,353844,Western Pacific
China,20-02-2020,51084,2007,1143,49941,Western Pacific
China,20-02-2020,204268,1615,867,203401,Western Pacific
China,20-02-2020,39912,1963,896,39016,Western Pacific
China,20-02-2020,411827,2134,1206,410621,Western Pacific
China,20-02-2020,419739,163,148,419591,Western Pacific
China,20-02-2020,53618,1324,301,53317,Western Pacific
China,20-02-2020,100257,2465,1137,99120,Western Pacific
China,20-02-2020,124103,1054,497,123606,Western Pacific
China,20-02-2020,241714,1959,15,241699,Western Pacific
China,20-02-2020,81849,2219,462,81387,Western Pacific
China,20-02-2020,361132,1,992,360140,Western Pacific
China,20-02-2020,365927,758,268,365659,Western Pacific
China,20-02-2020,430961,347,1103,429858,Western Pacific
China,20-02-2020,414141,2240,539,413602,Western Pacific
China,20-02-2020,56196,1174,661,55535,Western Pacific
China,20-02-2020,370600,887,1194,369406,Western Pacific
China,20-02-2020,167565,2494,78,167487,Western Pacific
China,20-02-2020,45850,2050,313,45537,Western Pacific
China,20-02-2020,260741,952,162,260579,Western Pacific
China,20-02-2020,131338,1389,198,131140,Western Pacific
China,20-02-2020,344851,824,834,344017,Western Pacific
China,20-02-2020,139465,1585,1104,138361,Western Pacific
China,20-02-2020,259607,1879,508,259099,Western Pacific
China,20-02-2020,196596,1740,2,196594,Western Pacific
Colombia,20-02-2020,183320,551,47,183273,Americas
Congo (Brazzaville),20-02-2020,129285,168,241,129044,Africa
Congo (Kinshasa),20-02-2020,253197,2145,481,252716,Africa
Costa Rica,20-02-2020,212695,974,1058,211637,Americas
Cote d'Ivoire,20-02-2020,270244,2363,295,269949,Africa
Croatia,20-02-2020,204469,1609,911,203558,Europe
Cuba,20-02-2020,187775,2305,1059,186716,Americas
Cyprus,20-02-2020,5088,828,43,5045,Europe
Czechia,20-02-2020,310324,1971,715,309609,Europe
Denmark,20-02-2020,310071,10,922,309149,Europe
Greenland,20-02-2020,40143,692,27,40116,Europe
Denmark,20-02-2020,423738,1296,59,423679,Europe
Djibouti,20-02-2020,107014,1150,578,106436,Eastern Mediterranean
Dominican Republic,20-02-2020,420900,1977,324,420576,Americas
Ecuador,20-02-2020,151763,2141,403,151360,Americas
Egypt,20-02-2020,327371,572,639,326732,Eastern Mediterranean
El Salvador,20-02-2020,25832,1587,293,25539,Americas
Equatorial Guinea,20-02-2020,14481,189,913,13568,Africa
Eritrea,20-02-2020,231466,433,366,231100,Africa
Estonia,20-02-2020,238953,2119,472,238481,Europe
Eswatini,20-02-2020,158935,12,264,158671,Africa
Ethiopia,20-02-2020,83764,1659,209,83555,Africa
Fiji,20-02-2020,110786,1119,1174,109612,Western Pacific
Finland,20-02-2020,316723,516,627,316096,Europe
France,20-02-2020,294229,1960,822,293407,Europe
France,20-02-2020,362190,77,540,361650,Europe
France,20-02-2020,305954,2215,820,305134,Europe
France,20-02-2020,430587,1285,1108,429479,Europe
France,20-02-2020,346223,2410,494,345729,Europe
France,20-02-2020,329965,1105,821,329144,Europe
France,20-02-2020,143214,563,871,142343,Europe
France,20-02-2020,301956,718,926,301030,Europe
France,20-02-2020,212558,296,686,211872,Europe
France,20-02-2020,43950,2394,994,42956,Europe
Gabon,20-02-2020,211016,2196,486,210530,Africa
Gambia,20-02-2020,92174,680,988,91186,Africa
Georgia,20-02-2020,258499,1506,443,258056,Europe
Germany,20-02-2020,140922,448,345,140577,Europe
Ghana,20-02-2020,265464,2457,360,265104,Africa
Greece,20-02-2020,26406,297,223,26183,Europe
Guatemala,20-02-2020,340349,1072,1081,339268,Americas
Guinea,20-02-2020,386673,2040,143,386530,Africa
Guyana,20-02-2020,407975,1509,242,407733,Americas
Haiti,20-02-2020,77523,1199,897,76626,Americas
Holy See,20-02-2020,92046,1075,1062,90984,Europe
Honduras,20-02-2020,370918,3,908,370010,Americas
Hungary,20-02-2020,114327,2412,227,114100,Europe
Iceland,20-02-2020,38233,1348,1046,37187,Europe
India,20-02-2020,74419,1109,432,73987,South-East Asia
Indonesia,20-02-2020,254820,730,598,254222,South-East Asia
Iran,20-02-2020,439161,507,404,438757,Eastern Mediterranean
Iraq,20-02-2020,320159,1029,439,319720,Eastern Mediterranean
Ireland,20-02-2020,356825,2138,648,356177,Europe
Israel,20-02-2020,371362,1381,1165,370197,Europe
Italy,20-02-2020,28402,1376,123,28279,Europe
Jamaica,20-02-2020,100968,283,132,100836,Americas
Japan,20-02-2020,442384,1085,637,441747,Western Pacific
Jordan,20-02-2020,104014,2429,934,103080,Eastern Mediterranean
Kazakhstan,20-02-2020,343863,1089,855,343008,Europe
Kenya,20-02-2020,73986,281,631,73355,Africa
South Korea,20-02-2020,434432,1291,1118,433314,Western Pacific
Kuwait,20-02-2020,86372,1596,387,85985,Eastern Mediterranean
Kyrgyzstan,20-02-2020,365675,336,777,364898,Europe
Latvia,20-02-2020,250932,17,947,249985,Europe
Lebanon,20-02-2020,18104,1718,124,17980,Eastern Mediterranean
Liberia,20-02-2020,371564,234,1175,370389,Africa
Liechtenstein,20-02-2020,412326,1623,176,412150,Europe
Lithuania,20-02-2020,54134,376,81,54053,Europe
Luxembourg,20-02-2020,136091,753,994,135097,Europe
Madagascar,20-02-2020,248539,477,1027,247512,Africa
Malaysia,20-02-2020,4441,437,918,3523,Western Pacific
Maldives,20-02-2020,296969,946,364,296605,South-East Asia
Malta,20-02-2020,81390,1697,499,80891,Europe
Mauritania,20-02-2020,111408,1517,3,111405,Africa
Mauritius,20-02-2020,320516,357,551,319965,Africa
Mexico,20-02-2020,372240,2276,611,371629,Americas
Moldova,20-02-2020,33288,554,258,33030,Europe
Monaco,20-02-2020,209384,71,23,209361,Europe
Mongolia,20-02-2020,351615,910,783,350832,Western Pacific
Montenegro,20-02-2020,258672,2337,1228,257444,Europe
Morocco,20-02-2020,121619,1134,633,120986,Eastern Mediterranean
Namibia,20-02-2020,417415,855,984,416431,Africa
Nepal,20-02-2020,250908,389,731,250177,South-East Asia
Netherlands,20-02-2020,111444,1097,615,110829,Europe
Netherlands,20-02-2020,6522,1898,868,5654,Europe
Netherlands,20-02-2020,78817,695,415,78402,Europe
Netherlands,20-02-2020,21227,469,1155,20072,Europe
New Zealand,20-02-2020,323254,1039,1243,322011,Western Pacific
Nicaragua,20-02-2020,323851,172,634,323217,Americas
Niger,20-02-2020,396200,128,678,395522,Africa
Nigeria,20-02-2020,115144,524,1069,114075,Africa
North Macedonia,20-02-2020,217031,2021,664,216367,Europe
Norway,20-02-2020,41117,990,312,40805,Europe
Oman,20-02-2020,99362,209,803,98559,Eastern Mediterranean
Pakistan,20-02-2020,181174,1944,956,180218,Eastern Mediterranean
Panama,20-02-2020,130859,1524,992,129867,Americas
Papua New Guinea,20-02-2020,424396,1203,157,424239,Western Pacific
Paraguay,20-02-2020,275716,223,1149,274567,Americas
Peru,20-02-2020,175306,664,294,175012,Americas
Philippines,20-02-2020,355192,713,1219,353973,Western Pacific
Poland,20-02-2020,246534,2241,773,245761,Europe
Portugal,20-02-2020,11677,1015,745,10932,Europe
Qatar,20-02-2020,423531,1855,834,422697,Eastern Mediterranean
Romania,20-02-2020,200821,1510,1053,199768,Europe
Russia,20-02-2020,248113,1764,787,247326,Europe
Rwanda,20-02-2020,163900,2207,195,163705,Africa
Saint Lucia,20-02-2020,355288,1007,1029,354259,Americas
Saint Vincent and the Grenadines,20-02-2020,42843,514,918,41925,Americas
San Marino,20-02-2020,354917,1946,616,354301,Europe
Saudi Arabia,20-02-2020,409806,1632,951,408855,Eastern Mediterranean
Senegal,20-02-2020,132071,769,623,131448,Africa
Serbia,20-02-2020,230452,1502,561,229891,Europe
Seychelles,20-02-2020,163477,71,456,163021,Africa
Singapore,20-02-2020,161465,898,635,160830,Western Pacific
Slovakia,20-02-2020,393759,697,383,393376,Europe
Slovenia,20-02-2020,375977,418,188,375789,Europe
Somalia,20-02-2020,86257,2111,862,85395,Eastern Mediterranean
South Africa,20-02-2020,302506,1437,578,301928,Africa
Spain,20-02-2020,437231,548,42,437189,Europe
Sri Lanka,20-02-2020,245769,1801,365,245404,South-East Asia
Sudan,20-02-2020,4158,907,339,3819,Eastern Mediterranean
Suriname,20-02-2020,257254,97,984,256270,Americas
Sweden,20-02-2020,357647,1613,661,356986,Europe
Switzerland,20-02-2020,191936,2276,1195,190741,Europe
Taiwan*,20-02-2020,232601,768,764,231837,Western Pacific
Tanzania,20-02-2020,338496,323,1033,337463,Africa
Thailand,20-02-2020,139758,2335,436,139322,South-East Asia
Togo,20-02-2020,387323,2170,496,386827,Africa
Trinidad and Tobago,20-02-2020,106144,29,1184,104960,Americas
Tunisia,20-02-2020,40728,580,364,40364,Eastern Mediterranean
Turkey,20-02-2020,332356,1887,536,331820,Europe
Uganda,20-02-2020,153921,215,818,153103,Africa
Ukraine,20-02-2020,168111,241,1168,166943,Europe
United Arab Emirates,20-02-2020,194781,921,270,194511,Eastern Mediterranean
United Kingdom,20-02-2020,54127,557,1133,52994,Europe
United Kingdom,20-02-2020,199957,1694,869,199088,Europe
United Kingdom,20-02-2020,69049,973,933,68116,Europe
United Kingdom,20-02-2020,10687,300,507,10180,Europe
United Kingdom,20-02-2020,102049,181,1021,101028,Europe
United Kingdom,20-02-2020,53684,1579,880,52804,Europe
United Kingdom,20-02-2020,119740,315,27,119713,Europe
Uruguay,20-02-2020,423990,465,970,423020,Americas
US,20-02-2020,200270,1256,77,200193,Americas
Uzbekistan,20-02-2020,332343,1178,1231,331112,Europe
Venezuela,20-02-2020,41007,1232,439,40568,Americas
Vietnam,20-02-2020,221270,1438,1000,220270,Western Pacific
Zambia,20-02-2020,2861,1277,1070,1791,Africa
Zimbabwe,20-02-2020,195760,2332,563,195197,Africa
Dominica,20-02-2020,151605,1803,1030,150575,Americas
Grenada,20-02-2020,362092,1813,773,361319,Americas
Mozambique,20-02-2020,344140,359,579,343561,Africa
Syria,20-02-2020,351703,306,1196,350507,Eastern Mediterranean
Timor-Leste,20-02-2020,393017,1728,628,392389,South-East Asia
Belize,20-02-2020,240406,1148,8,240398,Americas
Laos,20-02-2020,313475,362,578,312897,Western Pacific
Libya,20-02-2020,312617,483,1177,311440,Eastern Mediterranean
West Bank and Gaza,20-02-2020,63466,1133,752,62714,Eastern Mediterranean
Guinea-Bissau,20-02-2020,430048,746,331,429717,Africa
Mali,20-02-2020,449208,616,1077,448131,Africa
Saint Kitts and Nevis,20-02-2020,375024,1899,1207,373817,Americas
Canada,20-02-2020,327002,201,974,326028,Americas
Canada,20-02-2020,16456,408,440,16016,Americas
Kosovo,20-02-2020,405527,1810,1187,404340,Europe
Burma,20-02-2020,127978,1567,623,127355,South-East Asia
United Kingdom,20-02-2020,127472,612,1178,126294,Europe
United Kingdom,20-02-2020,412027,1165,904,411123,Europe
United Kingdom,20-02-2020,150614,632,112,150502,Europe
Botswana,20-02-2020,164237,1801,751,163486,Africa
Burundi,20-02-2020,248754,1287,119,248635,Africa
Sierra Leone,20-02-2020,430318,716,652,429666,Africa
Malawi,20-02-2020,418530,1776,630,417900,Africa
United Kingdom,20-02-2020,56905,1431,10,56895,Europe
France,20-02-2020,313912,1985,453,313459,Europe
South Sudan,20-02-2020,7604,731,98,7506,Africa
Western Sahara,20-02-2020,271412,2017,163,271249,Africa
Sao Tome and Principe,20-02-2020,257720,1794,829,256891,Africa
Yemen,20-02-2020,127789,1854,532,127257,Eastern Mediterranean
Comoros,20-02-2020,390016,358,681,389335,Africa
Tajikistan,20-02-2020,218654,834,707,217947,Europe
Lesotho,20-02-2020,26038,193,824,25214,Africa
Afghanistan,21-02-2020,317085,2448,293,316792,Eastern Mediterranean
Albania,21-02-2020,169321,1147,972,168349,Europe
Algeria,21-02-2020,433489,1520,1078,432411,Africa
Andorra,21-02-2020,177931,175,21,177910,Europe
Angola,21-02-2020,52157,862,915,51242,Africa
Antigua and Barbuda,21-02-2020,341810,26,549,341261,Americas
Argentina,21-02-2020,198981,1886,842,198139,Americas
Armenia,21-02-2020,130772,1176,1249,129523,Europe
Australia,21-02-2020,105110,460,604,104506,Western Pacific
Australia,21-02-2020,418126,520,757,417369,Western Pacific
Australia,21-02-2020,171453,529,126,171327,Western Pacific
Australia,21-02-2020,207554,1767,1019,206535,Western Pacific
Australia,21-02-2020,326414,1635,307,326107,Western Pacific
Australia,21-02-2020,93510,1669,111,93399,Western Pacific
Australia,21-02-2020,410701,2155,229,410472,Western Pacific
Australia,21-02-2020,278781,185,158,278623,Western Pacific
Austria,21-02-2020,402692,1751,869,401823,Europe
Azerbaijan,21-02-2020,428798,1374,800,427998,Europe
Bahamas,21-02-2020,88238,511,158,88080,Americas
Bahrain,21-02-2020,215709,962,1162,214547,Eastern Mediterranean
Bangladesh,21-02-2020,93396,83,1091,92305,South-East Asia
Barbados,21-02-2020,108821,1520,638,108183,Americas
Belarus,21-02-2020,42503,2314,1183,41320,Europe
Belgium,21-02-2020,54750,1184,811,53939,Europe
Benin,21-02-2020,73544,1026,63,73481,Africa
Bhutan,21-02-2020,339570,1984,558,339012,South-East Asia
Bolivia,21-02-2020,372930,1508,437,372493,Americas
Bosnia and Herzegovina,21-02-2020,287342,384,1097,286245,Europe
Brazil,21-02-2020,122893,1066,190,122703,Americas
Brunei,21-02-2020,205872,106,552,205320,Western Pacific
Bulgaria,21-02-2020,55737,1806,909,54828,Europe
Burkina Faso,21-02-2020,355985,486,537,355448,Africa
Cabo Verde,21-02-2020,134498,1520,56,134442,Africa
Cambodia,21-02-2020,4127,838,110,4017,Western Pacific
Cameroon,21-02-2020,285359,2029,524,284835,Africa
Canada,21-02-2020,164366,1612,1147,163219,Americas
Canada,21-02-2020,224095,1370,240,223855,Americas
Canada,21-02-2020,219853,1452,612,219241,Americas
Canada,21-02-2020,265768,1899,657,265111,Americas
Canada,21-02-2020,89423,897,500,88923,Americas
Canada,21-02-2020,139013,2324,273,138740,Americas
Canada,21-02-2020,125612,1950,313,125299,Americas
Canada,21-02-2020,176323,1561,773,175550,Americas
Canada,21-02-2020,278183,1554,1007,277176,Americas
Canada,21-02-2020,137046,736,767,136279,Americas
Central African Republic,21-02-2020,107045,906,629,106416,Africa
Chad,21-02-2020,406428,484,836,405592,Africa
Chile,21-02-2020,92528,217,115,92413,Americas
China,21-02-2020,298580,697,907,297673,Western Pacific
China,21-02-2020,25967,153,673,25294,Western Pacific
China,21-02-2020,391463,894,50,391413,Western Pacific
China,21-02-2020,137551,1523,492,137059,Western Pacific
China,21-02-2020,221759,1373,737,221022,Western Pacific
China,21-02-2020,297346,216,229,297117,Western Pacific
China,21-02-2020,277478,633,754,276724,Western Pacific
China,21-02-2020,246082,1575,165,245917,Western Pacific
China,21-02-2020,165816,148,612,165204,Western Pacific
China,21-02-2020,262990,2363,722,262268,Western Pacific
China,21-02-2020,116771,1929,159,116612,Western Pacific
China,21-02-2020,155729,403,138,155591,Western Pacific
China,21-02-2020,158043,1007,570,157473,Western Pacific
China,21-02-2020,300348,1286,288,300060,Western Pacific
China,21-02-2020,285914,261,625,285289,Western Pacific
China,21-02-2020,243919,863,348,243571,Western Pacific
China,21-02-2020,201170,511,695,200475,Western Pacific
China,21-02-2020,379783,301,868,378915,Western Pacific
China,21-02-2020,434300,1489,170,434130,Western Pacific
China,21-02-2020,337097,1555,1195,335902,Western Pacific
China,21-02-2020,331563,113,102,331461,Western Pacific
China,21-02-2020,439347,1444,473,438874,Western Pacific
China,21-02-2020,90310,1481,1180,89130,Western Pacific
China,21-02-2020,308636,127,101,308535,Western Pacific
China,21-02-2020,443752,431,556,443196,Western Pacific
China,21-02-2020,326860,861,721,326139,Western Pacific
China,21-02-2020,30253,207,535,29718,Western Pacific
China,21-02-2020,35919,310,250,35669,Western Pacific
China,21-02-2020,300530,2006,230,300300,Western Pacific
China,21-02-2020,92893,244,1032,91861,Western Pacific
China,21-02-2020,16386,1895,66,16320,Western Pacific
China,21-02-2020,136038,1344,853,135185,Western Pacific
China,21-02-2020,244166,1753,182,243984,Western Pacific
Colombia,21-02-2020,46546,1039,810,45736,Americas
Congo (Brazzaville),21-02-2020,349132,107,419,348713,Africa
Congo (Kinshasa),21-02-2020,357862,1948,739,357123,Africa
Costa Rica,21-02-2020,445760,1307,745,445015,Americas
Cote d'Ivoire,21-02-2020,433994,1398,670,433324,Africa
Croatia,21-02-2020,159630,2329,301,159329,Europe
Cuba,21-02-2020,50763,2352,796,49967,Americas
Cyprus,21-02-2020,405387,1487,361,405026,Europe
Czechia,21-02-2020,194271,1424,652,193619,Europe
Denmark,21-02-2020,136545,2065,387,136158,Europe
Greenland,21-02-2020,134175,951,836,133339,Europe
Denmark,21-02-2020,418986,2263,975,418011,Europe
Djibouti,21-02-2020,225964,789,1201,224763,Eastern Mediterranean
Dominican Republic,21-02-2020,265201,491,703,264498,Americas
Ecuador,21-02-2020,72309,309,1038,71271,Americas
Egypt,21-02-2020,191798,1942,46,191752,Eastern Mediterranean
El Salvador,21-02-2020,394507,1040,174,394333,Americas
Equatorial Guinea,21-02-2020,185736,471,367,185369,Africa
Eritrea,21-02-2020,44635,718,72,44563,Africa
Estonia,21-02-2020,68148,1314,396,67752,Europe
Eswatini,21-02-2020,305497,2064,411,305086,Africa
Ethiopia,21-02-2020,418787,2050,1113,417674,Africa
Fiji,21-02-2020,281174,1587,239,280935,Western Pacific
Finland,21-02-2020,236122,2304,526,235596,Europe
France,21-02-2020,332895,279,189,332706,Europe
France,21-02-2020,101994,128,42,101952,Europe
France,21-02-2020,404062,1547,1247,402815,Europe
France,21-02-2020,215489,2080,61,215428,Europe
France,21-02-2020,27586,2169,55,27531,Europe
France,21-02-2020,369352,2156,780,368572,Europe
France,21-02-2020,229637,511,628,229009,Europe
France,21-02-2020,296318,873,790,295528,Europe
France,21-02-2020,82276,1055,73,82203,Europe
France,21-02-2020,407472,32,332,407140,Europe
Gabon,21-02-2020,127830,1984,1148,126682,Africa
Gambia,21-02-2020,144434,1298,692,143742,Africa
Georgia,21-02-2020,164307,538,313,163994,Europe
Germany,21-02-2020,169782,828,517,169265,Europe
Ghana,21-02-2020,68327,658,293,68034,Africa
Greece,21-02-2020,90801,918,531,90270,Europe
Guatemala,21-02-2020,83672,2149,168,83504,Americas
Guinea,21-02-2020,215543,665,923,214620,Africa
Guyana,21-02-2020,399079,267,174,398905,Americas
Haiti,21-02-2020,333755,1856,1138,332617,Americas
Holy See,21-02-2020,346182,766,960,345222,Europe
Honduras,21-02-2020,152711,998,31,152680,Americas
Hungary,21-02-2020,305516,726,1067,304449,Europe
Iceland,21-02-2020,115829,1495,871,114958,Europe
India,21-02-2020,147736,818,1229,146507,South-East Asia
Indonesia,21-02-2020,46124,1696,709,45415,South-East Asia
Iran,21-02-2020,4843,671,1086,3757,Eastern Mediterranean
Iraq,21-02-2020,268069,1504,1215,266854,Eastern Mediterranean
Ireland,21-02-2020,409736,2107,554,409182,Europe
Israel,21-02-2020,363803,1098,603,363200,Europe
Italy,21-02-2020,168963,1481,643,168320,Europe
Jamaica,21-02-2020,377742,1653,973,376769,Americas
Japan,21-02-2020,142974,2325,847,142127,Western Pacific
Jordan,21-02-2020,19321,29,267,19054,Eastern Mediterranean
Kazakhstan,21-02-2020,362407,1043,172,362235,Europe
Kenya,21-02-2020,291745,1355,352,291393,Africa
South Korea,21-02-2020,64078,1333,446,63632,Western Pacific
Kuwait,21-02-2020,238132,1224,510,237622,Eastern Mediterranean
Kyrgyzstan,21-02-2020,114104,1560,572,113532,Europe
Latvia,21-02-2020,347610,2236,149,347461,Europe
Lebanon,21-02-2020,445427,2136,1094,444333,Eastern Mediterranean
Liberia,21-02-2020,86199,1950,434,85765,Africa
Liechtenstein,21-02-2020,388106,2029,154,387952,Europe
Lithuania,21-02-2020,261789,1693,254,261535,Europe
Luxembourg,21-02-2020,280045,1858,649,279396,Europe
Madagascar,21-02-2020,285097,1479,286,284811,Africa
Malaysia,21-02-2020,93021,1464,272,92749,Western Pacific
Maldives,21-02-2020,210731,1809,645,210086,South-East Asia
Malta,21-02-2020,318990,2160,1075,317915,Europe
Mauritania,21-02-2020,259352,410,1013,258339,Africa
Mauritius,21-02-2020,146759,18,749,146010,Africa
Mexico,21-02-2020,274505,1860,291,274214,Americas
Moldova,21-02-2020,40455,89,493,39962,Europe
Monaco,21-02-2020,385747,1026,527,385220,Europe
Mongolia,21-02-2020,275790,1028,1237,274553,Western Pacific
Montenegro,21-02-2020,339415,603,675,338740,Europe
Morocco,21-02-2020,140739,362,233,140506,Eastern Mediterranean
Namibia,21-02-2020,320341,2184,48,320293,Africa
Nepal,21-02-2020,202372,623,160,202212,South-East Asia
Netherlands,21-02-2020,17744,2409,146,17598,Europe
Netherlands,21-02-2020,384735,2061,923,383812,Europe
Netherlands,21-02-2020,371309,1605,180,371129,Europe
Netherlands,21-02-2020,292505,2125,970,291535,Europe
New Zealand,21-02-2020,440093,994,446,439647,Western Pacific
Nicaragua,21-02-2020,82725,593,1058,81667,Americas
Niger,21-02-2020,376522,636,545,375977,Africa
Nigeria,21-02-2020,395632,1232,1037,394595,Africa
North Macedonia,21-02-2020,244912,138,833,244079,Europe
Norway,21-02-2020,293252,1363,0,293252,Europe
Oman,21-02-2020,303930,875,1024,302906,Eastern Mediterranean
Pakistan,21-02-2020,154604,1173,1094,153510,Eastern Mediterranean
Panama,21-02-2020,8368,517,1091,7277,Americas
Papua New Guinea,21-02-2020,249448,1840,962,248486,Western Pacific
Paraguay,21-02-2020,99910,754,642,99268,Americas
Peru,21-02-2020,439528,402,457,439071,Americas
Philippines,21-02-2020,78721,1876,342,78379,Western Pacific
Poland,21-02-2020,361559,142,1226,360333,Europe
Portugal,21-02-2020,65806,1896,641,65165,Europe
Qatar,21-02-2020,309458,1248,874,308584,Eastern Mediterranean
Romania,21-02-2020,379042,1071,1212,377830,Europe
Russia,21-02-2020,44579,2151,894,43685,Europe
Rwanda,21-02-2020,358170,930,565,357605,Africa
Saint Lucia,21-02-2020,4446,2356,594,3852,Americas
Saint Vincent and the Grenadines,21-02-2020,242331,320,1041,241290,Americas
San Marino,21-02-2020,31578,2251,840,30738,Europe
Saudi Arabia,21-02-2020,233588,1021,1099,232489,Eastern Mediterranean
Senegal,21-02-2020,302130,238,499,301631,Africa
Serbia,21-02-2020,65966,587,1009,64957,Europe
Seychelles,21-02-2020,211521,1247,251,211270,Africa
Singapore,21-02-2020,325259,445,772,324487,Western Pacific
Slovakia,21-02-2020,289528,2215,574,288954,Europe
Slovenia,21-02-2020,49059,1449,781,48278,Europe
Somalia,21-02-2020,285485,529,69,285416,Eastern Mediterranean
South Africa,21-02-2020,97389,1369,1074,96315,Africa
Spain,21-02-2020,296292,311,371,295921,Europe
Sri Lanka,21-02-2020,428099,378,1235,426864,South-East Asia
Sudan,21-02-2020,162339,2442,1062,161277,Eastern Mediterranean
Suriname,21-02-2020,440910,2457,260,440650,Americas
Sweden,21-02-2020,239663,2224,855,238808,Europe
Switzerland,21-02-2020,15292,1274,1195,14097,Europe
Taiwan*,21-02-2020,25988,1698,776,25212,Western Pacific
Tanzania,21-02-2020,180980,491,945,180035,Africa
Thailand,21-02-2020,86107,2139,907,85200,South-East Asia
Togo,21-02-2020,54492,1391,563,53929,Africa
Trinidad and Tobago,21-02-2020,290038,2282,290,289748,Americas
Tunisia,21-02-2020,219093,190,41,219052,Eastern Mediterranean
Turkey,21-02-2020,406192,1500,748,405444,Europe
Uganda,21-02-2020,432135,54,287,431848,Africa
Ukraine,21-02-2020,388171,1705,1238,386933,Europe
United Arab Emirates,21-02-2020,421821,1505,883,420938,Eastern Mediterranean
United Kingdom,21-02-2020,290794,2166,60,290734,Europe
United Kingdom,21-02-2020,12423,1887,387,12036,Europe
United Kingdom,21-02-2020,56857,687,708,56149,Europe
United Kingdom,21-02-2020,65311,2059,946,64365,Europe
United Kingdom,21-02-2020,391771,427,927,390844,Europe
United Kingdom,21-02-2020,241859,1582,62,241797,Europe
United Kingdom,21-02-2020,388911,2050,1118,387793,Europe
Uruguay,21-02-2020,371811,2251,1213,370598,Americas
US,21-02-2020,183295,1197,1090,182205,Americas
Uzbekistan,21-02-2020,136991,2469,690,136301,Europe
Venezuela,21-02-2020,285965,292,1049,284916,Americas
Vietnam,21-02-2020,249243,1642,352,248891,Western Pacific
Zambia,21-02-2020,328856,267,176,328680,Africa
Zimbabwe,21-02-2020,71512,2319,623,70889,Africa
Dominica,21-02-2020,418703,2176,312,418391,Americas
Grenada,21-02-2020,385235,1154,366,384869,Americas
Mozambique,21-02-2020,441681,669,536,441145,Africa
Syria,21-02-2020,5669,1108,65,5604,Eastern Mediterranean
Timor-Leste,21-02-2020,210510,1282,482,210028,South-East Asia
Belize,21-02-2020,108784,1130,1193,107591,Americas
Laos,21-02-2020,40293,18,176,40117,Western Pacific
Libya,21-02-2020,140864,2368,333,140531,Eastern Mediterranean
West Bank and Gaza,21-02-2020,123110,519,646,122464,Eastern Mediterranean
Guinea-Bissau,21-02-2020,279273,1784,430,278843,Africa
Mali,21-02-2020,113466,1184,411,113055,Africa
Saint Kitts and Nevis,21-02-2020,30823,707,356,30467,Americas
Canada,21-02-2020,366066,636,772,365294,Americas
Canada,21-02-2020,180111,1916,798,179313,Americas
Kosovo,21-02-2020,436359,1897,1001,435358,Europe
Burma,21-02-2020,173839,89,82,173757,South-East Asia
United Kingdom,21-02-2020,229986,885,555,229431,Europe
United Kingdom,21-02-2020,87567,2045,1073,86494,Europe
United Kingdom,21-02-2020,160907,2007,515,160392,Europe
Botswana,21-02-2020,233422,1379,1017,232405,Africa
Burundi,21-02-2020,20339,1998,1247,19092,Africa
Sierra Leone,21-02-2020,339711,2216,927,338784,Africa
Malawi,21-02-2020,170772,1689,895,169877,Africa
United Kingdom,21-02-2020,411898,317,981,410917,Europe
France,21-02-2020,87729,1438,723,87006,Europe
South Sudan,21-02-2020,384472,403,217,384255,Africa
Western Sahara,21-02-2020,340400,16,194,340206,Africa
Sao Tome and Principe,21-02-2020,184903,79,743,184160,Africa
Yemen,21-02-2020,377748,1830,1221,376527,Eastern Mediterranean
Comoros,21-02-2020,187101,538,700,186401,Africa
Tajikistan,21-02-2020,59396,650,921,58475,Europe
Lesotho,21-02-2020,71853,1141,228,71625,Africa
Afghanistan,22-02-2020,387656,1540,608,387048,Eastern Mediterranean
Albania,22-02-2020,388475,1052,1018,387457,Europe
Algeria,22-02-2020,71361,2363,78,71283,Africa
Andorra,22-02-2020,353725,917,333,353392,Europe
Angola,22-02-2020,234423,620,670,233753,Africa
Antigua and Barbuda,22-02-2020,350401,107,1156,349245,Americas
Argentina,22-02-2020,366506,2260,755,365751,Americas
Armenia,22-02-2020,413910,2221,644,413266,Europe
Australia,22-02-2020,132531,628,975,131556,Western Pacific
Australia,22-02-2020,136997,238,614,136383,Western Pacific
Australia,22-02-2020,253651,1283,563,253088,Western Pacific
Australia,22-02-2020,317717,497,176,317541,Western Pacific
Australia,22-02-2020,111377,2011,358,111019,Western Pacific
Australia,22-02-2020,124392,1787,367,124025,Western Pacific
Australia,22-02-2020,337653,2091,291,337362,Western Pacific
Australia,22-02-2020,340006,1665,815,339191,Western Pacific
Austria,22-02-2020,149642,1500,551,149091,Europe
Azerbaijan,22-02-2020,290163,24,1031,289132,Europe
Bahamas,22-02-2020,442961,805,1018,441943,Americas
Bahrain,22-02-2020,155822,970,408,155414,Eastern Mediterranean
Bangladesh,22-02-2020,369758,185,597,369161,South-East Asia
Barbados,22-02-2020,355845,1047,758,355087,Americas
Belarus,22-02-2020,446412,1223,245,446167,Europe
Belgium,22-02-2020,361217,1717,948,360269,Europe
Benin,22-02-2020,326046,1806,305,325741,Africa
Bhutan,22-02-2020,78717,1537,1048,77669,South-East Asia
Bolivia,22-02-2020,185394,17,788,184606,Americas
Bosnia and Herzegovina,22-02-2020,124215,124,428,123787,Europe
Brazil,22-02-2020,204521,1231,565,203956,Americas
Brunei,22-02-2020,214968,1049,850,214118,Western Pacific
Bulgaria,22-02-2020,389745,1882,529,389216,Europe
Burkina Faso,22-02-2020,23855,398,368,23487,Africa
Cabo Verde,22-02-2020,65789,1921,348,65441,Africa
Cambodia,22-02-2020,396654,1075,556,396098,Western Pacific
Cameroon,22-02-2020,192656,1419,453,192203,Africa
Canada,22-02-2020,330638,1646,173,330465,Americas
Canada,22-02-2020,180797,252,1070,179727,Americas
Canada,22-02-2020,170331,1384,822,169509,Americas
Canada,22-02-2020,388630,2256,671,387959,Americas
Canada,22-02-2020,239529,1672,900,238629,Americas
Canada,22-02-2020,141799,486,1114,140685,Americas
Canada,22-02-2020,79235,34,1038,78197,Americas
Canada,22-02-2020,439050,2199,438,438612,Americas
Canada,22-02-2020,94707,2418,292,94415,Americas
Canada,22-02-2020,315670,1208,1042,314628,Americas
Central African Republic,22-02-2020,363043,275,794,362249,Africa
Chad,22-02-2020,206435,2349,170,206265,Africa
Chile,22-02-2020,395945,316,622,395323,Americas
China,22-02-2020,143998,2195,708,143290,Western Pacific
China,22-02-2020,195175,568,474,194701,Western Pacific
China,22-02-2020,167384,2377,995,166389,Western Pacific
China,22-02-2020,49822,1821,58,49764,Western Pacific
China,22-02-2020,16631,1561,735,15896,Western Pacific
China,22-02-2020,72877,1349,683,72194,Western Pacific
China,22-02-2020,190283,1876,1157,189126,Western Pacific
China,22-02-2020,423508,2174,736,422772,Western Pacific
China,22-02-2020,355705,195,517,355188,Western Pacific
China,22-02-2020,138186,1375,860,137326,Western Pacific
China,22-02-2020,33363,1220,534,32829,Western Pacific
China,22-02-2020,349738,793,594,349144,Western Pacific
China,22-02-2020,424063,944,1027,423036,Western Pacific
China,22-02-2020,326868,935,928,325940,Western Pacific
China,22-02-2020,191052,2211,1237,189815,Western Pacific
China,22-02-2020,427498,1277,384,427114,Western Pacific
China,22-02-2020,221978,1796,107,221871,Western Pacific
China,22-02-2020,260803,259,618,260185,Western Pacific
China,22-02-2020,259562,1893,629,258933,Western Pacific
China,22-02-2020,2669,1358,490,2179,Western Pacific
China,22-02-2020,65415,1134,224,65191,Western Pacific
China,22-02-2020,35207,568,802,34405,Western Pacific
China,22-02-2020,40289,890,1002,39287,Western Pacific
China,22-02-2020,199074,1021,289,198785,Western Pacific
China,22-02-2020,335507,604,798,334709,Western Pacific
China,22-02-2020,301012,923,251,300761,Western Pacific
China,22-02-2020,205920,2482,1161,204759,Western Pacific
China,22-02-2020,181126,453,1149,179977,Western Pacific
China,22-02-2020,374179,2055,745,373434,Western Pacific
China,22-02-2020,299734,8,86,299648,Western Pacific
China,22-02-2020,321778,1082,814,320964,Western Pacific
China,22-02-2020,428232,1769,1242,426990,Western Pacific
China,22-02-2020,225622,2057,611,225011,Western Pacific
Colombia,22-02-2020,360988,765,362,360626,Americas
Congo (Brazzaville),22-02-2020,164867,1729,13,164854,Africa
Congo (Kinshasa),22-02-2020,37429,2202,4,37425,Africa
Costa Rica,22-02-2020,112825,571,500,112325,Americas
Cote d'Ivoire,22-02-2020,152028,1210,747,151281,Africa
Croatia,22-02-2020,161126,691,272,160854,Europe
Cuba,22-02-2020,236663,95,402,236261,Americas
Cyprus,22-02-2020,90443,1050,927,89516,Europe
Czechia,22-02-2020,64536,2157,746,63790,Europe
Denmark,22-02-2020,384782,684,843,383939,Europe
Greenland,22-02-2020,248271,607,957,247314,Europe
Denmark,22-02-2020,107829,1634,325,107504,Europe
Djibouti,22-02-2020,336691,1100,1171,335520,Eastern Mediterranean
Dominican Republic,22-02-2020,338622,1446,825,337797,Americas
Ecuador,22-02-2020,131623,1670,275,131348,Americas
Egypt,22-02-2020,401409,1243,120,401289,Eastern Mediterranean
El Salvador,22-02-2020,393883,239,32,393851,Americas
Equatorial Guinea,22-02-2020,159459,2177,560,158899,Africa
Eritrea,22-02-2020,98528,861,890,97638,Africa
Estonia,22-02-2020,252029,2230,30,251999,Europe
Eswatini,22-02-2020,405865,76,743,405122,Africa
Ethiopia,22-02-2020,281051,2495,586,280465,Africa
Fiji,22-02-2020,330233,773,1010,329223,Western Pacific
Finland,22-02-2020,340375,2129,671,339704,Europe
France,22-02-2020,50736,1815,454,50282,Europe
France,22-02-2020,184357,2037,470,183887,Europe
France,22-02-2020,32432,433,917,31515,Europe
France,22-02-2020,22675,916,707,21968,Europe
France,22-02-2020,279904,824,1240,278664,Europe
France,22-02-2020,408718,1393,1216,407502,Europe
France,22-02-2020,360560,610,272,360288,Europe
France,22-02-2020,160266,2395,758,159508,Europe
France,22-02-2020,290309,294,986,289323,Europe
France,22-02-2020,66126,444,463,65663,Europe
Gabon,22-02-2020,124113,2106,746,123367,Africa
Gambia,22-02-2020,185717,965,716,185001,Africa
Georgia,22-02-2020,346187,1413,36,346151,Europe
Germany,22-02-2020,143696,328,1003,142693,Europe
Ghana,22-02-2020,1468,1273,563,905,Africa
Greece,22-02-2020,261091,2133,242,260849,Europe
Guatemala,22-02-2020,383798,1098,127,383671,Americas
Guinea,22-02-2020,124065,694,509,123556,Africa
Guyana,22-02-2020,260138,864,1218,258920,Americas
Haiti,22-02-2020,408845,2280,761,408084,Americas
Holy See,22-02-2020,417784,825,816,416968,Europe
Honduras,22-02-2020,332070,2496,870,331200,Americas
Hungary,22-02-2020,110133,1405,167,109966,Europe
Iceland,22-02-2020,388127,1355,818,387309,Europe
India,22-02-2020,81705,2441,290,81415,South-East Asia
Indonesia,22-02-2020,181844,1622,704,181140,South-East Asia
Iran,22-02-2020,206013,2141,4,206009,Eastern Mediterranean
Iraq,22-02-2020,442546,1218,1041,441505,Eastern Mediterranean
Ireland,22-02-2020,16601,1878,1248,15353,Europe
Israel,22-02-2020,418487,2337,481,418006,Europe
Italy,22-02-2020,58069,608,1184,56885,Europe
Jamaica,22-02-2020,41107,1351,686,40421,Americas
Japan,22-02-2020,52445,2258,790,51655,Western Pacific
Jordan,22-02-2020,79769,1532,197,79572,Eastern Mediterranean
Kazakhstan,22-02-2020,422695,1194,357,422338,Europe
Kenya,22-02-2020,335888,1092,396,335492,Africa
South Korea,22-02-2020,83919,693,194,83725,Western Pacific
Kuwait,22-02-2020,395382,563,1165,394217,Eastern Mediterranean
Kyrgyzstan,22-02-2020,109772,2395,341,109431,Europe
Latvia,22-02-2020,61844,772,439,61405,Europe
Lebanon,22-02-2020,436344,144,389,435955,Eastern Mediterranean
Liberia,22-02-2020,167986,558,1199,166787,Africa
Liechtenstein,22-02-2020,362532,2108,465,362067,Europe
Lithuania,22-02-2020,431314,518,718,430596,Europe
Luxembourg,22-02-2020,29517,333,168,29349,Europe
Madagascar,22-02-2020,58096,1528,9,58087,Africa
Malaysia,22-02-2020,231549,2306,276,231273,Western Pacific
Maldives,22-02-2020,229101,398,443,228658,South-East Asia
Malta,22-02-2020,174748,338,77,174671,Europe
Mauritania,22-02-2020,217345,1182,1104,216241,Africa
Mauritius,22-02-2020,387969,1372,461,387508,Africa
Mexico,22-02-2020,242977,2182,950,242027,Americas
Moldova,22-02-2020,186008,856,103,185905,Europe
Monaco,22-02-2020,78287,116,1146,77141,Europe
Mongolia,22-02-2020,130240,1738,347,129893,Western Pacific
Montenegro,22-02-2020,331376,168,642,330734,Europe
Morocco,22-02-2020,203038,2135,354,202684,Eastern Mediterranean
Namibia,22-02-2020,347167,1787,421,346746,Africa
Nepal,22-02-2020,40593,1096,653,39940,South-East Asia
Netherlands,22-02-2020,353917,970,71,353846,Europe
Netherlands,22-02-2020,328958,1459,830,328128,Europe
Netherlands,22-02-2020,220317,1374,825,219492,Europe
Netherlands,22-02-2020,30278,1761,582,29696,Europe
New Zealand,22-02-2020,293781,1131,1174,292607,Western Pacific
Nicaragua,22-02-2020,135096,1333,65,135031,Americas
Niger,22-02-2020,304236,1461,309,303927,Africa
Nigeria,22-02-2020,247271,2136,372,246899,Africa
North Macedonia,22-02-2020,4063,2291,985,3078,Europe
Norway,22-02-2020,372409,734,654,371755,Europe
Oman,22-02-2020,177502,603,1184,176318,Eastern Mediterranean
Pakistan,22-02-2020,242505,1102,1102,241403,Eastern Mediterranean
Panama,22-02-2020,1193,783,94,1099,Americas
Papua New Guinea,22-02-2020,56674,2289,819,55855,Western Pacific
Paraguay,22-02-2020,198468,1734,475,197993,Americas
Peru,22-02-2020,62671,786,986,61685,Americas
Philippines,22-02-2020,422096,1701,1199,420897,Western Pacific
Poland,22-02-2020,9236,717,76,9160,Europe
Portugal,22-02-2020,211049,699,533,210516,Europe
Qatar,22-02-2020,271686,2166,646,271040,Eastern Mediterranean
Romania,22-02-2020,120363,2178,169,120194,Europe
Russia,22-02-2020,185978,931,278,185700,Europe
Rwanda,22-02-2020,373341,1451,202,373139,Africa
Saint Lucia,22-02-2020,306080,1328,960,305120,Americas
Saint Vincent and the Grenadines,22-02-2020,243092,368,275,242817,Americas
San Marino,22-02-2020,88255,1973,297,87958,Europe
Saudi Arabia,22-02-2020,294533,1468,569,293964,Eastern Mediterranean
Senegal,22-02-2020,379354,529,88,379266,Africa
Serbia,22-02-2020,182959,868,917,182042,Europe
Seychelles,22-02-2020,3028,1093,238,2790,Africa
Singapore,22-02-2020,194031,301,361,193670,Western Pacific
Slovakia,22-02-2020,168945,2273,92,168853,Europe
Slovenia,22-02-2020,223032,1975,565,222467,Europe
Somalia,22-02-2020,105552,616,160,105392,Eastern Mediterranean
South Africa,22-02-2020,257119,1312,293,256826,Africa
Spain,22-02-2020,263523,873,1174,262349,Europe
Sri Lanka,22-02-2020,427727,2264,731,426996,South-East Asia
Sudan,22-02-2020,277849,131,846,277003,Eastern Mediterranean
Suriname,22-02-2020,233538,513,738,232800,Americas
Sweden,22-02-2020,161396,1772,429,160967,Europe
Switzerland,22-02-2020,70856,2272,542,70314,Europe
Taiwan*,22-02-2020,423671,1670,296,423375,Western Pacific
Tanzania,22-02-2020,417059,1581,79,416980,Africa
Thailand,22-02-2020,336907,879,1100,335807,South-East Asia
Togo,22-02-2020,6676,2074,87,6589,Africa
Trinidad and Tobago,22-02-2020,443443,1593,715,442728,Americas
Tunisia,22-02-2020,337491,2310,527,336964,Eastern Mediterranean
Turkey,22-02-2020,271952,1556,878,271074,Europe
Uganda,22-02-2020,282356,1495,256,282100,Africa
Ukraine,22-02-2020,449404,1403,954,448450,Europe
United Arab Emirates,22-02-2020,182721,2467,408,182313,Eastern Mediterranean
United Kingdom,22-02-2020,153508,2189,671,152837,Europe
United Kingdom,22-02-2020,357537,1508,117,357420,Europe
United Kingdom,22-02-2020,10089,2056,924,9165,Europe
United Kingdom,22-02-2020,90214,72,369,89845,Europe
United Kingdom,22-02-2020,122660,2467,1245,121415,Europe
United Kingdom,22-02-2020,3360,485,741,2619,Europe
United Kingdom,22-02-2020,445495,2,1250,444245,Europe
Uruguay,22-02-2020,234840,870,1226,233614,Americas
US,22-02-2020,35655,1358,312,35343,Americas
Uzbekistan,22-02-2020,445985,272,110,445875,Europe
Venezuela,22-02-2020,322596,1625,1196,321400,Americas
Vietnam,22-02-2020,102849,823,444,102405,Western Pacific
Zambia,22-02-2020,14002,1848,653,13349,Africa
Zimbabwe,22-02-2020,80724,714,0,80724,Africa
Dominica,22-02-2020,227217,307,667,226550,Americas
Grenada,22-02-2020,207765,1885,925,206840,Americas
Mozambique,22-02-2020,46800,1377,830,45970,Africa
Syria,22-02-2020,329036,1451,733,328303,Eastern Mediterranean
Timor-Leste,22-02-2020,431718,561,1088,430630,South-East Asia
Belize,22-02-2020,142796,12,1161,141635,Americas
Laos,22-02-2020,48222,1733,806,47416,Western Pacific
Libya,22-02-2020,173413,2008,1019,172394,Eastern Mediterranean
West Bank and Gaza,22-02-2020,163539,228,57,163482,Eastern Mediterranean
Guinea-Bissau,22-02-2020,221315,785,357,220958,Africa
Mali,22-02-2020,269252,794,270,268982,Africa
Saint Kitts and Nevis,22-02-2020,309789,744,1124,308665,Americas
Canada,22-02-2020,346784,1507,215,346569,Americas
Canada,22-02-2020,148434,275,1221,147213,Americas
Kosovo,22-02-2020,65143,993,1059,64084,Europe
Burma,22-02-2020,141279,813,985,140294,South-East Asia
United Kingdom,22-02-2020,347919,1214,1209,346710,Europe
United Kingdom,22-02-2020,310757,1654,1027,309730,Europe
United Kingdom,22-02-2020,5030,850,438,4592,Europe
Botswana,22-02-2020,303795,929,750,303045,Africa
Burundi,22-02-2020,121547,26,1123,120424,Africa
Sierra Leone,22-02-2020,159903,656,529,159374,Africa
Malawi,22-02-2020,291138,565,63,291075,Africa
United Kingdom,22-02-2020,361587,341,813,360774,Europe
France,22-02-2020,162288,2172,159,162129,Europe
South Sudan,22-02-2020,329796,517,812,328984,Africa
Western Sahara,22-02-2020,386536,2458,847,385689,Africa
Sao Tome and Principe,22-02-2020,317893,1641,715,317178,Africa
Yemen,22-02-2020,125072,1305,562,124510,Eastern Mediterranean
Comoros,22-02-2020,114068,620,795,113273,Africa
Tajikistan,22-02-2020,233977,183,719,233258,Europe
Lesotho,22-02-2020,173379,174,452,172927,Africa
Afghanistan,23-02-2020,22241,2412,384,21857,Eastern Mediterranean
Albania,23-02-2020,241839,1651,911,240928,Europe
Algeria,23-02-2020,345760,1245,797,344963,Africa
Andorra,23-02-2020,288815,1147,84,288731,Europe
Angola,23-02-2020,113939,193,768,113171,Africa
Antigua and Barbuda,23-02-2020,329928,1251,1192,328736,Americas
Argentina,23-02-2020,86266,1932,483,85783,Americas
Armenia,23-02-2020,210607,1937,88,210519,Europe
Australia,23-02-2020,440294,2277,402,439892,Western Pacific
Australia,23-02-2020,4878,713,328,4550,Western Pacific
Australia,23-02-2020,293101,1655,62,293039,Western Pacific
Australia,23-02-2020,264429,1693,921,263508,Western Pacific
Australia,23-02-2020,260285,237,214,260071,Western Pacific
Australia,23-02-2020,358067,2366,419,357648,Western Pacific
Australia,23-02-2020,164947,2211,416,164531,Western Pacific
Australia,23-02-2020,46384,1113,530,45854,Western Pacific
Austria,23-02-2020,418478,2458,186,418292,Europe
Azerbaijan,23-02-2020,395492,247,805,394687,Europe
Bahamas,23-02-2020,269487,1828,240,269247,Americas
Bahrain,23-02-2020,168866,2493,943,167923,Eastern Mediterranean
Bangladesh,23-02-2020,410202,1226,889,409313,South-East Asia
Barbados,23-02-2020,131984,1528,1205,130779,Americas
Belarus,23-02-2020,14371,2113,1096,13275,Europe
Belgium,23-02-2020,232690,2319,1089,231601,Europe
Benin,23-02-2020,63216,1945,751,62465,Africa
Bhutan,23-02-2020,164042,2284,38,164004,South-East Asia
Bolivia,23-02-2020,151902,2189,959,150943,Americas
Bosnia and Herzegovina,23-02-2020,93965,279,62,93903,Europe
Brazil,23-02-2020,78533,2229,936,77597,Americas
Brunei,23-02-2020,134511,2191,1127,133384,Western Pacific
Bulgaria,23-02-2020,338357,1042,759,337598,Europe
Burkina Faso,23-02-2020,111372,960,246,111126,Africa
Cabo Verde,23-02-2020,365780,575,993,364787,Africa
Cambodia,23-02-2020,84075,659,406,83669,Western Pacific
Cameroon,23-02-2020,370553,823,485,370068,Africa
Canada,23-02-2020,1998,971,281,1717,Americas
Canada,23-02-2020,61158,1950,402,60756,Americas
Canada,23-02-2020,256566,1164,322,256244,Americas
Canada,23-02-2020,300627,1160,764,299863,Americas
Canada,23-02-2020,266559,2184,1217,265342,Americas
Canada,23-02-2020,251668,1028,712,250956,Americas
Canada,23-02-2020,88828,1994,453,88375,Americas
Canada,23-02-2020,75832,2270,831,75001,Americas
Canada,23-02-2020,419955,1858,810,419145,Americas
Canada,23-02-2020,194784,2051,851,193933,Americas
Central African Republic,23-02-2020,303509,2411,292,303217,Africa
Chad,23-02-2020,110134,2129,1203,108931,Africa
Chile,23-02-2020,133745,2470,843,132902,Americas
China,23-02-2020,428855,84,645,428210,Western Pacific
China,23-02-2020,180833,353,1133,179700,Western Pacific
China,23-02-2020,136945,429,250,136695,Western Pacific
China,23-02-2020,80739,972,858,79881,Western Pacific
China,23-02-2020,177479,415,1049,176430,Western Pacific
China,23-02-2020,47003,247,233,46770,Western Pacific
China,23-02-2020,203034,2057,1139,201895,Western Pacific
China,23-02-2020,82454,855,277,82177,Western Pacific
China,23-02-2020,56912,875,361,56551,Western Pacific
China,23-02-2020,418738,1986,466,418272,Western Pacific
China,23-02-2020,189616,916,963,188653,Western Pacific
China,23-02-2020,28972,2260,689,28283,Western Pacific
China,23-02-2020,444147,27,1034,443113,Western Pacific
China,23-02-2020,447115,418,238,446877,Western Pacific
China,23-02-2020,42360,1523,758,41602,Western Pacific
China,23-02-2020,386087,1953,83,386004,Western Pacific
China,23-02-2020,441485,2144,31,441454,Western Pacific
China,23-02-2020,105880,1872,367,105513,Western Pacific
China,23-02-2020,337927,1536,166,337761,Western Pacific
China,23-02-2020,208388,1848,15,208373,Western Pacific
China,23-02-2020,129025,2200,625,128400,Western Pacific
China,23-02-2020,296762,2283,239,296523,Western Pacific
China,23-02-2020,430489,982,572,429917,Western Pacific
China,23-02-2020,375489,715,208,375281,Western Pacific
China,23-02-2020,336401,2028,867,335534,Western Pacific
China,23-02-2020,338915,1941,891,338024,Western Pacific
China,23-02-2020,40768,1453,1227,39541,Western Pacific
China,23-02-2020,350017,1890,603,349414,Western Pacific
China,23-02-2020,402563,1665,1157,401406,Western Pacific
China,23-02-2020,40262,85,530,39732,Western Pacific
China,23-02-2020,297552,1109,1069,296483,Western Pacific
China,23-02-2020,60241,2036,372,59869,Western Pacific
China,23-02-2020,324290,258,907,323383,Western Pacific
Colombia,23-02-2020,36766,1099,824,35942,Americas
Congo (Brazzaville),23-02-2020,109431,598,1074,108357,Africa
Congo (Kinshasa),23-02-2020,340190,1581,178,340012,Africa
Costa Rica,23-02-2020,193357,993,299,193058,Americas
Cote d'Ivoire,23-02-2020,130088,1701,726,129362,Africa
Croatia,23-02-2020,393088,2041,666,392422,Europe
Cuba,23-02-2020,171266,1386,443,170823,Americas
Cyprus,23-02-2020,29119,1766,900,28219,Europe
Czechia,23-02-2020,132868,1358,793,132075,Europe
Denmark,23-02-2020,170399,2494,526,169873,Europe
Greenland,23-02-2020,158494,279,889,157605,Europe
Denmark,23-02-2020,417274,859,233,417041,Europe
Djibouti,23-02-2020,432474,379,852,431622,Eastern Mediterranean
Dominican Republic,23-02-2020,86942,668,680,86262,Americas
Ecuador,23-02-2020,13857,1644,712,13145,Americas
Egypt,23-02-2020,424161,2207,239,423922,Eastern Mediterranean
El Salvador,23-02-2020,169585,1551,265,169320,Americas
Equatorial Guinea,23-02-2020,56385,768,131,56254,Africa
Eritrea,23-02-2020,217812,1869,382,217430,Africa
Estonia,23-02-2020,30007,493,724,29283,Europe
Eswatini,23-02-2020,269678,1046,382,269296,Africa
Ethiopia,23-02-2020,183362,1849,845,182517,Africa
Fiji,23-02-2020,128047,851,1230,126817,Western Pacific
Finland,23-02-2020,231998,1349,1083,230915,Europe
France,23-02-2020,201834,1433,308,201526,Europe
France,23-02-2020,20299,807,867,19432,Europe
France,23-02-2020,407304,1654,575,406729,Europe
France,23-02-2020,267430,1548,170,267260,Europe
France,23-02-2020,360133,981,97,360036,Europe
France,23-02-2020,19606,1500,333,19273,Europe
France,23-02-2020,422926,2282,574,422352,Europe
France,23-02-2020,210274,60,263,210011,Europe
France,23-02-2020,61843,126,1118,60725,Europe
France,23-02-2020,378733,1823,731,378002,Europe
Gabon,23-02-2020,74342,1630,320,74022,Africa
Gambia,23-02-2020,325826,537,884,324942,Africa
Georgia,23-02-2020,170338,107,1082,169256,Europe
Germany,23-02-2020,97880,1161,1004,96876,Europe
Ghana,23-02-2020,399575,2219,95,399480,Africa
Greece,23-02-2020,424024,90,247,423777,Europe
Guatemala,23-02-2020,314790,2217,257,314533,Americas
Guinea,23-02-2020,367884,1464,953,366931,Africa
Guyana,23-02-2020,358364,1489,552,357812,Americas
Haiti,23-02-2020,409717,730,621,409096,Americas
Holy See,23-02-2020,260263,389,1113,259150,Europe
Honduras,23-02-2020,113953,2008,863,113090,Americas
Hungary,23-02-2020,223839,2264,496,223343,Europe
Iceland,23-02-2020,316636,675,765,315871,Europe
India,23-02-2020,193196,1081,1030,192166,South-East Asia
Indonesia,23-02-2020,42731,1279,903,41828,South-East Asia
Iran,23-02-2020,372387,1362,1104,371283,Eastern Mediterranean
Iraq,23-02-2020,99714,1456,1091,98623,Eastern Mediterranean
Ireland,23-02-2020,414630,1768,665,413965,Europe
Israel,23-02-2020,254134,773,596,253538,Europe
Italy,23-02-2020,178931,31,754,178177,Europe
Jamaica,23-02-2020,140111,1960,1135,138976,Americas
Japan,23-02-2020,250768,1334,1210,249558,Western Pacific
Jordan,23-02-2020,329735,1093,1143,328592,Eastern Mediterranean
Kazakhstan,23-02-2020,168703,1819,805,167898,Europe
Kenya,23-02-2020,36377,885,54,36323,Africa
South Korea,23-02-2020,289837,1123,904,288933,Western Pacific
Kuwait,23-02-2020,24106,1619,381,23725,Eastern Mediterranean
Kyrgyzstan,23-02-2020,213181,789,947,212234,Europe
Latvia,23-02-2020,444710,242,562,444148,Europe
Lebanon,23-02-2020,404596,583,127,404469,Eastern Mediterranean
Liberia,23-02-2020,248398,66,564,247834,Africa
Liechtenstein,23-02-2020,304933,307,970,303963,Europe
Lithuania,23-02-2020,193688,2141,1130,192558,Europe
Luxembourg,23-02-2020,279230,845,888,278342,Europe
Madagascar,23-02-2020,196835,345,815,196020,Africa
Malaysia,23-02-2020,443022,2101,289,442733,Western Pacific
Maldives,23-02-2020,161816,1772,900,160916,South-East Asia
Malta,23-02-2020,260089,1961,235,259854,Europe
Mauritania,23-02-2020,400219,2276,133,400086,Africa
Mauritius,23-02-2020,220473,2484,591,219882,Africa
Mexico,23-02-2020,60065,1571,1139,58926,Americas
Moldova,23-02-2020,28935,2308,586,28349,Europe
Monaco,23-02-2020,291681,1439,630,291051,Europe
Mongolia,23-02-2020,266705,2102,159,266546,Western Pacific
Montenegro,23-02-2020,301080,954,103,300977,Europe
Morocco,23-02-2020,396420,721,625,395795,Eastern Mediterranean
Namibia,23-02-2020,398455,2430,539,397916,Africa
Nepal,23-02-2020,413116,1264,218,412898,South-East Asia
Netherlands,23-02-2020,186658,2448,990,185668,Europe
Netherlands,23-02-2020,251666,754,696,250970,Europe
Netherlands,23-02-2020,245527,682,28,245499,Europe
Netherlands,23-02-2020,350609,1406,425,350184,Europe
New Zealand,23-02-2020,425819,2368,745,425074,Western Pacific
Nicaragua,23-02-2020,113963,1093,623,113340,Americas
Niger,23-02-2020,35290,1793,543,34747,Africa
Nigeria,23-02-2020,324812,1905,1154,323658,Africa
North Macedonia,23-02-2020,282506,1720,280,282226,Europe
Norway,23-02-2020,97233,2316,664,96569,Europe
Oman,23-02-2020,37182,1805,761,36421,Eastern Mediterranean
Pakistan,23-02-2020,353463,735,204,353259,Eastern Mediterranean
Panama,23-02-2020,357578,926,318,357260,Americas
Papua New Guinea,23-02-2020,255410,1351,145,255265,Western Pacific
Paraguay,23-02-2020,347197,2172,971,346226,Americas
Peru,23-02-2020,112275,329,1235,111040,Americas
Philippines,23-02-2020,106664,951,1163,105501,Western Pacific
Poland,23-02-2020,419933,707,1246,418687,Europe
Portugal,23-02-2020,274713,501,245,274468,Europe
Qatar,23-02-2020,131799,798,1105,130694,Eastern Mediterranean
Romania,23-02-2020,300551,998,343,300208,Europe
Russia,23-02-2020,300893,2122,63,300830,Europe
Rwanda,23-02-2020,45383,848,211,45172,Africa
Saint Lucia,23-02-2020,439990,1909,701,439289,Americas
Saint Vincent and the Grenadines,23-02-2020,35428,273,898,34530,Americas
San Marino,23-02-2020,84162,2165,1247,82915,Europe
Saudi Arabia,23-02-2020,340690,635,403,340287,Eastern Mediterranean
Senegal,23-02-2020,256153,2426,366,255787,Africa
Serbia,23-02-2020,11964,1878,949,11015,Europe
Seychelles,23-02-2020,297176,584,435,296741,Africa
Singapore,23-02-2020,10275,1396,614,9661,Western Pacific
Slovakia,23-02-2020,264017,1103,405,263612,Europe
Slovenia,23-02-2020,201521,1041,524,200997,Europe
Somalia,23-02-2020,334023,168,337,333686,Eastern Mediterranean
South Africa,23-02-2020,109785,359,265,109520,Africa
Spain,23-02-2020,72950,1074,630,72320,Europe
Sri Lanka,23-02-2020,167254,1103,81,167173,South-East Asia
Sudan,23-02-2020,40693,2309,448,40245,Eastern Mediterranean
Suriname,23-02-2020,204923,1358,941,203982,Americas
Sweden,23-02-2020,199713,220,1249,198464,Europe
Switzerland,23-02-2020,299155,550,40,299115,Europe
Taiwan*,23-02-2020,275486,1676,230,275256,Western Pacific
Tanzania,23-02-2020,409714,40,1246,408468,Africa
Thailand,23-02-2020,6810,1513,448,6362,South-East Asia
Togo,23-02-2020,339704,612,32,339672,Africa
Trinidad and Tobago,23-02-2020,38697,2255,192,38505,Americas
Tunisia,23-02-2020,348807,910,1105,347702,Eastern Mediterranean
Turkey,23-02-2020,12922,379,98,12824,Europe
Uganda,23-02-2020,222651,1557,1076,221575,Africa
Ukraine,23-02-2020,151227,252,135,151092,Europe
United Arab Emirates,23-02-2020,420641,2082,874,419767,Eastern Mediterranean
United Kingdom,23-02-2020,404626,1345,996,403630,Europe
United Kingdom,23-02-2020,371067,1273,309,370758,Europe
United Kingdom,23-02-2020,410745,405,377,410368,Europe
United Kingdom,23-02-2020,27110,904,1038,26072,Europe
United Kingdom,23-02-2020,372035,2053,886,371149,Europe
United Kingdom,23-02-2020,46167,18,958,45209,Europe
United Kingdom,23-02-2020,191769,669,406,191363,Europe
Uruguay,23-02-2020,169247,1958,1023,168224,Americas
US,23-02-2020,95313,524,676,94637,Americas
Uzbekistan,23-02-2020,156913,1322,201,156712,Europe
Venezuela,23-02-2020,391709,273,919,390790,Americas
Vietnam,23-02-2020,413052,86,267,412785,Western Pacific
Zambia,23-02-2020,419415,254,736,418679,Africa
Zimbabwe,23-02-2020,343227,8,716,342511,Africa
Dominica,23-02-2020,29317,2290,1052,28265,Americas
Grenada,23-02-2020,338344,1743,585,337759,Americas
Mozambique,23-02-2020,138913,2489,531,138382,Africa
Syria,23-02-2020,180199,186,158,180041,Eastern Mediterranean
Timor-Leste,23-02-2020,399533,1771,835,398698,South-East Asia
Belize,23-02-2020,322861,2219,982,321879,Americas
Laos,23-02-2020,30952,1961,975,29977,Western Pacific
Libya,23-02-2020,138827,393,83,138744,Eastern Mediterranean
West Bank and Gaza,23-02-2020,143038,624,1042,141996,Eastern Mediterranean
Guinea-Bissau,23-02-2020,284584,2421,466,284118,Africa
Mali,23-02-2020,194658,344,1217,193441,Africa
Saint Kitts and Nevis,23-02-2020,144634,1410,857,143777,Americas
Canada,23-02-2020,49886,1054,689,49197,Americas
Canada,23-02-2020,105423,2468,303,105120,Americas
Kosovo,23-02-2020,324043,1909,1227,322816,Europe
Burma,23-02-2020,190114,241,263,189851,South-East Asia
United Kingdom,23-02-2020,56876,2125,740,56136,Europe
United Kingdom,23-02-2020,70827,1560,378,70449,Europe
United Kingdom,23-02-2020,331064,1217,310,330754,Europe
Botswana,23-02-2020,440969,1102,234,440735,Africa
Burundi,23-02-2020,418707,2420,698,418009,Africa
Sierra Leone,23-02-2020,261017,2074,99,260918,Africa
Malawi,23-02-2020,435001,1842,149,434852,Africa
United Kingdom,23-02-2020,4580,911,1226,3354,Europe
France,23-02-2020,426395,1076,431,425964,Europe
South Sudan,23-02-2020,120564,1834,38,120526,Africa
Western Sahara,23-02-2020,358865,1160,768,358097,Africa
Sao Tome and Principe,23-02-2020,318642,525,372,318270,Africa
Yemen,23-02-2020,428275,1174,939,427336,Eastern Mediterranean
Comoros,23-02-2020,327460,2468,263,327197,Africa
Tajikistan,23-02-2020,251353,1314,211,251142,Europe
Lesotho,23-02-2020,291377,856,751,290626,Africa
Afghanistan,24-02-2020,241946,737,701,241245,Eastern Mediterranean
Albania,24-02-2020,366237,248,1244,364993,Europe
Algeria,24-02-2020,371077,1587,54,371023,Africa
Andorra,24-02-2020,380063,38,526,379537,Europe
Angola,24-02-2020,154473,764,293,154180,Africa
Antigua and Barbuda,24-02-2020,361088,2441,517,360571,Americas
Argentina,24-02-2020,235229,1005,384,234845,Americas
Armenia,24-02-2020,251373,737,1238,250135,Europe
Australia,24-02-2020,301818,2246,379,301439,Western Pacific
Australia,24-02-2020,252936,668,651,252285,Western Pacific
Australia,24-02-2020,55449,198,594,54855,Western Pacific
Australia,24-02-2020,309791,32,727,309064,Western Pacific
Australia,24-02-2020,203207,1518,1042,202165,Western Pacific
Australia,24-02-2020,5377,68,1052,4325,Western Pacific
Australia,24-02-2020,123998,1229,715,123283,Western Pacific
Australia,24-02-2020,45195,142,710,44485,Western Pacific
Austria,24-02-2020,207371,2241,216,207155,Europe
Azerbaijan,24-02-2020,401739,962,746,400993,Europe
Bahamas,24-02-2020,18978,1823,1007,17971,Americas
Bahrain,24-02-2020,13174,2472,449,12725,Eastern Mediterranean
Bangladesh,24-02-2020,443817,482,1043,442774,South-East Asia
Barbados,24-02-2020,422875,2487,644,422231,Americas
Belarus,24-02-2020,202503,183,213,202290,Europe
Belgium,24-02-2020,38451,2010,205,38246,Europe
Benin,24-02-2020,163211,369,285,162926,Africa
Bhutan,24-02-2020,372973,1885,249,372724,South-East Asia
Bolivia,24-02-2020,282016,1018,518,281498,Americas
Bosnia and Herzegovina,24-02-2020,277810,709,372,277438,Europe
Brazil,24-02-2020,405419,1384,1022,404397,Americas
Brunei,24-02-2020,325495,1701,769,324726,Western Pacific
Bulgaria,24-02-2020,94304,62,1047,93257,Europe
Burkina Faso,24-02-2020,344624,1836,1062,343562,Africa
Cabo Verde,24-02-2020,370863,1120,1136,369727,Africa
Cambodia,24-02-2020,181858,2233,1213,180645,Western Pacific
Cameroon,24-02-2020,351716,357,127,351589,Africa
Canada,24-02-2020,20348,821,876,19472,Americas
Canada,24-02-2020,244475,2421,209,244266,Americas
Canada,24-02-2020,382706,2030,1037,381669,Americas
Canada,24-02-2020,389323,1061,1203,388120,Americas
Canada,24-02-2020,394417,2111,982,393435,Americas
Canada,24-02-2020,231061,2086,835,230226,Americas
Canada,24-02-2020,325952,948,802,325150,Americas
Canada,24-02-2020,269172,855,173,268999,Americas
Canada,24-02-2020,113639,301,600,113039,Americas
Canada,24-02-2020,419090,55,820,418270,Americas
Central African Republic,24-02-2020,42352,108,727,41625,Africa
Chad,24-02-2020,201771,1690,584,201187,Africa
Chile,24-02-2020,5186,2074,437,4749,Americas
China,24-02-2020,186511,1483,17,186494,Western Pacific
China,24-02-2020,348393,1622,893,347500,Western Pacific
China,24-02-2020,403213,341,380,402833,Western Pacific
China,24-02-2020,308742,1881,367,308375,Western Pacific
China,24-02-2020,337449,897,122,337327,Western Pacific
China,24-02-2020,137215,965,607,136608,Western Pacific
China,24-02-2020,448362,1316,627,447735,Western Pacific
China,24-02-2020,55538,1895,734,54804,Western Pacific
China,24-02-2020,46661,1283,87,46574,Western Pacific
China,24-02-2020,100358,2338,14,100344,Western Pacific
China,24-02-2020,174097,1873,1165,172932,Western Pacific
China,24-02-2020,273809,1974,1250,272559,Western Pacific
China,24-02-2020,275630,510,404,275226,Western Pacific
China,24-02-2020,261975,2206,579,261396,Western Pacific
China,24-02-2020,336416,1145,297,336119,Western Pacific
China,24-02-2020,67287,1372,927,66360,Western Pacific
China,24-02-2020,445938,2500,605,445333,Western Pacific
China,24-02-2020,448410,1740,94,448316,Western Pacific
China,24-02-2020,99378,1728,448,98930,Western Pacific
China,24-02-2020,35563,1449,1247,34316,Western Pacific
China,24-02-2020,334604,882,223,334381,Western Pacific
China,24-02-2020,90656,2250,1089,89567,Western Pacific
China,24-02-2020,95143,220,322,94821,Western Pacific
China,24-02-2020,26926,292,21,26905,Western Pacific
China,24-02-2020,199646,161,176,199470,Western Pacific
China,24-02-2020,197120,1748,1178,195942,Western Pacific
China,24-02-2020,334225,323,311,333914,Western Pacific
China,24-02-2020,60375,360,1055,59320,Western Pacific
China,24-02-2020,247221,2362,485,246736,Western Pacific
China,24-02-2020,306334,1419,958,305376,Western Pacific
China,24-02-2020,162442,1233,48,162394,Western Pacific
China,24-02-2020,401840,1139,937,400903,Western Pacific
China,24-02-2020,49354,1600,978,48376,Western Pacific
Colombia,24-02-2020,217634,1128,1200,216434,Americas
Congo (Brazzaville),24-02-2020,99795,94,388,99407,Africa
Congo (Kinshasa),24-02-2020,58016,891,655,57361,Africa
Costa Rica,24-02-2020,374715,1655,915,373800,Americas
Cote d'Ivoire,24-02-2020,69330,268,600,68730,Africa
Croatia,24-02-2020,439525,1491,296,439229,Europe
Cuba,24-02-2020,104248,1230,525,103723,Americas
Cyprus,24-02-2020,316583,955,714,315869,Europe
Czechia,24-02-2020,398349,1561,684,397665,Europe
Denmark,24-02-2020,109629,2173,163,109466,Europe
Greenland,24-02-2020,401555,341,193,401362,Europe
Denmark,24-02-2020,322318,37,1062,321256,Europe
Djibouti,24-02-2020,166867,1657,784,166083,Eastern Mediterranean
Dominican Republic,24-02-2020,3455,1656,32,3423,Americas
Ecuador,24-02-2020,364090,1717,977,363113,Americas
Egypt,24-02-2020,168451,436,1107,167344,Eastern Mediterranean
El Salvador,24-02-2020,322281,2142,883,321398,Americas
Equatorial Guinea,24-02-2020,269358,443,1246,268112,Africa
Eritrea,24-02-2020,76969,1057,645,76324,Africa
Estonia,24-02-2020,166591,442,565,166026,Europe
Eswatini,24-02-2020,205592,1931,1110,204482,Africa
Ethiopia,24-02-2020,7893,1394,934,6959,Africa
Fiji,24-02-2020,345083,467,711,344372,Western Pacific
Finland,24-02-2020,55841,1366,378,55463,Europe
France,24-02-2020,85165,1488,1180,83985,Europe
France,24-02-2020,245190,1849,97,245093,Europe
France,24-02-2020,86523,585,85,86438,Europe
France,24-02-2020,386846,499,165,386681,Europe
France,24-02-2020,419625,810,221,419404,Europe
France,24-02-2020,353029,2444,377,352652,Europe
France,24-02-2020,180209,481,704,179505,Europe
France,24-02-2020,50050,499,835,49215,Europe
France,24-02-2020,186912,2105,982,185930,Europe
France,24-02-2020,387681,2406,721,386960,Europe
Gabon,24-02-2020,206245,607,176,206069,Africa
Gambia,24-02-2020,234229,2477,1030,233199,Africa
Georgia,24-02-2020,167986,166,821,167165,Europe
Germany,24-02-2020,32533,241,791,31742,Europe
Ghana,24-02-2020,242303,1039,27,242276,Africa
Greece,24-02-2020,56669,914,116,56553,Europe
Guatemala,24-02-2020,28755,840,736,28019,Americas
Guinea,24-02-2020,6841,414,585,6256,Africa
Guyana,24-02-2020,148569,1802,1182,147387,Americas
Haiti,24-02-2020,182207,2492,682,181525,Americas
Holy See,24-02-2020,88068,2041,859,87209,Europe
Honduras,24-02-2020,309068,963,257,308811,Americas
Hungary,24-02-2020,376792,868,141,376651,Europe
Iceland,24-02-2020,226460,19,1124,225336,Europe
India,24-02-2020,395625,2473,385,395240,South-East Asia
Indonesia,24-02-2020,51965,198,419,51546,South-East Asia
Iran,24-02-2020,331473,509,709,330764,Eastern Mediterranean
Iraq,24-02-2020,383967,284,108,383859,Eastern Mediterranean
Ireland,24-02-2020,326092,1360,654,325438,Europe
Israel,24-02-2020,260675,1085,1248,259427,Europe
Italy,24-02-2020,445431,781,1046,444385,Europe
Jamaica,24-02-2020,399710,154,746,398964,Americas
Japan,24-02-2020,152871,75,1112,151759,Western Pacific
Jordan,24-02-2020,272700,28,534,272166,Eastern Mediterranean
Kazakhstan,24-02-2020,36363,339,313,36050,Europe
Kenya,24-02-2020,399917,307,146,399771,Africa
South Korea,24-02-2020,359212,1318,955,358257,Western Pacific
Kuwait,24-02-2020,246306,1120,1109,245197,Eastern Mediterranean
Kyrgyzstan,24-02-2020,70160,1808,723,69437,Europe
Latvia,24-02-2020,83090,1326,517,82573,Europe
Lebanon,24-02-2020,285750,1887,1154,284596,Eastern Mediterranean
Liberia,24-02-2020,367780,1399,118,367662,Africa
Liechtenstein,24-02-2020,30302,804,394,29908,Europe
Lithuania,24-02-2020,192174,2026,1176,190998,Europe
Luxembourg,24-02-2020,284270,722,1011,283259,Europe
Madagascar,24-02-2020,135967,2351,1034,134933,Africa
Malaysia,24-02-2020,94893,694,261,94632,Western Pacific
Maldives,24-02-2020,162152,1045,1195,160957,South-East Asia
Malta,24-02-2020,440888,228,319,440569,Europe
Mauritania,24-02-2020,427753,1972,165,427588,Africa
Mauritius,24-02-2020,12816,1905,762,12054,Africa
Mexico,24-02-2020,297738,554,78,297660,Americas
Moldova,24-02-2020,192735,1364,1169,191566,Europe
Monaco,24-02-2020,189610,1251,40,189570,Europe
Mongolia,24-02-2020,138614,1129,389,138225,Western Pacific
Montenegro,24-02-2020,233852,2248,378,233474,Europe
Morocco,24-02-2020,309238,2366,774,308464,Eastern Mediterranean
Namibia,24-02-2020,152982,1954,467,152515,Africa
Nepal,24-02-2020,362689,1487,977,361712,South-East Asia
Netherlands,24-02-2020,302745,1950,1147,301598,Europe
Netherlands,24-02-2020,127449,58,860,126589,Europe
Netherlands,24-02-2020,124781,821,839,123942,Europe
Netherlands,24-02-2020,138937,1209,79,138858,Europe
New Zealand,24-02-2020,79370,476,611,78759,Western Pacific
Nicaragua,24-02-2020,213099,1792,533,212566,Americas
Niger,24-02-2020,185122,1168,771,184351,Africa
Nigeria,24-02-2020,305616,1467,112,305504,Africa
North Macedonia,24-02-2020,376484,172,998,375486,Europe
Norway,24-02-2020,356167,2285,631,355536,Europe
Oman,24-02-2020,301923,2184,679,301244,Eastern Mediterranean
Pakistan,24-02-2020,317837,1092,1247,316590,Eastern Mediterranean
Panama,24-02-2020,418933,1331,356,418577,Americas
Papua New Guinea,24-02-2020,367168,947,527,366641,Western Pacific
Paraguay,24-02-2020,230396,1733,132,230264,Americas
Peru,24-02-2020,435792,1425,1011,434781,Americas
Philippines,24-02-2020,311260,1192,284,310976,Western Pacific
Poland,24-02-2020,407821,2269,527,407294,Europe
Portugal,24-02-2020,249063,1586,454,248609,Europe
Qatar,24-02-2020,213933,1554,239,213694,Eastern Mediterranean
Romania,24-02-2020,365874,666,1248,364626,Europe
Russia,24-02-2020,272170,372,1045,271125,Europe
Rwanda,24-02-2020,433048,1346,1130,431918,Africa
Saint Lucia,24-02-2020,277664,719,1118,276546,Americas
Saint Vincent and the Grenadines,24-02-2020,383886,1075,16,383870,Americas
San Marino,24-02-2020,258885,245,521,258364,Europe
Saudi Arabia,24-02-2020,345158,2279,1248,343910,Eastern Mediterranean
Senegal,24-02-2020,61846,1524,428,61418,Africa
Serbia,24-02-2020,70382,459,1008,69374,Europe
Seychelles,24-02-2020,41366,2171,1123,40243,Africa
Singapore,24-02-2020,42872,1101,221,42651,Western Pacific
Slovakia,24-02-2020,58745,1519,188,58557,Europe
Slovenia,24-02-2020,112737,2459,326,112411,Europe
Somalia,24-02-2020,380950,824,488,380462,Eastern Mediterranean
South Africa,24-02-2020,82984,1440,842,82142,Africa
Spain,24-02-2020,78732,2495,1246,77486,Europe
Sri Lanka,24-02-2020,106739,638,919,105820,South-East Asia
Sudan,24-02-2020,221285,737,808,220477,Eastern Mediterranean
Suriname,24-02-2020,314371,2103,42,314329,Americas
Sweden,24-02-2020,153151,1122,945,152206,Europe
Switzerland,24-02-2020,35717,268,601,35116,Europe
Taiwan*,24-02-2020,341647,1959,582,341065,Western Pacific
Tanzania,24-02-2020,162463,2426,863,161600,Africa
Thailand,24-02-2020,73668,1783,1079,72589,South-East Asia
Togo,24-02-2020,345480,752,635,344845,Africa
Trinidad and Tobago,24-02-2020,340487,1799,1250,339237,Americas
Tunisia,24-02-2020,316913,1483,833,316080,Eastern Mediterranean
Turkey,24-02-2020,104429,400,384,104045,Europe
Uganda,24-02-2020,345677,2236,583,345094,Africa
Ukraine,24-02-2020,307773,1492,351,307422,Europe
United Arab Emirates,24-02-2020,299304,87,62,299242,Eastern Mediterranean
United Kingdom,24-02-2020,448618,1325,739,447879,Europe
United Kingdom,24-02-2020,292383,842,770,291613,Europe
United Kingdom,24-02-2020,94394,2053,332,94062,Europe
United Kingdom,24-02-2020,353642,2467,896,352746,Europe
United Kingdom,24-02-2020,335857,128,222,335635,Europe
United Kingdom,24-02-2020,264267,1027,146,264121,Europe
United Kingdom,24-02-2020,34659,1762,8,34651,Europe
Uruguay,24-02-2020,409232,1014,244,408988,Americas
US,24-02-2020,188105,269,944,187161,Americas
Uzbekistan,24-02-2020,177367,1996,406,176961,Europe
Venezuela,24-02-2020,266619,2334,29,266590,Americas
Vietnam,24-02-2020,324639,850,988,323651,Western Pacific
Zambia,24-02-2020,30336,715,36,30300,Africa
Zimbabwe,24-02-2020,248078,1808,180,247898,Africa
Dominica,24-02-2020,41543,1942,591,40952,Americas
Grenada,24-02-2020,432875,1104,570,432305,Americas
Mozambique,24-02-2020,218185,1845,1161,217024,Africa
Syria,24-02-2020,346867,1015,772,346095,Eastern Mediterranean
Timor-Leste,24-02-2020,327928,912,1063,326865,South-East Asia
Belize,24-02-2020,191298,1055,99,191199,Americas
Laos,24-02-2020,153227,1785,1233,151994,Western Pacific
Libya,24-02-2020,139294,1880,300,138994,Eastern Mediterranean
West Bank and Gaza,24-02-2020,270192,1520,945,269247,Eastern Mediterranean
Guinea-Bissau,24-02-2020,247815,963,137,247678,Africa
Mali,24-02-2020,223608,2118,1157,222451,Africa
Saint Kitts and Nevis,24-02-2020,117094,1001,105,116989,Americas
Canada,24-02-2020,229843,1825,719,229124,Americas
Canada,24-02-2020,233018,412,173,232845,Americas
Kosovo,24-02-2020,88460,1853,40,88420,Europe
Burma,24-02-2020,130440,1961,112,130328,South-East Asia
United Kingdom,24-02-2020,232510,2039,8,232502,Europe
United Kingdom,24-02-2020,393871,1281,782,393089,Europe
United Kingdom,24-02-2020,32647,1721,530,32117,Europe
Botswana,24-02-2020,1301,2016,1054,247,Africa
Burundi,24-02-2020,189365,449,688,188677,Africa
Sierra Leone,24-02-2020,196812,1004,1061,195751,Africa
Malawi,24-02-2020,292403,534,133,292270,Africa
United Kingdom,24-02-2020,129723,1385,1144,128579,Europe
France,24-02-2020,394732,1990,472,394260,Europe
South Sudan,24-02-2020,399517,22,1014,398503,Africa
Western Sahara,24-02-2020,174114,1763,1000,173114,Africa
Sao Tome and Principe,24-02-2020,193054,1431,954,192100,Africa
Yemen,24-02-2020,413257,770,342,412915,Eastern Mediterranean
Comoros,24-02-2020,446717,965,782,445935,Africa
Tajikistan,24-02-2020,221046,2352,1176,219870,Europe
Lesotho,24-02-2020,16022,1436,975,15047,Africa
Afghanistan,25-02-2020,320233,1060,703,319530,Eastern Mediterranean
Albania,25-02-2020,327283,2095,1133,326150,Europe
Algeria,25-02-2020,51410,1988,142,51268,Africa
Andorra,25-02-2020,349975,2190,495,349480,Europe
Angola,25-02-2020,386268,2007,1054,385214,Africa
Antigua and Barbuda,25-02-2020,227806,219,347,227459,Americas
Argentina,25-02-2020,394693,1603,699,393994,Americas
Armenia,25-02-2020,407742,1771,1074,406668,Europe
Australia,25-02-2020,189524,1586,1176,188348,Western Pacific
Australia,25-02-2020,331200,1106,869,330331,Western Pacific
Australia,25-02-2020,193941,12,527,193414,Western Pacific
Australia,25-02-2020,173830,1620,1088,172742,Western Pacific
Australia,25-02-2020,45813,1453,802,45011,Western Pacific
Australia,25-02-2020,60428,1105,918,59510,Western Pacific
Australia,25-02-2020,303385,1178,387,302998,Western Pacific
Australia,25-02-2020,306872,2468,316,306556,Western Pacific
Austria,25-02-2020,288141,1926,373,287768,Europe
Azerbaijan,25-02-2020,299873,1125,880,298993,Europe
Bahamas,25-02-2020,163045,70,748,162297,Americas
Bahrain,25-02-2020,382077,117,1141,380936,Eastern Mediterranean
Bangladesh,25-02-2020,438917,378,372,438545,South-East Asia
Barbados,25-02-2020,292727,1820,46,292681,Americas
Belarus,25-02-2020,19614,1485,224,19390,Europe
Belgium,25-02-2020,91878,443,75,91803,Europe
Benin,25-02-2020,185484,935,1246,184238,Africa
Bhutan,25-02-2020,349298,768,94,349204,South-East Asia
Bolivia,25-02-2020,291756,1814,490,291266,Americas
Bosnia and Herzegovina,25-02-2020,393962,1576,627,393335,Europe
Brazil,25-02-2020,327644,456,789,326855,Americas
Brunei,25-02-2020,418973,1596,1192,417781,Western Pacific
Bulgaria,25-02-2020,240559,857,415,240144,Europe
Burkina Faso,25-02-2020,176669,1761,557,176112,Africa
Cabo Verde,25-02-2020,235253,2475,829,234424,Africa
Cambodia,25-02-2020,294945,1856,518,294427,Western Pacific
Cameroon,25-02-2020,15990,869,1022,14968,Africa
Canada,25-02-2020,445258,612,505,444753,Americas
Canada,25-02-2020,168973,699,251,168722,Americas
Canada,25-02-2020,303912,1179,540,303372,Americas
Canada,25-02-2020,314702,1490,1199,313503,Americas
Canada,25-02-2020,172447,115,996,171451,Americas
Canada,25-02-2020,251911,2376,736,251175,Americas
Canada,25-02-2020,13263,520,896,12367,Americas
Canada,25-02-2020,249873,966,646,249227,Americas
Canada,25-02-2020,321045,736,93,320952,Americas
Canada,25-02-2020,139463,1977,868,138595,Americas
Central African Republic,25-02-2020,132899,559,213,132686,Africa
Chad,25-02-2020,384343,516,422,383921,Africa
Chile,25-02-2020,221655,2215,477,221178,Americas
China,25-02-2020,7813,1222,1144,6669,Western Pacific
China,25-02-2020,403570,255,864,402706,Western Pacific
China,25-02-2020,104096,2080,509,103587,Western Pacific
China,25-02-2020,128207,1930,935,127272,Western Pacific
China,25-02-2020,431362,1836,245,431117,Western Pacific
China,25-02-2020,47428,1375,381,47047,Western Pacific
China,25-02-2020,304665,1927,129,304536,Western Pacific
China,25-02-2020,120072,445,906,119166,Western Pacific
China,25-02-2020,333943,1087,80,333863,Western Pacific
China,25-02-2020,337784,305,207,337577,Western Pacific
China,25-02-2020,171988,1092,793,171195,Western Pacific
China,25-02-2020,318283,528,1129,317154,Western Pacific
China,25-02-2020,443856,1355,300,443556,Western Pacific
China,25-02-2020,171402,367,887,170515,Western Pacific
China,25-02-2020,343397,44,914,342483,Western Pacific
China,25-02-2020,200056,1877,234,199822,Western Pacific
China,25-02-2020,434490,24,797,433693,Western Pacific
China,25-02-2020,106552,1957,178,106374,Western Pacific
China,25-02-2020,300106,1750,863,299243,Western Pacific
China,25-02-2020,200048,1848,811,199237,Western Pacific
China,25-02-2020,56645,1439,244,56401,Western Pacific
China,25-02-2020,182802,1196,1204,181598,Western Pacific
China,25-02-2020,290052,832,658,289394,Western Pacific
China,25-02-2020,15444,1805,104,15340,Western Pacific
China,25-02-2020,210092,2366,266,209826,Western Pacific
China,25-02-2020,261597,360,747,260850,Western Pacific
China,25-02-2020,127015,363,230,126785,Western Pacific
China,25-02-2020,58880,511,1173,57707,Western Pacific
China,25-02-2020,169990,1834,939,169051,Western Pacific
China,25-02-2020,322143,216,1024,321119,Western Pacific
China,25-02-2020,302317,1902,671,301646,Western Pacific
China,25-02-2020,375224,165,554,374670,Western Pacific
China,25-02-2020,45905,2270,615,45290,Western Pacific
Colombia,25-02-2020,190155,334,625,189530,Americas
Congo (Brazzaville),25-02-2020,278041,2358,678,277363,Africa
Congo (Kinshasa),25-02-2020,91344,58,161,91183,Africa
Costa Rica,25-02-2020,137795,215,244,137551,Americas
Cote d'Ivoire,25-02-2020,209566,1106,839,208727,Africa
Croatia,25-02-2020,20261,501,1250,19011,Europe
Cuba,25-02-2020,330811,1489,110,330701,Americas
Cyprus,25-02-2020,339540,1860,492,339048,Europe
Czechia,25-02-2020,372146,2226,1,372145,Europe
Denmark,25-02-2020,52849,1666,849,52000,Europe
Greenland,25-02-2020,210233,715,357,209876,Europe
Denmark,25-02-2020,394868,582,1009,393859,Europe
Djibouti,25-02-2020,177007,103,958,176049,Eastern Mediterranean
Dominican Republic,25-02-2020,386891,167,483,386408,Americas
Ecuador,25-02-2020,408284,1461,95,408189,Americas
Egypt,25-02-2020,88881,1153,654,88227,Eastern Mediterranean
El Salvador,25-02-2020,59924,33,673,59251,Americas
Equatorial Guinea,25-02-2020,80780,2017,127,80653,Africa
Eritrea,25-02-2020,320052,1744,744,319308,Africa
Estonia,25-02-2020,174566,2158,618,173948,Europe
Eswatini,25-02-2020,318215,433,5,318210,Africa
Ethiopia,25-02-2020,114601,2259,894,113707,Africa
Fiji,25-02-2020,408737,448,1222,407515,Western Pacific
Finland,25-02-2020,5914,2487,777,5137,Europe
France,25-02-2020,245863,1502,1250,244613,Europe
France,25-02-2020,235057,299,437,234620,Europe
France,25-02-2020,108403,501,180,108223,Europe
France,25-02-2020,90412,371,502,89910,Europe
France,25-02-2020,440502,125,94,440408,Europe
France,25-02-2020,394503,1902,427,394076,Europe
France,25-02-2020,437027,187,660,436367,Europe
France,25-02-2020,81390,988,1236,80154,Europe
France,25-02-2020,83904,1572,579,83325,Europe
France,25-02-2020,257794,1876,5,257789,Europe
Gabon,25-02-2020,241185,373,356,240829,Africa
Gambia,25-02-2020,441490,57,507,440983,Africa
Georgia,25-02-2020,62987,360,422,62565,Europe
Germany,25-02-2020,213780,876,973,212807,Europe
Ghana,25-02-2020,210307,2205,694,209613,Africa
Greece,25-02-2020,359280,1725,75,359205,Europe
Guatemala,25-02-2020,220928,1948,401,220527,Americas
Guinea,25-02-2020,125127,2467,774,124353,Africa
Guyana,25-02-2020,77192,1290,1109,76083,Americas
Haiti,25-02-2020,81659,13,1073,80586,Americas
Holy See,25-02-2020,121866,1131,402,121464,Europe
Honduras,25-02-2020,307786,524,124,307662,Americas
Hungary,25-02-2020,244770,863,752,244018,Europe
Iceland,25-02-2020,397050,1373,780,396270,Europe
India,25-02-2020,236241,2268,926,235315,South-East Asia
Indonesia,25-02-2020,119835,1280,1203,118632,South-East Asia
Iran,25-02-2020,393775,777,835,392940,Eastern Mediterranean
Iraq,25-02-2020,289697,1673,80,289617,Eastern Mediterranean
Ireland,25-02-2020,108958,793,1067,107891,Europe
Israel,25-02-2020,79104,245,686,78418,Europe
Italy,25-02-2020,368304,1551,998,367306,Europe
Jamaica,25-02-2020,68287,2009,393,67894,Americas
Japan,25-02-2020,440825,1081,409,440416,Western Pacific
Jordan,25-02-2020,14269,642,1137,13132,Eastern Mediterranean
Kazakhstan,25-02-2020,79988,1616,587,79401,Europe
Kenya,25-02-2020,215729,1244,500,215229,Africa
South Korea,25-02-2020,185226,1761,24,185202,Western Pacific
Kuwait,25-02-2020,65991,1179,872,65119,Eastern Mediterranean
Kyrgyzstan,25-02-2020,317499,2385,682,316817,Europe
Latvia,25-02-2020,249232,1714,1061,248171,Europe
Lebanon,25-02-2020,286589,75,1166,285423,Eastern Mediterranean
Liberia,25-02-2020,98756,427,799,97957,Africa
Liechtenstein,25-02-2020,259055,1179,82,258973,Europe
Lithuania,25-02-2020,8938,310,1154,7784,Europe
Luxembourg,25-02-2020,375785,119,963,374822,Europe
Madagascar,25-02-2020,328277,1699,564,327713,Africa
Malaysia,25-02-2020,31408,339,228,31180,Western Pacific
Maldives,25-02-2020,278461,116,116,278345,South-East Asia
Malta,25-02-2020,198795,2353,1173,197622,Europe
Mauritania,25-02-2020,87791,1803,527,87264,Africa
Mauritius,25-02-2020,442169,1881,809,441360,Africa
Mexico,25-02-2020,25497,823,249,25248,Americas
Moldova,25-02-2020,377222,888,1213,376009,Europe
Monaco,25-02-2020,257740,617,409,257331,Europe
Mongolia,25-02-2020,149268,2325,1092,148176,Western Pacific
Montenegro,25-02-2020,218406,1562,318,218088,Europe
Morocco,25-02-2020,277739,759,1033,276706,Eastern Mediterranean
Namibia,25-02-2020,247110,1548,1158,245952,Africa
Nepal,25-02-2020,362197,485,963,361234,South-East Asia
Netherlands,25-02-2020,356663,730,377,356286,Europe
Netherlands,25-02-2020,80279,2073,749,79530,Europe
Netherlands,25-02-2020,40405,2259,696,39709,Europe
Netherlands,25-02-2020,176436,713,1159,175277,Europe
New Zealand,25-02-2020,187118,686,753,186365,Western Pacific
Nicaragua,25-02-2020,135178,238,574,134604,Americas
Niger,25-02-2020,30185,6,519,29666,Africa
Nigeria,25-02-2020,93100,1609,1037,92063,Africa
North Macedonia,25-02-2020,74168,1922,980,73188,Europe
Norway,25-02-2020,317517,310,1046,316471,Europe
Oman,25-02-2020,373646,1997,95,373551,Eastern Mediterranean
Pakistan,25-02-2020,215624,1577,853,214771,Eastern Mediterranean
Panama,25-02-2020,21562,1637,671,20891,Americas
Papua New Guinea,25-02-2020,32263,2004,659,31604,Western Pacific
Paraguay,25-02-2020,432500,1308,253,432247,Americas
Peru,25-02-2020,49624,1057,926,48698,Americas
Philippines,25-02-2020,96488,2118,320,96168,Western Pacific
Poland,25-02-2020,63059,1037,95,62964,Europe
Portugal,25-02-2020,368075,2321,1190,366885,Europe
Qatar,25-02-2020,224890,49,945,223945,Eastern Mediterranean
Romania,25-02-2020,73976,1243,1020,72956,Europe
Russia,25-02-2020,382194,553,503,381691,Europe
Rwanda,25-02-2020,80177,405,621,79556,Africa
Saint Lucia,25-02-2020,441583,1943,1167,440416,Americas
Saint Vincent and the Grenadines,25-02-2020,161704,1689,354,161350,Americas
San Marino,25-02-2020,107114,990,1059,106055,Europe
Saudi Arabia,25-02-2020,173933,373,77,173856,Eastern Mediterranean
Senegal,25-02-2020,213844,2245,531,213313,Africa
Serbia,25-02-2020,444131,1726,1145,442986,Europe
Seychelles,25-02-2020,262006,1514,488,261518,Africa
Singapore,25-02-2020,312759,508,865,311894,Western Pacific
Slovakia,25-02-2020,97119,2274,231,96888,Europe
Slovenia,25-02-2020,56964,2277,965,55999,Europe
Somalia,25-02-2020,97613,1474,830,96783,Eastern Mediterranean
South Africa,25-02-2020,381949,874,1111,380838,Africa
Spain,25-02-2020,333134,221,438,332696,Europe
Sri Lanka,25-02-2020,176534,512,33,176501,South-East Asia
Sudan,25-02-2020,241674,1549,808,240866,Eastern Mediterranean
Suriname,25-02-2020,408645,1844,702,407943,Americas
Sweden,25-02-2020,320126,55,897,319229,Europe
Switzerland,25-02-2020,319316,1635,83,319233,Europe
Taiwan*,25-02-2020,46305,1943,515,45790,Western Pacific
Tanzania,25-02-2020,237787,829,204,237583,Africa
Thailand,25-02-2020,300995,102,614,300381,South-East Asia
Togo,25-02-2020,108986,2346,462,108524,Africa
Trinidad and Tobago,25-02-2020,416077,297,519,415558,Americas
Tunisia,25-02-2020,358341,2347,927,357414,Eastern Mediterranean
Turkey,25-02-2020,264929,2487,859,264070,Europe
Uganda,25-02-2020,419550,1996,384,419166,Africa
Ukraine,25-02-2020,297437,1896,33,297404,Europe
United Arab Emirates,25-02-2020,221326,596,990,220336,Eastern Mediterranean
United Kingdom,25-02-2020,395332,270,954,394378,Europe
United Kingdom,25-02-2020,398944,1078,371,398573,Europe
United Kingdom,25-02-2020,299773,2464,531,299242,Europe
United Kingdom,25-02-2020,66837,1460,500,66337,Europe
United Kingdom,25-02-2020,231820,1114,1175,230645,Europe
United Kingdom,25-02-2020,337966,182,577,337389,Europe
United Kingdom,25-02-2020,99920,1140,497,99423,Europe
Uruguay,25-02-2020,23006,1907,886,22120,Americas
US,25-02-2020,115510,1522,367,115143,Americas
Uzbekistan,25-02-2020,64140,1669,238,63902,Europe
Venezuela,25-02-2020,443546,2069,777,442769,Americas
Vietnam,25-02-2020,162474,1879,568,161906,Western Pacific
Zambia,25-02-2020,28423,1212,400,28023,Africa
Zimbabwe,25-02-2020,132907,587,225,132682,Africa
Dominica,25-02-2020,160259,523,597,159662,Americas
Grenada,25-02-2020,227481,188,1028,226453,Americas
Mozambique,25-02-2020,75723,1349,1226,74497,Africa
Syria,25-02-2020,446233,2094,1059,445174,Eastern Mediterranean
Timor-Leste,25-02-2020,257473,75,782,256691,South-East Asia
Belize,25-02-2020,174078,2048,429,173649,Americas
Laos,25-02-2020,198210,2049,997,197213,Western Pacific
Libya,25-02-2020,351518,184,864,350654,Eastern Mediterranean
West Bank and Gaza,25-02-2020,155814,743,559,155255,Eastern Mediterranean
Guinea-Bissau,25-02-2020,108411,828,473,107938,Africa
Mali,25-02-2020,281653,684,918,280735,Africa
Saint Kitts and Nevis,25-02-2020,281044,1270,892,280152,Americas
Canada,25-02-2020,145504,1738,821,144683,Americas
Canada,25-02-2020,350302,183,615,349687,Americas
Kosovo,25-02-2020,115156,2500,761,114395,Europe
Burma,25-02-2020,203454,1604,345,203109,South-East Asia
United Kingdom,25-02-2020,297700,299,930,296770,Europe
United Kingdom,25-02-2020,13334,661,1164,12170,Europe
United Kingdom,25-02-2020,447243,1807,105,447138,Europe
Botswana,25-02-2020,8783,2492,238,8545,Africa
Burundi,25-02-2020,147385,436,642,146743,Africa
Sierra Leone,25-02-2020,432793,2226,1222,431571,Africa
Malawi,25-02-2020,54255,166,366,53889,Africa
United Kingdom,25-02-2020,216441,290,3,216438,Europe
France,25-02-2020,330595,495,946,329649,Europe
South Sudan,25-02-2020,382153,1334,877,381276,Africa
Western Sahara,25-02-2020,231222,1424,562,230660,Africa
Sao Tome and Principe,25-02-2020,303343,1919,867,302476,Africa
Yemen,25-02-2020,445079,1245,362,444717,Eastern Mediterranean
Comoros,25-02-2020,257343,1731,955,256388,Africa
Tajikistan,25-02-2020,188138,1906,21,188117,Europe
Lesotho,25-02-2020,357268,776,826,356442,Africa
Afghanistan,26-02-2020,44133,1558,260,43873,Eastern Mediterranean
Albania,26-02-2020,356635,140,388,356247,Europe
Algeria,26-02-2020,188058,17,320,187738,Africa
Andorra,26-02-2020,110869,2092,630,110239,Europe
Angola,26-02-2020,79049,1681,300,78749,Africa
Antigua and Barbuda,26-02-2020,99541,2413,195,99346,Americas
Argentina,26-02-2020,240180,1981,273,239907,Americas
Armenia,26-02-2020,251703,401,381,251322,Europe
Australia,26-02-2020,61655,2158,114,61541,Western Pacific
Australia,26-02-2020,138807,2175,670,138137,Western Pacific
Australia,26-02-2020,58828,2393,788,58040,Western Pacific
Australia,26-02-2020,122123,311,813,121310,Western Pacific
Australia,26-02-2020,315387,228,149,315238,Western Pacific
Australia,26-02-2020,151066,1608,902,150164,Western Pacific
Australia,26-02-2020,96358,2280,328,96030,Western Pacific
Australia,26-02-2020,140139,779,710,139429,Western Pacific
Austria,26-02-2020,17512,853,347,17165,Europe
Azerbaijan,26-02-2020,244466,1439,1200,243266,Europe
Bahamas,26-02-2020,206915,2099,1028,205887,Americas
Bahrain,26-02-2020,295220,2094,885,294335,Eastern Mediterranean
Bangladesh,26-02-2020,19382,1134,696,18686,South-East Asia
Barbados,26-02-2020,226204,698,989,225215,Americas
Belarus,26-02-2020,444261,1245,252,444009,Europe
Belgium,26-02-2020,105054,2472,413,104641,Europe
Benin,26-02-2020,317924,2482,480,317444,Africa
Bhutan,26-02-2020,20188,609,1205,18983,South-East Asia
Bolivia,26-02-2020,145086,295,239,144847,Americas
Bosnia and Herzegovina,26-02-2020,119523,1422,404,119119,Europe
Brazil,26-02-2020,135369,311,46,135323,Americas
Brunei,26-02-2020,376833,642,167,376666,Western Pacific
Bulgaria,26-02-2020,86762,1556,262,86500,Europe
Burkina Faso,26-02-2020,110205,2241,849,109356,Africa
Cabo Verde,26-02-2020,28176,422,780,27396,Africa
Cambodia,26-02-2020,353480,289,220,353260,Western Pacific
Cameroon,26-02-2020,224389,1456,930,223459,Africa
Canada,26-02-2020,105521,2015,12,105509,Americas
Canada,26-02-2020,118281,547,344,117937,Americas
Canada,26-02-2020,449075,1293,228,448847,Americas
Canada,26-02-2020,48135,165,404,47731,Americas
Canada,26-02-2020,259537,238,50,259487,Americas
Canada,26-02-2020,371480,1333,845,370635,Americas
Canada,26-02-2020,75111,1679,180,74931,Americas
Canada,26-02-2020,405901,543,849,405052,Americas
Canada,26-02-2020,266454,1366,106,266348,Americas
Canada,26-02-2020,182624,2441,1198,181426,Americas
Central African Republic,26-02-2020,425125,74,940,424185,Africa
Chad,26-02-2020,207018,1878,1234,205784,Africa
Chile,26-02-2020,205981,1778,8,205973,Americas
China,26-02-2020,36821,2332,737,36084,Western Pacific
China,26-02-2020,204046,673,834,203212,Western Pacific
China,26-02-2020,404266,1150,602,403664,Western Pacific
China,26-02-2020,98216,2212,173,98043,Western Pacific
China,26-02-2020,288273,1184,67,288206,Western Pacific
China,26-02-2020,307932,1767,88,307844,Western Pacific
China,26-02-2020,367663,406,906,366757,Western Pacific
China,26-02-2020,414359,595,346,414013,Western Pacific
China,26-02-2020,297148,997,601,296547,Western Pacific
China,26-02-2020,152922,1975,238,152684,Western Pacific
China,26-02-2020,110965,1142,320,110645,Western Pacific
China,26-02-2020,334247,513,1246,333001,Western Pacific
China,26-02-2020,320051,878,521,319530,Western Pacific
China,26-02-2020,262732,2075,814,261918,Western Pacific
China,26-02-2020,123096,131,703,122393,Western Pacific
China,26-02-2020,379604,605,450,379154,Western Pacific
China,26-02-2020,355051,1288,1198,353853,Western Pacific
China,26-02-2020,304447,354,1050,303397,Western Pacific
China,26-02-2020,30527,1899,714,29813,Western Pacific
China,26-02-2020,114263,169,1218,113045,Western Pacific
China,26-02-2020,434592,1011,24,434568,Western Pacific
China,26-02-2020,380823,221,643,380180,Western Pacific
China,26-02-2020,380005,2173,1200,378805,Western Pacific
China,26-02-2020,6037,1845,994,5043,Western Pacific
China,26-02-2020,129698,1335,149,129549,Western Pacific
China,26-02-2020,95232,536,236,94996,Western Pacific
China,26-02-2020,157269,435,1104,156165,Western Pacific
China,26-02-2020,425900,1988,134,425766,Western Pacific
China,26-02-2020,299747,244,231,299516,Western Pacific
China,26-02-2020,387013,319,38,386975,Western Pacific
China,26-02-2020,272452,411,673,271779,Western Pacific
China,26-02-2020,175153,1485,613,174540,Western Pacific
China,26-02-2020,155651,1237,503,155148,Western Pacific
Colombia,26-02-2020,232810,1875,31,232779,Americas
Congo (Brazzaville),26-02-2020,58523,1390,954,57569,Africa
Congo (Kinshasa),26-02-2020,446938,527,524,446414,Africa
Costa Rica,26-02-2020,12096,2331,845,11251,Americas
Cote d'Ivoire,26-02-2020,40119,1055,175,39944,Africa
Croatia,26-02-2020,60638,2135,885,59753,Europe
Cuba,26-02-2020,309831,356,596,309235,Americas
Cyprus,26-02-2020,134185,1166,686,133499,Europe
Czechia,26-02-2020,436609,591,761,435848,Europe
Denmark,26-02-2020,120838,1524,1128,119710,Europe
Greenland,26-02-2020,116046,2241,679,115367,Europe
Denmark,26-02-2020,253,2071,1244,-991,Europe
Djibouti,26-02-2020,385781,1657,1201,384580,Eastern Mediterranean
Dominican Republic,26-02-2020,72562,948,171,72391,Americas
Ecuador,26-02-2020,258544,2133,746,257798,Americas
Egypt,26-02-2020,260520,2496,194,260326,Eastern Mediterranean
El Salvador,26-02-2020,206466,153,1125,205341,Americas
Equatorial Guinea,26-02-2020,349166,1131,1111,348055,Africa
Eritrea,26-02-2020,165864,673,435,165429,Africa
Estonia,26-02-2020,335691,207,1144,334547,Europe
Eswatini,26-02-2020,361419,2032,1212,360207,Africa
Ethiopia,26-02-2020,275950,533,805,275145,Africa
Fiji,26-02-2020,49761,1726,912,48849,Western Pacific
Finland,26-02-2020,390528,771,1092,389436,Europe
France,26-02-2020,415941,1443,475,415466,Europe
France,26-02-2020,24688,1882,673,24015,Europe
France,26-02-2020,380636,1698,1247,379389,Europe
France,26-02-2020,7909,1828,1207,6702,Europe
France,26-02-2020,319246,713,265,318981,Europe
France,26-02-2020,41356,1018,1162,40194,Europe
France,26-02-2020,136139,258,308,135831,Europe
France,26-02-2020,11828,1074,191,11637,Europe
France,26-02-2020,107800,1438,903,106897,Europe
France,26-02-2020,161323,1591,990,160333,Europe
Gabon,26-02-2020,231461,1906,633,230828,Africa
Gambia,26-02-2020,381906,2267,737,381169,Africa
Georgia,26-02-2020,442205,534,155,442050,Europe
Germany,26-02-2020,371682,1137,948,370734,Europe
Ghana,26-02-2020,75511,781,1061,74450,Africa
Greece,26-02-2020,418702,1380,391,418311,Europe
Guatemala,26-02-2020,277970,1609,718,277252,Americas
Guinea,26-02-2020,434288,285,556,433732,Africa
Guyana,26-02-2020,276013,927,429,275584,Americas
Haiti,26-02-2020,292614,132,485,292129,Americas
Holy See,26-02-2020,49989,2384,506,49483,Europe
Honduras,26-02-2020,159626,315,300,159326,Americas
Hungary,26-02-2020,332886,744,1102,331784,Europe
Iceland,26-02-2020,240601,838,219,240382,Europe
India,26-02-2020,418969,115,202,418767,South-East Asia
Indonesia,26-02-2020,61907,15,884,61023,South-East Asia
Iran,26-02-2020,63603,1713,292,63311,Eastern Mediterranean
Iraq,26-02-2020,66449,867,837,65612,Eastern Mediterranean
Ireland,26-02-2020,180288,1476,890,179398,Europe
Israel,26-02-2020,416813,2169,790,416023,Europe
Italy,26-02-2020,291292,1785,678,290614,Europe
Jamaica,26-02-2020,93314,641,725,92589,Americas
Japan,26-02-2020,225365,368,1047,224318,Western Pacific
Jordan,26-02-2020,134422,883,1096,133326,Eastern Mediterranean
Kazakhstan,26-02-2020,422340,517,1212,421128,Europe
Kenya,26-02-2020,178799,405,65,178734,Africa
South Korea,26-02-2020,155074,1383,341,154733,Western Pacific
Kuwait,26-02-2020,419006,972,1019,417987,Eastern Mediterranean
Kyrgyzstan,26-02-2020,272740,1316,149,272591,Europe
Latvia,26-02-2020,142725,769,1138,141587,Europe
Lebanon,26-02-2020,201028,203,483,200545,Eastern Mediterranean
Liberia,26-02-2020,112477,2028,1167,111310,Africa
Liechtenstein,26-02-2020,205812,1080,9,205803,Europe
Lithuania,26-02-2020,441794,1547,412,441382,Europe
Luxembourg,26-02-2020,286732,2408,963,285769,Europe
Madagascar,26-02-2020,145568,596,331,145237,Africa
Malaysia,26-02-2020,256427,710,18,256409,Western Pacific
Maldives,26-02-2020,410862,1580,88,410774,South-East Asia
Malta,26-02-2020,417940,2332,454,417486,Europe
Mauritania,26-02-2020,393975,1543,450,393525,Africa
Mauritius,26-02-2020,36704,2235,418,36286,Africa
Mexico,26-02-2020,355850,1943,1210,354640,Americas
Moldova,26-02-2020,47977,2491,856,47121,Europe
Monaco,26-02-2020,252601,305,727,251874,Europe
Mongolia,26-02-2020,86023,1831,636,85387,Western Pacific
Montenegro,26-02-2020,303148,735,497,302651,Europe
Morocco,26-02-2020,231683,1157,109,231574,Eastern Mediterranean
Namibia,26-02-2020,254443,648,359,254084,Africa
Nepal,26-02-2020,73866,1158,236,73630,South-East Asia
Netherlands,26-02-2020,280742,628,1229,279513,Europe
Netherlands,26-02-2020,343707,0,996,342711,Europe
Netherlands,26-02-2020,365886,1860,1086,364800,Europe
Netherlands,26-02-2020,81548,2333,279,81269,Europe
New Zealand,26-02-2020,393700,658,963,392737,Western Pacific
Nicaragua,26-02-2020,283339,1973,1058,282281,Americas
Niger,26-02-2020,179371,1074,271,179100,Africa
Nigeria,26-02-2020,237432,585,276,237156,Africa
North Macedonia,26-02-2020,372421,943,285,372136,Europe
Norway,26-02-2020,79477,1858,75,79402,Europe
Oman,26-02-2020,48994,974,236,48758,Eastern Mediterranean
Pakistan,26-02-2020,168777,778,1218,167559,Eastern Mediterranean
Panama,26-02-2020,56627,685,194,56433,Americas
Papua New Guinea,26-02-2020,193530,47,529,193001,Western Pacific
Paraguay,26-02-2020,213781,721,1159,212622,Americas
Peru,26-02-2020,95154,630,221,94933,Americas
Philippines,26-02-2020,362188,1679,226,361962,Western Pacific
Poland,26-02-2020,109030,552,1154,107876,Europe
Portugal,26-02-2020,111425,1602,647,110778,Europe
Qatar,26-02-2020,89247,2315,993,88254,Eastern Mediterranean
Romania,26-02-2020,7717,98,274,7443,Europe
Russia,26-02-2020,434549,239,1132,433417,Europe
Rwanda,26-02-2020,240039,469,749,239290,Africa
Saint Lucia,26-02-2020,88635,1116,11,88624,Americas
Saint Vincent and the Grenadines,26-02-2020,165083,1857,315,164768,Americas
San Marino,26-02-2020,320516,23,619,319897,Europe
Saudi Arabia,26-02-2020,288235,2128,5,288230,Eastern Mediterranean
Senegal,26-02-2020,314063,2469,1211,312852,Africa
Serbia,26-02-2020,390756,2417,427,390329,Europe
Seychelles,26-02-2020,224725,2118,469,224256,Africa
Singapore,26-02-2020,161134,2459,742,160392,Western Pacific
Slovakia,26-02-2020,197450,2063,551,196899,Europe
Slovenia,26-02-2020,228171,1631,1188,226983,Europe
Somalia,26-02-2020,443727,409,454,443273,Eastern Mediterranean
South Africa,26-02-2020,35710,2307,141,35569,Africa
Spain,26-02-2020,113796,1719,1187,112609,Europe
Sri Lanka,26-02-2020,172441,1277,120,172321,South-East Asia
Sudan,26-02-2020,367110,515,561,366549,Eastern Mediterranean
Suriname,26-02-2020,150133,396,355,149778,Americas
Sweden,26-02-2020,53155,2398,520,52635,Europe
Switzerland,26-02-2020,337260,1093,816,336444,Europe
Taiwan*,26-02-2020,416754,2138,956,415798,Western Pacific
Tanzania,26-02-2020,11778,227,211,11567,Africa
Thailand,26-02-2020,24502,2358,667,23835,South-East Asia
Togo,26-02-2020,8117,536,23,8094,Africa
Trinidad and Tobago,26-02-2020,407394,2395,109,407285,Americas
Tunisia,26-02-2020,160530,1344,118,160412,Eastern Mediterranean
Turkey,26-02-2020,351030,291,1041,349989,Europe
Uganda,26-02-2020,415429,821,583,414846,Africa
Ukraine,26-02-2020,354995,445,898,354097,Europe
United Arab Emirates,26-02-2020,261181,1408,1024,260157,Eastern Mediterranean
United Kingdom,26-02-2020,80428,1811,96,80332,Europe
United Kingdom,26-02-2020,391267,2101,1166,390101,Europe
United Kingdom,26-02-2020,240582,879,418,240164,Europe
United Kingdom,26-02-2020,366263,2337,1096,365167,Europe
United Kingdom,26-02-2020,12589,2168,974,11615,Europe
United Kingdom,26-02-2020,85792,1654,598,85194,Europe
United Kingdom,26-02-2020,276124,793,1215,274909,Europe
Uruguay,26-02-2020,373096,2122,1065,372031,Americas
US,26-02-2020,307562,1913,768,306794,Americas
Uzbekistan,26-02-2020,215339,1223,325,215014,Europe
Venezuela,26-02-2020,204037,1218,582,203455,Americas
Vietnam,26-02-2020,329608,2280,128,329480,Western Pacific
Zambia,26-02-2020,447845,43,701,447144,Africa
Zimbabwe,26-02-2020,425494,1639,755,424739,Africa
Dominica,26-02-2020,405974,2029,243,405731,Americas
Grenada,26-02-2020,246476,2375,974,245502,Americas
Mozambique,26-02-2020,243954,762,946,243008,Africa
Syria,26-02-2020,110307,319,638,109669,Eastern Mediterranean
Timor-Leste,26-02-2020,446982,1746,258,446724,South-East Asia
Belize,26-02-2020,275371,767,520,274851,Americas
Laos,26-02-2020,39282,1462,491,38791,Western Pacific
Libya,26-02-2020,15727,2274,1204,14523,Eastern Mediterranean
West Bank and Gaza,26-02-2020,394151,226,1220,392931,Eastern Mediterranean
Guinea-Bissau,26-02-2020,264963,855,22,264941,Africa
Mali,26-02-2020,317026,2004,214,316812,Africa
Saint Kitts and Nevis,26-02-2020,342995,1468,725,342270,Americas
Canada,26-02-2020,443426,2106,517,442909,Americas
Canada,26-02-2020,48490,2243,1218,47272,Americas
Kosovo,26-02-2020,355370,736,604,354766,Europe
Burma,26-02-2020,433408,1034,201,433207,South-East Asia
United Kingdom,26-02-2020,196535,1402,1179,195356,Europe
United Kingdom,26-02-2020,124793,1113,53,124740,Europe
United Kingdom,26-02-2020,298672,524,574,298098,Europe
Botswana,26-02-2020,156281,1899,513,155768,Africa
Burundi,26-02-2020,69086,792,226,68860,Africa
Sierra Leone,26-02-2020,101550,811,719,100831,Africa
Malawi,26-02-2020,16487,1554,1082,15405,Africa
United Kingdom,26-02-2020,252932,2269,449,252483,Europe
France,26-02-2020,263967,1971,589,263378,Europe
South Sudan,26-02-2020,218744,5,1045,217699,Africa
Western Sahara,26-02-2020,304285,2008,1040,303245,Africa
Sao Tome and Principe,26-02-2020,311954,158,1126,310828,Africa
Yemen,26-02-2020,124479,1683,741,123738,Eastern Mediterranean
Comoros,26-02-2020,258252,1638,179,258073,Africa
Tajikistan,26-02-2020,332829,1874,1030,331799,Europe
Lesotho,26-02-2020,430033,801,135,429898,Africa
Afghanistan,27-02-2020,254959,1399,670,254289,Eastern Mediterranean
Albania,27-02-2020,354311,765,1104,353207,Europe
Algeria,27-02-2020,139229,412,189,139040,Africa
Andorra,27-02-2020,293691,998,480,293211,Europe
Angola,27-02-2020,179349,1916,885,178464,Africa
Antigua and Barbuda,27-02-2020,149061,2388,852,148209,Americas
Argentina,27-02-2020,221207,2489,36,221171,Americas
Armenia,27-02-2020,75263,1295,1246,74017,Europe
Australia,27-02-2020,283705,2081,138,283567,Western Pacific
Australia,27-02-2020,235887,645,1118,234769,Western Pacific
Australia,27-02-2020,32681,980,691,31990,Western Pacific
Australia,27-02-2020,390231,735,1025,389206,Western Pacific
Australia,27-02-2020,84260,1519,232,84028,Western Pacific
Australia,27-02-2020,318373,53,920,317453,Western Pacific
Australia,27-02-2020,27911,2334,238,27673,Western Pacific
Australia,27-02-2020,262148,1863,1179,260969,Western Pacific
Austria,27-02-2020,62339,2101,293,62046,Europe
Azerbaijan,27-02-2020,399177,73,374,398803,Europe
Bahamas,27-02-2020,326649,468,478,326171,Americas
Bahrain,27-02-2020,184940,2174,287,184653,Eastern Mediterranean
Bangladesh,27-02-2020,260392,278,1235,259157,South-East Asia
Barbados,27-02-2020,192341,199,447,191894,Americas
Belarus,27-02-2020,401069,1545,911,400158,Europe
Belgium,27-02-2020,270450,1368,803,269647,Europe
Benin,27-02-2020,27957,1304,402,27555,Africa
Bhutan,27-02-2020,18094,1165,1222,16872,South-East Asia
Bolivia,27-02-2020,9283,1239,967,8316,Americas
Bosnia and Herzegovina,27-02-2020,270618,1775,726,269892,Europe
Brazil,27-02-2020,338734,58,1029,337705,Americas
Brunei,27-02-2020,110304,1851,359,109945,Western Pacific
Bulgaria,27-02-2020,66009,1204,1157,64852,Europe
Burkina Faso,27-02-2020,300078,2439,713,299365,Africa
Cabo Verde,27-02-2020,77351,967,468,76883,Africa
Cambodia,27-02-2020,280638,2364,1022,279616,Western Pacific
Cameroon,27-02-2020,429147,1535,822,428325,Africa
Canada,27-02-2020,223950,429,371,223579,Americas
Canada,27-02-2020,396126,1468,22,396104,Americas
Canada,27-02-2020,271658,1360,588,271070,Americas
Canada,27-02-2020,307630,451,820,306810,Americas
Canada,27-02-2020,150753,630,801,149952,Americas
Canada,27-02-2020,314292,198,4,314288,Americas
Canada,27-02-2020,55737,260,1110,54627,Americas
Canada,27-02-2020,275628,1711,1073,274555,Americas
Canada,27-02-2020,422821,1576,1209,421612,Americas
Canada,27-02-2020,92645,2392,393,92252,Americas
Central African Republic,27-02-2020,332944,596,278,332666,Africa
Chad,27-02-2020,258987,1418,204,258783,Africa
Chile,27-02-2020,337750,1097,864,336886,Americas
China,27-02-2020,246340,1272,263,246077,Western Pacific
China,27-02-2020,60371,1569,679,59692,Western Pacific
China,27-02-2020,334015,2120,105,333910,Western Pacific
China,27-02-2020,81642,1279,1071,80571,Western Pacific
China,27-02-2020,449174,202,802,448372,Western Pacific
China,27-02-2020,269586,1128,1051,268535,Western Pacific
China,27-02-2020,443251,1014,1152,442099,Western Pacific
China,27-02-2020,205451,1604,641,204810,Western Pacific
China,27-02-2020,38878,1446,953,37925,Western Pacific
China,27-02-2020,445960,1575,380,445580,Western Pacific
China,27-02-2020,116318,2042,43,116275,Western Pacific
China,27-02-2020,274852,1299,800,274052,Western Pacific
China,27-02-2020,268933,1065,1150,267783,Western Pacific
China,27-02-2020,218999,1454,489,218510,Western Pacific
China,27-02-2020,84776,1431,170,84606,Western Pacific
China,27-02-2020,73356,1555,806,72550,Western Pacific
China,27-02-2020,235665,504,456,235209,Western Pacific
China,27-02-2020,79578,1155,165,79413,Western Pacific
China,27-02-2020,267643,1803,666,266977,Western Pacific
China,27-02-2020,309966,1582,1205,308761,Western Pacific
China,27-02-2020,335989,1902,675,335314,Western Pacific
China,27-02-2020,25466,58,1197,24269,Western Pacific
China,27-02-2020,392953,80,309,392644,Western Pacific
China,27-02-2020,235211,670,1010,234201,Western Pacific
China,27-02-2020,262558,940,546,262012,Western Pacific
China,27-02-2020,200003,345,989,199014,Western Pacific
China,27-02-2020,192239,1752,432,191807,Western Pacific
China,27-02-2020,89619,2047,577,89042,Western Pacific
China,27-02-2020,385851,1154,1167,384684,Western Pacific
China,27-02-2020,317292,464,756,316536,Western Pacific
China,27-02-2020,12795,2022,571,12224,Western Pacific
China,27-02-2020,15790,2081,307,15483,Western Pacific
China,27-02-2020,265231,2010,734,264497,Western Pacific
Colombia,27-02-2020,351564,2304,536,351028,Americas
Congo (Brazzaville),27-02-2020,428891,1755,797,428094,Africa
Congo (Kinshasa),27-02-2020,45990,1662,357,45633,Africa
Costa Rica,27-02-2020,423696,1295,1074,422622,Americas
Cote d'Ivoire,27-02-2020,14854,620,603,14251,Africa
Croatia,27-02-2020,395277,149,564,394713,Europe
Cuba,27-02-2020,245656,564,210,245446,Americas
Cyprus,27-02-2020,86173,1929,415,85758,Europe
Czechia,27-02-2020,150510,1454,1063,149447,Europe
Denmark,27-02-2020,407677,1732,516,407161,Europe
Greenland,27-02-2020,213652,2417,1005,212647,Europe
Denmark,27-02-2020,412185,1688,843,411342,Europe
Djibouti,27-02-2020,179790,704,349,179441,Eastern Mediterranean
Dominican Republic,27-02-2020,104001,2205,106,103895,Americas
Ecuador,27-02-2020,205677,1874,182,205495,Americas
Egypt,27-02-2020,438487,649,275,438212,Eastern Mediterranean
El Salvador,27-02-2020,420095,2168,1203,418892,Americas
Equatorial Guinea,27-02-2020,15686,201,52,15634,Africa
Eritrea,27-02-2020,412069,1733,769,411300,Africa
Estonia,27-02-2020,439227,334,1056,438171,Europe
Eswatini,27-02-2020,433773,485,1058,432715,Africa
Ethiopia,27-02-2020,142194,693,133,142061,Africa
Fiji,27-02-2020,217516,700,829,216687,Western Pacific
Finland,27-02-2020,195873,2309,163,195710,Europe
France,27-02-2020,33608,302,997,32611,Europe
France,27-02-2020,216480,1777,489,215991,Europe
France,27-02-2020,421878,1815,540,421338,Europe
France,27-02-2020,53135,1270,339,52796,Europe
France,27-02-2020,243632,2215,924,242708,Europe
France,27-02-2020,221245,2410,165,221080,Europe
France,27-02-2020,32404,1854,988,31416,Europe
France,27-02-2020,69627,1603,635,68992,Europe
France,27-02-2020,13106,1305,449,12657,Europe
France,27-02-2020,207871,1755,724,207147,Europe
Gabon,27-02-2020,285501,1475,274,285227,Africa
Gambia,27-02-2020,286255,1637,743,285512,Africa
Georgia,27-02-2020,443690,1733,434,443256,Europe
Germany,27-02-2020,153980,939,264,153716,Europe
Ghana,27-02-2020,188082,2350,1013,187069,Africa
Greece,27-02-2020,368630,350,1131,367499,Europe
Guatemala,27-02-2020,53387,2053,147,53240,Americas
Guinea,27-02-2020,198818,172,622,198196,Africa
Guyana,27-02-2020,41187,1132,276,40911,Americas
Haiti,27-02-2020,10591,1146,894,9697,Americas
Holy See,27-02-2020,206047,1303,140,205907,Europe
Honduras,27-02-2020,102419,2183,661,101758,Americas
Hungary,27-02-2020,322473,514,201,322272,Europe
Iceland,27-02-2020,232974,2010,1000,231974,Europe
India,27-02-2020,216266,1242,1056,215210,South-East Asia
Indonesia,27-02-2020,276129,57,150,275979,South-East Asia
Iran,27-02-2020,155985,669,1140,154845,Eastern Mediterranean
Iraq,27-02-2020,51282,668,725,50557,Eastern Mediterranean
Ireland,27-02-2020,434382,231,968,433414,Europe
Israel,27-02-2020,100754,2079,616,100138,Europe
Italy,27-02-2020,215737,1255,831,214906,Europe
Jamaica,27-02-2020,7062,2198,1228,5834,Americas
Japan,27-02-2020,253468,505,962,252506,Western Pacific
Jordan,27-02-2020,196314,1536,600,195714,Eastern Mediterranean
Kazakhstan,27-02-2020,337332,402,92,337240,Europe
Kenya,27-02-2020,299333,1743,58,299275,Africa
South Korea,27-02-2020,290602,18,62,290540,Western Pacific
Kuwait,27-02-2020,339337,49,752,338585,Eastern Mediterranean
Kyrgyzstan,27-02-2020,153029,2324,663,152366,Europe
Latvia,27-02-2020,216334,666,25,216309,Europe
Lebanon,27-02-2020,312901,1179,464,312437,Eastern Mediterranean
Liberia,27-02-2020,123274,1466,392,122882,Africa
Liechtenstein,27-02-2020,264714,1582,142,264572,Europe
Lithuania,27-02-2020,278661,1317,1084,277577,Europe
Luxembourg,27-02-2020,166456,1087,119,166337,Europe
Madagascar,27-02-2020,397969,2340,930,397039,Africa
Malaysia,27-02-2020,258946,1513,353,258593,Western Pacific
Maldives,27-02-2020,31650,1578,737,30913,South-East Asia
Malta,27-02-2020,435894,1956,158,435736,Europe
Mauritania,27-02-2020,65941,1908,620,65321,Africa
Mauritius,27-02-2020,63735,273,1035,62700,Africa
Mexico,27-02-2020,393188,390,935,392253,Americas
Moldova,27-02-2020,434018,2280,952,433066,Europe
Monaco,27-02-2020,69111,477,876,68235,Europe
Mongolia,27-02-2020,133781,2210,831,132950,Western Pacific
Montenegro,27-02-2020,272946,1854,426,272520,Europe
Morocco,27-02-2020,427387,436,413,426974,Eastern Mediterranean
Namibia,27-02-2020,79263,213,830,78433,Africa
Nepal,27-02-2020,333660,228,838,332822,South-East Asia
Netherlands,27-02-2020,314956,579,1151,313805,Europe
Netherlands,27-02-2020,200330,1783,314,200016,Europe
Netherlands,27-02-2020,387459,385,795,386664,Europe
Netherlands,27-02-2020,275531,2341,53,275478,Europe
New Zealand,27-02-2020,275793,2474,497,275296,Western Pacific
Nicaragua,27-02-2020,229481,569,330,229151,Americas
Niger,27-02-2020,43361,661,149,43212,Africa
Nigeria,27-02-2020,187100,881,122,186978,Africa
North Macedonia,27-02-2020,227269,306,1010,226259,Europe
Norway,27-02-2020,341386,41,32,341354,Europe
Oman,27-02-2020,52393,1881,455,51938,Eastern Mediterranean
Pakistan,27-02-2020,340972,1484,526,340446,Eastern Mediterranean
Panama,27-02-2020,391878,2108,442,391436,Americas
Papua New Guinea,27-02-2020,305359,1248,440,304919,Western Pacific
Paraguay,27-02-2020,88118,593,1070,87048,Americas
Peru,27-02-2020,218614,1156,427,218187,Americas
Philippines,27-02-2020,40290,1866,132,40158,Western Pacific
Poland,27-02-2020,214569,1748,961,213608,Europe
Portugal,27-02-2020,386027,1657,1242,384785,Europe
Qatar,27-02-2020,111628,1279,358,111270,Eastern Mediterranean
Romania,27-02-2020,153958,1080,25,153933,Europe
Russia,27-02-2020,415968,993,939,415029,Europe
Rwanda,27-02-2020,158600,1042,1158,157442,Africa
Saint Lucia,27-02-2020,256496,1999,394,256102,Americas
Saint Vincent and the Grenadines,27-02-2020,195158,42,222,194936,Americas
San Marino,27-02-2020,296389,1761,965,295424,Europe
Saudi Arabia,27-02-2020,25862,803,441,25421,Eastern Mediterranean
Senegal,27-02-2020,97906,75,365,97541,Africa
Serbia,27-02-2020,259132,992,1240,257892,Europe
Seychelles,27-02-2020,246813,294,239,246574,Africa
Singapore,27-02-2020,54512,927,1141,53371,Western Pacific
Slovakia,27-02-2020,201623,1820,1023,200600,Europe
Slovenia,27-02-2020,248004,2256,490,247514,Europe
Somalia,27-02-2020,15319,680,898,14421,Eastern Mediterranean
South Africa,27-02-2020,185151,555,166,184985,Africa
Spain,27-02-2020,148518,124,51,148467,Europe
Sri Lanka,27-02-2020,5275,556,1243,4032,South-East Asia
Sudan,27-02-2020,283608,1014,114,283494,Eastern Mediterranean
Suriname,27-02-2020,92537,607,214,92323,Americas
Sweden,27-02-2020,287121,865,384,286737,Europe
Switzerland,27-02-2020,79879,2002,36,79843,Europe
Taiwan*,27-02-2020,385227,291,895,384332,Western Pacific
Tanzania,27-02-2020,417937,1252,575,417362,Africa
Thailand,27-02-2020,60117,1540,392,59725,South-East Asia
Togo,27-02-2020,185755,1028,966,184789,Africa
Trinidad and Tobago,27-02-2020,374419,947,229,374190,Americas
Tunisia,27-02-2020,332678,2237,65,332613,Eastern Mediterranean
Turkey,27-02-2020,314182,1358,700,313482,Europe
Uganda,27-02-2020,106437,2418,957,105480,Africa
Ukraine,27-02-2020,329135,899,809,328326,Europe
United Arab Emirates,27-02-2020,7987,2209,62,7925,Eastern Mediterranean
United Kingdom,27-02-2020,107444,981,1031,106413,Europe
United Kingdom,27-02-2020,179630,666,266,179364,Europe
United Kingdom,27-02-2020,277154,339,397,276757,Europe
United Kingdom,27-02-2020,209012,1274,1096,207916,Europe
United Kingdom,27-02-2020,73301,535,858,72443,Europe
United Kingdom,27-02-2020,335734,2351,97,335637,Europe
United Kingdom,27-02-2020,158887,1700,236,158651,Europe
Uruguay,27-02-2020,189970,937,550,189420,Americas
US,27-02-2020,302075,403,798,301277,Americas
Uzbekistan,27-02-2020,76608,1884,351,76257,Europe
Venezuela,27-02-2020,35848,2443,575,35273,Americas
Vietnam,27-02-2020,161205,1223,62,161143,Western Pacific
Zambia,27-02-2020,78719,509,706,78013,Africa
Zimbabwe,27-02-2020,436667,1261,1075,435592,Africa
Dominica,27-02-2020,59358,2293,334,59024,Americas
Grenada,27-02-2020,390478,400,302,390176,Americas
Mozambique,27-02-2020,178768,2077,159,178609,Africa
Syria,27-02-2020,367561,46,353,367208,Eastern Mediterranean
Timor-Leste,27-02-2020,334130,918,363,333767,South-East Asia
Belize,27-02-2020,355263,2026,51,355212,Americas
Laos,27-02-2020,86357,2416,368,85989,Western Pacific
Libya,27-02-2020,60512,99,499,60013,Eastern Mediterranean
West Bank and Gaza,27-02-2020,362953,1799,562,362391,Eastern Mediterranean
Guinea-Bissau,27-02-2020,315195,1844,215,314980,Africa
Mali,27-02-2020,345345,122,117,345228,Africa
Saint Kitts and Nevis,27-02-2020,40213,808,1089,39124,Americas
Canada,27-02-2020,446481,897,1075,445406,Americas
Canada,27-02-2020,404041,1444,1216,402825,Americas
Kosovo,27-02-2020,236084,145,1110,234974,Europe
Burma,27-02-2020,24757,755,70,24687,South-East Asia
United Kingdom,27-02-2020,155989,1091,1218,154771,Europe
United Kingdom,27-02-2020,114057,2487,116,113941,Europe
United Kingdom,27-02-2020,231184,191,46,231138,Europe
Botswana,27-02-2020,115839,2489,98,115741,Africa
Burundi,27-02-2020,173802,1521,712,173090,Africa
Sierra Leone,27-02-2020,366155,1202,506,365649,Africa
Malawi,27-02-2020,273928,650,77,273851,Africa
United Kingdom,27-02-2020,156273,1072,979,155294,Europe
France,27-02-2020,266727,1571,327,266400,Europe
South Sudan,27-02-2020,215847,2179,606,215241,Africa
Western Sahara,27-02-2020,208696,1356,162,208534,Africa
Sao Tome and Principe,27-02-2020,314993,858,509,314484,Africa
Yemen,27-02-2020,48308,2200,55,48253,Eastern Mediterranean
Comoros,27-02-2020,384658,2087,617,384041,Africa
Tajikistan,27-02-2020,327641,382,1070,326571,Europe
Lesotho,27-02-2020,301280,729,841,300439,Africa
Afghanistan,28-02-2020,85316,202,1032,84284,Eastern Mediterranean
Albania,28-02-2020,428754,2048,442,428312,Europe
Algeria,28-02-2020,15437,2270,979,14458,Africa
Andorra,28-02-2020,210464,726,695,209769,Europe
Angola,28-02-2020,292114,1935,1196,290918,Africa
Antigua and Barbuda,28-02-2020,444420,126,806,443614,Americas
Argentina,28-02-2020,318170,2292,144,318026,Americas
Armenia,28-02-2020,99767,689,715,99052,Europe
Australia,28-02-2020,408647,131,944,407703,Western Pacific
Australia,28-02-2020,316766,618,760,316006,Western Pacific
Australia,28-02-2020,80025,311,487,79538,Western Pacific
Australia,28-02-2020,36397,2292,619,35778,Western Pacific
Australia,28-02-2020,383215,2399,890,382325,Western Pacific
Australia,28-02-2020,397018,596,157,396861,Western Pacific
Australia,28-02-2020,62282,607,19,62263,Western Pacific
Australia,28-02-2020,154555,322,893,153662,Western Pacific
Austria,28-02-2020,89137,954,485,88652,Europe
Azerbaijan,28-02-2020,238653,1197,61,238592,Europe
Bahamas,28-02-2020,42296,1343,621,41675,Americas
Bahrain,28-02-2020,172838,1090,546,172292,Eastern Mediterranean
Bangladesh,28-02-2020,440586,328,368,440218,South-East Asia
Barbados,28-02-2020,292600,2423,420,292180,Americas
Belarus,28-02-2020,339030,1499,415,338615,Europe
Belgium,28-02-2020,309248,2078,346,308902,Europe
Benin,28-02-2020,339844,684,832,339012,Africa
Bhutan,28-02-2020,4629,605,734,3895,South-East Asia
Bolivia,28-02-2020,141306,141,47,141259,Americas
Bosnia and Herzegovina,28-02-2020,300789,2379,158,300631,Europe
Brazil,28-02-2020,448999,2106,71,448928,Americas
Brunei,28-02-2020,21032,870,637,20395,Western Pacific
Bulgaria,28-02-2020,14676,1724,653,14023,Europe
Burkina Faso,28-02-2020,323016,1952,49,322967,Africa
Cabo Verde,28-02-2020,436831,1036,1013,435818,Africa
Cambodia,28-02-2020,49251,66,423,48828,Western Pacific
Cameroon,28-02-2020,213863,1940,1173,212690,Africa
Canada,28-02-2020,435009,1560,229,434780,Americas
Canada,28-02-2020,66432,466,1236,65196,Americas
Canada,28-02-2020,254564,579,912,253652,Americas
Canada,28-02-2020,223476,323,931,222545,Americas
Canada,28-02-2020,193808,223,530,193278,Americas
Canada,28-02-2020,359227,862,324,358903,Americas
Canada,28-02-2020,323295,1235,577,322718,Americas
Canada,28-02-2020,177140,1016,865,176275,Americas
Canada,28-02-2020,439913,2121,379,439534,Americas
Canada,28-02-2020,143918,2282,1230,142688,Americas
Central African Republic,28-02-2020,185712,1921,486,185226,Africa
Chad,28-02-2020,188263,905,555,187708,Africa
Chile,28-02-2020,388040,2412,383,387657,Americas
China,28-02-2020,439161,2161,1031,438130,Western Pacific
China,28-02-2020,377362,629,470,376892,Western Pacific
China,28-02-2020,120098,1268,22,120076,Western Pacific
China,28-02-2020,182914,1583,1244,181670,Western Pacific
China,28-02-2020,4897,1971,881,4016,Western Pacific
China,28-02-2020,345093,259,927,344166,Western Pacific
China,28-02-2020,318707,1174,640,318067,Western Pacific
China,28-02-2020,180413,2412,24,180389,Western Pacific
China,28-02-2020,14641,842,981,13660,Western Pacific
China,28-02-2020,332515,620,950,331565,Western Pacific
China,28-02-2020,62542,2404,162,62380,Western Pacific
China,28-02-2020,335234,1430,1047,334187,Western Pacific
China,28-02-2020,320732,805,1213,319519,Western Pacific
China,28-02-2020,371364,1225,937,370427,Western Pacific
China,28-02-2020,210558,1424,515,210043,Western Pacific
China,28-02-2020,86639,768,749,85890,Western Pacific
China,28-02-2020,17876,195,586,17290,Western Pacific
China,28-02-2020,448170,233,1085,447085,Western Pacific
China,28-02-2020,264041,1342,22,264019,Western Pacific
China,28-02-2020,135720,1853,1123,134597,Western Pacific
China,28-02-2020,237824,9,1113,236711,Western Pacific
China,28-02-2020,280919,805,240,280679,Western Pacific
China,28-02-2020,136844,768,84,136760,Western Pacific
China,28-02-2020,384037,946,187,383850,Western Pacific
China,28-02-2020,122054,2357,1017,121037,Western Pacific
China,28-02-2020,430202,2197,217,429985,Western Pacific
China,28-02-2020,294837,1374,38,294799,Western Pacific
China,28-02-2020,389847,1991,694,389153,Western Pacific
China,28-02-2020,301377,2252,779,300598,Western Pacific
China,28-02-2020,300930,2199,779,300151,Western Pacific
China,28-02-2020,384974,2462,209,384765,Western Pacific
China,28-02-2020,387096,1972,254,386842,Western Pacific
China,28-02-2020,118057,1208,630,117427,Western Pacific
Colombia,28-02-2020,45758,2394,346,45412,Americas
Congo (Brazzaville),28-02-2020,202534,1634,674,201860,Africa
Congo (Kinshasa),28-02-2020,142660,1302,572,142088,Africa
Costa Rica,28-02-2020,160754,9,6,160748,Americas
Cote d'Ivoire,28-02-2020,239137,160,915,238222,Africa
Croatia,28-02-2020,44514,658,632,43882,Europe
Cuba,28-02-2020,322127,342,956,321171,Americas
Cyprus,28-02-2020,415482,580,413,415069,Europe
Czechia,28-02-2020,42163,1523,1116,41047,Europe
Denmark,28-02-2020,426111,217,483,425628,Europe
Greenland,28-02-2020,347808,2174,366,347442,Europe
Denmark,28-02-2020,237430,1041,806,236624,Europe
Djibouti,28-02-2020,215836,1645,1072,214764,Eastern Mediterranean
Dominican Republic,28-02-2020,273347,560,1116,272231,Americas
Ecuador,28-02-2020,146012,2268,628,145384,Americas
Egypt,28-02-2020,134087,347,746,133341,Eastern Mediterranean
El Salvador,28-02-2020,357174,481,510,356664,Americas
Equatorial Guinea,28-02-2020,326131,1443,1029,325102,Africa
Eritrea,28-02-2020,176581,1634,1051,175530,Africa
Estonia,28-02-2020,255927,123,25,255902,Europe
Eswatini,28-02-2020,265452,2467,420,265032,Africa
Ethiopia,28-02-2020,449230,1443,870,448360,Africa
Fiji,28-02-2020,121727,1748,1089,120638,Western Pacific
Finland,28-02-2020,175264,1726,711,174553,Europe
France,28-02-2020,402964,1213,746,402218,Europe
France,28-02-2020,221193,696,441,220752,Europe
France,28-02-2020,322977,1040,487,322490,Europe
France,28-02-2020,429986,47,164,429822,Europe
France,28-02-2020,77109,1956,504,76605,Europe
France,28-02-2020,107351,634,36,107315,Europe
France,28-02-2020,124446,874,20,124426,Europe
France,28-02-2020,112894,1850,752,112142,Europe
France,28-02-2020,380223,2479,291,379932,Europe
France,28-02-2020,108972,1697,192,108780,Europe
Gabon,28-02-2020,45792,756,1049,44743,Africa
Gambia,28-02-2020,135580,1526,876,134704,Africa
Georgia,28-02-2020,22899,420,1142,21757,Europe
Germany,28-02-2020,220792,1285,739,220053,Europe
Ghana,28-02-2020,168971,213,652,168319,Africa
Greece,28-02-2020,327776,2368,667,327109,Europe
Guatemala,28-02-2020,4745,1334,1021,3724,Americas
Guinea,28-02-2020,46802,2044,354,46448,Africa
Guyana,28-02-2020,117199,2103,730,116469,Americas
Haiti,28-02-2020,388412,2258,851,387561,Americas
Holy See,28-02-2020,292791,721,303,292488,Europe
Honduras,28-02-2020,358592,188,534,358058,Americas
Hungary,28-02-2020,329836,2342,722,329114,Europe
Iceland,28-02-2020,109547,1794,944,108603,Europe
India,28-02-2020,101558,946,906,100652,South-East Asia
Indonesia,28-02-2020,61029,2471,757,60272,South-East Asia
Iran,28-02-2020,178638,430,942,177696,Eastern Mediterranean
Iraq,28-02-2020,130670,410,1064,129606,Eastern Mediterranean
Ireland,28-02-2020,399891,879,559,399332,Europe
Israel,28-02-2020,414752,361,548,414204,Europe
Italy,28-02-2020,217361,1663,747,216614,Europe
Jamaica,28-02-2020,353924,1967,683,353241,Americas
Japan,28-02-2020,25939,2398,1157,24782,Western Pacific
Jordan,28-02-2020,419046,599,1009,418037,Eastern Mediterranean
Kazakhstan,28-02-2020,331622,1835,1173,330449,Europe
Kenya,28-02-2020,58523,1367,903,57620,Africa
South Korea,28-02-2020,195560,1103,218,195342,Western Pacific
Kuwait,28-02-2020,390458,2131,744,389714,Eastern Mediterranean
Kyrgyzstan,28-02-2020,182852,1862,373,182479,Europe
Latvia,28-02-2020,273367,1775,65,273302,Europe
Lebanon,28-02-2020,293807,916,110,293697,Eastern Mediterranean
Liberia,28-02-2020,191183,1428,839,190344,Africa
Liechtenstein,28-02-2020,310573,2291,133,310440,Europe
Lithuania,28-02-2020,412710,827,235,412475,Europe
Luxembourg,28-02-2020,319257,1908,535,318722,Europe
Madagascar,28-02-2020,38224,348,517,37707,Africa
Malaysia,28-02-2020,80999,1281,1213,79786,Western Pacific
Maldives,28-02-2020,200375,1134,966,199409,South-East Asia
Malta,28-02-2020,346310,1316,1193,345117,Europe
Mauritania,28-02-2020,401143,2313,183,400960,Africa
Mauritius,28-02-2020,244953,1624,312,244641,Africa
Mexico,28-02-2020,275129,792,191,274938,Americas
Moldova,28-02-2020,65294,1670,939,64355,Europe
Monaco,28-02-2020,255337,2365,770,254567,Europe
Mongolia,28-02-2020,61468,566,1178,60290,Western Pacific
Montenegro,28-02-2020,80628,2413,333,80295,Europe
Morocco,28-02-2020,322864,2497,1114,321750,Eastern Mediterranean
Namibia,28-02-2020,4986,92,597,4389,Africa
Nepal,28-02-2020,219131,2139,1199,217932,South-East Asia
Netherlands,28-02-2020,13229,749,1020,12209,Europe
Netherlands,28-02-2020,290445,559,759,289686,Europe
Netherlands,28-02-2020,221137,193,934,220203,Europe
Netherlands,28-02-2020,113108,1791,1028,112080,Europe
New Zealand,28-02-2020,22621,1584,867,21754,Western Pacific
Nicaragua,28-02-2020,387669,1407,660,387009,Americas
Niger,28-02-2020,256707,1183,261,256446,Africa
Nigeria,28-02-2020,114882,1475,154,114728,Africa
North Macedonia,28-02-2020,260468,933,441,260027,Europe
Norway,28-02-2020,97713,364,991,96722,Europe
Oman,28-02-2020,50826,1893,255,50571,Eastern Mediterranean
Pakistan,28-02-2020,228009,513,206,227803,Eastern Mediterranean
Panama,28-02-2020,285534,1296,891,284643,Americas
Papua New Guinea,28-02-2020,424684,438,1012,423672,Western Pacific
Paraguay,28-02-2020,41055,1442,682,40373,Americas
Peru,28-02-2020,149075,103,863,148212,Americas
Philippines,28-02-2020,237412,2198,558,236854,Western Pacific
Poland,28-02-2020,396447,1794,402,396045,Europe
Portugal,28-02-2020,112544,61,117,112427,Europe
Qatar,28-02-2020,290835,755,338,290497,Eastern Mediterranean
Romania,28-02-2020,374889,1063,145,374744,Europe
Russia,28-02-2020,346143,1180,398,345745,Europe
Rwanda,28-02-2020,139164,626,1041,138123,Africa
Saint Lucia,28-02-2020,76062,2343,288,75774,Americas
Saint Vincent and the Grenadines,28-02-2020,92562,2388,886,91676,Americas
San Marino,28-02-2020,138560,596,1052,137508,Europe
Saudi Arabia,28-02-2020,308127,1036,227,307900,Eastern Mediterranean
Senegal,28-02-2020,62926,932,108,62818,Africa
Serbia,28-02-2020,313851,2115,6,313845,Europe
Seychelles,28-02-2020,17525,838,995,16530,Africa
Singapore,28-02-2020,368595,334,1156,367439,Western Pacific
Slovakia,28-02-2020,260811,1307,234,260577,Europe
Slovenia,28-02-2020,46594,1052,481,46113,Europe
Somalia,28-02-2020,354051,932,860,353191,Eastern Mediterranean
South Africa,28-02-2020,383198,575,997,382201,Africa
Spain,28-02-2020,446694,2330,675,446019,Europe
Sri Lanka,28-02-2020,202992,2350,125,202867,South-East Asia
Sudan,28-02-2020,385835,849,866,384969,Eastern Mediterranean
Suriname,28-02-2020,371965,2227,132,371833,Americas
Sweden,28-02-2020,93774,330,304,93470,Europe
Switzerland,28-02-2020,189008,468,1020,187988,Europe
Taiwan*,28-02-2020,383498,1383,387,383111,Western Pacific
Tanzania,28-02-2020,114945,1613,891,114054,Africa
Thailand,28-02-2020,159937,2048,816,159121,South-East Asia
Togo,28-02-2020,300000,1707,1032,298968,Africa
Trinidad and Tobago,28-02-2020,299616,729,513,299103,Americas
Tunisia,28-02-2020,123998,518,899,123099,Eastern Mediterranean
Turkey,28-02-2020,300698,370,636,300062,Europe
Uganda,28-02-2020,197829,2427,1187,196642,Africa
Ukraine,28-02-2020,402283,2062,852,401431,Europe
United Arab Emirates,28-02-2020,268899,60,288,268611,Eastern Mediterranean
United Kingdom,28-02-2020,38921,323,947,37974,Europe
United Kingdom,28-02-2020,24719,1611,181,24538,Europe
United Kingdom,28-02-2020,27780,2420,17,27763,Europe
United Kingdom,28-02-2020,258617,770,1208,257409,Europe
United Kingdom,28-02-2020,109152,447,935,108217,Europe
United Kingdom,28-02-2020,60664,2397,648,60016,Europe
United Kingdom,28-02-2020,324680,836,673,324007,Europe
Uruguay,28-02-2020,401347,19,592,400755,Americas
US,28-02-2020,344285,2273,596,343689,Americas
Uzbekistan,28-02-2020,206771,1131,1196,205575,Europe
Venezuela,28-02-2020,380429,2283,334,380095,Americas
Vietnam,28-02-2020,430788,1897,701,430087,Western Pacific
Zambia,28-02-2020,155815,1152,643,155172,Africa
Zimbabwe,28-02-2020,282801,868,381,282420,Africa
Dominica,28-02-2020,431615,1950,871,430744,Americas
Grenada,28-02-2020,232199,242,1054,231145,Americas
Mozambique,28-02-2020,184440,1248,893,183547,Africa
Syria,28-02-2020,314999,1888,573,314426,Eastern Mediterranean
Timor-Leste,28-02-2020,276137,540,598,275539,South-East Asia
Belize,28-02-2020,7164,143,1170,5994,Americas
Laos,28-02-2020,206373,1788,1092,205281,Western Pacific
Libya,28-02-2020,335162,436,286,334876,Eastern Mediterranean
West Bank and Gaza,28-02-2020,199182,2482,1003,198179,Eastern Mediterranean
Guinea-Bissau,28-02-2020,448014,691,173,447841,Africa
Mali,28-02-2020,380717,1746,182,380535,Africa
Saint Kitts and Nevis,28-02-2020,229093,1516,299,228794,Americas
Canada,28-02-2020,278123,800,867,277256,Americas
Canada,28-02-2020,392857,2016,148,392709,Americas
Kosovo,28-02-2020,70409,1661,736,69673,Europe
Burma,28-02-2020,26170,534,44,26126,South-East Asia
United Kingdom,28-02-2020,29639,574,769,28870,Europe
United Kingdom,28-02-2020,175901,71,500,175401,Europe
United Kingdom,28-02-2020,78935,845,20,78915,Europe
Botswana,28-02-2020,87177,2252,1218,85959,Africa
Burundi,28-02-2020,189838,274,595,189243,Africa
Sierra Leone,28-02-2020,41647,667,80,41567,Africa
Malawi,28-02-2020,123893,2488,958,122935,Africa
United Kingdom,28-02-2020,414462,2025,655,413807,Europe
France,28-02-2020,189908,842,395,189513,Europe
South Sudan,28-02-2020,354604,2334,136,354468,Africa
Western Sahara,28-02-2020,299387,1821,462,298925,Africa
Sao Tome and Principe,28-02-2020,295330,1403,701,294629,Africa
Yemen,28-02-2020,434919,98,1151,433768,Eastern Mediterranean
Comoros,28-02-2020,118204,1674,1077,117127,Africa
Tajikistan,28-02-2020,2955,592,846,2109,Europe
Lesotho,28-02-2020,20297,1066,35,20262,Africa
Afghanistan,29-02-2020,238685,1968,1076,237609,Eastern Mediterranean
Albania,29-02-2020,208196,1930,932,207264,Europe
Algeria,29-02-2020,100260,1293,353,99907,Africa
Andorra,29-02-2020,436475,536,414,436061,Europe
Angola,29-02-2020,418064,707,911,417153,Africa
Antigua and Barbuda,29-02-2020,152878,70,1175,151703,Americas
Argentina,29-02-2020,76583,733,655,75928,Americas
Armenia,29-02-2020,81796,1647,103,81693,Europe
Australia,29-02-2020,181958,1392,253,181705,Western Pacific
Australia,29-02-2020,241504,1050,997,240507,Western Pacific
Australia,29-02-2020,357619,926,1014,356605,Western Pacific
Australia,29-02-2020,231820,1140,696,231124,Western Pacific
Australia,29-02-2020,185033,2392,708,184325,Western Pacific
Australia,29-02-2020,335584,44,216,335368,Western Pacific
Australia,29-02-2020,402147,325,323,401824,Western Pacific
Australia,29-02-2020,106472,1063,219,106253,Western Pacific
Austria,29-02-2020,181027,388,639,180388,Europe
Azerbaijan,29-02-2020,286348,959,1156,285192,Europe
Bahamas,29-02-2020,400346,168,1214,399132,Americas
Bahrain,29-02-2020,374736,1863,694,374042,Eastern Mediterranean
Bangladesh,29-02-2020,251424,2422,80,251344,South-East Asia
Barbados,29-02-2020,90839,1813,976,89863,Americas
Belarus,29-02-2020,54393,184,277,54116,Europe
Belgium,29-02-2020,140813,547,952,139861,Europe
Benin,29-02-2020,68781,2179,137,68644,Africa
Bhutan,29-02-2020,18140,2057,62,18078,South-East Asia
Bolivia,29-02-2020,29493,470,95,29398,Americas
Bosnia and Herzegovina,29-02-2020,225813,220,825,224988,Europe
Brazil,29-02-2020,185415,22,21,185394,Americas
Brunei,29-02-2020,83063,1798,391,82672,Western Pacific
Bulgaria,29-02-2020,57786,463,528,57258,Europe
Burkina Faso,29-02-2020,156930,697,262,156668,Africa
Cabo Verde,29-02-2020,138851,1821,788,138063,Africa
Cambodia,29-02-2020,198261,363,446,197815,Western Pacific
Cameroon,29-02-2020,413242,1491,570,412672,Africa
Canada,29-02-2020,176067,1562,265,175802,Americas
Canada,29-02-2020,102465,1124,1161,101304,Americas
Canada,29-02-2020,54186,2379,95,54091,Americas
Canada,29-02-2020,100965,523,854,100111,Americas
Canada,29-02-2020,213420,1309,199,213221,Americas
Canada,29-02-2020,68918,1062,1111,67807,Americas
Canada,29-02-2020,249630,852,774,248856,Americas
Canada,29-02-2020,88633,2356,486,88147,Americas
Canada,29-02-2020,80772,955,986,79786,Americas
Canada,29-02-2020,416955,1658,902,416053,Americas
Central African Republic,29-02-2020,258019,1623,12,258007,Africa
Chad,29-02-2020,309048,1550,1009,308039,Africa
Chile,29-02-2020,58158,2257,283,57875,Americas
China,29-02-2020,131734,1510,1046,130688,Western Pacific
China,29-02-2020,255761,1967,856,254905,Western Pacific
China,29-02-2020,43928,352,913,43015,Western Pacific
China,29-02-2020,351955,1113,981,350974,Western Pacific
China,29-02-2020,25688,1764,520,25168,Western Pacific
China,29-02-2020,94437,889,396,94041,Western Pacific
China,29-02-2020,37426,138,319,37107,Western Pacific
China,29-02-2020,300545,1833,754,299791,Western Pacific
China,29-02-2020,167417,886,319,167098,Western Pacific
China,29-02-2020,42229,2213,1049,41180,Western Pacific
China,29-02-2020,296925,2362,688,296237,Western Pacific
China,29-02-2020,237581,2500,572,237009,Western Pacific
China,29-02-2020,359459,1186,1032,358427,Western Pacific
China,29-02-2020,107598,1992,603,106995,Western Pacific
China,29-02-2020,211467,615,892,210575,Western Pacific
China,29-02-2020,83960,2453,803,83157,Western Pacific
China,29-02-2020,424959,1538,988,423971,Western Pacific
China,29-02-2020,105878,2020,881,104997,Western Pacific
China,29-02-2020,93742,2025,716,93026,Western Pacific
China,29-02-2020,340221,357,1061,339160,Western Pacific
China,29-02-2020,171122,2008,714,170408,Western Pacific
China,29-02-2020,304578,1557,215,304363,Western Pacific
China,29-02-2020,53670,2133,746,52924,Western Pacific
China,29-02-2020,68776,918,302,68474,Western Pacific
China,29-02-2020,267869,2307,345,267524,Western Pacific
China,29-02-2020,212121,498,220,211901,Western Pacific
China,29-02-2020,446409,1036,460,445949,Western Pacific
China,29-02-2020,376391,709,1046,375345,Western Pacific
China,29-02-2020,15192,365,1170,14022,Western Pacific
China,29-02-2020,346395,1084,582,345813,Western Pacific
China,29-02-2020,375185,912,1180,374005,Western Pacific
China,29-02-2020,121409,1487,380,121029,Western Pacific
China,29-02-2020,278933,1894,25,278908,Western Pacific
Colombia,29-02-2020,21188,62,236,20952,Americas
Congo (Brazzaville),29-02-2020,35821,2074,853,34968,Africa
Congo (Kinshasa),29-02-2020,188008,2450,966,187042,Africa
Costa Rica,29-02-2020,48187,898,180,48007,Americas
Cote d'Ivoire,29-02-2020,253825,2331,856,252969,Africa
Croatia,29-02-2020,165556,872,1163,164393,Europe
Cuba,29-02-2020,386313,1368,914,385399,Americas
Cyprus,29-02-2020,43706,1245,372,43334,Europe
Czechia,29-02-2020,407470,1202,225,407245,Europe
Denmark,29-02-2020,136975,327,726,136249,Europe
Greenland,29-02-2020,242116,2376,160,241956,Europe
Denmark,29-02-2020,361566,675,1143,360423,Europe
Djibouti,29-02-2020,42594,936,1209,41385,Eastern Mediterranean
Dominican Republic,29-02-2020,103482,1741,702,102780,Americas
Ecuador,29-02-2020,75042,2314,235,74807,Americas
Egypt,29-02-2020,364255,1569,97,364158,Eastern Mediterranean
El Salvador,29-02-2020,43307,796,229,43078,Americas
Equatorial Guinea,29-02-2020,313618,13,723,312895,Africa
Eritrea,29-02-2020,53390,975,567,52823,Africa
Estonia,29-02-2020,92365,930,87,92278,Europe
Eswatini,29-02-2020,319,1356,483,-164,Africa
Ethiopia,29-02-2020,338952,145,682,338270,Africa
Fiji,29-02-2020,385354,559,638,384716,Western Pacific
Finland,29-02-2020,367617,181,1210,366407,Europe
France,29-02-2020,124719,1128,569,124150,Europe
France,29-02-2020,400099,393,691,399408,Europe
France,29-02-2020,40437,287,1013,39424,Europe
France,29-02-2020,158589,1952,1035,157554,Europe
France,29-02-2020,331317,2481,565,330752,Europe
France,29-02-2020,363854,2456,618,363236,Europe
France,29-02-2020,162857,1310,416,162441,Europe
France,29-02-2020,368258,550,87,368171,Europe
France,29-02-2020,115902,2077,712,115190,Europe
France,29-02-2020,226110,152,1115,224995,Europe
Gabon,29-02-2020,114320,1697,666,113654,Africa
Gambia,29-02-2020,198530,1638,599,197931,Africa
Georgia,29-02-2020,46040,2087,16,46024,Europe
Germany,29-02-2020,183051,1232,847,182204,Europe
Ghana,29-02-2020,382422,485,1097,381325,Africa
Greece,29-02-2020,433304,2189,841,432463,Europe
Guatemala,29-02-2020,172305,2408,877,171428,Americas
Guinea,29-02-2020,270993,338,478,270515,Africa
Guyana,29-02-2020,372941,2226,1120,371821,Americas
Haiti,29-02-2020,422082,1567,1037,421045,Americas
Holy See,29-02-2020,168737,19,625,168112,Europe
Honduras,29-02-2020,30003,1664,202,29801,Americas
Hungary,29-02-2020,429203,1795,1155,428048,Europe
Iceland,29-02-2020,208155,717,1104,207051,Europe
India,29-02-2020,104486,7,402,104084,South-East Asia
Indonesia,29-02-2020,94905,264,911,93994,South-East Asia
Iran,29-02-2020,339525,323,1068,338457,Eastern Mediterranean
Iraq,29-02-2020,378989,1518,875,378114,Eastern Mediterranean
Ireland,29-02-2020,245330,1803,1108,244222,Europe
Israel,29-02-2020,331911,2197,1011,330900,Europe
Italy,29-02-2020,126358,1911,779,125579,Europe
Jamaica,29-02-2020,404342,1134,10,404332,Americas
Japan,29-02-2020,371622,324,171,371451,Western Pacific
Jordan,29-02-2020,90709,2432,610,90099,Eastern Mediterranean
Kazakhstan,29-02-2020,412334,633,339,411995,Europe
Kenya,29-02-2020,212226,2156,307,211919,Africa
South Korea,29-02-2020,35789,1225,493,35296,Western Pacific
Kuwait,29-02-2020,302748,1476,1177,301571,Eastern Mediterranean
Kyrgyzstan,29-02-2020,342210,2431,554,341656,Europe
Latvia,29-02-2020,126307,2009,714,125593,Europe
Lebanon,29-02-2020,378716,862,97,378619,Eastern Mediterranean
Liberia,29-02-2020,88837,2313,983,87854,Africa
Liechtenstein,29-02-2020,356181,129,141,356040,Europe
Lithuania,29-02-2020,236599,1162,224,236375,Europe
Luxembourg,29-02-2020,216732,1894,1036,215696,Europe
Madagascar,29-02-2020,398744,1336,924,397820,Africa
Malaysia,29-02-2020,145125,978,984,144141,Western Pacific
Maldives,29-02-2020,354764,2416,1125,353639,South-East Asia
Malta,29-02-2020,241102,1865,324,240778,Europe
Mauritania,29-02-2020,270288,1023,1,270287,Africa
Mauritius,29-02-2020,122583,1010,860,121723,Africa
Mexico,29-02-2020,171340,2185,69,171271,Americas
Moldova,29-02-2020,237249,1468,617,236632,Europe
Monaco,29-02-2020,14544,3,362,14182,Europe
Mongolia,29-02-2020,428827,2279,18,428809,Western Pacific
Montenegro,29-02-2020,399700,1979,559,399141,Europe
Morocco,29-02-2020,69744,109,750,68994,Eastern Mediterranean
Namibia,29-02-2020,120771,893,284,120487,Africa
Nepal,29-02-2020,334169,384,161,334008,South-East Asia
Netherlands,29-02-2020,300495,1579,474,300021,Europe
Netherlands,29-02-2020,378325,399,719,377606,Europe
Netherlands,29-02-2020,296809,1866,328,296481,Europe
Netherlands,29-02-2020,51440,842,309,51131,Europe
New Zealand,29-02-2020,398901,505,103,398798,Western Pacific
Nicaragua,29-02-2020,100016,625,575,99441,Americas
Niger,29-02-2020,232443,1640,815,231628,Africa
Nigeria,29-02-2020,262939,2207,485,262454,Africa
North Macedonia,29-02-2020,275316,818,263,275053,Europe
Norway,29-02-2020,152590,887,604,151986,Europe
Oman,29-02-2020,143760,2173,522,143238,Eastern Mediterranean
Pakistan,29-02-2020,165238,1209,598,164640,Eastern Mediterranean
Panama,29-02-2020,80483,2454,77,80406,Americas
Papua New Guinea,29-02-2020,428418,508,759,427659,Western Pacific
Paraguay,29-02-2020,257256,1392,46,257210,Americas
Peru,29-02-2020,273059,2268,581,272478,Americas
Philippines,29-02-2020,350143,1199,177,349966,Western Pacific
Poland,29-02-2020,141430,1423,83,141347,Europe
Portugal,29-02-2020,201447,68,308,201139,Europe
Qatar,29-02-2020,272697,1837,1175,271522,Eastern Mediterranean
Romania,29-02-2020,184516,784,605,183911,Europe
Russia,29-02-2020,430437,2019,537,429900,Europe
Rwanda,29-02-2020,266296,2376,108,266188,Africa
Saint Lucia,29-02-2020,355379,638,746,354633,Americas
Saint Vincent and the Grenadines,29-02-2020,335941,2499,594,335347,Americas
San Marino,29-02-2020,407295,39,587,406708,Europe
Saudi Arabia,29-02-2020,210658,1772,218,210440,Eastern Mediterranean
Senegal,29-02-2020,238277,2151,218,238059,Africa
Serbia,29-02-2020,103584,1955,407,103177,Europe
Seychelles,29-02-2020,289016,39,250,288766,Africa
Singapore,29-02-2020,121141,2470,994,120147,Western Pacific
Slovakia,29-02-2020,3190,925,1035,2155,Europe
Slovenia,29-02-2020,274327,519,772,273555,Europe
Somalia,29-02-2020,94867,1321,528,94339,Eastern Mediterranean
South Africa,29-02-2020,241379,899,334,241045,Africa
Spain,29-02-2020,282593,358,306,282287,Europe
Sri Lanka,29-02-2020,265192,1481,751,264441,South-East Asia
Sudan,29-02-2020,219276,1947,542,218734,Eastern Mediterranean
Suriname,29-02-2020,436879,214,966,435913,Americas
Sweden,29-02-2020,382995,1469,748,382247,Europe
Switzerland,29-02-2020,133132,892,287,132845,Europe
Taiwan*,29-02-2020,91347,713,273,91074,Western Pacific
Tanzania,29-02-2020,340323,214,1083,339240,Africa
Thailand,29-02-2020,270805,1809,660,270145,South-East Asia
Togo,29-02-2020,229278,376,1066,228212,Africa
Trinidad and Tobago,29-02-2020,391902,531,1098,390804,Americas
Tunisia,29-02-2020,106776,2405,608,106168,Eastern Mediterranean
Turkey,29-02-2020,284745,1027,860,283885,Europe
Uganda,29-02-2020,95633,166,861,94772,Africa
Ukraine,29-02-2020,299703,2083,744,298959,Europe
United Arab Emirates,29-02-2020,139268,1559,13,139255,Eastern Mediterranean
United Kingdom,29-02-2020,202118,491,738,201380,Europe
United Kingdom,29-02-2020,210361,1110,608,209753,Europe
United Kingdom,29-02-2020,95409,1163,722,94687,Europe
United Kingdom,29-02-2020,89769,2225,437,89332,Europe
United Kingdom,29-02-2020,72852,1179,1220,71632,Europe
United Kingdom,29-02-2020,43277,2097,527,42750,Europe
United Kingdom,29-02-2020,344975,1116,365,344610,Europe
Uruguay,29-02-2020,128822,2400,834,127988,Americas
US,29-02-2020,275133,640,180,274953,Americas
Uzbekistan,29-02-2020,424977,305,1218,423759,Europe
Venezuela,29-02-2020,220541,2139,579,219962,Americas
Vietnam,29-02-2020,389098,320,469,388629,Western Pacific
Zambia,29-02-2020,313365,2209,1160,312205,Africa
Zimbabwe,29-02-2020,334786,74,163,334623,Africa
Dominica,29-02-2020,447175,2381,733,446442,Americas
Grenada,29-02-2020,167632,1000,516,167116,Americas
Mozambique,29-02-2020,15702,105,948,14754,Africa
Syria,29-02-2020,314666,1200,161,314505,Eastern Mediterranean
Timor-Leste,29-02-2020,243025,2438,1089,241936,South-East Asia
Belize,29-02-2020,249442,430,605,248837,Americas
Laos,29-02-2020,432454,1104,590,431864,Western Pacific
Libya,29-02-2020,384701,2386,758,383943,Eastern Mediterranean
West Bank and Gaza,29-02-2020,323187,1032,644,322543,Eastern Mediterranean
Guinea-Bissau,29-02-2020,442310,352,1149,441161,Africa
Mali,29-02-2020,295677,2440,403,295274,Africa
Saint Kitts and Nevis,29-02-2020,162027,995,580,161447,Americas
Canada,29-02-2020,326968,501,12,326956,Americas
Canada,29-02-2020,99142,1292,419,98723,Americas
Kosovo,29-02-2020,229559,94,294,229265,Europe
Burma,29-02-2020,448901,1716,168,448733,South-East Asia
United Kingdom,29-02-2020,146738,1423,354,146384,Europe
United Kingdom,29-02-2020,161476,1359,261,161215,Europe
United Kingdom,29-02-2020,67965,1672,651,67314,Europe
Botswana,29-02-2020,166389,2185,62,166327,Africa
Burundi,29-02-2020,141435,1375,388,141047,Africa
Sierra Leone,29-02-2020,384276,897,325,383951,Africa
Malawi,29-02-2020,23770,1543,347,23423,Africa
United Kingdom,29-02-2020,448956,1458,353,448603,Europe
France,29-02-2020,402247,1502,1126,401121,Europe
South Sudan,29-02-2020,285971,428,80,285891,Africa
Western Sahara,29-02-2020,345034,1738,1128,343906,Africa
Sao Tome and Principe,29-02-2020,284852,2247,178,284674,Africa
Yemen,29-02-2020,122025,2194,255,121770,Eastern Mediterranean
Comoros,29-02-2020,106312,758,710,105602,Africa
Tajikistan,29-02-2020,288578,207,383,288195,Europe
Lesotho,29-02-2020,302082,2144,287,301795,Africa
Afghanistan,01-03-2020,409667,1394,1213,408454,Eastern Mediterranean
Albania,01-03-2020,318064,2414,796,317268,Europe
Algeria,01-03-2020,267904,1511,1216,266688,Africa
Andorra,01-03-2020,256820,1443,654,256166,Europe
Angola,01-03-2020,260640,1718,828,259812,Africa
Antigua and Barbuda,01-03-2020,184438,1306,690,183748,Americas
Argentina,01-03-2020,297409,399,128,297281,Americas
Armenia,01-03-2020,118934,999,483,118451,Europe
Australia,01-03-2020,24217,2492,871,23346,Western Pacific
Australia,01-03-2020,1919,1053,967,952,Western Pacific
Australia,01-03-2020,245565,2266,122,245443,Western Pacific
Australia,01-03-2020,401175,1330,1021,400154,Western Pacific
Australia,01-03-2020,207872,1057,1185,206687,Western Pacific
Australia,01-03-2020,351448,448,1051,350397,Western Pacific
Australia,01-03-2020,196382,342,193,196189,Western Pacific
Australia,01-03-2020,438891,2306,220,438671,Western Pacific
Austria,01-03-2020,37642,1831,654,36988,Europe
Azerbaijan,01-03-2020,204740,2094,1089,203651,Europe
Bahamas,01-03-2020,198500,1068,384,198116,Americas
Bahrain,01-03-2020,7876,1567,981,6895,Eastern Mediterranean
Bangladesh,01-03-2020,374619,508,604,374015,South-East Asia
Barbados,01-03-2020,189675,1405,239,189436,Americas
Belarus,01-03-2020,423272,1442,658,422614,Europe
Belgium,01-03-2020,397601,2143,400,397201,Europe
Benin,01-03-2020,264156,2239,723,263433,Africa
Bhutan,01-03-2020,63058,1507,385,62673,South-East Asia
Bolivia,01-03-2020,270602,78,989,269613,Americas
Bosnia and Herzegovina,01-03-2020,59804,634,596,59208,Europe
Brazil,01-03-2020,210042,160,322,209720,Americas
Brunei,01-03-2020,293485,532,1120,292365,Western Pacific
Bulgaria,01-03-2020,252117,2074,1038,251079,Europe
Burkina Faso,01-03-2020,363180,377,606,362574,Africa
Cabo Verde,01-03-2020,180178,927,904,179274,Africa
Cambodia,01-03-2020,319874,12,111,319763,Western Pacific
Cameroon,01-03-2020,139493,2085,377,139116,Africa
Canada,01-03-2020,348280,2444,215,348065,Americas
Canada,01-03-2020,134538,1212,1056,133482,Americas
Canada,01-03-2020,9893,451,1044,8849,Americas
Canada,01-03-2020,373298,2080,677,372621,Americas
Canada,01-03-2020,53393,698,226,53167,Americas
Canada,01-03-2020,7868,529,371,7497,Americas
Canada,01-03-2020,347946,2303,616,347330,Americas
Canada,01-03-2020,285893,371,445,285448,Americas
Canada,01-03-2020,43013,1550,40,42973,Americas
Canada,01-03-2020,442592,728,255,442337,Americas
Central African Republic,01-03-2020,18793,2047,872,17921,Africa
Chad,01-03-2020,102451,2482,665,101786,Africa
Chile,01-03-2020,230092,1745,657,229435,Americas
China,01-03-2020,207673,1596,194,207479,Western Pacific
China,01-03-2020,3519,1029,229,3290,Western Pacific
China,01-03-2020,402279,1696,41,402238,Western Pacific
China,01-03-2020,435964,1930,1126,434838,Western Pacific
China,01-03-2020,349226,1195,956,348270,Western Pacific
China,01-03-2020,44446,2127,1180,43266,Western Pacific
China,01-03-2020,147317,977,833,146484,Western Pacific
China,01-03-2020,293613,1193,260,293353,Western Pacific
China,01-03-2020,199925,708,196,199729,Western Pacific
China,01-03-2020,230646,2473,136,230510,Western Pacific
China,01-03-2020,94286,646,1009,93277,Western Pacific
China,01-03-2020,13734,1019,313,13421,Western Pacific
China,01-03-2020,183796,573,996,182800,Western Pacific
China,01-03-2020,294399,860,507,293892,Western Pacific
China,01-03-2020,17257,470,395,16862,Western Pacific
China,01-03-2020,333886,526,281,333605,Western Pacific
China,01-03-2020,416395,1011,635,415760,Western Pacific
China,01-03-2020,182628,472,966,181662,Western Pacific
China,01-03-2020,305945,736,775,305170,Western Pacific
China,01-03-2020,272645,259,300,272345,Western Pacific
China,01-03-2020,346912,2313,222,346690,Western Pacific
China,01-03-2020,373224,89,927,372297,Western Pacific
China,01-03-2020,371539,1665,211,371328,Western Pacific
China,01-03-2020,421166,1040,268,420898,Western Pacific
China,01-03-2020,94851,944,606,94245,Western Pacific
China,01-03-2020,204698,353,27,204671,Western Pacific
China,01-03-2020,37157,1670,1150,36007,Western Pacific
China,01-03-2020,285622,1804,859,284763,Western Pacific
China,01-03-2020,3479,238,108,3371,Western Pacific
China,01-03-2020,35598,2370,560,35038,Western Pacific
China,01-03-2020,183724,308,35,183689,Western Pacific
China,01-03-2020,267811,1480,73,267738,Western Pacific
China,01-03-2020,414173,1043,67,414106,Western Pacific
Colombia,01-03-2020,234661,2051,710,233951,Americas
Congo (Brazzaville),01-03-2020,84472,141,157,84315,Africa
Congo (Kinshasa),01-03-2020,355145,2264,1086,354059,Africa
Costa Rica,01-03-2020,36703,628,121,36582,Americas
Cote d'Ivoire,01-03-2020,302587,1699,653,301934,Africa
Croatia,01-03-2020,141922,1194,1050,140872,Europe
Cuba,01-03-2020,247239,1674,868,246371,Americas
Cyprus,01-03-2020,424010,2419,902,423108,Europe
Czechia,01-03-2020,385220,1624,1117,384103,Europe
Denmark,01-03-2020,420642,669,230,420412,Europe
Greenland,01-03-2020,391456,107,80,391376,Europe
Denmark,01-03-2020,211130,2480,241,210889,Europe
Djibouti,01-03-2020,69375,1904,34,69341,Eastern Mediterranean
Dominican Republic,01-03-2020,425281,641,816,424465,Americas
Ecuador,01-03-2020,387737,1051,28,387709,Americas
Egypt,01-03-2020,433766,978,723,433043,Eastern Mediterranean
El Salvador,01-03-2020,120884,101,620,120264,Americas
Equatorial Guinea,01-03-2020,140848,1201,730,140118,Africa
Eritrea,01-03-2020,269089,1660,515,268574,Africa
Estonia,01-03-2020,250154,375,596,249558,Europe
Eswatini,01-03-2020,422053,1554,42,422011,Africa
Ethiopia,01-03-2020,321456,596,13,321443,Africa
Fiji,01-03-2020,382299,1396,363,381936,Western Pacific
Finland,01-03-2020,218139,2471,576,217563,Europe
France,01-03-2020,396253,2158,1109,395144,Europe
France,01-03-2020,136495,2175,1143,135352,Europe
France,01-03-2020,223298,234,1104,222194,Europe
France,01-03-2020,240096,1555,415,239681,Europe
France,01-03-2020,163836,2104,617,163219,Europe
France,01-03-2020,258836,1938,793,258043,Europe
France,01-03-2020,264817,1756,604,264213,Europe
France,01-03-2020,337535,1239,206,337329,Europe
France,01-03-2020,318438,1855,756,317682,Europe
France,01-03-2020,353888,2434,413,353475,Europe
Gabon,01-03-2020,134220,366,712,133508,Africa
Gambia,01-03-2020,431846,716,10,431836,Africa
Georgia,01-03-2020,211896,2253,1106,210790,Europe
Germany,01-03-2020,191329,2205,1124,190205,Europe
Ghana,01-03-2020,292467,1838,868,291599,Africa
Greece,01-03-2020,37569,684,814,36755,Europe
Guatemala,01-03-2020,365511,762,480,365031,Americas
Guinea,01-03-2020,74757,1658,929,73828,Africa
Guyana,01-03-2020,45918,1867,593,45325,Americas
Haiti,01-03-2020,355618,1374,777,354841,Americas
Holy See,01-03-2020,178166,1522,406,177760,Europe
Honduras,01-03-2020,114452,2495,966,113486,Americas
Hungary,01-03-2020,113048,1246,803,112245,Europe
Iceland,01-03-2020,238060,2066,766,237294,Europe
India,01-03-2020,160993,1493,183,160810,South-East Asia
Indonesia,01-03-2020,232963,1899,578,232385,South-East Asia
Iran,01-03-2020,404852,83,99,404753,Eastern Mediterranean
Iraq,01-03-2020,241861,643,112,241749,Eastern Mediterranean
Ireland,01-03-2020,259195,1207,1235,257960,Europe
Israel,01-03-2020,82830,1541,981,81849,Europe
Italy,01-03-2020,431298,80,363,430935,Europe
Jamaica,01-03-2020,376687,126,490,376197,Americas
Japan,01-03-2020,65846,2458,784,65062,Western Pacific
Jordan,01-03-2020,33213,1096,1108,32105,Eastern Mediterranean
Kazakhstan,01-03-2020,221003,1919,859,220144,Europe
Kenya,01-03-2020,391424,1787,1180,390244,Africa
South Korea,01-03-2020,268679,68,754,267925,Western Pacific
Kuwait,01-03-2020,93218,1163,517,92701,Eastern Mediterranean
Kyrgyzstan,01-03-2020,347841,1807,250,347591,Europe
Latvia,01-03-2020,55336,1728,890,54446,Europe
Lebanon,01-03-2020,119529,1041,1171,118358,Eastern Mediterranean
Liberia,01-03-2020,279036,1377,522,278514,Africa
Liechtenstein,01-03-2020,297314,1839,865,296449,Europe
Lithuania,01-03-2020,44004,1475,908,43096,Europe
Luxembourg,01-03-2020,284207,758,875,283332,Europe
Madagascar,01-03-2020,129035,1783,312,128723,Africa
Malaysia,01-03-2020,108164,627,60,108104,Western Pacific
Maldives,01-03-2020,129438,782,648,128790,South-East Asia
Malta,01-03-2020,189546,1607,464,189082,Europe
Mauritania,01-03-2020,361236,461,641,360595,Africa
Mauritius,01-03-2020,276647,218,620,276027,Africa
Mexico,01-03-2020,50633,1121,848,49785,Americas
Moldova,01-03-2020,406336,1944,494,405842,Europe
Monaco,01-03-2020,48921,2192,618,48303,Europe
Mongolia,01-03-2020,385400,1174,71,385329,Western Pacific
Montenegro,01-03-2020,160558,2367,1001,159557,Europe
Morocco,01-03-2020,238770,1754,302,238468,Eastern Mediterranean
Namibia,01-03-2020,183999,1237,335,183664,Africa
Nepal,01-03-2020,392038,394,11,392027,South-East Asia
Netherlands,01-03-2020,7551,1454,194,7357,Europe
Netherlands,01-03-2020,418621,105,39,418582,Europe
Netherlands,01-03-2020,259754,1555,459,259295,Europe
Netherlands,01-03-2020,90660,1236,397,90263,Europe
New Zealand,01-03-2020,100890,518,989,99901,Western Pacific
Nicaragua,01-03-2020,205610,208,322,205288,Americas
Niger,01-03-2020,72488,1878,546,71942,Africa
Nigeria,01-03-2020,57806,1848,1177,56629,Africa
North Macedonia,01-03-2020,218859,1469,1151,217708,Europe
Norway,01-03-2020,437957,1647,1235,436722,Europe
Oman,01-03-2020,26908,1688,316,26592,Eastern Mediterranean
Pakistan,01-03-2020,147270,1667,807,146463,Eastern Mediterranean
Panama,01-03-2020,46916,796,299,46617,Americas
Papua New Guinea,01-03-2020,369077,1162,1165,367912,Western Pacific
Paraguay,01-03-2020,51356,2419,115,51241,Americas
Peru,01-03-2020,168065,341,841,167224,Americas
Philippines,01-03-2020,367663,2028,198,367465,Western Pacific
Poland,01-03-2020,49111,1708,824,48287,Europe
Portugal,01-03-2020,8453,1428,67,8386,Europe
Qatar,01-03-2020,241858,1858,763,241095,Eastern Mediterranean
Romania,01-03-2020,30664,22,1187,29477,Europe
Russia,01-03-2020,214739,1044,993,213746,Europe
Rwanda,01-03-2020,261257,965,551,260706,Africa
Saint Lucia,01-03-2020,276493,1496,152,276341,Americas
Saint Vincent and the Grenadines,01-03-2020,274321,387,647,273674,Americas
San Marino,01-03-2020,174970,748,212,174758,Europe
Saudi Arabia,01-03-2020,216941,2178,119,216822,Eastern Mediterranean
Senegal,01-03-2020,222511,1792,1133,221378,Africa
Serbia,01-03-2020,27986,1573,26,27960,Europe
Seychelles,01-03-2020,210159,1098,1009,209150,Africa
Singapore,01-03-2020,325516,1594,199,325317,Western Pacific
Slovakia,01-03-2020,11735,1310,884,10851,Europe
Slovenia,01-03-2020,412168,683,807,411361,Europe
Somalia,01-03-2020,449343,6,739,448604,Eastern Mediterranean
South Africa,01-03-2020,263983,2059,1238,262745,Africa
Spain,01-03-2020,45188,1889,742,44446,Europe
Sri Lanka,01-03-2020,28156,488,322,27834,South-East Asia
Sudan,01-03-2020,131735,644,253,131482,Eastern Mediterranean
Suriname,01-03-2020,213041,1881,603,212438,Americas
Sweden,01-03-2020,156405,1857,1183,155222,Europe
Switzerland,01-03-2020,165499,169,228,165271,Europe
Taiwan*,01-03-2020,19507,1122,1196,18311,Western Pacific
Tanzania,01-03-2020,378198,1803,208,377990,Africa
Thailand,01-03-2020,411810,652,1064,410746,South-East Asia
Togo,01-03-2020,441281,870,1152,440129,Africa
Trinidad and Tobago,01-03-2020,12856,1989,772,12084,Americas
Tunisia,01-03-2020,47220,1471,832,46388,Eastern Mediterranean
Turkey,01-03-2020,343040,500,601,342439,Europe
Uganda,01-03-2020,426919,2459,1058,425861,Africa
Ukraine,01-03-2020,238793,2446,306,238487,Europe
United Arab Emirates,01-03-2020,212791,2490,592,212199,Eastern Mediterranean
United Kingdom,01-03-2020,48282,250,946,47336,Europe
United Kingdom,01-03-2020,62991,830,519,62472,Europe
United Kingdom,01-03-2020,13624,713,479,13145,Europe
United Kingdom,01-03-2020,272316,1118,1120,271196,Europe
United Kingdom,01-03-2020,68024,700,113,67911,Europe
United Kingdom,01-03-2020,384495,1484,536,383959,Europe
United Kingdom,01-03-2020,96011,631,1201,94810,Europe
Uruguay,01-03-2020,383459,2229,236,383223,Americas
US,01-03-2020,167243,1945,977,166266,Americas
Uzbekistan,01-03-2020,61115,538,136,60979,Europe
Venezuela,01-03-2020,164915,841,915,164000,Americas
Vietnam,01-03-2020,327555,327,933,326622,Western Pacific
Zambia,01-03-2020,161666,369,549,161117,Africa
Zimbabwe,01-03-2020,125357,2331,180,125177,Africa
Dominica,01-03-2020,24497,2237,974,23523,Americas
Grenada,01-03-2020,281319,503,805,280514,Americas
Mozambique,01-03-2020,415131,1735,1124,414007,Africa
Syria,01-03-2020,288130,847,732,287398,Eastern Mediterranean
Timor-Leste,01-03-2020,400174,177,389,399785,South-East Asia
Belize,01-03-2020,103280,2094,1065,102215,Americas
Laos,01-03-2020,365802,1596,565,365237,Western Pacific
Libya,01-03-2020,364743,811,905,363838,Eastern Mediterranean
West Bank and Gaza,01-03-2020,385616,1248,1180,384436,Eastern Mediterranean
Guinea-Bissau,01-03-2020,205454,808,54,205400,Africa
Mali,01-03-2020,414623,1459,785,413838,Africa
Saint Kitts and Nevis,01-03-2020,20300,471,1232,19068,Americas
Canada,01-03-2020,336885,1754,762,336123,Americas
Canada,01-03-2020,434295,1920,1111,433184,Americas
Kosovo,01-03-2020,137340,2219,563,136777,Europe
Burma,01-03-2020,16441,761,923,15518,South-East Asia
United Kingdom,01-03-2020,350859,1545,179,350680,Europe
United Kingdom,01-03-2020,241299,419,744,240555,Europe
United Kingdom,01-03-2020,234022,1150,81,233941,Europe
Botswana,01-03-2020,144783,1584,17,144766,Africa
Burundi,01-03-2020,230432,2060,642,229790,Africa
Sierra Leone,01-03-2020,281155,196,906,280249,Africa
Malawi,01-03-2020,185676,532,1200,184476,Africa
United Kingdom,01-03-2020,378024,1811,914,377110,Europe
France,01-03-2020,69778,2250,0,69778,Europe
South Sudan,01-03-2020,100503,355,806,99697,Africa
Western Sahara,01-03-2020,333640,170,3,333637,Africa
Sao Tome and Principe,01-03-2020,318504,1252,6,318498,Africa
Yemen,01-03-2020,363583,1233,409,363174,Eastern Mediterranean
Comoros,01-03-2020,46527,136,689,45838,Africa
Tajikistan,01-03-2020,212365,2281,347,212018,Europe
Lesotho,01-03-2020,218490,1837,362,218128,Africa
Afghanistan,02-03-2020,80168,1715,752,79416,Eastern Mediterranean
Albania,02-03-2020,441980,1196,152,441828,Europe
Algeria,02-03-2020,350097,195,1168,348929,Africa
Andorra,02-03-2020,41602,2372,437,41165,Europe
Angola,02-03-2020,434853,712,924,433929,Africa
Antigua and Barbuda,02-03-2020,441647,1234,515,441132,Americas
Argentina,02-03-2020,300096,2377,1231,298865,Americas
Armenia,02-03-2020,49209,1043,1171,48038,Europe
Australia,02-03-2020,380684,1849,1048,379636,Western Pacific
Australia,02-03-2020,129908,947,502,129406,Western Pacific
Australia,02-03-2020,373076,1439,1136,371940,Western Pacific
Australia,02-03-2020,332859,2270,479,332380,Western Pacific
Australia,02-03-2020,230631,1166,1019,229612,Western Pacific
Australia,02-03-2020,118183,2182,714,117469,Western Pacific
Australia,02-03-2020,91556,1878,1250,90306,Western Pacific
Australia,02-03-2020,265910,2050,102,265808,Western Pacific
Austria,02-03-2020,186229,1369,877,185352,Europe
Azerbaijan,02-03-2020,63282,473,1010,62272,Europe
Bahamas,02-03-2020,244313,1887,99,244214,Americas
Bahrain,02-03-2020,362249,167,1030,361219,Eastern Mediterranean
Bangladesh,02-03-2020,385277,1051,123,385154,South-East Asia
Barbados,02-03-2020,335344,1355,484,334860,Americas
Belarus,02-03-2020,153175,692,1110,152065,Europe
Belgium,02-03-2020,362892,190,418,362474,Europe
Benin,02-03-2020,422588,53,465,422123,Africa
Bhutan,02-03-2020,333841,934,820,333021,South-East Asia
Bolivia,02-03-2020,44680,1291,36,44644,Americas
Bosnia and Herzegovina,02-03-2020,161031,1357,310,160721,Europe
Brazil,02-03-2020,316470,907,122,316348,Americas
Brunei,02-03-2020,392609,2143,1139,391470,Western Pacific
Bulgaria,02-03-2020,154325,2123,933,153392,Europe
Burkina Faso,02-03-2020,26971,1957,321,26650,Africa
Cabo Verde,02-03-2020,4277,1568,667,3610,Africa
Cambodia,02-03-2020,169905,1574,1178,168727,Western Pacific
Cameroon,02-03-2020,442108,356,916,441192,Africa
Canada,02-03-2020,408253,1705,553,407700,Americas
Canada,02-03-2020,410446,60,1079,409367,Americas
Canada,02-03-2020,118406,47,822,117584,Americas
Canada,02-03-2020,245644,490,707,244937,Americas
Canada,02-03-2020,261416,2259,270,261146,Americas
Canada,02-03-2020,120316,508,116,120200,Americas
Canada,02-03-2020,2118,732,729,1389,Americas
Canada,02-03-2020,115143,1638,397,114746,Americas
Canada,02-03-2020,368307,147,104,368203,Americas
Canada,02-03-2020,7700,286,1022,6678,Americas
Central African Republic,02-03-2020,2190,2304,599,1591,Africa
Chad,02-03-2020,6009,1038,191,5818,Africa
Chile,02-03-2020,163042,756,504,162538,Americas
China,02-03-2020,210928,2336,619,210309,Western Pacific
China,02-03-2020,205572,918,184,205388,Western Pacific
China,02-03-2020,197690,879,16,197674,Western Pacific
China,02-03-2020,110560,2220,662,109898,Western Pacific
China,02-03-2020,138665,1336,750,137915,Western Pacific
China,02-03-2020,34086,642,450,33636,Western Pacific
China,02-03-2020,315516,945,960,314556,Western Pacific
China,02-03-2020,331700,786,178,331522,Western Pacific
China,02-03-2020,132862,215,289,132573,Western Pacific
China,02-03-2020,33614,2056,946,32668,Western Pacific
China,02-03-2020,100327,1504,508,99819,Western Pacific
China,02-03-2020,83357,2296,356,83001,Western Pacific
China,02-03-2020,339693,709,184,339509,Western Pacific
China,02-03-2020,421268,2435,865,420403,Western Pacific
China,02-03-2020,227129,464,800,226329,Western Pacific
China,02-03-2020,445041,312,480,444561,Western Pacific
China,02-03-2020,265303,1804,378,264925,Western Pacific
China,02-03-2020,107133,619,574,106559,Western Pacific
China,02-03-2020,106715,1425,1003,105712,Western Pacific
China,02-03-2020,203901,1695,1229,202672,Western Pacific
China,02-03-2020,340984,1277,997,339987,Western Pacific
China,02-03-2020,45646,614,602,45044,Western Pacific
China,02-03-2020,325893,770,1030,324863,Western Pacific
China,02-03-2020,286342,1245,541,285801,Western Pacific
China,02-03-2020,202544,2104,211,202333,Western Pacific
China,02-03-2020,367430,2191,877,366553,Western Pacific
China,02-03-2020,333330,1296,57,333273,Western Pacific
China,02-03-2020,311050,1902,687,310363,Western Pacific
China,02-03-2020,2583,927,471,2112,Western Pacific
China,02-03-2020,164957,1062,550,164407,Western Pacific
China,02-03-2020,8740,1625,818,7922,Western Pacific
China,02-03-2020,203078,1164,64,203014,Western Pacific
China,02-03-2020,433396,667,909,432487,Western Pacific
Colombia,02-03-2020,224349,1611,34,224315,Americas
Congo (Brazzaville),02-03-2020,33106,54,4,33102,Africa
Congo (Kinshasa),02-03-2020,12029,2431,567,11462,Africa
Costa Rica,02-03-2020,207515,2067,691,206824,Americas
Cote d'Ivoire,02-03-2020,267427,1873,401,267026,Africa
Croatia,02-03-2020,142502,2154,298,142204,Europe
Cuba,02-03-2020,128584,1128,997,127587,Americas
Cyprus,02-03-2020,50506,1210,354,50152,Europe
Czechia,02-03-2020,417198,298,1051,416147,Europe
Denmark,02-03-2020,260310,1549,880,259430,Europe
Greenland,02-03-2020,111887,1805,1066,110821,Europe
Denmark,02-03-2020,224792,1874,1092,223700,Europe
Djibouti,02-03-2020,361202,23,1147,360055,Eastern Mediterranean
Dominican Republic,02-03-2020,404782,1902,138,404644,Americas
Ecuador,02-03-2020,417839,727,182,417657,Americas
Egypt,02-03-2020,413702,186,1112,412590,Eastern Mediterranean
El Salvador,02-03-2020,362445,2231,789,361656,Americas
Equatorial Guinea,02-03-2020,33104,2063,276,32828,Africa
Eritrea,02-03-2020,5124,1249,338,4786,Africa
Estonia,02-03-2020,149627,695,445,149182,Europe
Eswatini,02-03-2020,367883,447,706,367177,Africa
Ethiopia,02-03-2020,49817,84,795,49022,Africa
Fiji,02-03-2020,327231,752,608,326623,Western Pacific
Finland,02-03-2020,38266,2285,1034,37232,Europe
France,02-03-2020,137941,2361,115,137826,Europe
France,02-03-2020,325300,78,239,325061,Europe
France,02-03-2020,229754,235,439,229315,Europe
France,02-03-2020,439021,2226,499,438522,Europe
France,02-03-2020,32440,2312,220,32220,Europe
France,02-03-2020,265992,1442,292,265700,Europe
France,02-03-2020,150648,1756,892,149756,Europe
France,02-03-2020,181216,1561,152,181064,Europe
France,02-03-2020,403926,112,544,403382,Europe
France,02-03-2020,297277,1142,1157,296120,Europe
Gabon,02-03-2020,759,477,321,438,Africa
Gambia,02-03-2020,15334,1858,228,15106,Africa
Georgia,02-03-2020,146804,1814,30,146774,Europe
Germany,02-03-2020,227965,1664,1104,226861,Europe
Ghana,02-03-2020,418444,1333,565,417879,Africa
Greece,02-03-2020,419076,1617,1182,417894,Europe
Guatemala,02-03-2020,296389,737,246,296143,Americas
Guinea,02-03-2020,427705,773,1225,426480,Africa
Guyana,02-03-2020,62225,1282,916,61309,Americas
Haiti,02-03-2020,330904,2272,474,330430,Americas
Holy See,02-03-2020,8156,1067,749,7407,Europe
Honduras,02-03-2020,404412,1188,953,403459,Americas
Hungary,02-03-2020,216455,2434,50,216405,Europe
Iceland,02-03-2020,262089,1410,848,261241,Europe
India,02-03-2020,181285,717,446,180839,South-East Asia
Indonesia,02-03-2020,338629,1787,1152,337477,South-East Asia
Iran,02-03-2020,426208,2035,759,425449,Eastern Mediterranean
Iraq,02-03-2020,131725,785,1106,130619,Eastern Mediterranean
Ireland,02-03-2020,146092,1814,137,145955,Europe
Israel,02-03-2020,81627,223,510,81117,Europe
Italy,02-03-2020,352213,1306,769,351444,Europe
Jamaica,02-03-2020,296976,2437,1062,295914,Americas
Japan,02-03-2020,210120,1908,687,209433,Western Pacific
Jordan,02-03-2020,268600,621,243,268357,Eastern Mediterranean
Kazakhstan,02-03-2020,94464,1931,996,93468,Europe
Kenya,02-03-2020,99699,1183,222,99477,Africa
South Korea,02-03-2020,278991,1532,642,278349,Western Pacific
Kuwait,02-03-2020,217046,1711,422,216624,Eastern Mediterranean
Kyrgyzstan,02-03-2020,420514,114,602,419912,Europe
Latvia,02-03-2020,424332,651,636,423696,Europe
Lebanon,02-03-2020,261764,1646,279,261485,Eastern Mediterranean
Liberia,02-03-2020,90717,993,836,89881,Africa
Liechtenstein,02-03-2020,329266,1336,1036,328230,Europe
Lithuania,02-03-2020,147726,669,300,147426,Europe
Luxembourg,02-03-2020,98405,2253,1247,97158,Europe
Madagascar,02-03-2020,277888,193,1180,276708,Africa
Malaysia,02-03-2020,409942,834,206,409736,Western Pacific
Maldives,02-03-2020,16817,2493,683,16134,South-East Asia
Malta,02-03-2020,222114,1322,850,221264,Europe
Mauritania,02-03-2020,206512,2326,113,206399,Africa
Mauritius,02-03-2020,397948,773,1225,396723,Africa
Mexico,02-03-2020,126556,344,329,126227,Americas
Moldova,02-03-2020,205893,1793,914,204979,Europe
Monaco,02-03-2020,167997,351,791,167206,Europe
Mongolia,02-03-2020,88622,2262,1243,87379,Western Pacific
Montenegro,02-03-2020,387103,1933,931,386172,Europe
Morocco,02-03-2020,322088,1179,298,321790,Eastern Mediterranean
Namibia,02-03-2020,76306,946,145,76161,Africa
Nepal,02-03-2020,405436,1461,864,404572,South-East Asia
Netherlands,02-03-2020,308989,2235,327,308662,Europe
Netherlands,02-03-2020,379777,142,680,379097,Europe
Netherlands,02-03-2020,213478,531,127,213351,Europe
Netherlands,02-03-2020,287625,1105,1215,286410,Europe
New Zealand,02-03-2020,3641,2214,572,3069,Western Pacific
Nicaragua,02-03-2020,252246,234,962,251284,Americas
Niger,02-03-2020,249434,2480,820,248614,Africa
Nigeria,02-03-2020,268807,2464,439,268368,Africa
North Macedonia,02-03-2020,11674,2052,896,10778,Europe
Norway,02-03-2020,262128,319,1244,260884,Europe
Oman,02-03-2020,222006,862,229,221777,Eastern Mediterranean
Pakistan,02-03-2020,8491,598,525,7966,Eastern Mediterranean
Panama,02-03-2020,275894,664,565,275329,Americas
Papua New Guinea,02-03-2020,291470,1187,1199,290271,Western Pacific
Paraguay,02-03-2020,219088,1971,595,218493,Americas
Peru,02-03-2020,261415,1479,406,261009,Americas
Philippines,02-03-2020,387021,2298,810,386211,Western Pacific
Poland,02-03-2020,133876,1871,115,133761,Europe
Portugal,02-03-2020,120062,1900,856,119206,Europe
Qatar,02-03-2020,352501,1665,307,352194,Eastern Mediterranean
Romania,02-03-2020,32006,1052,826,31180,Europe
Russia,02-03-2020,430940,916,136,430804,Europe
Rwanda,02-03-2020,133451,220,438,133013,Africa
Saint Lucia,02-03-2020,312841,2410,605,312236,Americas
Saint Vincent and the Grenadines,02-03-2020,171700,924,1192,170508,Americas
San Marino,02-03-2020,415790,2297,1237,414553,Europe
Saudi Arabia,02-03-2020,118752,1009,845,117907,Eastern Mediterranean
Senegal,02-03-2020,63306,1075,103,63203,Africa
Serbia,02-03-2020,253402,1617,487,252915,Europe
Seychelles,02-03-2020,150697,1036,330,150367,Africa
Singapore,02-03-2020,262098,812,407,261691,Western Pacific
Slovakia,02-03-2020,323859,1315,546,323313,Europe
Slovenia,02-03-2020,172315,2,514,171801,Europe
Somalia,02-03-2020,15065,2290,32,15033,Eastern Mediterranean
South Africa,02-03-2020,232851,2188,1181,231670,Africa
Spain,02-03-2020,44902,395,1204,43698,Europe
Sri Lanka,02-03-2020,398948,281,1057,397891,South-East Asia
Sudan,02-03-2020,53528,1200,821,52707,Eastern Mediterranean
Suriname,02-03-2020,379715,1142,784,378931,Americas
Sweden,02-03-2020,269624,304,296,269328,Europe
Switzerland,02-03-2020,419441,758,68,419373,Europe
Taiwan*,02-03-2020,289391,775,22,289369,Western Pacific
Tanzania,02-03-2020,288532,474,725,287807,Africa
Thailand,02-03-2020,204013,731,997,203016,South-East Asia
Togo,02-03-2020,355547,925,358,355189,Africa
Trinidad and Tobago,02-03-2020,263440,1125,317,263123,Americas
Tunisia,02-03-2020,210164,2098,603,209561,Eastern Mediterranean
Turkey,02-03-2020,36375,1220,0,36375,Europe
Uganda,02-03-2020,45471,540,1098,44373,Africa
Ukraine,02-03-2020,220202,1021,221,219981,Europe
United Arab Emirates,02-03-2020,372197,1502,91,372106,Eastern Mediterranean
United Kingdom,02-03-2020,122766,68,72,122694,Europe
United Kingdom,02-03-2020,299220,812,493,298727,Europe
United Kingdom,02-03-2020,343344,372,827,342517,Europe
United Kingdom,02-03-2020,298211,1989,399,297812,Europe
United Kingdom,02-03-2020,315504,2496,1124,314380,Europe
United Kingdom,02-03-2020,255048,137,817,254231,Europe
United Kingdom,02-03-2020,188280,1328,993,187287,Europe
Uruguay,02-03-2020,141278,2492,1051,140227,Americas
US,02-03-2020,197311,136,704,196607,Americas
Uzbekistan,02-03-2020,440591,17,1118,439473,Europe
Venezuela,02-03-2020,311527,1136,1113,310414,Americas
Vietnam,02-03-2020,377710,2190,477,377233,Western Pacific
Zambia,02-03-2020,143531,181,1068,142463,Africa
Zimbabwe,02-03-2020,195682,1989,1118,194564,Africa
Dominica,02-03-2020,341868,59,292,341576,Americas
Grenada,02-03-2020,425406,1272,387,425019,Americas
Mozambique,02-03-2020,175344,1990,312,175032,Africa
Syria,02-03-2020,248603,1182,727,247876,Eastern Mediterranean
Timor-Leste,02-03-2020,347096,2220,900,346196,South-East Asia
Belize,02-03-2020,230236,1735,337,229899,Americas
Laos,02-03-2020,172011,196,601,171410,Western Pacific
Libya,02-03-2020,231939,2431,500,231439,Eastern Mediterranean
West Bank and Gaza,02-03-2020,20345,1232,106,20239,Eastern Mediterranean
Guinea-Bissau,02-03-2020,364920,1355,447,364473,Africa
Mali,02-03-2020,123508,2386,537,122971,Africa
Saint Kitts and Nevis,02-03-2020,308328,1683,230,308098,Americas
Canada,02-03-2020,277778,2128,652,277126,Americas
Canada,02-03-2020,252614,698,781,251833,Americas
Kosovo,02-03-2020,291817,465,962,290855,Europe
Burma,02-03-2020,368821,1961,287,368534,South-East Asia
United Kingdom,02-03-2020,360968,1372,391,360577,Europe
United Kingdom,02-03-2020,248813,1281,69,248744,Europe
United Kingdom,02-03-2020,150324,1780,624,149700,Europe
Botswana,02-03-2020,331899,537,1080,330819,Africa
Burundi,02-03-2020,180824,438,415,180409,Africa
Sierra Leone,02-03-2020,93392,2426,1162,92230,Africa
Malawi,02-03-2020,93185,2347,70,93115,Africa
United Kingdom,02-03-2020,124018,792,1157,122861,Europe
France,02-03-2020,323081,2144,290,322791,Europe
South Sudan,02-03-2020,39146,1994,1196,37950,Africa
Western Sahara,02-03-2020,300166,1369,644,299522,Africa
Sao Tome and Principe,02-03-2020,226081,668,13,226068,Africa
Yemen,02-03-2020,176970,976,740,176230,Eastern Mediterranean
Comoros,02-03-2020,262393,611,919,261474,Africa
Tajikistan,02-03-2020,213070,1798,1032,212038,Europe
Lesotho,02-03-2020,189793,1171,860,188933,Africa
Afghanistan,03-03-2020,236011,1887,581,235430,Eastern Mediterranean
Albania,03-03-2020,60171,2400,476,59695,Europe
Algeria,03-03-2020,19267,316,737,18530,Africa
Andorra,03-03-2020,350460,364,336,350124,Europe
Angola,03-03-2020,245391,2200,524,244867,Africa
Antigua and Barbuda,03-03-2020,311173,2129,417,310756,Americas
Argentina,03-03-2020,102463,909,527,101936,Americas
Armenia,03-03-2020,421093,2117,1045,420048,Europe
Australia,03-03-2020,63321,1837,91,63230,Western Pacific
Australia,03-03-2020,428500,742,827,427673,Western Pacific
Australia,03-03-2020,281062,1586,1044,280018,Western Pacific
Australia,03-03-2020,101391,1835,749,100642,Western Pacific
Australia,03-03-2020,309086,2134,77,309009,Western Pacific
Australia,03-03-2020,17209,544,47,17162,Western Pacific
Australia,03-03-2020,65194,1115,515,64679,Western Pacific
Australia,03-03-2020,449199,502,814,448385,Western Pacific
Austria,03-03-2020,215753,1085,773,214980,Europe
Azerbaijan,03-03-2020,249372,78,379,248993,Europe
Bahamas,03-03-2020,70294,1046,69,70225,Americas
Bahrain,03-03-2020,317143,709,489,316654,Eastern Mediterranean
Bangladesh,03-03-2020,109515,1791,540,108975,South-East Asia
Barbados,03-03-2020,308936,1905,1122,307814,Americas
Belarus,03-03-2020,341936,993,353,341583,Europe
Belgium,03-03-2020,180855,293,876,179979,Europe
Benin,03-03-2020,118320,391,1202,117118,Africa
Bhutan,03-03-2020,26790,1227,246,26544,South-East Asia
Bolivia,03-03-2020,302437,2219,737,301700,Americas
Bosnia and Herzegovina,03-03-2020,270231,1249,50,270181,Europe
Brazil,03-03-2020,144446,2004,1247,143199,Americas
Brunei,03-03-2020,331382,884,1178,330204,Western Pacific
Bulgaria,03-03-2020,448124,744,1212,446912,Europe
Burkina Faso,03-03-2020,209418,418,450,208968,Africa
Cabo Verde,03-03-2020,193646,940,518,193128,Africa
Cambodia,03-03-2020,378915,32,575,378340,Western Pacific
Cameroon,03-03-2020,351454,1658,676,350778,Africa
Canada,03-03-2020,344261,14,244,344017,Americas
Canada,03-03-2020,181852,924,765,181087,Americas
Canada,03-03-2020,130858,467,716,130142,Americas
Canada,03-03-2020,177470,1030,360,177110,Americas
Canada,03-03-2020,7216,2005,832,6384,Americas
Canada,03-03-2020,251140,53,723,250417,Americas
Canada,03-03-2020,125279,2148,346,124933,Americas
Canada,03-03-2020,129715,284,746,128969,Americas
Canada,03-03-2020,59523,251,707,58816,Americas
Canada,03-03-2020,59411,678,409,59002,Americas
Central African Republic,03-03-2020,75427,727,848,74579,Africa
Chad,03-03-2020,119518,1738,331,119187,Africa
Chile,03-03-2020,352922,137,665,352257,Americas
China,03-03-2020,61524,2124,161,61363,Western Pacific
China,03-03-2020,111366,2239,1183,110183,Western Pacific
China,03-03-2020,420934,1817,683,420251,Western Pacific
China,03-03-2020,29131,605,298,28833,Western Pacific
China,03-03-2020,209056,1976,657,208399,Western Pacific
China,03-03-2020,256019,139,205,255814,Western Pacific
China,03-03-2020,140164,1692,592,139572,Western Pacific
China,03-03-2020,54648,1682,250,54398,Western Pacific
China,03-03-2020,258498,802,543,257955,Western Pacific
China,03-03-2020,141336,84,12,141324,Western Pacific
China,03-03-2020,354031,1757,175,353856,Western Pacific
China,03-03-2020,322679,1914,294,322385,Western Pacific
China,03-03-2020,269511,1191,785,268726,Western Pacific
China,03-03-2020,149645,1308,938,148707,Western Pacific
China,03-03-2020,161715,843,961,160754,Western Pacific
China,03-03-2020,33911,100,73,33838,Western Pacific
China,03-03-2020,53187,1089,225,52962,Western Pacific
China,03-03-2020,72689,1309,272,72417,Western Pacific
China,03-03-2020,358323,2234,1218,357105,Western Pacific
China,03-03-2020,322960,1711,149,322811,Western Pacific
China,03-03-2020,199399,1538,981,198418,Western Pacific
China,03-03-2020,234776,1645,1028,233748,Western Pacific
China,03-03-2020,144850,637,1171,143679,Western Pacific
China,03-03-2020,203240,615,427,202813,Western Pacific
China,03-03-2020,387494,1057,1178,386316,Western Pacific
China,03-03-2020,347918,1487,510,347408,Western Pacific
China,03-03-2020,2207,2225,335,1872,Western Pacific
China,03-03-2020,23359,427,435,22924,Western Pacific
China,03-03-2020,180496,1681,833,179663,Western Pacific
China,03-03-2020,161099,1881,1202,159897,Western Pacific
China,03-03-2020,92455,1748,286,92169,Western Pacific
China,03-03-2020,111985,15,553,111432,Western Pacific
China,03-03-2020,200698,6,1015,199683,Western Pacific
Colombia,03-03-2020,448699,2233,1165,447534,Americas
Congo (Brazzaville),03-03-2020,300867,387,590,300277,Africa
Congo (Kinshasa),03-03-2020,269345,716,471,268874,Africa
Costa Rica,03-03-2020,72404,2287,706,71698,Americas
Cote d'Ivoire,03-03-2020,212077,202,378,211699,Africa
Croatia,03-03-2020,318391,1278,937,317454,Europe
Cuba,03-03-2020,166997,2412,511,166486,Americas
Cyprus,03-03-2020,54476,990,620,53856,Europe
Czechia,03-03-2020,48038,730,724,47314,Europe
Denmark,03-03-2020,247604,2074,1177,246427,Europe
Greenland,03-03-2020,431329,483,219,431110,Europe
Denmark,03-03-2020,139597,1661,736,138861,Europe
Djibouti,03-03-2020,115855,694,1046,114809,Eastern Mediterranean
Dominican Republic,03-03-2020,240645,2297,425,240220,Americas
Ecuador,03-03-2020,55388,165,1139,54249,Americas
Egypt,03-03-2020,298129,1131,741,297388,Eastern Mediterranean
El Salvador,03-03-2020,240894,1760,258,240636,Americas
Equatorial Guinea,03-03-2020,39995,1768,953,39042,Africa
Eritrea,03-03-2020,235062,1429,10,235052,Africa
Estonia,03-03-2020,62842,899,1008,61834,Europe
Eswatini,03-03-2020,278493,907,695,277798,Africa
Ethiopia,03-03-2020,203001,192,1018,201983,Africa
Fiji,03-03-2020,244946,727,545,244401,Western Pacific
Finland,03-03-2020,149389,927,1240,148149,Europe
France,03-03-2020,358765,1165,634,358131,Europe
France,03-03-2020,6235,779,867,5368,Europe
France,03-03-2020,164255,309,899,163356,Europe
France,03-03-2020,52604,89,106,52498,Europe
France,03-03-2020,238298,910,761,237537,Europe
France,03-03-2020,244445,862,320,244125,Europe
France,03-03-2020,263611,1736,921,262690,Europe
France,03-03-2020,75256,473,582,74674,Europe
France,03-03-2020,44764,856,820,43944,Europe
France,03-03-2020,198929,2139,403,198526,Europe
Gabon,03-03-2020,338391,395,1125,337266,Africa
Gambia,03-03-2020,206568,696,608,205960,Africa
Georgia,03-03-2020,340442,201,268,340174,Europe
Germany,03-03-2020,383310,126,226,383084,Europe
Ghana,03-03-2020,271339,125,423,270916,Africa
Greece,03-03-2020,14838,862,1241,13597,Europe
Guatemala,03-03-2020,371644,397,1091,370553,Americas
Guinea,03-03-2020,131151,728,300,130851,Africa
Guyana,03-03-2020,392304,758,358,391946,Americas
Haiti,03-03-2020,157446,316,681,156765,Americas
Holy See,03-03-2020,416538,745,426,416112,Europe
Honduras,03-03-2020,332127,2139,982,331145,Americas
Hungary,03-03-2020,33039,1770,402,32637,Europe
Iceland,03-03-2020,17139,1225,66,17073,Europe
India,03-03-2020,99244,1889,506,98738,South-East Asia
Indonesia,03-03-2020,119497,2263,959,118538,South-East Asia
Iran,03-03-2020,94479,2139,777,93702,Eastern Mediterranean
Iraq,03-03-2020,205288,868,689,204599,Eastern Mediterranean
Ireland,03-03-2020,273600,1330,683,272917,Europe
Israel,03-03-2020,70878,66,396,70482,Europe
Italy,03-03-2020,191510,1617,632,190878,Europe
Jamaica,03-03-2020,435226,1931,590,434636,Americas
Japan,03-03-2020,54526,1284,974,53552,Western Pacific
Jordan,03-03-2020,111709,1518,96,111613,Eastern Mediterranean
Kazakhstan,03-03-2020,161805,1356,419,161386,Europe
Kenya,03-03-2020,194132,188,68,194064,Africa
South Korea,03-03-2020,176255,479,467,175788,Western Pacific
Kuwait,03-03-2020,120717,942,313,120404,Eastern Mediterranean
Kyrgyzstan,03-03-2020,393537,1891,383,393154,Europe
Latvia,03-03-2020,80531,2272,59,80472,Europe
Lebanon,03-03-2020,419865,354,615,419250,Eastern Mediterranean
Liberia,03-03-2020,184926,1450,1007,183919,Africa
Liechtenstein,03-03-2020,329727,548,535,329192,Europe
Lithuania,03-03-2020,346094,927,1242,344852,Europe
Luxembourg,03-03-2020,349788,1948,367,349421,Europe
Madagascar,03-03-2020,253105,1412,8,253097,Africa
Malaysia,03-03-2020,32207,1329,765,31442,Western Pacific
Maldives,03-03-2020,393006,1742,954,392052,South-East Asia
Malta,03-03-2020,138425,1891,837,137588,Europe
Mauritania,03-03-2020,8077,644,118,7959,Africa
Mauritius,03-03-2020,43545,548,1006,42539,Africa
Mexico,03-03-2020,101049,570,26,101023,Americas
Moldova,03-03-2020,129081,640,522,128559,Europe
Monaco,03-03-2020,368979,2284,122,368857,Europe
Mongolia,03-03-2020,125649,1024,60,125589,Western Pacific
Montenegro,03-03-2020,215967,1173,205,215762,Europe
Morocco,03-03-2020,110648,1016,1235,109413,Eastern Mediterranean
Namibia,03-03-2020,386642,1724,25,386617,Africa
Nepal,03-03-2020,205818,2137,72,205746,South-East Asia
Netherlands,03-03-2020,317904,1206,866,317038,Europe
Netherlands,03-03-2020,309816,369,260,309556,Europe
Netherlands,03-03-2020,44708,1142,471,44237,Europe
Netherlands,03-03-2020,75393,1143,387,75006,Europe
New Zealand,03-03-2020,262905,883,536,262369,Western Pacific
Nicaragua,03-03-2020,51405,1719,623,50782,Americas
Niger,03-03-2020,382611,1603,548,382063,Africa
Nigeria,03-03-2020,88665,743,862,87803,Africa
North Macedonia,03-03-2020,195387,2008,1224,194163,Europe
Norway,03-03-2020,339000,887,512,338488,Europe
Oman,03-03-2020,90108,1094,874,89234,Eastern Mediterranean
Pakistan,03-03-2020,54620,1687,469,54151,Eastern Mediterranean
Panama,03-03-2020,127811,1651,883,126928,Americas
Papua New Guinea,03-03-2020,344098,2026,96,344002,Western Pacific
Paraguay,03-03-2020,21555,2489,262,21293,Americas
Peru,03-03-2020,8958,1823,1179,7779,Americas
Philippines,03-03-2020,244509,2169,109,244400,Western Pacific
Poland,03-03-2020,396590,863,1040,395550,Europe
Portugal,03-03-2020,371030,1632,639,370391,Europe
Qatar,03-03-2020,202370,1705,549,201821,Eastern Mediterranean
Romania,03-03-2020,60308,162,835,59473,Europe
Russia,03-03-2020,3493,2007,296,3197,Europe
Rwanda,03-03-2020,168946,849,171,168775,Africa
Saint Lucia,03-03-2020,449929,823,158,449771,Americas
Saint Vincent and the Grenadines,03-03-2020,237409,590,1247,236162,Americas
San Marino,03-03-2020,102202,297,35,102167,Europe
Saudi Arabia,03-03-2020,71210,1557,210,71000,Eastern Mediterranean
Senegal,03-03-2020,373398,591,610,372788,Africa
Serbia,03-03-2020,355178,1044,974,354204,Europe
Seychelles,03-03-2020,17648,1467,393,17255,Africa
Singapore,03-03-2020,137651,548,619,137032,Western Pacific
Slovakia,03-03-2020,266766,553,357,266409,Europe
Slovenia,03-03-2020,362724,725,162,362562,Europe
Somalia,03-03-2020,9289,1479,937,8352,Eastern Mediterranean
South Africa,03-03-2020,441318,1373,1234,440084,Africa
Spain,03-03-2020,87279,9,283,86996,Europe
Sri Lanka,03-03-2020,415614,1944,809,414805,South-East Asia
Sudan,03-03-2020,392166,654,378,391788,Eastern Mediterranean
Suriname,03-03-2020,225745,290,1124,224621,Americas
Sweden,03-03-2020,178963,2059,30,178933,Europe
Switzerland,03-03-2020,227999,2471,425,227574,Europe
Taiwan*,03-03-2020,399225,2463,842,398383,Western Pacific
Tanzania,03-03-2020,303253,1902,820,302433,Africa
Thailand,03-03-2020,284529,1117,1024,283505,South-East Asia
Togo,03-03-2020,223228,657,2,223226,Africa
Trinidad and Tobago,03-03-2020,340455,58,1088,339367,Americas
Tunisia,03-03-2020,99190,1230,535,98655,Eastern Mediterranean
Turkey,03-03-2020,168567,476,667,167900,Europe
Uganda,03-03-2020,215184,810,219,214965,Africa
Ukraine,03-03-2020,97173,374,125,97048,Europe
United Arab Emirates,03-03-2020,203887,1600,1247,202640,Eastern Mediterranean
United Kingdom,03-03-2020,267386,1336,483,266903,Europe
United Kingdom,03-03-2020,77168,2052,179,76989,Europe
United Kingdom,03-03-2020,40823,290,115,40708,Europe
United Kingdom,03-03-2020,383120,1290,525,382595,Europe
United Kingdom,03-03-2020,19396,139,193,19203,Europe
United Kingdom,03-03-2020,431833,89,1146,430687,Europe
United Kingdom,03-03-2020,137604,857,668,136936,Europe
Uruguay,03-03-2020,93487,406,317,93170,Americas
US,03-03-2020,419775,994,448,419327,Americas
Uzbekistan,03-03-2020,315237,224,40,315197,Europe
Venezuela,03-03-2020,389442,236,903,388539,Americas
Vietnam,03-03-2020,448172,1871,71,448101,Western Pacific
Zambia,03-03-2020,405333,1481,418,404915,Africa
Zimbabwe,03-03-2020,422573,1051,462,422111,Africa
Dominica,03-03-2020,251341,1758,703,250638,Americas
Grenada,03-03-2020,433018,1998,548,432470,Americas
Mozambique,03-03-2020,223596,1488,380,223216,Africa
Syria,03-03-2020,48143,277,197,47946,Eastern Mediterranean
Timor-Leste,03-03-2020,424956,1352,810,424146,South-East Asia
Belize,03-03-2020,426918,1614,354,426564,Americas
Laos,03-03-2020,435996,170,828,435168,Western Pacific
Libya,03-03-2020,204347,2082,909,203438,Eastern Mediterranean
West Bank and Gaza,03-03-2020,377529,2124,718,376811,Eastern Mediterranean
Guinea-Bissau,03-03-2020,397545,1148,1217,396328,Africa
Mali,03-03-2020,203226,1645,179,203047,Africa
Saint Kitts and Nevis,03-03-2020,89304,1191,1233,88071,Americas
Canada,03-03-2020,172685,2005,1097,171588,Americas
Canada,03-03-2020,253746,2042,583,253163,Americas
Kosovo,03-03-2020,444466,1145,845,443621,Europe
Burma,03-03-2020,194437,382,540,193897,South-East Asia
United Kingdom,03-03-2020,221859,562,10,221849,Europe
United Kingdom,03-03-2020,279308,402,996,278312,Europe
United Kingdom,03-03-2020,330026,351,62,329964,Europe
Botswana,03-03-2020,402205,1098,1020,401185,Africa
Burundi,03-03-2020,266293,1891,585,265708,Africa
Sierra Leone,03-03-2020,444419,1439,1196,443223,Africa
Malawi,03-03-2020,48667,1193,761,47906,Africa
United Kingdom,03-03-2020,433021,1442,863,432158,Europe
France,03-03-2020,99790,1289,661,99129,Europe
South Sudan,03-03-2020,277636,1012,829,276807,Africa
Western Sahara,03-03-2020,306295,198,425,305870,Africa
Sao Tome and Principe,03-03-2020,28038,288,216,27822,Africa
Yemen,03-03-2020,34848,27,1135,33713,Eastern Mediterranean
Comoros,03-03-2020,48611,1290,203,48408,Africa
Tajikistan,03-03-2020,360323,2172,1020,359303,Europe
Lesotho,03-03-2020,447602,13,244,447358,Africa
Afghanistan,04-03-2020,388158,1704,138,388020,Eastern Mediterranean
Albania,04-03-2020,184311,1961,556,183755,Europe
Algeria,04-03-2020,198940,735,932,198008,Africa
Andorra,04-03-2020,303930,1154,1041,302889,Europe
Angola,04-03-2020,148313,1837,1110,147203,Africa
Antigua and Barbuda,04-03-2020,396991,640,935,396056,Americas
Argentina,04-03-2020,297346,564,77,297269,Americas
Armenia,04-03-2020,423934,184,916,423018,Europe
Australia,04-03-2020,265603,931,1170,264433,Western Pacific
Australia,04-03-2020,123515,22,956,122559,Western Pacific
Australia,04-03-2020,339174,550,270,338904,Western Pacific
Australia,04-03-2020,189342,1180,13,189329,Western Pacific
Australia,04-03-2020,353918,1690,922,352996,Western Pacific
Australia,04-03-2020,419802,923,365,419437,Western Pacific
Australia,04-03-2020,4,291,971,-967,Western Pacific
Australia,04-03-2020,152537,228,1199,151338,Western Pacific
Austria,04-03-2020,61296,1822,869,60427,Europe
Azerbaijan,04-03-2020,399516,759,568,398948,Europe
Bahamas,04-03-2020,305089,261,557,304532,Americas
Bahrain,04-03-2020,37680,2261,1123,36557,Eastern Mediterranean
Bangladesh,04-03-2020,410020,1690,946,409074,South-East Asia
Barbados,04-03-2020,122848,1016,539,122309,Americas
Belarus,04-03-2020,128979,187,619,128360,Europe
Belgium,04-03-2020,158200,1061,694,157506,Europe
Benin,04-03-2020,189842,2061,563,189279,Africa
Bhutan,04-03-2020,66905,1677,813,66092,South-East Asia
Bolivia,04-03-2020,335682,385,17,335665,Americas
Bosnia and Herzegovina,04-03-2020,136437,1459,49,136388,Europe
Brazil,04-03-2020,45802,243,1234,44568,Americas
Brunei,04-03-2020,199930,240,1061,198869,Western Pacific
Bulgaria,04-03-2020,247423,1088,409,247014,Europe
Burkina Faso,04-03-2020,282327,861,1020,281307,Africa
Cabo Verde,04-03-2020,97695,715,569,97126,Africa
Cambodia,04-03-2020,234089,41,1015,233074,Western Pacific
Cameroon,04-03-2020,43484,2456,644,42840,Africa
Canada,04-03-2020,102533,1905,269,102264,Americas
Canada,04-03-2020,292715,1319,866,291849,Americas
Canada,04-03-2020,422996,1620,825,422171,Americas
Canada,04-03-2020,56946,378,954,55992,Americas
Canada,04-03-2020,239316,997,871,238445,Americas
Canada,04-03-2020,355448,1671,1152,354296,Americas
Canada,04-03-2020,191684,442,182,191502,Americas
Canada,04-03-2020,232869,23,367,232502,Americas
Canada,04-03-2020,396431,1472,1158,395273,Americas
Canada,04-03-2020,216431,1492,1189,215242,Americas
Central African Republic,04-03-2020,258986,535,451,258535,Africa
Chad,04-03-2020,91327,767,101,91226,Africa
Chile,04-03-2020,256226,1478,845,255381,Americas
China,04-03-2020,340559,1333,399,340160,Western Pacific
China,04-03-2020,143645,623,319,143326,Western Pacific
China,04-03-2020,210307,1355,817,209490,Western Pacific
China,04-03-2020,118849,2148,1053,117796,Western Pacific
China,04-03-2020,34845,288,19,34826,Western Pacific
China,04-03-2020,69398,1447,1156,68242,Western Pacific
China,04-03-2020,127472,193,718,126754,Western Pacific
China,04-03-2020,257603,1086,1066,256537,Western Pacific
China,04-03-2020,20824,525,1230,19594,Western Pacific
China,04-03-2020,176856,697,556,176300,Western Pacific
China,04-03-2020,140228,1751,1195,139033,Western Pacific
China,04-03-2020,429590,2056,649,428941,Western Pacific
China,04-03-2020,292975,1033,601,292374,Western Pacific
China,04-03-2020,200709,1456,21,200688,Western Pacific
China,04-03-2020,426812,694,1250,425562,Western Pacific
China,04-03-2020,319642,2493,954,318688,Western Pacific
China,04-03-2020,49081,2313,174,48907,Western Pacific
China,04-03-2020,446126,307,684,445442,Western Pacific
China,04-03-2020,337044,2488,639,336405,Western Pacific
China,04-03-2020,160707,259,537,160170,Western Pacific
China,04-03-2020,410396,2416,378,410018,Western Pacific
China,04-03-2020,5985,960,117,5868,Western Pacific
China,04-03-2020,311045,1539,791,310254,Western Pacific
China,04-03-2020,342585,1814,933,341652,Western Pacific
China,04-03-2020,354310,2231,12,354298,Western Pacific
China,04-03-2020,265417,411,191,265226,Western Pacific
China,04-03-2020,294874,490,178,294696,Western Pacific
China,04-03-2020,103643,2235,431,103212,Western Pacific
China,04-03-2020,17260,2101,196,17064,Western Pacific
China,04-03-2020,246346,1982,298,246048,Western Pacific
China,04-03-2020,407055,1024,102,406953,Western Pacific
China,04-03-2020,143479,2470,892,142587,Western Pacific
China,04-03-2020,15159,1502,1210,13949,Western Pacific
Colombia,04-03-2020,3342,1619,261,3081,Americas
Congo (Brazzaville),04-03-2020,272146,1368,295,271851,Africa
Congo (Kinshasa),04-03-2020,415077,1003,744,414333,Africa
Costa Rica,04-03-2020,150959,805,265,150694,Americas
Cote d'Ivoire,04-03-2020,332144,1650,111,332033,Africa
Croatia,04-03-2020,110505,202,1062,109443,Europe
Cuba,04-03-2020,45518,2373,306,45212,Americas
Cyprus,04-03-2020,171932,1112,1009,170923,Europe
Czechia,04-03-2020,155388,1014,1237,154151,Europe
Denmark,04-03-2020,55241,1398,50,55191,Europe
Greenland,04-03-2020,407611,1954,924,406687,Europe
Denmark,04-03-2020,214819,184,1231,213588,Europe
Djibouti,04-03-2020,304385,157,40,304345,Eastern Mediterranean
Dominican Republic,04-03-2020,279640,1780,1036,278604,Americas
Ecuador,04-03-2020,208459,2090,754,207705,Americas
Egypt,04-03-2020,248392,284,1183,247209,Eastern Mediterranean
El Salvador,04-03-2020,294834,1462,91,294743,Americas
Equatorial Guinea,04-03-2020,448107,1591,751,447356,Africa
Eritrea,04-03-2020,293545,2335,575,292970,Africa
Estonia,04-03-2020,77111,376,861,76250,Europe
Eswatini,04-03-2020,305634,2296,415,305219,Africa
Ethiopia,04-03-2020,410058,776,395,409663,Africa
Fiji,04-03-2020,195326,2189,291,195035,Western Pacific
Finland,04-03-2020,179234,1847,151,179083,Europe
France,04-03-2020,239745,886,425,239320,Europe
France,04-03-2020,285398,1646,1209,284189,Europe
France,04-03-2020,430146,389,134,430012,Europe
France,04-03-2020,132164,103,551,131613,Europe
France,04-03-2020,338733,687,1020,337713,Europe
France,04-03-2020,436684,497,353,436331,Europe
France,04-03-2020,286834,2086,891,285943,Europe
France,04-03-2020,31960,2333,525,31435,Europe
France,04-03-2020,409778,1887,1233,408545,Europe
France,04-03-2020,264124,2422,514,263610,Europe
Gabon,04-03-2020,310907,2120,940,309967,Africa
Gambia,04-03-2020,411778,2041,887,410891,Africa
Georgia,04-03-2020,93759,520,349,93410,Europe
Germany,04-03-2020,66359,352,1246,65113,Europe
Ghana,04-03-2020,319257,706,116,319141,Africa
Greece,04-03-2020,166169,609,1016,165153,Europe
Guatemala,04-03-2020,358082,1603,181,357901,Americas
Guinea,04-03-2020,175867,517,803,175064,Africa
Guyana,04-03-2020,212903,1886,426,212477,Americas
Haiti,04-03-2020,256026,1549,679,255347,Americas
Holy See,04-03-2020,325420,724,1116,324304,Europe
Honduras,04-03-2020,289860,1527,258,289602,Americas
Hungary,04-03-2020,46110,379,564,45546,Europe
Iceland,04-03-2020,324199,802,862,323337,Europe
India,04-03-2020,205140,2193,318,204822,South-East Asia
Indonesia,04-03-2020,132446,1016,647,131799,South-East Asia
Iran,04-03-2020,71823,2496,661,71162,Eastern Mediterranean
Iraq,04-03-2020,233169,868,1172,231997,Eastern Mediterranean
Ireland,04-03-2020,5875,521,369,5506,Europe
Israel,04-03-2020,34616,1575,183,34433,Europe
Italy,04-03-2020,321686,1867,454,321232,Europe
Jamaica,04-03-2020,36202,1,341,35861,Americas
Japan,04-03-2020,364131,1514,207,363924,Western Pacific
Jordan,04-03-2020,37379,239,865,36514,Eastern Mediterranean
Kazakhstan,04-03-2020,442519,2401,617,441902,Europe
Kenya,04-03-2020,390275,1701,56,390219,Africa
South Korea,04-03-2020,223763,842,230,223533,Western Pacific
Kuwait,04-03-2020,411821,102,1039,410782,Eastern Mediterranean
Kyrgyzstan,04-03-2020,339868,414,344,339524,Europe
Latvia,04-03-2020,97253,15,687,96566,Europe
Lebanon,04-03-2020,58430,442,1108,57322,Eastern Mediterranean
Liberia,04-03-2020,137178,2108,260,136918,Africa
Liechtenstein,04-03-2020,394993,2139,218,394775,Europe
Lithuania,04-03-2020,261923,1080,450,261473,Europe
Luxembourg,04-03-2020,221373,1523,0,221373,Europe
Madagascar,04-03-2020,407540,1590,316,407224,Africa
Malaysia,04-03-2020,38148,2362,651,37497,Western Pacific
Maldives,04-03-2020,225151,947,1079,224072,South-East Asia
Malta,04-03-2020,20897,591,1167,19730,Europe
Mauritania,04-03-2020,52278,463,645,51633,Africa
Mauritius,04-03-2020,28616,2193,554,28062,Africa
Mexico,04-03-2020,38591,2224,282,38309,Americas
Moldova,04-03-2020,303136,1033,5,303131,Europe
Monaco,04-03-2020,39233,1046,1164,38069,Europe
Mongolia,04-03-2020,352208,759,474,351734,Western Pacific
Montenegro,04-03-2020,355447,1242,13,355434,Europe
Morocco,04-03-2020,142074,22,871,141203,Eastern Mediterranean
Namibia,04-03-2020,301396,179,291,301105,Africa
Nepal,04-03-2020,248471,916,30,248441,South-East Asia
Netherlands,04-03-2020,327303,777,1126,326177,Europe
Netherlands,04-03-2020,206527,352,235,206292,Europe
Netherlands,04-03-2020,53412,2039,750,52662,Europe
Netherlands,04-03-2020,302907,1342,928,301979,Europe
New Zealand,04-03-2020,316158,478,334,315824,Western Pacific
Nicaragua,04-03-2020,546,1728,355,191,Americas
Niger,04-03-2020,15273,1294,972,14301,Africa
Nigeria,04-03-2020,284734,1464,31,284703,Africa
North Macedonia,04-03-2020,26635,45,843,25792,Europe
Norway,04-03-2020,430431,2032,1240,429191,Europe
Oman,04-03-2020,384991,1100,1122,383869,Eastern Mediterranean
Pakistan,04-03-2020,143692,330,290,143402,Eastern Mediterranean
Panama,04-03-2020,104064,1335,1165,102899,Americas
Papua New Guinea,04-03-2020,310470,1429,858,309612,Western Pacific
Paraguay,04-03-2020,146575,978,126,146449,Americas
Peru,04-03-2020,134790,1339,220,134570,Americas
Philippines,04-03-2020,336412,2102,112,336300,Western Pacific
Poland,04-03-2020,888,1019,1109,-221,Europe
Portugal,04-03-2020,194428,105,983,193445,Europe
Qatar,04-03-2020,183745,1851,1159,182586,Eastern Mediterranean
Romania,04-03-2020,341326,2292,115,341211,Europe
Russia,04-03-2020,316611,1732,188,316423,Europe
Rwanda,04-03-2020,229364,1050,564,228800,Africa
Saint Lucia,04-03-2020,382129,1144,374,381755,Americas
Saint Vincent and the Grenadines,04-03-2020,386366,1863,141,386225,Americas
San Marino,04-03-2020,130371,1414,123,130248,Europe
Saudi Arabia,04-03-2020,239769,2015,504,239265,Eastern Mediterranean
Senegal,04-03-2020,171832,1813,649,171183,Africa
Serbia,04-03-2020,79801,1446,886,78915,Europe
Seychelles,04-03-2020,154287,1031,59,154228,Africa
Singapore,04-03-2020,195976,2469,947,195029,Western Pacific
Slovakia,04-03-2020,174331,1931,161,174170,Europe
Slovenia,04-03-2020,360413,205,36,360377,Europe
Somalia,04-03-2020,13165,1625,104,13061,Eastern Mediterranean
South Africa,04-03-2020,177727,50,222,177505,Africa
Spain,04-03-2020,158770,2453,374,158396,Europe
Sri Lanka,04-03-2020,352300,1124,738,351562,South-East Asia
Sudan,04-03-2020,256340,555,599,255741,Eastern Mediterranean
Suriname,04-03-2020,391545,1930,430,391115,Americas
Sweden,04-03-2020,62329,1266,858,61471,Europe
Switzerland,04-03-2020,296078,978,124,295954,Europe
Taiwan*,04-03-2020,137836,1157,643,137193,Western Pacific
Tanzania,04-03-2020,110382,2226,1134,109248,Africa
Thailand,04-03-2020,224923,420,521,224402,South-East Asia
Togo,04-03-2020,93646,762,211,93435,Africa
Trinidad and Tobago,04-03-2020,309911,1906,1177,308734,Americas
Tunisia,04-03-2020,84068,2401,1117,82951,Eastern Mediterranean
Turkey,04-03-2020,357955,468,584,357371,Europe
Uganda,04-03-2020,424371,520,310,424061,Africa
Ukraine,04-03-2020,189158,2377,618,188540,Europe
United Arab Emirates,04-03-2020,392450,2378,75,392375,Eastern Mediterranean
United Kingdom,04-03-2020,76146,955,179,75967,Europe
United Kingdom,04-03-2020,221931,1642,25,221906,Europe
United Kingdom,04-03-2020,297570,1813,941,296629,Europe
United Kingdom,04-03-2020,217282,2494,909,216373,Europe
United Kingdom,04-03-2020,31254,476,889,30365,Europe
United Kingdom,04-03-2020,99043,2334,844,98199,Europe
United Kingdom,04-03-2020,164180,194,247,163933,Europe
Uruguay,04-03-2020,226793,1043,135,226658,Americas
US,04-03-2020,262045,756,629,261416,Americas
Uzbekistan,04-03-2020,296414,2271,1091,295323,Europe
Venezuela,04-03-2020,252622,156,1249,251373,Americas
Vietnam,04-03-2020,178769,328,590,178179,Western Pacific
Zambia,04-03-2020,172759,193,519,172240,Africa
Zimbabwe,04-03-2020,64189,1073,732,63457,Africa
Dominica,04-03-2020,336499,1488,12,336487,Americas
Grenada,04-03-2020,63326,388,602,62724,Americas
Mozambique,04-03-2020,329951,2224,644,329307,Africa
Syria,04-03-2020,274622,417,980,273642,Eastern Mediterranean
Timor-Leste,04-03-2020,296911,1789,1090,295821,South-East Asia
Belize,04-03-2020,160430,935,1030,159400,Americas
Laos,04-03-2020,79080,2087,183,78897,Western Pacific
Libya,04-03-2020,294176,2205,1152,293024,Eastern Mediterranean
West Bank and Gaza,04-03-2020,287836,2446,963,286873,Eastern Mediterranean
Guinea-Bissau,04-03-2020,362490,234,395,362095,Africa
Mali,04-03-2020,247256,1647,629,246627,Africa
Saint Kitts and Nevis,04-03-2020,200046,1411,723,199323,Americas
Canada,04-03-2020,78916,886,149,78767,Americas
Canada,04-03-2020,105905,133,200,105705,Americas
Kosovo,04-03-2020,188705,2424,1106,187599,Europe
Burma,04-03-2020,88839,1320,89,88750,South-East Asia
United Kingdom,04-03-2020,11387,2296,342,11045,Europe
United Kingdom,04-03-2020,46286,507,1164,45122,Europe
United Kingdom,04-03-2020,39854,1608,168,39686,Europe
Botswana,04-03-2020,40107,1900,443,39664,Africa
Burundi,04-03-2020,130851,158,488,130363,Africa
Sierra Leone,04-03-2020,375327,2056,1116,374211,Africa
Malawi,04-03-2020,46430,235,20,46410,Africa
United Kingdom,04-03-2020,255735,2429,410,255325,Europe
France,04-03-2020,111309,2424,278,111031,Europe
South Sudan,04-03-2020,325615,1240,877,324738,Africa
Western Sahara,04-03-2020,23439,2477,158,23281,Africa
Sao Tome and Principe,04-03-2020,159209,1206,273,158936,Africa
Yemen,04-03-2020,313286,250,31,313255,Eastern Mediterranean
Comoros,04-03-2020,360338,1741,48,360290,Africa
Tajikistan,04-03-2020,150543,1828,455,150088,Europe
Lesotho,04-03-2020,167613,1311,826,166787,Africa
Afghanistan,05-03-2020,297755,1949,275,297480,Eastern Mediterranean
Albania,05-03-2020,413367,1325,348,413019,Europe
Algeria,05-03-2020,220638,620,981,219657,Africa
Andorra,05-03-2020,422686,306,22,422664,Europe
Angola,05-03-2020,192861,1908,993,191868,Africa
Antigua and Barbuda,05-03-2020,290192,1845,566,289626,Americas
Argentina,05-03-2020,244572,1041,1,244571,Americas
Armenia,05-03-2020,380489,1626,507,379982,Europe
Australia,05-03-2020,9519,2436,896,8623,Western Pacific
Australia,05-03-2020,187028,852,834,186194,Western Pacific
Australia,05-03-2020,33547,137,659,32888,Western Pacific
Australia,05-03-2020,134924,457,1067,133857,Western Pacific
Australia,05-03-2020,404340,1898,215,404125,Western Pacific
Australia,05-03-2020,41907,2228,259,41648,Western Pacific
Australia,05-03-2020,22059,1307,860,21199,Western Pacific
Australia,05-03-2020,70177,748,611,69566,Western Pacific
Austria,05-03-2020,171671,1178,596,171075,Europe
Azerbaijan,05-03-2020,268623,1970,564,268059,Europe
Bahamas,05-03-2020,80792,2245,771,80021,Americas
Bahrain,05-03-2020,371887,1343,1226,370661,Eastern Mediterranean
Bangladesh,05-03-2020,119616,1555,1047,118569,South-East Asia
Barbados,05-03-2020,2769,1002,999,1770,Americas
Belarus,05-03-2020,169344,42,933,168411,Europe
Belgium,05-03-2020,250420,1945,1014,249406,Europe
Benin,05-03-2020,332168,780,274,331894,Africa
Bhutan,05-03-2020,445751,696,182,445569,South-East Asia
Bolivia,05-03-2020,18727,845,455,18272,Americas
Bosnia and Herzegovina,05-03-2020,426987,2260,203,426784,Europe
Brazil,05-03-2020,424596,1504,514,424082,Americas
Brunei,05-03-2020,245834,759,16,245818,Western Pacific
Bulgaria,05-03-2020,329360,723,556,328804,Europe
Burkina Faso,05-03-2020,428504,355,768,427736,Africa
Cabo Verde,05-03-2020,152855,1141,1139,151716,Africa
Cambodia,05-03-2020,301703,1273,683,301020,Western Pacific
Cameroon,05-03-2020,181498,1590,415,181083,Africa
Canada,05-03-2020,366096,2129,990,365106,Americas
Canada,05-03-2020,41690,224,858,40832,Americas
Canada,05-03-2020,224990,1155,619,224371,Americas
Canada,05-03-2020,373052,942,63,372989,Americas
Canada,05-03-2020,5687,2137,134,5553,Americas
Canada,05-03-2020,146535,143,264,146271,Americas
Canada,05-03-2020,244918,422,244,244674,Americas
Canada,05-03-2020,402068,714,134,401934,Americas
Canada,05-03-2020,289710,213,663,289047,Americas
Canada,05-03-2020,212551,975,873,211678,Americas
Central African Republic,05-03-2020,422840,133,170,422670,Africa
Chad,05-03-2020,406811,2220,97,406714,Africa
Chile,05-03-2020,99382,2419,1001,98381,Americas
China,05-03-2020,226137,1834,1114,225023,Western Pacific
China,05-03-2020,67749,1281,765,66984,Western Pacific
China,05-03-2020,201581,1483,117,201464,Western Pacific
China,05-03-2020,254875,1158,20,254855,Western Pacific
China,05-03-2020,300253,1275,799,299454,Western Pacific
China,05-03-2020,187692,960,1184,186508,Western Pacific
China,05-03-2020,365071,532,706,364365,Western Pacific
China,05-03-2020,83483,2471,687,82796,Western Pacific
China,05-03-2020,87134,1341,372,86762,Western Pacific
China,05-03-2020,156242,10,456,155786,Western Pacific
China,05-03-2020,359763,249,802,358961,Western Pacific
China,05-03-2020,147962,537,532,147430,Western Pacific
China,05-03-2020,1631,2378,1226,405,Western Pacific
China,05-03-2020,364868,1068,166,364702,Western Pacific
China,05-03-2020,309090,870,144,308946,Western Pacific
China,05-03-2020,358296,2482,804,357492,Western Pacific
China,05-03-2020,275234,176,315,274919,Western Pacific
China,05-03-2020,320788,2030,1155,319633,Western Pacific
China,05-03-2020,67972,1184,5,67967,Western Pacific
China,05-03-2020,139639,1779,738,138901,Western Pacific
China,05-03-2020,449412,2392,1030,448382,Western Pacific
China,05-03-2020,72112,1658,518,71594,Western Pacific
China,05-03-2020,167910,1814,1053,166857,Western Pacific
China,05-03-2020,406548,121,1093,405455,Western Pacific
China,05-03-2020,399461,2169,92,399369,Western Pacific
China,05-03-2020,373387,2293,633,372754,Western Pacific
China,05-03-2020,292142,1108,867,291275,Western Pacific
China,05-03-2020,389650,188,874,388776,Western Pacific
China,05-03-2020,380226,1938,271,379955,Western Pacific
China,05-03-2020,157460,863,822,156638,Western Pacific
China,05-03-2020,415195,1505,648,414547,Western Pacific
China,05-03-2020,221727,1819,713,221014,Western Pacific
China,05-03-2020,144169,1828,55,144114,Western Pacific
Colombia,05-03-2020,255433,950,1091,254342,Americas
Congo (Brazzaville),05-03-2020,398452,1115,856,397596,Africa
Congo (Kinshasa),05-03-2020,449925,782,724,449201,Africa
Costa Rica,05-03-2020,257612,163,686,256926,Americas
Cote d'Ivoire,05-03-2020,410941,1396,1241,409700,Africa
Croatia,05-03-2020,117176,736,923,116253,Europe
Cuba,05-03-2020,266719,987,999,265720,Americas
Cyprus,05-03-2020,269223,2284,77,269146,Europe
Czechia,05-03-2020,141275,1897,119,141156,Europe
Denmark,05-03-2020,177361,906,919,176442,Europe
Greenland,05-03-2020,24031,1442,688,23343,Europe
Denmark,05-03-2020,174379,2412,156,174223,Europe
Djibouti,05-03-2020,395441,574,453,394988,Eastern Mediterranean
Dominican Republic,05-03-2020,74119,122,567,73552,Americas
Ecuador,05-03-2020,410808,2131,962,409846,Americas
Egypt,05-03-2020,167203,1145,535,166668,Eastern Mediterranean
El Salvador,05-03-2020,390999,1045,376,390623,Americas
Equatorial Guinea,05-03-2020,63961,2169,304,63657,Africa
Eritrea,05-03-2020,251433,190,848,250585,Africa
Estonia,05-03-2020,16228,2297,425,15803,Europe
Eswatini,05-03-2020,37401,1850,525,36876,Africa
Ethiopia,05-03-2020,242123,1238,334,241789,Africa
Fiji,05-03-2020,302749,1461,753,301996,Western Pacific
Finland,05-03-2020,338836,2164,1174,337662,Europe
France,05-03-2020,343501,1399,1018,342483,Europe
France,05-03-2020,235215,1019,1104,234111,Europe
France,05-03-2020,314954,1601,1136,313818,Europe
France,05-03-2020,188881,1882,1050,187831,Europe
France,05-03-2020,101749,1867,73,101676,Europe
France,05-03-2020,234582,2149,1018,233564,Europe
France,05-03-2020,238686,781,689,237997,Europe
France,05-03-2020,173469,926,106,173363,Europe
France,05-03-2020,186647,1798,82,186565,Europe
France,05-03-2020,290475,199,775,289700,Europe
Gabon,05-03-2020,198098,2109,797,197301,Africa
Gambia,05-03-2020,32353,237,1076,31277,Africa
Georgia,05-03-2020,355918,1120,83,355835,Europe
Germany,05-03-2020,299586,811,226,299360,Europe
Ghana,05-03-2020,373745,148,330,373415,Africa
Greece,05-03-2020,363726,2063,149,363577,Europe
Guatemala,05-03-2020,258501,320,1184,257317,Americas
Guinea,05-03-2020,232674,1771,1043,231631,Africa
Guyana,05-03-2020,182068,161,438,181630,Americas
Haiti,05-03-2020,196997,2182,637,196360,Americas
Holy See,05-03-2020,403277,1626,912,402365,Europe
Honduras,05-03-2020,427660,1324,591,427069,Americas
Hungary,05-03-2020,67725,1757,893,66832,Europe
Iceland,05-03-2020,327671,801,335,327336,Europe
India,05-03-2020,430875,2093,488,430387,South-East Asia
Indonesia,05-03-2020,325087,1231,1146,323941,South-East Asia
Iran,05-03-2020,264665,1996,641,264024,Eastern Mediterranean
Iraq,05-03-2020,243866,163,1026,242840,Eastern Mediterranean
Ireland,05-03-2020,422486,12,171,422315,Europe
Israel,05-03-2020,311779,843,839,310940,Europe
Italy,05-03-2020,246817,1990,727,246090,Europe
Jamaica,05-03-2020,415388,2167,763,414625,Americas
Japan,05-03-2020,204005,878,921,203084,Western Pacific
Jordan,05-03-2020,35778,2141,263,35515,Eastern Mediterranean
Kazakhstan,05-03-2020,269439,1797,995,268444,Europe
Kenya,05-03-2020,365157,1344,810,364347,Africa
South Korea,05-03-2020,258421,2422,100,258321,Western Pacific
Kuwait,05-03-2020,369604,2327,642,368962,Eastern Mediterranean
Kyrgyzstan,05-03-2020,279674,1150,1074,278600,Europe
Latvia,05-03-2020,354213,612,1020,353193,Europe
Lebanon,05-03-2020,222253,1632,1120,221133,Eastern Mediterranean
Liberia,05-03-2020,192531,2108,239,192292,Africa
Liechtenstein,05-03-2020,191388,491,269,191119,Europe
Lithuania,05-03-2020,192717,2339,718,191999,Europe
Luxembourg,05-03-2020,50553,2047,471,50082,Europe
Madagascar,05-03-2020,421357,570,1008,420349,Africa
Malaysia,05-03-2020,318582,106,1162,317420,Western Pacific
Maldives,05-03-2020,332365,1488,1062,331303,South-East Asia
Malta,05-03-2020,243065,1423,874,242191,Europe
Mauritania,05-03-2020,118673,1655,565,118108,Africa
Mauritius,05-03-2020,38799,710,672,38127,Africa
Mexico,05-03-2020,46679,374,193,46486,Americas
Moldova,05-03-2020,327463,615,291,327172,Europe
Monaco,05-03-2020,382362,1690,1119,381243,Europe
Mongolia,05-03-2020,290839,2010,634,290205,Western Pacific
Montenegro,05-03-2020,233067,1112,1063,232004,Europe
Morocco,05-03-2020,186416,101,592,185824,Eastern Mediterranean
Namibia,05-03-2020,443272,2309,273,442999,Africa
Nepal,05-03-2020,386577,2014,1022,385555,South-East Asia
Netherlands,05-03-2020,326179,297,162,326017,Europe
Netherlands,05-03-2020,264775,620,308,264467,Europe
Netherlands,05-03-2020,63500,1426,428,63072,Europe
Netherlands,05-03-2020,268762,2293,1209,267553,Europe
New Zealand,05-03-2020,412631,2389,207,412424,Western Pacific
Nicaragua,05-03-2020,258470,1756,902,257568,Americas
Niger,05-03-2020,354365,1385,156,354209,Africa
Nigeria,05-03-2020,400493,1280,1064,399429,Africa
North Macedonia,05-03-2020,150434,1909,511,149923,Europe
Norway,05-03-2020,129976,2083,328,129648,Europe
Oman,05-03-2020,139438,1747,472,138966,Eastern Mediterranean
Pakistan,05-03-2020,390038,2344,219,389819,Eastern Mediterranean
Panama,05-03-2020,373168,1627,899,372269,Americas
Papua New Guinea,05-03-2020,57659,669,922,56737,Western Pacific
Paraguay,05-03-2020,340914,492,497,340417,Americas
Peru,05-03-2020,128986,673,1104,127882,Americas
Philippines,05-03-2020,194332,2134,974,193358,Western Pacific
Poland,05-03-2020,243660,2189,869,242791,Europe
Portugal,05-03-2020,398558,208,568,397990,Europe
Qatar,05-03-2020,301369,1843,628,300741,Eastern Mediterranean
Romania,05-03-2020,328964,636,357,328607,Europe
Russia,05-03-2020,6191,1890,1235,4956,Europe
Rwanda,05-03-2020,245463,1753,691,244772,Africa
Saint Lucia,05-03-2020,1763,973,454,1309,Americas
Saint Vincent and the Grenadines,05-03-2020,136806,79,882,135924,Americas
San Marino,05-03-2020,141373,1420,745,140628,Europe
Saudi Arabia,05-03-2020,365695,394,498,365197,Eastern Mediterranean
Senegal,05-03-2020,93649,1868,233,93416,Africa
Serbia,05-03-2020,382294,1791,1198,381096,Europe
Seychelles,05-03-2020,308318,886,543,307775,Africa
Singapore,05-03-2020,286127,1837,450,285677,Western Pacific
Slovakia,05-03-2020,422841,311,99,422742,Europe
Slovenia,05-03-2020,252870,2310,320,252550,Europe
Somalia,05-03-2020,161380,2148,81,161299,Eastern Mediterranean
South Africa,05-03-2020,401331,437,685,400646,Africa
Spain,05-03-2020,351695,464,343,351352,Europe
Sri Lanka,05-03-2020,117728,1189,596,117132,South-East Asia
Sudan,05-03-2020,201265,1175,1042,200223,Eastern Mediterranean
Suriname,05-03-2020,7248,681,472,6776,Americas
Sweden,05-03-2020,388722,2013,1151,387571,Europe
Switzerland,05-03-2020,210117,1666,473,209644,Europe
Taiwan*,05-03-2020,208656,966,112,208544,Western Pacific
Tanzania,05-03-2020,17459,1298,909,16550,Africa
Thailand,05-03-2020,80044,815,864,79180,South-East Asia
Togo,05-03-2020,19145,807,856,18289,Africa
Trinidad and Tobago,05-03-2020,171659,1855,324,171335,Americas
Tunisia,05-03-2020,396323,1684,251,396072,Eastern Mediterranean
Turkey,05-03-2020,304725,1098,388,304337,Europe
Uganda,05-03-2020,117772,2105,801,116971,Africa
Ukraine,05-03-2020,406847,825,376,406471,Europe
United Arab Emirates,05-03-2020,423503,626,243,423260,Eastern Mediterranean
United Kingdom,05-03-2020,291372,989,992,290380,Europe
United Kingdom,05-03-2020,42476,166,218,42258,Europe
United Kingdom,05-03-2020,396957,1803,848,396109,Europe
United Kingdom,05-03-2020,385129,1058,268,384861,Europe
United Kingdom,05-03-2020,395988,2136,1185,394803,Europe
United Kingdom,05-03-2020,259346,2395,66,259280,Europe
United Kingdom,05-03-2020,416940,1478,637,416303,Europe
Uruguay,05-03-2020,407571,595,406,407165,Americas
US,05-03-2020,207430,193,999,206431,Americas
Uzbekistan,05-03-2020,4899,154,494,4405,Europe
Venezuela,05-03-2020,130983,319,383,130600,Americas
Vietnam,05-03-2020,302841,939,733,302108,Western Pacific
Zambia,05-03-2020,291566,2050,585,290981,Africa
Zimbabwe,05-03-2020,334339,2091,405,333934,Africa
Dominica,05-03-2020,145695,684,991,144704,Americas
Grenada,05-03-2020,13916,473,17,13899,Americas
Mozambique,05-03-2020,171639,151,595,171044,Africa
Syria,05-03-2020,224069,1510,278,223791,Eastern Mediterranean
Timor-Leste,05-03-2020,332787,798,800,331987,South-East Asia
Belize,05-03-2020,306510,2124,209,306301,Americas
Laos,05-03-2020,242938,1607,640,242298,Western Pacific
Libya,05-03-2020,227555,360,1221,226334,Eastern Mediterranean
West Bank and Gaza,05-03-2020,245547,97,939,244608,Eastern Mediterranean
Guinea-Bissau,05-03-2020,283591,2479,966,282625,Africa
Mali,05-03-2020,94114,765,140,93974,Africa
Saint Kitts and Nevis,05-03-2020,234651,2185,449,234202,Americas
Canada,05-03-2020,398714,55,939,397775,Americas
Canada,05-03-2020,239601,922,763,238838,Americas
Kosovo,05-03-2020,278938,993,957,277981,Europe
Burma,05-03-2020,41340,341,624,40716,South-East Asia
United Kingdom,05-03-2020,89055,1434,181,88874,Europe
United Kingdom,05-03-2020,232926,2,1020,231906,Europe
United Kingdom,05-03-2020,226647,1112,591,226056,Europe
Botswana,05-03-2020,410973,886,37,410936,Africa
Burundi,05-03-2020,437753,485,1084,436669,Africa
Sierra Leone,05-03-2020,87334,1313,19,87315,Africa
Malawi,05-03-2020,365121,732,1159,363962,Africa
United Kingdom,05-03-2020,403310,858,889,402421,Europe
France,05-03-2020,152794,2450,529,152265,Europe
South Sudan,05-03-2020,203846,596,1100,202746,Africa
Western Sahara,05-03-2020,238206,437,500,237706,Africa
Sao Tome and Principe,05-03-2020,65763,1806,896,64867,Africa
Yemen,05-03-2020,420997,549,360,420637,Eastern Mediterranean
Comoros,05-03-2020,295088,11,853,294235,Africa
Tajikistan,05-03-2020,198911,2311,403,198508,Europe
Lesotho,05-03-2020,438665,1136,966,437699,Africa
Afghanistan,06-03-2020,278271,986,1,278270,Eastern Mediterranean
Albania,06-03-2020,167346,1854,393,166953,Europe
Algeria,06-03-2020,93442,1265,573,92869,Africa
Andorra,06-03-2020,353247,604,1043,352204,Europe
Angola,06-03-2020,41141,1068,321,40820,Africa
Antigua and Barbuda,06-03-2020,186162,970,463,185699,Americas
Argentina,06-03-2020,363114,962,906,362208,Americas
Armenia,06-03-2020,444446,1239,284,444162,Europe
Australia,06-03-2020,24169,2137,916,23253,Western Pacific
Australia,06-03-2020,66160,1276,1138,65022,Western Pacific
Australia,06-03-2020,25154,650,763,24391,Western Pacific
Australia,06-03-2020,308805,440,473,308332,Western Pacific
Australia,06-03-2020,43827,2007,1014,42813,Western Pacific
Australia,06-03-2020,251867,1357,283,251584,Western Pacific
Australia,06-03-2020,396146,1103,1103,395043,Western Pacific
Australia,06-03-2020,157781,1990,509,157272,Western Pacific
Austria,06-03-2020,92091,1949,1222,90869,Europe
Azerbaijan,06-03-2020,417926,754,633,417293,Europe
Bahamas,06-03-2020,177999,222,218,177781,Americas
Bahrain,06-03-2020,73089,1800,353,72736,Eastern Mediterranean
Bangladesh,06-03-2020,265623,707,1002,264621,South-East Asia
Barbados,06-03-2020,323378,351,457,322921,Americas
Belarus,06-03-2020,30078,1001,480,29598,Europe
Belgium,06-03-2020,393566,2485,155,393411,Europe
Benin,06-03-2020,56944,1514,953,55991,Africa
Bhutan,06-03-2020,177589,1087,730,176859,South-East Asia
Bolivia,06-03-2020,247256,28,938,246318,Americas
Bosnia and Herzegovina,06-03-2020,342184,769,440,341744,Europe
Brazil,06-03-2020,199304,186,986,198318,Americas
Brunei,06-03-2020,17906,2369,1160,16746,Western Pacific
Bulgaria,06-03-2020,893,2158,703,190,Europe
Burkina Faso,06-03-2020,276346,1747,749,275597,Africa
Cabo Verde,06-03-2020,255626,2045,682,254944,Africa
Cambodia,06-03-2020,88583,389,399,88184,Western Pacific
Cameroon,06-03-2020,252360,1146,981,251379,Africa
Canada,06-03-2020,433706,360,617,433089,Americas
Canada,06-03-2020,86254,1852,232,86022,Americas
Canada,06-03-2020,59110,885,406,58704,Americas
Canada,06-03-2020,271786,78,853,270933,Americas
Canada,06-03-2020,282767,816,915,281852,Americas
Canada,06-03-2020,144493,1492,884,143609,Americas
Canada,06-03-2020,221012,87,3,221009,Americas
Canada,06-03-2020,228520,2367,669,227851,Americas
Canada,06-03-2020,177099,757,1027,176072,Americas
Canada,06-03-2020,322118,1503,1005,321113,Americas
Central African Republic,06-03-2020,69852,944,572,69280,Africa
Chad,06-03-2020,167144,106,663,166481,Africa
Chile,06-03-2020,329900,417,658,329242,Americas
China,06-03-2020,371184,1436,1151,370033,Western Pacific
China,06-03-2020,120537,324,895,119642,Western Pacific
China,06-03-2020,436391,1213,47,436344,Western Pacific
China,06-03-2020,306704,665,779,305925,Western Pacific
China,06-03-2020,157284,1224,795,156489,Western Pacific
China,06-03-2020,154145,1297,997,153148,Western Pacific
China,06-03-2020,397370,632,591,396779,Western Pacific
China,06-03-2020,337521,2335,404,337117,Western Pacific
China,06-03-2020,206750,862,559,206191,Western Pacific
China,06-03-2020,3530,193,1203,2327,Western Pacific
China,06-03-2020,317598,2434,95,317503,Western Pacific
China,06-03-2020,4396,1249,733,3663,Western Pacific
China,06-03-2020,194504,2391,271,194233,Western Pacific
China,06-03-2020,187488,1659,769,186719,Western Pacific
China,06-03-2020,22183,1876,49,22134,Western Pacific
China,06-03-2020,138750,1440,299,138451,Western Pacific
China,06-03-2020,292942,1611,909,292033,Western Pacific
China,06-03-2020,139874,1016,724,139150,Western Pacific
China,06-03-2020,345462,740,432,345030,Western Pacific
China,06-03-2020,98511,521,713,97798,Western Pacific
China,06-03-2020,30118,1125,769,29349,Western Pacific
China,06-03-2020,25291,2477,389,24902,Western Pacific
China,06-03-2020,56344,668,1058,55286,Western Pacific
China,06-03-2020,305632,2142,13,305619,Western Pacific
China,06-03-2020,250702,2315,135,250567,Western Pacific
China,06-03-2020,20982,527,594,20388,Western Pacific
China,06-03-2020,129392,1293,173,129219,Western Pacific
China,06-03-2020,147653,1283,1187,146466,Western Pacific
China,06-03-2020,214674,570,450,214224,Western Pacific
China,06-03-2020,348655,479,795,347860,Western Pacific
China,06-03-2020,130269,2464,467,129802,Western Pacific
China,06-03-2020,189298,958,775,188523,Western Pacific
China,06-03-2020,220244,2417,856,219388,Western Pacific
Colombia,06-03-2020,380907,2062,639,380268,Americas
Congo (Brazzaville),06-03-2020,248475,604,743,247732,Africa
Congo (Kinshasa),06-03-2020,401422,1407,422,401000,Africa
Costa Rica,06-03-2020,254998,403,55,254943,Americas
Cote d'Ivoire,06-03-2020,402204,1696,549,401655,Africa
Croatia,06-03-2020,286777,1304,80,286697,Europe
Cuba,06-03-2020,435160,2419,683,434477,Americas
Cyprus,06-03-2020,418137,1540,575,417562,Europe
Czechia,06-03-2020,38845,1589,101,38744,Europe
Denmark,06-03-2020,332241,1331,934,331307,Europe
Greenland,06-03-2020,3261,647,265,2996,Europe
Denmark,06-03-2020,378322,2003,199,378123,Europe
Djibouti,06-03-2020,96141,898,391,95750,Eastern Mediterranean
Dominican Republic,06-03-2020,114223,2384,1202,113021,Americas
Ecuador,06-03-2020,11351,878,255,11096,Americas
Egypt,06-03-2020,374214,722,531,373683,Eastern Mediterranean
El Salvador,06-03-2020,192517,287,258,192259,Americas
Equatorial Guinea,06-03-2020,34727,2205,926,33801,Africa
Eritrea,06-03-2020,70798,581,1234,69564,Africa
Estonia,06-03-2020,249515,268,183,249332,Europe
Eswatini,06-03-2020,114575,1188,259,114316,Africa
Ethiopia,06-03-2020,94852,855,1210,93642,Africa
Fiji,06-03-2020,190512,1981,717,189795,Western Pacific
Finland,06-03-2020,131376,1575,162,131214,Europe
France,06-03-2020,294673,261,585,294088,Europe
France,06-03-2020,404252,34,1087,403165,Europe
France,06-03-2020,392099,1627,294,391805,Europe
France,06-03-2020,158382,1411,1241,157141,Europe
France,06-03-2020,11449,1613,463,10986,Europe
France,06-03-2020,62582,625,698,61884,Europe
France,06-03-2020,26125,1293,525,25600,Europe
France,06-03-2020,118422,999,294,118128,Europe
France,06-03-2020,275265,2129,572,274693,Europe
France,06-03-2020,265102,2138,906,264196,Europe
Gabon,06-03-2020,289531,1081,67,289464,Africa
Gambia,06-03-2020,232458,1321,922,231536,Africa
Georgia,06-03-2020,18273,1795,1207,17066,Europe
Germany,06-03-2020,292060,232,463,291597,Europe
Ghana,06-03-2020,110148,270,298,109850,Africa
Greece,06-03-2020,246745,1991,926,245819,Europe
Guatemala,06-03-2020,372295,1151,666,371629,Americas
Guinea,06-03-2020,220095,1896,864,219231,Africa
Guyana,06-03-2020,98416,2366,1094,97322,Americas
Haiti,06-03-2020,505,164,314,191,Americas
Holy See,06-03-2020,295923,321,631,295292,Europe
Honduras,06-03-2020,209849,1946,503,209346,Americas
Hungary,06-03-2020,99204,157,26,99178,Europe
Iceland,06-03-2020,317260,274,510,316750,Europe
India,06-03-2020,261879,1146,147,261732,South-East Asia
Indonesia,06-03-2020,301443,1116,966,300477,South-East Asia
Iran,06-03-2020,91971,826,559,91412,Eastern Mediterranean
Iraq,06-03-2020,198448,2080,147,198301,Eastern Mediterranean
Ireland,06-03-2020,71462,1708,484,70978,Europe
Israel,06-03-2020,433596,322,212,433384,Europe
Italy,06-03-2020,70937,1977,426,70511,Europe
Jamaica,06-03-2020,106095,1716,20,106075,Americas
Japan,06-03-2020,399471,1,272,399199,Western Pacific
Jordan,06-03-2020,102853,2241,1012,101841,Eastern Mediterranean
Kazakhstan,06-03-2020,130017,1541,863,129154,Europe
Kenya,06-03-2020,236906,2445,721,236185,Africa
South Korea,06-03-2020,292311,1998,1179,291132,Western Pacific
Kuwait,06-03-2020,330330,187,610,329720,Eastern Mediterranean
Kyrgyzstan,06-03-2020,127070,561,1084,125986,Europe
Latvia,06-03-2020,201393,1115,576,200817,Europe
Lebanon,06-03-2020,370089,302,594,369495,Eastern Mediterranean
Liberia,06-03-2020,206416,961,1142,205274,Africa
Liechtenstein,06-03-2020,308981,723,551,308430,Europe
Lithuania,06-03-2020,303141,1169,744,302397,Europe
Luxembourg,06-03-2020,165793,579,134,165659,Europe
Madagascar,06-03-2020,50081,349,663,49418,Africa
Malaysia,06-03-2020,188181,1853,227,187954,Western Pacific
Maldives,06-03-2020,63652,1080,563,63089,South-East Asia
Malta,06-03-2020,172380,602,158,172222,Europe
Mauritania,06-03-2020,440263,331,321,439942,Africa
Mauritius,06-03-2020,414202,1327,711,413491,Africa
Mexico,06-03-2020,250851,850,144,250707,Americas
Moldova,06-03-2020,398172,1739,224,397948,Europe
Monaco,06-03-2020,28805,495,1167,27638,Europe
Mongolia,06-03-2020,61443,89,127,61316,Western Pacific
Montenegro,06-03-2020,301978,284,197,301781,Europe
Morocco,06-03-2020,206494,63,710,205784,Eastern Mediterranean
Namibia,06-03-2020,44396,2021,157,44239,Africa
Nepal,06-03-2020,292269,258,397,291872,South-East Asia
Netherlands,06-03-2020,270569,1736,505,270064,Europe
Netherlands,06-03-2020,423020,447,791,422229,Europe
Netherlands,06-03-2020,353692,188,1000,352692,Europe
Netherlands,06-03-2020,337947,23,118,337829,Europe
New Zealand,06-03-2020,420526,404,364,420162,Western Pacific
Nicaragua,06-03-2020,418603,785,801,417802,Americas
Niger,06-03-2020,298802,2156,982,297820,Africa
Nigeria,06-03-2020,212500,1269,635,211865,Africa
North Macedonia,06-03-2020,402179,1051,386,401793,Europe
Norway,06-03-2020,156536,1150,978,155558,Europe
Oman,06-03-2020,73602,1766,194,73408,Eastern Mediterranean
Pakistan,06-03-2020,376106,458,749,375357,Eastern Mediterranean
Panama,06-03-2020,17370,793,1036,16334,Americas
Papua New Guinea,06-03-2020,274238,633,907,273331,Western Pacific
Paraguay,06-03-2020,379367,364,1090,378277,Americas
Peru,06-03-2020,37421,1148,672,36749,Americas
Philippines,06-03-2020,149753,1901,58,149695,Western Pacific
Poland,06-03-2020,52801,1944,107,52694,Europe
Portugal,06-03-2020,305682,1517,247,305435,Europe
Qatar,06-03-2020,265166,1307,452,264714,Eastern Mediterranean
Romania,06-03-2020,90234,398,589,89645,Europe
Russia,06-03-2020,80400,2368,1160,79240,Europe
Rwanda,06-03-2020,118361,2128,1053,117308,Africa
Saint Lucia,06-03-2020,313326,205,1108,312218,Americas
Saint Vincent and the Grenadines,06-03-2020,388677,198,829,387848,Americas
San Marino,06-03-2020,394887,2109,129,394758,Europe
Saudi Arabia,06-03-2020,283553,705,238,283315,Eastern Mediterranean
Senegal,06-03-2020,300400,1503,1168,299232,Africa
Serbia,06-03-2020,106977,829,1131,105846,Europe
Seychelles,06-03-2020,37016,104,1196,35820,Africa
Singapore,06-03-2020,306767,593,170,306597,Western Pacific
Slovakia,06-03-2020,37772,2211,1072,36700,Europe
Slovenia,06-03-2020,20747,982,356,20391,Europe
Somalia,06-03-2020,307707,2492,851,306856,Eastern Mediterranean
South Africa,06-03-2020,184303,1861,143,184160,Africa
Spain,06-03-2020,28109,2326,373,27736,Europe
Sri Lanka,06-03-2020,325481,1439,1075,324406,South-East Asia
Sudan,06-03-2020,93138,1749,1178,91960,Eastern Mediterranean
Suriname,06-03-2020,387054,1617,117,386937,Americas
Sweden,06-03-2020,360318,1517,908,359410,Europe
Switzerland,06-03-2020,353081,965,54,353027,Europe
Taiwan*,06-03-2020,81333,454,1089,80244,Western Pacific
Tanzania,06-03-2020,297290,2200,660,296630,Africa
Thailand,06-03-2020,94777,1413,869,93908,South-East Asia
Togo,06-03-2020,94157,178,601,93556,Africa
Trinidad and Tobago,06-03-2020,290991,942,116,290875,Americas
Tunisia,06-03-2020,22214,2176,38,22176,Eastern Mediterranean
Turkey,06-03-2020,146522,954,895,145627,Europe
Uganda,06-03-2020,69287,322,248,69039,Africa
Ukraine,06-03-2020,444762,1898,179,444583,Europe
United Arab Emirates,06-03-2020,373774,1863,471,373303,Eastern Mediterranean
United Kingdom,06-03-2020,183198,1430,6,183192,Europe
United Kingdom,06-03-2020,339296,1534,911,338385,Europe
United Kingdom,06-03-2020,216892,1972,971,215921,Europe
United Kingdom,06-03-2020,398789,2309,273,398516,Europe
United Kingdom,06-03-2020,86452,2412,1007,85445,Europe
United Kingdom,06-03-2020,213914,985,171,213743,Europe
United Kingdom,06-03-2020,324300,457,927,323373,Europe
Uruguay,06-03-2020,351733,425,229,351504,Americas
US,06-03-2020,292504,1962,721,291783,Americas
Uzbekistan,06-03-2020,297337,637,879,296458,Europe
Venezuela,06-03-2020,261765,1363,1234,260531,Americas
Vietnam,06-03-2020,448429,1433,715,447714,Western Pacific
Zambia,06-03-2020,307063,1629,584,306479,Africa
Zimbabwe,06-03-2020,137522,1110,57,137465,Africa
Dominica,06-03-2020,135129,1691,603,134526,Americas
Grenada,06-03-2020,172460,30,328,172132,Americas
Mozambique,06-03-2020,62856,312,687,62169,Africa
Syria,06-03-2020,140929,2027,43,140886,Eastern Mediterranean
Timor-Leste,06-03-2020,91343,1829,1135,90208,South-East Asia
Belize,06-03-2020,200076,644,1227,198849,Americas
Laos,06-03-2020,36186,2201,928,35258,Western Pacific
Libya,06-03-2020,222357,1309,1064,221293,Eastern Mediterranean
West Bank and Gaza,06-03-2020,432038,672,616,431422,Eastern Mediterranean
Guinea-Bissau,06-03-2020,316891,2050,987,315904,Africa
Mali,06-03-2020,145090,704,207,144883,Africa
Saint Kitts and Nevis,06-03-2020,421783,626,329,421454,Americas
Canada,06-03-2020,346937,1249,1232,345705,Americas
Canada,06-03-2020,126376,1057,244,126132,Americas
Kosovo,06-03-2020,43887,835,947,42940,Europe
Burma,06-03-2020,189822,117,326,189496,South-East Asia
United Kingdom,06-03-2020,315593,102,985,314608,Europe
United Kingdom,06-03-2020,235854,1715,202,235652,Europe
United Kingdom,06-03-2020,356850,1692,601,356249,Europe
Botswana,06-03-2020,166066,1316,770,165296,Africa
Burundi,06-03-2020,208268,96,602,207666,Africa
Sierra Leone,06-03-2020,41750,2479,541,41209,Africa
Malawi,06-03-2020,181516,1327,503,181013,Africa
United Kingdom,06-03-2020,160285,2312,655,159630,Europe
France,06-03-2020,268748,2115,274,268474,Europe
South Sudan,06-03-2020,351027,678,568,350459,Africa
Western Sahara,06-03-2020,400717,446,515,400202,Africa
Sao Tome and Principe,06-03-2020,7290,1035,420,6870,Africa
Yemen,06-03-2020,163723,685,681,163042,Eastern Mediterranean
Comoros,06-03-2020,74544,2038,726,73818,Africa
Tajikistan,06-03-2020,108077,699,590,107487,Europe
Lesotho,06-03-2020,418231,1273,467,417764,Africa
Afghanistan,07-03-2020,6458,1052,52,6406,Eastern Mediterranean
Albania,07-03-2020,58615,1558,704,57911,Europe
Algeria,07-03-2020,53945,6,13,53932,Africa
Andorra,07-03-2020,336918,1704,1056,335862,Europe
Angola,07-03-2020,326119,751,597,325522,Africa
Antigua and Barbuda,07-03-2020,164359,2377,732,163627,Americas
Argentina,07-03-2020,10589,132,622,9967,Americas
Armenia,07-03-2020,412167,944,685,411482,Europe
Australia,07-03-2020,229756,2308,136,229620,Western Pacific
Australia,07-03-2020,410361,2194,442,409919,Western Pacific
Australia,07-03-2020,127661,850,96,127565,Western Pacific
Australia,07-03-2020,348754,874,427,348327,Western Pacific
Australia,07-03-2020,234070,1467,240,233830,Western Pacific
Australia,07-03-2020,134752,1421,802,133950,Western Pacific
Australia,07-03-2020,351711,2,704,351007,Western Pacific
Australia,07-03-2020,325921,707,977,324944,Western Pacific
Austria,07-03-2020,240906,586,623,240283,Europe
Azerbaijan,07-03-2020,13444,1118,679,12765,Europe
Bahamas,07-03-2020,327732,461,1002,326730,Americas
Bahrain,07-03-2020,274269,1767,1032,273237,Eastern Mediterranean
Bangladesh,07-03-2020,400845,2244,72,400773,South-East Asia
Barbados,07-03-2020,367335,976,1202,366133,Americas
Belarus,07-03-2020,135556,988,494,135062,Europe
Belgium,07-03-2020,110439,1395,989,109450,Europe
Benin,07-03-2020,366398,1108,877,365521,Africa
Bhutan,07-03-2020,75127,468,417,74710,South-East Asia
Bolivia,07-03-2020,258879,347,334,258545,Americas
Bosnia and Herzegovina,07-03-2020,308580,937,155,308425,Europe
Brazil,07-03-2020,40137,1095,821,39316,Americas
Brunei,07-03-2020,290777,1178,1194,289583,Western Pacific
Bulgaria,07-03-2020,398686,1368,546,398140,Europe
Burkina Faso,07-03-2020,68314,230,642,67672,Africa
Cabo Verde,07-03-2020,367992,382,88,367904,Africa
Cambodia,07-03-2020,139547,1901,497,139050,Western Pacific
Cameroon,07-03-2020,220234,138,954,219280,Africa
Canada,07-03-2020,123305,101,938,122367,Americas
Canada,07-03-2020,265088,2002,496,264592,Americas
Canada,07-03-2020,383762,1177,1008,382754,Americas
Canada,07-03-2020,101391,383,768,100623,Americas
Canada,07-03-2020,217360,1014,23,217337,Americas
Canada,07-03-2020,414707,2361,128,414579,Americas
Canada,07-03-2020,432033,1025,1007,431026,Americas
Canada,07-03-2020,410347,1047,971,409376,Americas
Canada,07-03-2020,18198,1188,1200,16998,Americas
Canada,07-03-2020,149934,364,184,149750,Americas
Central African Republic,07-03-2020,154366,404,950,153416,Africa
Chad,07-03-2020,307226,1186,610,306616,Africa
Chile,07-03-2020,281520,2441,196,281324,Americas
China,07-03-2020,360484,2399,81,360403,Western Pacific
China,07-03-2020,191678,1724,1115,190563,Western Pacific
China,07-03-2020,413118,1896,417,412701,Western Pacific
China,07-03-2020,73694,1015,581,73113,Western Pacific
China,07-03-2020,329173,2335,1125,328048,Western Pacific
China,07-03-2020,393854,1816,142,393712,Western Pacific
China,07-03-2020,404717,1173,115,404602,Western Pacific
China,07-03-2020,161211,91,517,160694,Western Pacific
China,07-03-2020,206732,107,312,206420,Western Pacific
China,07-03-2020,409767,238,919,408848,Western Pacific
China,07-03-2020,364673,46,1003,363670,Western Pacific
China,07-03-2020,12790,1557,963,11827,Western Pacific
China,07-03-2020,140757,1130,301,140456,Western Pacific
China,07-03-2020,238922,1763,1168,237754,Western Pacific
China,07-03-2020,147236,2411,273,146963,Western Pacific
China,07-03-2020,63467,1289,875,62592,Western Pacific
China,07-03-2020,142762,540,677,142085,Western Pacific
China,07-03-2020,174269,2043,359,173910,Western Pacific
China,07-03-2020,258095,2096,788,257307,Western Pacific
China,07-03-2020,394662,173,859,393803,Western Pacific
China,07-03-2020,58543,1371,1080,57463,Western Pacific
China,07-03-2020,266489,317,64,266425,Western Pacific
China,07-03-2020,182426,2162,119,182307,Western Pacific
China,07-03-2020,332602,690,53,332549,Western Pacific
China,07-03-2020,435807,1210,960,434847,Western Pacific
China,07-03-2020,39278,1505,1017,38261,Western Pacific
China,07-03-2020,401479,797,583,400896,Western Pacific
China,07-03-2020,217250,1269,917,216333,Western Pacific
China,07-03-2020,234791,903,507,234284,Western Pacific
China,07-03-2020,157516,1724,692,156824,Western Pacific
China,07-03-2020,308942,898,345,308597,Western Pacific
China,07-03-2020,363643,1904,12,363631,Western Pacific
China,07-03-2020,93573,924,1197,92376,Western Pacific
Colombia,07-03-2020,326205,1689,1038,325167,Americas
Congo (Brazzaville),07-03-2020,191717,1432,659,191058,Africa
Congo (Kinshasa),07-03-2020,46287,750,976,45311,Africa
Costa Rica,07-03-2020,101395,647,408,100987,Americas
Cote d'Ivoire,07-03-2020,230510,446,366,230144,Africa
Croatia,07-03-2020,42554,1180,225,42329,Europe
Cuba,07-03-2020,107998,1810,813,107185,Americas
Cyprus,07-03-2020,314590,0,341,314249,Europe
Czechia,07-03-2020,193414,2080,354,193060,Europe
Denmark,07-03-2020,248168,1052,1007,247161,Europe
Greenland,07-03-2020,103095,528,616,102479,Europe
Denmark,07-03-2020,157949,361,1088,156861,Europe
Djibouti,07-03-2020,432783,232,965,431818,Eastern Mediterranean
Dominican Republic,07-03-2020,379350,1971,244,379106,Americas
Ecuador,07-03-2020,374300,611,1156,373144,Americas
Egypt,07-03-2020,152205,706,533,151672,Eastern Mediterranean
El Salvador,07-03-2020,19607,2170,165,19442,Americas
Equatorial Guinea,07-03-2020,314552,2098,1133,313419,Africa
Eritrea,07-03-2020,130462,2160,1108,129354,Africa
Estonia,07-03-2020,215298,112,1181,214117,Europe
Eswatini,07-03-2020,193004,1195,1241,191763,Africa
Ethiopia,07-03-2020,116845,1958,1143,115702,Africa
Fiji,07-03-2020,346663,1725,595,346068,Western Pacific
Finland,07-03-2020,83096,1187,339,82757,Europe
France,07-03-2020,267603,2402,345,267258,Europe
France,07-03-2020,213786,1414,1236,212550,Europe
France,07-03-2020,326879,605,791,326088,Europe
France,07-03-2020,88060,1982,453,87607,Europe
France,07-03-2020,43236,747,919,42317,Europe
France,07-03-2020,264368,2375,1172,263196,Europe
France,07-03-2020,296833,1282,588,296245,Europe
France,07-03-2020,245480,223,658,244822,Europe
France,07-03-2020,235420,1189,512,234908,Europe
France,07-03-2020,407615,1303,974,406641,Europe
Gabon,07-03-2020,265936,1298,507,265429,Africa
Gambia,07-03-2020,169845,1467,852,168993,Africa
Georgia,07-03-2020,143849,1388,32,143817,Europe
Germany,07-03-2020,414118,837,797,413321,Europe
Ghana,07-03-2020,47317,1473,356,46961,Africa
Greece,07-03-2020,70087,1958,549,69538,Europe
Guatemala,07-03-2020,33141,2498,1068,32073,Americas
Guinea,07-03-2020,244521,232,814,243707,Africa
Guyana,07-03-2020,308386,504,225,308161,Americas
Haiti,07-03-2020,25786,2050,276,25510,Americas
Holy See,07-03-2020,768,986,605,163,Europe
Honduras,07-03-2020,275832,1990,495,275337,Americas
Hungary,07-03-2020,402637,634,1057,401580,Europe
Iceland,07-03-2020,192410,1637,484,191926,Europe
India,07-03-2020,404409,535,298,404111,South-East Asia
Indonesia,07-03-2020,42599,1276,171,42428,South-East Asia
Iran,07-03-2020,354516,1783,1201,353315,Eastern Mediterranean
Iraq,07-03-2020,408386,1722,595,407791,Eastern Mediterranean
Ireland,07-03-2020,106341,1930,486,105855,Europe
Israel,07-03-2020,79444,425,1216,78228,Europe
Italy,07-03-2020,294418,952,1002,293416,Europe
Jamaica,07-03-2020,321341,143,808,320533,Americas
Japan,07-03-2020,297928,2393,835,297093,Western Pacific
Jordan,07-03-2020,140447,1808,820,139627,Eastern Mediterranean
Kazakhstan,07-03-2020,403973,624,361,403612,Europe
Kenya,07-03-2020,97942,2271,1181,96761,Africa
South Korea,07-03-2020,230610,1333,1234,229376,Western Pacific
Kuwait,07-03-2020,136952,1705,297,136655,Eastern Mediterranean
Kyrgyzstan,07-03-2020,190006,842,123,189883,Europe
Latvia,07-03-2020,444327,1777,401,443926,Europe
Lebanon,07-03-2020,189285,1865,403,188882,Eastern Mediterranean
Liberia,07-03-2020,358386,1559,1147,357239,Africa
Liechtenstein,07-03-2020,276461,1780,692,275769,Europe
Lithuania,07-03-2020,109518,1739,735,108783,Europe
Luxembourg,07-03-2020,169343,1135,248,169095,Europe
Madagascar,07-03-2020,436773,33,712,436061,Africa
Malaysia,07-03-2020,8574,1018,1197,7377,Western Pacific
Maldives,07-03-2020,429043,153,1032,428011,South-East Asia
Malta,07-03-2020,174183,284,1190,172993,Europe
Mauritania,07-03-2020,406970,2382,974,405996,Africa
Mauritius,07-03-2020,11008,337,713,10295,Africa
Mexico,07-03-2020,419992,2173,761,419231,Americas
Moldova,07-03-2020,158859,260,564,158295,Europe
Monaco,07-03-2020,337211,1370,315,336896,Europe
Mongolia,07-03-2020,202818,2061,1138,201680,Western Pacific
Montenegro,07-03-2020,298555,1379,1143,297412,Europe
Morocco,07-03-2020,118472,822,326,118146,Eastern Mediterranean
Namibia,07-03-2020,150904,1228,1018,149886,Africa
Nepal,07-03-2020,95408,323,180,95228,South-East Asia
Netherlands,07-03-2020,233438,577,1095,232343,Europe
Netherlands,07-03-2020,276399,2210,828,275571,Europe
Netherlands,07-03-2020,277571,1314,181,277390,Europe
Netherlands,07-03-2020,358602,184,157,358445,Europe
New Zealand,07-03-2020,432397,2483,1108,431289,Western Pacific
Nicaragua,07-03-2020,25387,599,267,25120,Americas
Niger,07-03-2020,39340,1704,685,38655,Africa
Nigeria,07-03-2020,232801,1655,1048,231753,Africa
North Macedonia,07-03-2020,123482,2052,399,123083,Europe
Norway,07-03-2020,110095,1225,1074,109021,Europe
Oman,07-03-2020,311276,1771,629,310647,Eastern Mediterranean
Pakistan,07-03-2020,359094,1785,124,358970,Eastern Mediterranean
Panama,07-03-2020,399588,1271,928,398660,Americas
Papua New Guinea,07-03-2020,167509,1448,1071,166438,Western Pacific
Paraguay,07-03-2020,171337,880,832,170505,Americas
Peru,07-03-2020,338307,120,737,337570,Americas
Philippines,07-03-2020,317545,1014,159,317386,Western Pacific
Poland,07-03-2020,122485,2478,25,122460,Europe
Portugal,07-03-2020,197470,1240,497,196973,Europe
Qatar,07-03-2020,244160,497,611,243549,Eastern Mediterranean
Romania,07-03-2020,287235,13,1030,286205,Europe
Russia,07-03-2020,60513,1105,576,59937,Europe
Rwanda,07-03-2020,79599,424,330,79269,Africa
Saint Lucia,07-03-2020,81846,2139,456,81390,Americas
Saint Vincent and the Grenadines,07-03-2020,402304,752,660,401644,Americas
San Marino,07-03-2020,37482,2332,1216,36266,Europe
Saudi Arabia,07-03-2020,168775,14,110,168665,Eastern Mediterranean
Senegal,07-03-2020,299118,1815,206,298912,Africa
Serbia,07-03-2020,322197,777,498,321699,Europe
Seychelles,07-03-2020,380913,1861,791,380122,Africa
Singapore,07-03-2020,360826,150,12,360814,Western Pacific
Slovakia,07-03-2020,362150,1493,42,362108,Europe
Slovenia,07-03-2020,233683,2449,415,233268,Europe
Somalia,07-03-2020,104381,1336,612,103769,Eastern Mediterranean
South Africa,07-03-2020,287469,443,1231,286238,Africa
Spain,07-03-2020,27632,1926,309,27323,Europe
Sri Lanka,07-03-2020,144175,1163,247,143928,South-East Asia
Sudan,07-03-2020,294079,1060,17,294062,Eastern Mediterranean
Suriname,07-03-2020,238479,719,492,237987,Americas
Sweden,07-03-2020,132556,2311,22,132534,Europe
Switzerland,07-03-2020,57550,2238,789,56761,Europe
Taiwan*,07-03-2020,201605,1260,330,201275,Western Pacific
Tanzania,07-03-2020,119100,2473,531,118569,Africa
Thailand,07-03-2020,247516,1142,1100,246416,South-East Asia
Togo,07-03-2020,102375,1078,741,101634,Africa
Trinidad and Tobago,07-03-2020,289535,2398,717,288818,Americas
Tunisia,07-03-2020,47387,721,108,47279,Eastern Mediterranean
Turkey,07-03-2020,394861,1474,412,394449,Europe
Uganda,07-03-2020,354218,259,737,353481,Africa
Ukraine,07-03-2020,153994,2342,887,153107,Europe
United Arab Emirates,07-03-2020,197829,2469,989,196840,Eastern Mediterranean
United Kingdom,07-03-2020,413951,1274,250,413701,Europe
United Kingdom,07-03-2020,398907,600,1126,397781,Europe
United Kingdom,07-03-2020,153928,1542,123,153805,Europe
United Kingdom,07-03-2020,244984,2105,428,244556,Europe
United Kingdom,07-03-2020,383357,2284,1003,382354,Europe
United Kingdom,07-03-2020,176483,1821,59,176424,Europe
United Kingdom,07-03-2020,349090,1705,382,348708,Europe
Uruguay,07-03-2020,428317,869,592,427725,Americas
US,07-03-2020,4877,2212,613,4264,Americas
Uzbekistan,07-03-2020,284739,2407,354,284385,Europe
Venezuela,07-03-2020,63489,301,885,62604,Americas
Vietnam,07-03-2020,413443,1405,835,412608,Western Pacific
Zambia,07-03-2020,337106,501,943,336163,Africa
Zimbabwe,07-03-2020,316382,462,866,315516,Africa
Dominica,07-03-2020,346519,1188,139,346380,Americas
Grenada,07-03-2020,154209,753,834,153375,Americas
Mozambique,07-03-2020,8966,1885,23,8943,Africa
Syria,07-03-2020,13936,870,368,13568,Eastern Mediterranean
Timor-Leste,07-03-2020,286702,110,1149,285553,South-East Asia
Belize,07-03-2020,233027,613,193,232834,Americas
Laos,07-03-2020,268461,127,424,268037,Western Pacific
Libya,07-03-2020,249392,884,558,248834,Eastern Mediterranean
West Bank and Gaza,07-03-2020,348327,1983,1165,347162,Eastern Mediterranean
Guinea-Bissau,07-03-2020,185956,372,1028,184928,Africa
Mali,07-03-2020,419262,989,97,419165,Africa
Saint Kitts and Nevis,07-03-2020,198904,661,378,198526,Americas
Canada,07-03-2020,158798,1195,348,158450,Americas
Canada,07-03-2020,164202,489,1180,163022,Americas
Kosovo,07-03-2020,211743,226,505,211238,Europe
Burma,07-03-2020,83998,1951,1133,82865,South-East Asia
United Kingdom,07-03-2020,374327,1551,1015,373312,Europe
United Kingdom,07-03-2020,242338,2351,1220,241118,Europe
United Kingdom,07-03-2020,214847,343,241,214606,Europe
Botswana,07-03-2020,390290,714,258,390032,Africa
Burundi,07-03-2020,312719,2376,375,312344,Africa
Sierra Leone,07-03-2020,393302,1548,773,392529,Africa
Malawi,07-03-2020,387116,449,975,386141,Africa
United Kingdom,07-03-2020,90169,1012,472,89697,Europe
France,07-03-2020,156063,1750,884,155179,Europe
South Sudan,07-03-2020,321113,2119,885,320228,Africa
Western Sahara,07-03-2020,330889,1275,290,330599,Africa
Sao Tome and Principe,07-03-2020,302873,2295,1046,301827,Africa
Yemen,07-03-2020,449765,50,1019,448746,Eastern Mediterranean
Comoros,07-03-2020,388940,2483,539,388401,Africa
Tajikistan,07-03-2020,188397,2367,1003,187394,Europe
Lesotho,07-03-2020,328794,2250,956,327838,Africa
Afghanistan,08-03-2020,426239,1633,680,425559,Eastern Mediterranean
Albania,08-03-2020,14848,1534,52,14796,Europe
Algeria,08-03-2020,414668,1506,11,414657,Africa
Andorra,08-03-2020,109245,1694,296,108949,Europe
Angola,08-03-2020,154039,1378,205,153834,Africa
Antigua and Barbuda,08-03-2020,8287,235,403,7884,Americas
Argentina,08-03-2020,407481,937,334,407147,Americas
Armenia,08-03-2020,394535,742,441,394094,Europe
Australia,08-03-2020,318052,1183,919,317133,Western Pacific
Australia,08-03-2020,94994,1425,1198,93796,Western Pacific
Australia,08-03-2020,126832,445,191,126641,Western Pacific
Australia,08-03-2020,180957,646,344,180613,Western Pacific
Australia,08-03-2020,247289,1584,981,246308,Western Pacific
Australia,08-03-2020,356912,2462,1241,355671,Western Pacific
Australia,08-03-2020,371779,126,529,371250,Western Pacific
Australia,08-03-2020,373106,126,192,372914,Western Pacific
Austria,08-03-2020,194623,1271,771,193852,Europe
Azerbaijan,08-03-2020,18492,370,450,18042,Europe
Bahamas,08-03-2020,33582,1120,42,33540,Americas
Bahrain,08-03-2020,14346,1320,171,14175,Eastern Mediterranean
Bangladesh,08-03-2020,364724,1388,761,363963,South-East Asia
Barbados,08-03-2020,1656,2485,1072,584,Americas
Belarus,08-03-2020,21145,796,1069,20076,Europe
Belgium,08-03-2020,445069,1290,509,444560,Europe
Benin,08-03-2020,179765,520,1052,178713,Africa
Bhutan,08-03-2020,121371,84,60,121311,South-East Asia
Bolivia,08-03-2020,3083,1771,168,2915,Americas
Bosnia and Herzegovina,08-03-2020,321572,2402,832,320740,Europe
Brazil,08-03-2020,390728,2260,689,390039,Americas
Brunei,08-03-2020,277543,815,167,277376,Western Pacific
Bulgaria,08-03-2020,320260,795,661,319599,Europe
Burkina Faso,08-03-2020,207391,2348,484,206907,Africa
Cabo Verde,08-03-2020,113693,128,312,113381,Africa
Cambodia,08-03-2020,219685,1198,1088,218597,Western Pacific
Cameroon,08-03-2020,407035,148,353,406682,Africa
Canada,08-03-2020,101292,914,107,101185,Americas
Canada,08-03-2020,226139,251,161,225978,Americas
Canada,08-03-2020,429430,785,470,428960,Americas
Canada,08-03-2020,205811,546,452,205359,Americas
Canada,08-03-2020,11566,2308,634,10932,Americas
Canada,08-03-2020,129087,813,535,128552,Americas
Canada,08-03-2020,177295,765,734,176561,Americas
Canada,08-03-2020,77597,1868,118,77479,Americas
Canada,08-03-2020,363089,1231,570,362519,Americas
Canada,08-03-2020,189,1848,196,-7,Americas
Central African Republic,08-03-2020,47577,1942,750,46827,Africa
Chad,08-03-2020,86941,955,1217,85724,Africa
Chile,08-03-2020,35917,2061,437,35480,Americas
China,08-03-2020,183936,621,1181,182755,Western Pacific
China,08-03-2020,85705,1715,341,85364,Western Pacific
China,08-03-2020,306888,254,1137,305751,Western Pacific
China,08-03-2020,72704,817,122,72582,Western Pacific
China,08-03-2020,29745,1542,198,29547,Western Pacific
China,08-03-2020,247123,843,129,246994,Western Pacific
China,08-03-2020,399417,1717,1090,398327,Western Pacific
China,08-03-2020,429442,2311,1098,428344,Western Pacific
China,08-03-2020,289735,934,1176,288559,Western Pacific
China,08-03-2020,93683,428,744,92939,Western Pacific
China,08-03-2020,418810,303,11,418799,Western Pacific
China,08-03-2020,44196,907,203,43993,Western Pacific
China,08-03-2020,137133,1652,966,136167,Western Pacific
China,08-03-2020,241139,2047,200,240939,Western Pacific
China,08-03-2020,71096,1040,69,71027,Western Pacific
China,08-03-2020,221941,713,281,221660,Western Pacific
China,08-03-2020,338384,809,961,337423,Western Pacific
China,08-03-2020,87887,1634,79,87808,Western Pacific
China,08-03-2020,181532,1512,989,180543,Western Pacific
China,08-03-2020,380893,1592,1209,379684,Western Pacific
China,08-03-2020,216689,1262,1094,215595,Western Pacific
China,08-03-2020,392499,1802,1090,391409,Western Pacific
China,08-03-2020,351108,1342,1071,350037,Western Pacific
China,08-03-2020,136748,1739,139,136609,Western Pacific
China,08-03-2020,404182,869,218,403964,Western Pacific
China,08-03-2020,449146,942,181,448965,Western Pacific
China,08-03-2020,314707,567,142,314565,Western Pacific
China,08-03-2020,10845,1060,1001,9844,Western Pacific
China,08-03-2020,22998,590,185,22813,Western Pacific
China,08-03-2020,106244,759,874,105370,Western Pacific
China,08-03-2020,213993,1268,125,213868,Western Pacific
China,08-03-2020,264625,1533,1187,263438,Western Pacific
China,08-03-2020,363292,291,250,363042,Western Pacific
Colombia,08-03-2020,136874,1331,630,136244,Americas
Congo (Brazzaville),08-03-2020,229919,1816,84,229835,Africa
Congo (Kinshasa),08-03-2020,18031,509,86,17945,Africa
Costa Rica,08-03-2020,392360,93,223,392137,Americas
Cote d'Ivoire,08-03-2020,134463,1825,516,133947,Africa
Croatia,08-03-2020,174469,757,761,173708,Europe
Cuba,08-03-2020,26157,1435,706,25451,Americas
Cyprus,08-03-2020,98746,1228,94,98652,Europe
Czechia,08-03-2020,254984,255,370,254614,Europe
Denmark,08-03-2020,281135,2126,1070,280065,Europe
Greenland,08-03-2020,198631,385,1172,197459,Europe
Denmark,08-03-2020,363832,853,89,363743,Europe
Djibouti,08-03-2020,162355,1426,487,161868,Eastern Mediterranean
Dominican Republic,08-03-2020,152951,1529,1059,151892,Americas
Ecuador,08-03-2020,128721,1135,243,128478,Americas
Egypt,08-03-2020,149098,327,475,148623,Eastern Mediterranean
El Salvador,08-03-2020,248956,689,9,248947,Americas
Equatorial Guinea,08-03-2020,321186,1262,961,320225,Africa
Eritrea,08-03-2020,103180,1046,53,103127,Africa
Estonia,08-03-2020,318420,752,292,318128,Europe
Eswatini,08-03-2020,402144,1248,79,402065,Africa
Ethiopia,08-03-2020,410661,471,617,410044,Africa
Fiji,08-03-2020,77137,2064,161,76976,Western Pacific
Finland,08-03-2020,311467,1940,470,310997,Europe
France,08-03-2020,95301,1817,908,94393,Europe
France,08-03-2020,213705,226,538,213167,Europe
France,08-03-2020,394168,1122,677,393491,Europe
France,08-03-2020,132854,2347,411,132443,Europe
France,08-03-2020,418379,114,1246,417133,Europe
France,08-03-2020,67753,1245,604,67149,Europe
France,08-03-2020,420144,1564,1066,419078,Europe
France,08-03-2020,357216,1130,462,356754,Europe
France,08-03-2020,58931,2061,435,58496,Europe
France,08-03-2020,293959,1094,351,293608,Europe
Gabon,08-03-2020,335987,2477,636,335351,Africa
Gambia,08-03-2020,269822,1860,793,269029,Africa
Georgia,08-03-2020,320828,175,1064,319764,Europe
Germany,08-03-2020,238462,51,224,238238,Europe
Ghana,08-03-2020,233863,1704,162,233701,Africa
Greece,08-03-2020,107516,1553,1079,106437,Europe
Guatemala,08-03-2020,326867,232,611,326256,Americas
Guinea,08-03-2020,42628,738,863,41765,Africa
Guyana,08-03-2020,341819,578,821,340998,Americas
Haiti,08-03-2020,14547,91,1044,13503,Americas
Holy See,08-03-2020,372141,2376,292,371849,Europe
Honduras,08-03-2020,236767,1721,699,236068,Americas
Hungary,08-03-2020,293311,1313,989,292322,Europe
Iceland,08-03-2020,319989,1252,723,319266,Europe
India,08-03-2020,178205,2496,321,177884,South-East Asia
Indonesia,08-03-2020,18134,1754,842,17292,South-East Asia
Iran,08-03-2020,254813,1835,1127,253686,Eastern Mediterranean
Iraq,08-03-2020,309752,447,1132,308620,Eastern Mediterranean
Ireland,08-03-2020,390543,1972,655,389888,Europe
Israel,08-03-2020,300842,660,176,300666,Europe
Italy,08-03-2020,242584,1184,499,242085,Europe
Jamaica,08-03-2020,365934,1940,323,365611,Americas
Japan,08-03-2020,257042,1630,1031,256011,Western Pacific
Jordan,08-03-2020,12173,1394,596,11577,Eastern Mediterranean
Kazakhstan,08-03-2020,335472,241,721,334751,Europe
Kenya,08-03-2020,86201,1224,84,86117,Africa
South Korea,08-03-2020,449434,1712,934,448500,Western Pacific
Kuwait,08-03-2020,63294,2420,1190,62104,Eastern Mediterranean
Kyrgyzstan,08-03-2020,284340,2308,509,283831,Europe
Latvia,08-03-2020,272844,1301,865,271979,Europe
Lebanon,08-03-2020,206445,1438,30,206415,Eastern Mediterranean
Liberia,08-03-2020,339214,123,62,339152,Africa
Liechtenstein,08-03-2020,241884,2186,569,241315,Europe
Lithuania,08-03-2020,168868,1004,998,167870,Europe
Luxembourg,08-03-2020,54868,2312,140,54728,Europe
Madagascar,08-03-2020,115362,1008,18,115344,Africa
Malaysia,08-03-2020,213053,2236,897,212156,Western Pacific
Maldives,08-03-2020,227159,1844,835,226324,South-East Asia
Malta,08-03-2020,294693,2193,534,294159,Europe
Mauritania,08-03-2020,281372,91,68,281304,Africa
Mauritius,08-03-2020,426590,1967,607,425983,Africa
Mexico,08-03-2020,207827,1230,594,207233,Americas
Moldova,08-03-2020,232246,2322,407,231839,Europe
Monaco,08-03-2020,316664,2190,676,315988,Europe
Mongolia,08-03-2020,278403,1815,190,278213,Western Pacific
Montenegro,08-03-2020,81278,1968,1173,80105,Europe
Morocco,08-03-2020,48886,1279,868,48018,Eastern Mediterranean
Namibia,08-03-2020,195291,433,215,195076,Africa
Nepal,08-03-2020,376955,2154,1159,375796,South-East Asia
Netherlands,08-03-2020,369779,110,651,369128,Europe
Netherlands,08-03-2020,203691,698,482,203209,Europe
Netherlands,08-03-2020,312545,1759,526,312019,Europe
Netherlands,08-03-2020,191807,1108,952,190855,Europe
New Zealand,08-03-2020,267196,999,510,266686,Western Pacific
Nicaragua,08-03-2020,420791,1238,953,419838,Americas
Niger,08-03-2020,303644,1640,971,302673,Africa
Nigeria,08-03-2020,65962,1018,485,65477,Africa
North Macedonia,08-03-2020,176135,2198,128,176007,Europe
Norway,08-03-2020,46076,1594,1107,44969,Europe
Oman,08-03-2020,383709,1233,682,383027,Eastern Mediterranean
Pakistan,08-03-2020,39659,1428,657,39002,Eastern Mediterranean
Panama,08-03-2020,48837,1539,362,48475,Americas
Papua New Guinea,08-03-2020,303087,1747,654,302433,Western Pacific
Paraguay,08-03-2020,401089,754,666,400423,Americas
Peru,08-03-2020,101284,2316,1203,100081,Americas
Philippines,08-03-2020,45270,626,1171,44099,Western Pacific
Poland,08-03-2020,291339,2419,109,291230,Europe
Portugal,08-03-2020,135491,274,491,135000,Europe
Qatar,08-03-2020,185933,915,735,185198,Eastern Mediterranean
Romania,08-03-2020,177887,290,171,177716,Europe
Russia,08-03-2020,33850,142,956,32894,Europe
Rwanda,08-03-2020,240101,2211,357,239744,Africa
Saint Lucia,08-03-2020,326958,257,1072,325886,Americas
Saint Vincent and the Grenadines,08-03-2020,88149,2397,681,87468,Americas
San Marino,08-03-2020,42576,151,660,41916,Europe
Saudi Arabia,08-03-2020,329850,934,1224,328626,Eastern Mediterranean
Senegal,08-03-2020,426439,1554,1043,425396,Africa
Serbia,08-03-2020,305488,2038,462,305026,Europe
Seychelles,08-03-2020,113884,1680,733,113151,Africa
Singapore,08-03-2020,444471,1590,1022,443449,Western Pacific
Slovakia,08-03-2020,186269,1033,536,185733,Europe
Slovenia,08-03-2020,325883,513,456,325427,Europe
Somalia,08-03-2020,358279,1546,521,357758,Eastern Mediterranean
South Africa,08-03-2020,201474,1607,366,201108,Africa
Spain,08-03-2020,149497,2499,1149,148348,Europe
Sri Lanka,08-03-2020,331198,2038,983,330215,South-East Asia
Sudan,08-03-2020,365920,954,193,365727,Eastern Mediterranean
Suriname,08-03-2020,332474,2317,1103,331371,Americas
Sweden,08-03-2020,125221,2079,387,124834,Europe
Switzerland,08-03-2020,146546,664,117,146429,Europe
Taiwan*,08-03-2020,220032,454,888,219144,Western Pacific
Tanzania,08-03-2020,283483,961,1045,282438,Africa
Thailand,08-03-2020,403397,1743,310,403087,South-East Asia
Togo,08-03-2020,244374,1223,140,244234,Africa
Trinidad and Tobago,08-03-2020,157305,995,661,156644,Americas
Tunisia,08-03-2020,187840,599,91,187749,Eastern Mediterranean
Turkey,08-03-2020,375001,980,298,374703,Europe
Uganda,08-03-2020,152418,6,56,152362,Africa
Ukraine,08-03-2020,52777,1986,755,52022,Europe
United Arab Emirates,08-03-2020,433188,1168,559,432629,Eastern Mediterranean
United Kingdom,08-03-2020,146164,731,1014,145150,Europe
United Kingdom,08-03-2020,174694,943,1108,173586,Europe
United Kingdom,08-03-2020,325759,1459,611,325148,Europe
United Kingdom,08-03-2020,366615,507,812,365803,Europe
United Kingdom,08-03-2020,143224,1448,307,142917,Europe
United Kingdom,08-03-2020,49371,1955,570,48801,Europe
United Kingdom,08-03-2020,224085,1891,348,223737,Europe
Uruguay,08-03-2020,243427,1058,1187,242240,Americas
US,08-03-2020,153554,352,1156,152398,Americas
Uzbekistan,08-03-2020,303000,1425,1143,301857,Europe
Venezuela,08-03-2020,40625,796,1024,39601,Americas
Vietnam,08-03-2020,234558,1451,1190,233368,Western Pacific
Zambia,08-03-2020,213874,2275,1012,212862,Africa
Zimbabwe,08-03-2020,378594,1308,1250,377344,Africa
Dominica,08-03-2020,158041,1402,1125,156916,Americas
Grenada,08-03-2020,128915,1127,813,128102,Americas
Mozambique,08-03-2020,390554,1249,1076,389478,Africa
Syria,08-03-2020,62800,627,808,61992,Eastern Mediterranean
Timor-Leste,08-03-2020,25203,1222,1176,24027,South-East Asia
Belize,08-03-2020,97288,16,738,96550,Americas
Laos,08-03-2020,324665,2384,990,323675,Western Pacific
Libya,08-03-2020,60161,1752,909,59252,Eastern Mediterranean
West Bank and Gaza,08-03-2020,156077,640,1167,154910,Eastern Mediterranean
Guinea-Bissau,08-03-2020,426984,1972,465,426519,Africa
Mali,08-03-2020,229055,2249,166,228889,Africa
Saint Kitts and Nevis,08-03-2020,266266,1518,54,266212,Americas
Canada,08-03-2020,144119,2460,1244,142875,Americas
Canada,08-03-2020,341588,1913,149,341439,Americas
Kosovo,08-03-2020,14741,1735,616,14125,Europe
Burma,08-03-2020,414412,1726,650,413762,South-East Asia
United Kingdom,08-03-2020,60831,930,953,59878,Europe
United Kingdom,08-03-2020,265307,55,991,264316,Europe
United Kingdom,08-03-2020,80559,499,518,80041,Europe
Botswana,08-03-2020,60281,285,312,59969,Africa
Burundi,08-03-2020,255947,1762,1023,254924,Africa
Sierra Leone,08-03-2020,226801,951,484,226317,Africa
Malawi,08-03-2020,245634,382,93,245541,Africa
United Kingdom,08-03-2020,203725,775,323,203402,Europe
France,08-03-2020,19695,1745,1220,18475,Europe
South Sudan,08-03-2020,103844,203,839,103005,Africa
Western Sahara,08-03-2020,9868,168,494,9374,Africa
Sao Tome and Principe,08-03-2020,323719,2316,1076,322643,Africa
Yemen,08-03-2020,221153,936,758,220395,Eastern Mediterranean
Comoros,08-03-2020,344379,766,1140,343239,Africa
Tajikistan,08-03-2020,365583,1028,291,365292,Europe
Lesotho,08-03-2020,338563,437,324,338239,Africa
Afghanistan,09-03-2020,47933,276,647,47286,Eastern Mediterranean
Albania,09-03-2020,236013,1889,234,235779,Europe
Algeria,09-03-2020,90921,1408,98,90823,Africa
Andorra,09-03-2020,32802,2209,985,31817,Europe
Angola,09-03-2020,112522,198,399,112123,Africa
Antigua and Barbuda,09-03-2020,295514,67,604,294910,Americas
Argentina,09-03-2020,401109,539,120,400989,Americas
Armenia,09-03-2020,70843,2490,1010,69833,Europe
Australia,09-03-2020,377597,1474,228,377369,Western Pacific
Australia,09-03-2020,300285,1763,426,299859,Western Pacific
Australia,09-03-2020,356329,1867,362,355967,Western Pacific
Australia,09-03-2020,213693,1901,108,213585,Western Pacific
Australia,09-03-2020,11995,1738,1082,10913,Western Pacific
Australia,09-03-2020,433143,857,667,432476,Western Pacific
Australia,09-03-2020,155809,1708,975,154834,Western Pacific
Australia,09-03-2020,303191,529,266,302925,Western Pacific
Austria,09-03-2020,161430,33,429,161001,Europe
Azerbaijan,09-03-2020,38749,2247,515,38234,Europe
Bahamas,09-03-2020,115104,1365,756,114348,Americas
Bahrain,09-03-2020,296122,764,38,296084,Eastern Mediterranean
Bangladesh,09-03-2020,112344,1048,354,111990,South-East Asia
Barbados,09-03-2020,410937,1505,1016,409921,Americas
Belarus,09-03-2020,121297,2440,1049,120248,Europe
Belgium,09-03-2020,393650,938,919,392731,Europe
Benin,09-03-2020,200768,1348,86,200682,Africa
Bhutan,09-03-2020,413140,192,835,412305,South-East Asia
Bolivia,09-03-2020,75978,2034,639,75339,Americas
Bosnia and Herzegovina,09-03-2020,358205,351,1032,357173,Europe
Brazil,09-03-2020,395974,1227,312,395662,Americas
Brunei,09-03-2020,333729,1805,306,333423,Western Pacific
Bulgaria,09-03-2020,333537,1347,702,332835,Europe
Burkina Faso,09-03-2020,364188,729,1040,363148,Africa
Cabo Verde,09-03-2020,103965,2492,13,103952,Africa
Cambodia,09-03-2020,113466,2155,538,112928,Western Pacific
Cameroon,09-03-2020,283018,1163,393,282625,Africa
Canada,09-03-2020,30818,2209,190,30628,Americas
Canada,09-03-2020,50731,1174,692,50039,Americas
Canada,09-03-2020,257567,824,1125,256442,Americas
Canada,09-03-2020,154340,825,791,153549,Americas
Canada,09-03-2020,70976,2330,175,70801,Americas
Canada,09-03-2020,435446,996,359,435087,Americas
Canada,09-03-2020,66530,2405,799,65731,Americas
Canada,09-03-2020,262047,638,185,261862,Americas
Canada,09-03-2020,385196,2445,165,385031,Americas
Canada,09-03-2020,264920,782,534,264386,Americas
Central African Republic,09-03-2020,255884,1172,908,254976,Africa
Chad,09-03-2020,242197,1687,935,241262,Africa
Chile,09-03-2020,188791,2236,1206,187585,Americas
China,09-03-2020,246865,501,1247,245618,Western Pacific
China,09-03-2020,387978,2052,1028,386950,Western Pacific
China,09-03-2020,233415,2307,620,232795,Western Pacific
China,09-03-2020,324429,1508,1004,323425,Western Pacific
China,09-03-2020,277024,1653,465,276559,Western Pacific
China,09-03-2020,150573,1722,798,149775,Western Pacific
China,09-03-2020,144321,1363,832,143489,Western Pacific
China,09-03-2020,19764,1993,77,19687,Western Pacific
China,09-03-2020,11593,2412,778,10815,Western Pacific
China,09-03-2020,40688,2371,1202,39486,Western Pacific
China,09-03-2020,273575,670,1070,272505,Western Pacific
China,09-03-2020,373676,978,1195,372481,Western Pacific
China,09-03-2020,405296,623,937,404359,Western Pacific
China,09-03-2020,14168,1052,517,13651,Western Pacific
China,09-03-2020,324276,588,39,324237,Western Pacific
China,09-03-2020,45201,699,1105,44096,Western Pacific
China,09-03-2020,20,1809,226,-206,Western Pacific
China,09-03-2020,306507,826,1237,305270,Western Pacific
China,09-03-2020,374865,1556,873,373992,Western Pacific
China,09-03-2020,214747,2259,632,214115,Western Pacific
China,09-03-2020,410411,2141,714,409697,Western Pacific
China,09-03-2020,256683,419,57,256626,Western Pacific
China,09-03-2020,202223,158,773,201450,Western Pacific
China,09-03-2020,306774,2064,607,306167,Western Pacific
China,09-03-2020,184694,247,80,184614,Western Pacific
China,09-03-2020,181847,2360,1079,180768,Western Pacific
China,09-03-2020,148364,653,816,147548,Western Pacific
China,09-03-2020,359904,1256,461,359443,Western Pacific
China,09-03-2020,171319,638,192,171127,Western Pacific
China,09-03-2020,110019,1707,1125,108894,Western Pacific
China,09-03-2020,10869,1670,598,10271,Western Pacific
China,09-03-2020,71000,1562,707,70293,Western Pacific
China,09-03-2020,383839,17,458,383381,Western Pacific
Colombia,09-03-2020,104037,1070,988,103049,Americas
Congo (Brazzaville),09-03-2020,168789,1189,929,167860,Africa
Congo (Kinshasa),09-03-2020,239052,359,152,238900,Africa
Costa Rica,09-03-2020,422433,2412,630,421803,Americas
Cote d'Ivoire,09-03-2020,80495,669,812,79683,Africa
Croatia,09-03-2020,332855,1048,1102,331753,Europe
Cuba,09-03-2020,112204,518,1010,111194,Americas
Cyprus,09-03-2020,350307,2154,312,349995,Europe
Czechia,09-03-2020,201848,1972,850,200998,Europe
Denmark,09-03-2020,231040,1829,635,230405,Europe
Greenland,09-03-2020,147339,123,934,146405,Europe
Denmark,09-03-2020,176940,727,1231,175709,Europe
Djibouti,09-03-2020,367208,533,652,366556,Eastern Mediterranean
Dominican Republic,09-03-2020,412509,729,691,411818,Americas
Ecuador,09-03-2020,34532,2063,1181,33351,Americas
Egypt,09-03-2020,374962,487,180,374782,Eastern Mediterranean
El Salvador,09-03-2020,49414,1493,1122,48292,Americas
Equatorial Guinea,09-03-2020,188616,2033,607,188009,Africa
Eritrea,09-03-2020,382907,2051,92,382815,Africa
Estonia,09-03-2020,106036,1047,835,105201,Europe
Eswatini,09-03-2020,239498,2417,685,238813,Africa
Ethiopia,09-03-2020,94599,1522,903,93696,Africa
Fiji,09-03-2020,379914,354,1148,378766,Western Pacific
Finland,09-03-2020,22835,1909,386,22449,Europe
France,09-03-2020,416517,1473,354,416163,Europe
France,09-03-2020,197308,1975,819,196489,Europe
France,09-03-2020,181644,1108,769,180875,Europe
France,09-03-2020,414989,1551,48,414941,Europe
France,09-03-2020,120737,861,728,120009,Europe
France,09-03-2020,260532,951,223,260309,Europe
France,09-03-2020,44099,1597,103,43996,Europe
France,09-03-2020,291097,2474,269,290828,Europe
France,09-03-2020,19067,643,620,18447,Europe
France,09-03-2020,153647,1524,1058,152589,Europe
Gabon,09-03-2020,59079,2340,570,58509,Africa
Gambia,09-03-2020,145451,494,852,144599,Africa
Georgia,09-03-2020,223380,2315,630,222750,Europe
Germany,09-03-2020,66439,2067,402,66037,Europe
Ghana,09-03-2020,184273,394,1166,183107,Africa
Greece,09-03-2020,58497,888,921,57576,Europe
Guatemala,09-03-2020,284773,1545,460,284313,Americas
Guinea,09-03-2020,71142,574,896,70246,Africa
Guyana,09-03-2020,308758,105,668,308090,Americas
Haiti,09-03-2020,107869,230,656,107213,Americas
Holy See,09-03-2020,446780,1188,555,446225,Europe
Honduras,09-03-2020,445348,1993,662,444686,Americas
Hungary,09-03-2020,420687,325,1103,419584,Europe
Iceland,09-03-2020,348212,2121,1198,347014,Europe
India,09-03-2020,77296,433,264,77032,South-East Asia
Indonesia,09-03-2020,156935,1665,1133,155802,South-East Asia
Iran,09-03-2020,76226,960,281,75945,Eastern Mediterranean
Iraq,09-03-2020,180335,931,679,179656,Eastern Mediterranean
Ireland,09-03-2020,375409,1591,843,374566,Europe
Israel,09-03-2020,14072,2448,198,13874,Europe
Italy,09-03-2020,312194,1905,183,312011,Europe
Jamaica,09-03-2020,17753,1818,603,17150,Americas
Japan,09-03-2020,121067,441,153,120914,Western Pacific
Jordan,09-03-2020,233366,821,21,233345,Eastern Mediterranean
Kazakhstan,09-03-2020,291812,1449,1051,290761,Europe
Kenya,09-03-2020,284773,1036,602,284171,Africa
South Korea,09-03-2020,405991,2253,967,405024,Western Pacific
Kuwait,09-03-2020,431121,2213,1105,430016,Eastern Mediterranean
Kyrgyzstan,09-03-2020,102753,1198,585,102168,Europe
Latvia,09-03-2020,300354,1449,13,300341,Europe
Lebanon,09-03-2020,141867,787,460,141407,Eastern Mediterranean
Liberia,09-03-2020,401266,1563,868,400398,Africa
Liechtenstein,09-03-2020,437142,1138,1198,435944,Europe
Lithuania,09-03-2020,212411,1387,1013,211398,Europe
Luxembourg,09-03-2020,386612,1969,1041,385571,Europe
Madagascar,09-03-2020,22308,527,762,21546,Africa
Malaysia,09-03-2020,62495,408,788,61707,Western Pacific
Maldives,09-03-2020,224393,607,1060,223333,South-East Asia
Malta,09-03-2020,89771,1514,940,88831,Europe
Mauritania,09-03-2020,415313,1102,66,415247,Africa
Mauritius,09-03-2020,415526,2282,1236,414290,Africa
Mexico,09-03-2020,5999,1411,480,5519,Americas
Moldova,09-03-2020,276010,845,294,275716,Europe
Monaco,09-03-2020,395535,1455,163,395372,Europe
Mongolia,09-03-2020,123383,1526,595,122788,Western Pacific
Montenegro,09-03-2020,150191,554,1115,149076,Europe
Morocco,09-03-2020,13708,2002,755,12953,Eastern Mediterranean
Namibia,09-03-2020,426213,540,772,425441,Africa
Nepal,09-03-2020,426851,2334,74,426777,South-East Asia
Netherlands,09-03-2020,223294,857,401,222893,Europe
Netherlands,09-03-2020,221463,982,30,221433,Europe
Netherlands,09-03-2020,280805,855,899,279906,Europe
Netherlands,09-03-2020,74915,1785,967,73948,Europe
New Zealand,09-03-2020,158009,132,1037,156972,Western Pacific
Nicaragua,09-03-2020,1757,589,958,799,Americas
Niger,09-03-2020,354211,902,427,353784,Africa
Nigeria,09-03-2020,99079,185,328,98751,Africa
North Macedonia,09-03-2020,96971,2284,78,96893,Europe
Norway,09-03-2020,383145,1714,1113,382032,Europe
Oman,09-03-2020,384652,1021,709,383943,Eastern Mediterranean
Pakistan,09-03-2020,4965,2409,789,4176,Eastern Mediterranean
Panama,09-03-2020,234425,536,993,233432,Americas
Papua New Guinea,09-03-2020,19026,1203,771,18255,Western Pacific
Paraguay,09-03-2020,366846,1611,237,366609,Americas
Peru,09-03-2020,3021,150,440,2581,Americas
Philippines,09-03-2020,19776,1203,768,19008,Western Pacific
Poland,09-03-2020,44283,2012,927,43356,Europe
Portugal,09-03-2020,449311,1669,578,448733,Europe
Qatar,09-03-2020,324578,1032,326,324252,Eastern Mediterranean
Romania,09-03-2020,18185,1879,942,17243,Europe
Russia,09-03-2020,348426,2255,795,347631,Europe
Rwanda,09-03-2020,51127,614,431,50696,Africa
Saint Lucia,09-03-2020,216666,1905,230,216436,Americas
Saint Vincent and the Grenadines,09-03-2020,326437,1197,157,326280,Americas
San Marino,09-03-2020,147479,1730,28,147451,Europe
Saudi Arabia,09-03-2020,203774,710,481,203293,Eastern Mediterranean
Senegal,09-03-2020,119866,2495,467,119399,Africa
Serbia,09-03-2020,294477,1204,720,293757,Europe
Seychelles,09-03-2020,37995,1278,657,37338,Africa
Singapore,09-03-2020,22680,2464,673,22007,Western Pacific
Slovakia,09-03-2020,89735,477,1141,88594,Europe
Slovenia,09-03-2020,279355,2222,774,278581,Europe
Somalia,09-03-2020,444976,709,698,444278,Eastern Mediterranean
South Africa,09-03-2020,152763,959,456,152307,Africa
Spain,09-03-2020,187653,1288,861,186792,Europe
Sri Lanka,09-03-2020,182230,2102,963,181267,South-East Asia
Sudan,09-03-2020,166545,1257,703,165842,Eastern Mediterranean
Suriname,09-03-2020,25008,1502,371,24637,Americas
Sweden,09-03-2020,358831,233,886,357945,Europe
Switzerland,09-03-2020,11339,1186,1057,10282,Europe
Taiwan*,09-03-2020,126726,651,680,126046,Western Pacific
Tanzania,09-03-2020,41767,1502,90,41677,Africa
Thailand,09-03-2020,28061,1600,223,27838,South-East Asia
Togo,09-03-2020,68896,1843,570,68326,Africa
Trinidad and Tobago,09-03-2020,434417,1390,176,434241,Americas
Tunisia,09-03-2020,19410,917,398,19012,Eastern Mediterranean
Turkey,09-03-2020,376452,1750,559,375893,Europe
Uganda,09-03-2020,200191,923,592,199599,Africa
Ukraine,09-03-2020,312635,53,260,312375,Europe
United Arab Emirates,09-03-2020,311186,1087,107,311079,Eastern Mediterranean
United Kingdom,09-03-2020,356218,652,887,355331,Europe
United Kingdom,09-03-2020,359009,496,348,358661,Europe
United Kingdom,09-03-2020,142775,209,611,142164,Europe
United Kingdom,09-03-2020,347244,423,168,347076,Europe
United Kingdom,09-03-2020,83182,1139,648,82534,Europe
United Kingdom,09-03-2020,33002,2295,835,32167,Europe
United Kingdom,09-03-2020,109543,757,1081,108462,Europe
Uruguay,09-03-2020,18867,882,55,18812,Americas
US,09-03-2020,387176,111,318,386858,Americas
Uzbekistan,09-03-2020,54923,1404,286,54637,Europe
Venezuela,09-03-2020,12141,1251,892,11249,Americas
Vietnam,09-03-2020,422471,2485,610,421861,Western Pacific
Zambia,09-03-2020,347505,2077,276,347229,Africa
Zimbabwe,09-03-2020,147480,1844,385,147095,Africa
Dominica,09-03-2020,352496,42,142,352354,Americas
Grenada,09-03-2020,212605,2204,2,212603,Americas
Mozambique,09-03-2020,100091,2111,296,99795,Africa
Syria,09-03-2020,23000,117,649,22351,Eastern Mediterranean
Timor-Leste,09-03-2020,193057,1258,844,192213,South-East Asia
Belize,09-03-2020,75848,337,814,75034,Americas
Laos,09-03-2020,131936,2299,780,131156,Western Pacific
Libya,09-03-2020,243042,2145,186,242856,Eastern Mediterranean
West Bank and Gaza,09-03-2020,300754,105,30,300724,Eastern Mediterranean
Guinea-Bissau,09-03-2020,239211,746,218,238993,Africa
Mali,09-03-2020,64456,2104,820,63636,Africa
Saint Kitts and Nevis,09-03-2020,309472,97,58,309414,Americas
Canada,09-03-2020,388796,94,880,387916,Americas
Canada,09-03-2020,98278,395,343,97935,Americas
Kosovo,09-03-2020,270124,1641,970,269154,Europe
Burma,09-03-2020,203895,2182,958,202937,South-East Asia
United Kingdom,09-03-2020,201511,1169,840,200671,Europe
United Kingdom,09-03-2020,214887,2484,962,213925,Europe
United Kingdom,09-03-2020,423073,2097,212,422861,Europe
Botswana,09-03-2020,275260,62,948,274312,Africa
Burundi,09-03-2020,163117,2290,825,162292,Africa
Sierra Leone,09-03-2020,280989,242,1069,279920,Africa
Malawi,09-03-2020,275036,577,460,274576,Africa
United Kingdom,09-03-2020,137253,1112,629,136624,Europe
France,09-03-2020,84093,705,481,83612,Europe
South Sudan,09-03-2020,342174,848,1179,340995,Africa
Western Sahara,09-03-2020,298133,2347,461,297672,Africa
Sao Tome and Principe,09-03-2020,305582,902,77,305505,Africa
Yemen,09-03-2020,294963,1321,958,294005,Eastern Mediterranean
Comoros,09-03-2020,18108,1573,13,18095,Africa
Tajikistan,09-03-2020,28673,1544,712,27961,Europe
Lesotho,09-03-2020,208679,1103,510,208169,Africa
Afghanistan,10-03-2020,129336,990,932,128404,Eastern Mediterranean
Albania,10-03-2020,109738,1137,195,109543,Europe
Algeria,10-03-2020,131670,2490,260,131410,Africa
Andorra,10-03-2020,212993,1033,1166,211827,Europe
Angola,10-03-2020,211072,1740,1233,209839,Africa
Antigua and Barbuda,10-03-2020,104080,2389,108,103972,Americas
Argentina,10-03-2020,427778,786,944,426834,Americas
Armenia,10-03-2020,30796,1976,233,30563,Europe
Australia,10-03-2020,312513,2333,234,312279,Western Pacific
Australia,10-03-2020,78324,2291,843,77481,Western Pacific
Australia,10-03-2020,253169,987,329,252840,Western Pacific
Australia,10-03-2020,135027,1278,1215,133812,Western Pacific
Australia,10-03-2020,93386,713,918,92468,Western Pacific
Australia,10-03-2020,380120,922,626,379494,Western Pacific
Australia,10-03-2020,13484,1833,115,13369,Western Pacific
Australia,10-03-2020,442662,1245,954,441708,Western Pacific
Austria,10-03-2020,195045,1422,683,194362,Europe
Azerbaijan,10-03-2020,71760,1691,597,71163,Europe
Bahamas,10-03-2020,236587,2400,959,235628,Americas
Bahrain,10-03-2020,404258,1701,545,403713,Eastern Mediterranean
Bangladesh,10-03-2020,421499,409,170,421329,South-East Asia
Barbados,10-03-2020,98412,2282,712,97700,Americas
Belarus,10-03-2020,112932,2273,526,112406,Europe
Belgium,10-03-2020,203637,371,335,203302,Europe
Benin,10-03-2020,249306,2344,1103,248203,Africa
Bhutan,10-03-2020,390554,67,294,390260,South-East Asia
Bolivia,10-03-2020,4107,831,845,3262,Americas
Bosnia and Herzegovina,10-03-2020,362997,1408,637,362360,Europe
Brazil,10-03-2020,156735,1604,12,156723,Americas
Brunei,10-03-2020,207047,912,500,206547,Western Pacific
Bulgaria,10-03-2020,439017,383,1066,437951,Europe
Burkina Faso,10-03-2020,65374,1627,240,65134,Africa
Cabo Verde,10-03-2020,379322,2124,593,378729,Africa
Cambodia,10-03-2020,440222,1703,864,439358,Western Pacific
Cameroon,10-03-2020,430779,674,988,429791,Africa
Canada,10-03-2020,206582,1510,1207,205375,Americas
Canada,10-03-2020,60264,2481,1128,59136,Americas
Canada,10-03-2020,197967,24,953,197014,Americas
Canada,10-03-2020,407533,2063,577,406956,Americas
Canada,10-03-2020,328012,1206,26,327986,Americas
Canada,10-03-2020,262279,1346,1235,261044,Americas
Canada,10-03-2020,64415,167,1019,63396,Americas
Canada,10-03-2020,357665,1783,1079,356586,Americas
Canada,10-03-2020,262934,112,663,262271,Americas
Canada,10-03-2020,13387,1066,29,13358,Americas
Central African Republic,10-03-2020,139639,457,437,139202,Africa
Chad,10-03-2020,94632,382,1241,93391,Africa
Chile,10-03-2020,179812,1193,528,179284,Americas
China,10-03-2020,165741,1120,265,165476,Western Pacific
China,10-03-2020,211411,884,633,210778,Western Pacific
China,10-03-2020,218940,457,254,218686,Western Pacific
China,10-03-2020,249135,420,558,248577,Western Pacific
China,10-03-2020,503,417,1170,-667,Western Pacific
China,10-03-2020,353410,1194,151,353259,Western Pacific
China,10-03-2020,356425,2480,396,356029,Western Pacific
China,10-03-2020,26908,341,511,26397,Western Pacific
China,10-03-2020,380718,1530,235,380483,Western Pacific
China,10-03-2020,400894,1916,1125,399769,Western Pacific
China,10-03-2020,387689,662,688,387001,Western Pacific
China,10-03-2020,352349,1966,726,351623,Western Pacific
China,10-03-2020,9025,719,788,8237,Western Pacific
China,10-03-2020,358431,2181,837,357594,Western Pacific
China,10-03-2020,191027,116,955,190072,Western Pacific
China,10-03-2020,423591,2382,124,423467,Western Pacific
China,10-03-2020,114938,555,441,114497,Western Pacific
China,10-03-2020,56280,615,169,56111,Western Pacific
China,10-03-2020,182319,404,1124,181195,Western Pacific
China,10-03-2020,254885,1056,1044,253841,Western Pacific
China,10-03-2020,283638,142,1014,282624,Western Pacific
China,10-03-2020,336973,1773,1119,335854,Western Pacific
China,10-03-2020,55947,1447,492,55455,Western Pacific
China,10-03-2020,105053,1119,663,104390,Western Pacific
China,10-03-2020,221821,1243,1236,220585,Western Pacific
China,10-03-2020,370537,1486,547,369990,Western Pacific
China,10-03-2020,237750,377,744,237006,Western Pacific
China,10-03-2020,439504,335,1168,438336,Western Pacific
China,10-03-2020,157710,2163,446,157264,Western Pacific
China,10-03-2020,130789,1234,492,130297,Western Pacific
China,10-03-2020,31428,1790,117,31311,Western Pacific
China,10-03-2020,408375,2458,943,407432,Western Pacific
China,10-03-2020,103572,2127,275,103297,Western Pacific
Colombia,10-03-2020,223860,1043,129,223731,Americas
Congo (Brazzaville),10-03-2020,200253,2149,248,200005,Africa
Congo (Kinshasa),10-03-2020,93432,1714,407,93025,Africa
Costa Rica,10-03-2020,1404,2046,289,1115,Americas
Cote d'Ivoire,10-03-2020,163503,464,511,162992,Africa
Croatia,10-03-2020,397205,2094,57,397148,Europe
Cuba,10-03-2020,125636,1148,666,124970,Americas
Cyprus,10-03-2020,60312,2493,697,59615,Europe
Czechia,10-03-2020,302275,1817,756,301519,Europe
Denmark,10-03-2020,262027,1773,1130,260897,Europe
Greenland,10-03-2020,141687,1682,254,141433,Europe
Denmark,10-03-2020,415624,1401,440,415184,Europe
Djibouti,10-03-2020,382107,2039,926,381181,Eastern Mediterranean
Dominican Republic,10-03-2020,100842,1603,1113,99729,Americas
Ecuador,10-03-2020,170758,138,524,170234,Americas
Egypt,10-03-2020,41255,219,192,41063,Eastern Mediterranean
El Salvador,10-03-2020,179052,1194,932,178120,Americas
Equatorial Guinea,10-03-2020,247696,1757,1221,246475,Africa
Eritrea,10-03-2020,257319,1869,620,256699,Africa
Estonia,10-03-2020,200749,1117,302,200447,Europe
Eswatini,10-03-2020,98742,1164,1001,97741,Africa
Ethiopia,10-03-2020,7647,212,492,7155,Africa
Fiji,10-03-2020,289311,635,242,289069,Western Pacific
Finland,10-03-2020,87611,988,792,86819,Europe
France,10-03-2020,191775,1591,836,190939,Europe
France,10-03-2020,154463,1534,749,153714,Europe
France,10-03-2020,180913,1874,443,180470,Europe
France,10-03-2020,401157,1902,1099,400058,Europe
France,10-03-2020,256174,1560,736,255438,Europe
France,10-03-2020,171424,2160,1159,170265,Europe
France,10-03-2020,29403,1280,1240,28163,Europe
France,10-03-2020,205585,2342,871,204714,Europe
France,10-03-2020,10457,2119,239,10218,Europe
France,10-03-2020,259898,1333,1085,258813,Europe
Gabon,10-03-2020,89979,54,518,89461,Africa
Gambia,10-03-2020,274598,365,497,274101,Africa
Georgia,10-03-2020,442094,1521,1195,440899,Europe
Germany,10-03-2020,396813,195,312,396501,Europe
Ghana,10-03-2020,396067,2058,840,395227,Africa
Greece,10-03-2020,8095,115,72,8023,Europe
Guatemala,10-03-2020,236354,2136,851,235503,Americas
Guinea,10-03-2020,90486,1088,347,90139,Africa
Guyana,10-03-2020,162596,258,665,161931,Americas
Haiti,10-03-2020,337817,832,1101,336716,Americas
Holy See,10-03-2020,238588,2301,849,237739,Europe
Honduras,10-03-2020,92006,699,21,91985,Americas
Hungary,10-03-2020,240539,1367,493,240046,Europe
Iceland,10-03-2020,100494,1304,431,100063,Europe
India,10-03-2020,89495,1908,986,88509,South-East Asia
Indonesia,10-03-2020,430851,1045,943,429908,South-East Asia
Iran,10-03-2020,150862,911,969,149893,Eastern Mediterranean
Iraq,10-03-2020,177445,752,1026,176419,Eastern Mediterranean
Ireland,10-03-2020,334436,1004,1142,333294,Europe
Israel,10-03-2020,160569,2445,630,159939,Europe
Italy,10-03-2020,7553,491,992,6561,Europe
Jamaica,10-03-2020,182451,681,150,182301,Americas
Japan,10-03-2020,104109,410,1107,103002,Western Pacific
Jordan,10-03-2020,310944,2272,426,310518,Eastern Mediterranean
Kazakhstan,10-03-2020,395291,619,872,394419,Europe
Kenya,10-03-2020,53019,22,699,52320,Africa
South Korea,10-03-2020,156675,1901,27,156648,Western Pacific
Kuwait,10-03-2020,144921,1120,567,144354,Eastern Mediterranean
Kyrgyzstan,10-03-2020,265154,1943,397,264757,Europe
Latvia,10-03-2020,175406,1190,402,175004,Europe
Lebanon,10-03-2020,312849,2487,1012,311837,Eastern Mediterranean
Liberia,10-03-2020,215415,850,286,215129,Africa
Liechtenstein,10-03-2020,119796,1143,305,119491,Europe
Lithuania,10-03-2020,25596,2328,847,24749,Europe
Luxembourg,10-03-2020,382482,546,279,382203,Europe
Madagascar,10-03-2020,425534,1519,515,425019,Africa
Malaysia,10-03-2020,103507,978,90,103417,Western Pacific
Maldives,10-03-2020,113808,2381,1156,112652,South-East Asia
Malta,10-03-2020,364608,850,1018,363590,Europe
Mauritania,10-03-2020,366512,82,428,366084,Africa
Mauritius,10-03-2020,284218,243,526,283692,Africa
Mexico,10-03-2020,376310,938,722,375588,Americas
Moldova,10-03-2020,345567,2155,654,344913,Europe
Monaco,10-03-2020,99133,1280,94,99039,Europe
Mongolia,10-03-2020,105739,1064,638,105101,Western Pacific
Montenegro,10-03-2020,296945,294,365,296580,Europe
Morocco,10-03-2020,87793,4,683,87110,Eastern Mediterranean
Namibia,10-03-2020,291853,347,1212,290641,Africa
Nepal,10-03-2020,38086,1655,962,37124,South-East Asia
Netherlands,10-03-2020,266358,1376,504,265854,Europe
Netherlands,10-03-2020,242205,2446,124,242081,Europe
Netherlands,10-03-2020,391247,215,1228,390019,Europe
Netherlands,10-03-2020,261288,1778,135,261153,Europe
New Zealand,10-03-2020,142860,340,896,141964,Western Pacific
Nicaragua,10-03-2020,285798,781,1134,284664,Americas
Niger,10-03-2020,251413,1711,1159,250254,Africa
Nigeria,10-03-2020,432753,1638,166,432587,Africa
North Macedonia,10-03-2020,189687,135,64,189623,Europe
Norway,10-03-2020,52645,795,750,51895,Europe
Oman,10-03-2020,393128,1594,78,393050,Eastern Mediterranean
Pakistan,10-03-2020,432315,1197,165,432150,Eastern Mediterranean
Panama,10-03-2020,48273,1841,1099,47174,Americas
Papua New Guinea,10-03-2020,110646,1535,115,110531,Western Pacific
Paraguay,10-03-2020,3967,298,752,3215,Americas
Peru,10-03-2020,276665,2444,1236,275429,Americas
Philippines,10-03-2020,155646,1198,807,154839,Western Pacific
Poland,10-03-2020,369097,1111,652,368445,Europe
Portugal,10-03-2020,109304,1364,413,108891,Europe
Qatar,10-03-2020,224042,1549,757,223285,Eastern Mediterranean
Romania,10-03-2020,60079,1142,151,59928,Europe
Russia,10-03-2020,444339,1039,225,444114,Europe
Rwanda,10-03-2020,258442,157,505,257937,Africa
Saint Lucia,10-03-2020,432724,375,741,431983,Americas
Saint Vincent and the Grenadines,10-03-2020,32192,1211,681,31511,Americas
San Marino,10-03-2020,58118,2021,636,57482,Europe
Saudi Arabia,10-03-2020,100925,373,1197,99728,Eastern Mediterranean
Senegal,10-03-2020,29878,1003,259,29619,Africa
Serbia,10-03-2020,135101,1941,342,134759,Europe
Seychelles,10-03-2020,23223,1679,332,22891,Africa
Singapore,10-03-2020,350534,2480,214,350320,Western Pacific
Slovakia,10-03-2020,164726,1543,260,164466,Europe
Slovenia,10-03-2020,24390,2113,969,23421,Europe
Somalia,10-03-2020,167921,2460,1214,166707,Eastern Mediterranean
South Africa,10-03-2020,73425,2392,677,72748,Africa
Spain,10-03-2020,62060,87,966,61094,Europe
Sri Lanka,10-03-2020,386902,1250,1085,385817,South-East Asia
Sudan,10-03-2020,415143,745,1130,414013,Eastern Mediterranean
Suriname,10-03-2020,149906,705,891,149015,Americas
Sweden,10-03-2020,387462,77,1101,386361,Europe
Switzerland,10-03-2020,17984,1728,875,17109,Europe
Taiwan*,10-03-2020,215179,308,483,214696,Western Pacific
Tanzania,10-03-2020,256727,617,348,256379,Africa
Thailand,10-03-2020,184866,1865,456,184410,South-East Asia
Togo,10-03-2020,447027,260,262,446765,Africa
Trinidad and Tobago,10-03-2020,54973,386,703,54270,Americas
Tunisia,10-03-2020,46094,327,371,45723,Eastern Mediterranean
Turkey,10-03-2020,281458,467,308,281150,Europe
Uganda,10-03-2020,9890,1285,650,9240,Africa
Ukraine,10-03-2020,374749,1302,1199,373550,Europe
United Arab Emirates,10-03-2020,225589,2244,65,225524,Eastern Mediterranean
United Kingdom,10-03-2020,407561,1523,167,407394,Europe
United Kingdom,10-03-2020,51765,139,888,50877,Europe
United Kingdom,10-03-2020,61626,438,333,61293,Europe
United Kingdom,10-03-2020,825,1057,653,172,Europe
United Kingdom,10-03-2020,303613,181,193,303420,Europe
United Kingdom,10-03-2020,128059,83,536,127523,Europe
United Kingdom,10-03-2020,335850,2380,138,335712,Europe
Uruguay,10-03-2020,22755,10,1054,21701,Americas
US,10-03-2020,387139,979,545,386594,Americas
Uzbekistan,10-03-2020,388585,1176,1119,387466,Europe
Venezuela,10-03-2020,13872,1409,1015,12857,Americas
Vietnam,10-03-2020,233485,1881,1190,232295,Western Pacific
Zambia,10-03-2020,323074,763,1169,321905,Africa
Zimbabwe,10-03-2020,403211,1080,88,403123,Africa
Dominica,10-03-2020,24945,985,1020,23925,Americas
Grenada,10-03-2020,26410,1510,1221,25189,Americas
Mozambique,10-03-2020,12169,891,420,11749,Africa
Syria,10-03-2020,362059,2251,533,361526,Eastern Mediterranean
Timor-Leste,10-03-2020,300044,1718,513,299531,South-East Asia
Belize,10-03-2020,71667,2237,216,71451,Americas
Laos,10-03-2020,24096,1264,1159,22937,Western Pacific
Libya,10-03-2020,301791,2338,132,301659,Eastern Mediterranean
West Bank and Gaza,10-03-2020,338909,513,1131,337778,Eastern Mediterranean
Guinea-Bissau,10-03-2020,434637,1073,792,433845,Africa
Mali,10-03-2020,311913,2452,116,311797,Africa
Saint Kitts and Nevis,10-03-2020,347507,1983,761,346746,Americas
Canada,10-03-2020,32951,1778,466,32485,Americas
Canada,10-03-2020,376424,868,201,376223,Americas
Kosovo,10-03-2020,257567,912,970,256597,Europe
Burma,10-03-2020,139932,1894,475,139457,South-East Asia
United Kingdom,10-03-2020,425049,574,427,424622,Europe
United Kingdom,10-03-2020,410090,1175,1123,408967,Europe
United Kingdom,10-03-2020,35049,1524,204,34845,Europe
Botswana,10-03-2020,255037,1936,1145,253892,Africa
Burundi,10-03-2020,347531,1804,169,347362,Africa
Sierra Leone,10-03-2020,311462,185,541,310921,Africa
Malawi,10-03-2020,396410,297,65,396345,Africa
United Kingdom,10-03-2020,140551,1901,1092,139459,Europe
France,10-03-2020,22630,137,1117,21513,Europe
South Sudan,10-03-2020,57661,2262,255,57406,Africa
Western Sahara,10-03-2020,221044,1393,253,220791,Africa
Sao Tome and Principe,10-03-2020,153782,2460,117,153665,Africa
Yemen,10-03-2020,388501,1181,235,388266,Eastern Mediterranean
Comoros,10-03-2020,267655,2405,391,267264,Africa
Tajikistan,10-03-2020,440962,1372,147,440815,Europe
Lesotho,10-03-2020,169451,129,1041,168410,Africa
Afghanistan,11-03-2020,197300,1759,633,196667,Eastern Mediterranean
Albania,11-03-2020,5149,57,508,4641,Europe
Algeria,11-03-2020,98689,2066,783,97906,Africa
Andorra,11-03-2020,116351,1556,1101,115250,Europe
Angola,11-03-2020,263495,879,1218,262277,Africa
Antigua and Barbuda,11-03-2020,433916,699,884,433032,Americas
Argentina,11-03-2020,353371,2129,1007,352364,Americas
Armenia,11-03-2020,46464,1919,1007,45457,Europe
Australia,11-03-2020,214114,177,988,213126,Western Pacific
Australia,11-03-2020,181155,532,9,181146,Western Pacific
Australia,11-03-2020,181416,568,274,181142,Western Pacific
Australia,11-03-2020,292171,2497,1009,291162,Western Pacific
Australia,11-03-2020,410614,1450,1017,409597,Western Pacific
Australia,11-03-2020,50586,529,749,49837,Western Pacific
Australia,11-03-2020,319210,1213,107,319103,Western Pacific
Australia,11-03-2020,3986,2341,759,3227,Western Pacific
Austria,11-03-2020,418101,2043,712,417389,Europe
Azerbaijan,11-03-2020,328101,2219,1164,326937,Europe
Bahamas,11-03-2020,362435,2093,1055,361380,Americas
Bahrain,11-03-2020,231119,1953,165,230954,Eastern Mediterranean
Bangladesh,11-03-2020,184728,308,576,184152,South-East Asia
Barbados,11-03-2020,74601,1485,185,74416,Americas
Belarus,11-03-2020,284455,1788,699,283756,Europe
Belgium,11-03-2020,27374,1333,768,26606,Europe
Benin,11-03-2020,155267,1187,776,154491,Africa
Bhutan,11-03-2020,211179,997,772,210407,South-East Asia
Bolivia,11-03-2020,234974,1402,875,234099,Americas
Bosnia and Herzegovina,11-03-2020,47480,1731,476,47004,Europe
Brazil,11-03-2020,247297,1518,477,246820,Americas
Brunei,11-03-2020,322137,2086,861,321276,Western Pacific
Bulgaria,11-03-2020,366584,1532,162,366422,Europe
Burkina Faso,11-03-2020,152947,594,142,152805,Africa
Cabo Verde,11-03-2020,316889,1646,674,316215,Africa
Cambodia,11-03-2020,272364,1229,223,272141,Western Pacific
Cameroon,11-03-2020,337937,2496,212,337725,Africa
Canada,11-03-2020,190859,1664,631,190228,Americas
Canada,11-03-2020,147259,1193,919,146340,Americas
Canada,11-03-2020,80462,197,1038,79424,Americas
Canada,11-03-2020,388363,504,824,387539,Americas
Canada,11-03-2020,94577,674,1009,93568,Americas
Canada,11-03-2020,256621,227,1245,255376,Americas
Canada,11-03-2020,176767,342,1163,175604,Americas
Canada,11-03-2020,377031,293,127,376904,Americas
Canada,11-03-2020,298919,2081,1000,297919,Americas
Canada,11-03-2020,313829,1955,344,313485,Americas
Central African Republic,11-03-2020,168114,1125,404,167710,Africa
Chad,11-03-2020,153841,1675,767,153074,Africa
Chile,11-03-2020,424378,2236,846,423532,Americas
China,11-03-2020,148114,1569,314,147800,Western Pacific
China,11-03-2020,11782,2213,830,10952,Western Pacific
China,11-03-2020,107961,260,1153,106808,Western Pacific
China,11-03-2020,29919,265,81,29838,Western Pacific
China,11-03-2020,336672,2036,742,335930,Western Pacific
China,11-03-2020,224150,1285,362,223788,Western Pacific
China,11-03-2020,408480,1041,683,407797,Western Pacific
China,11-03-2020,238245,1814,272,237973,Western Pacific
China,11-03-2020,274604,1012,275,274329,Western Pacific
China,11-03-2020,56691,1730,300,56391,Western Pacific
China,11-03-2020,121581,1020,150,121431,Western Pacific
China,11-03-2020,268832,2318,1168,267664,Western Pacific
China,11-03-2020,225634,1056,85,225549,Western Pacific
China,11-03-2020,173243,343,983,172260,Western Pacific
China,11-03-2020,167688,467,316,167372,Western Pacific
China,11-03-2020,325083,1058,452,324631,Western Pacific
China,11-03-2020,341288,2050,250,341038,Western Pacific
China,11-03-2020,276233,703,1010,275223,Western Pacific
China,11-03-2020,409290,1894,320,408970,Western Pacific
China,11-03-2020,79258,1780,95,79163,Western Pacific
China,11-03-2020,58082,606,485,57597,Western Pacific
China,11-03-2020,303477,1446,559,302918,Western Pacific
China,11-03-2020,163220,2142,723,162497,Western Pacific
China,11-03-2020,248759,733,1140,247619,Western Pacific
China,11-03-2020,112380,310,703,111677,Western Pacific
China,11-03-2020,135223,90,1226,133997,Western Pacific
China,11-03-2020,167126,2398,729,166397,Western Pacific
China,11-03-2020,342726,1627,641,342085,Western Pacific
China,11-03-2020,62675,380,154,62521,Western Pacific
China,11-03-2020,161972,2120,507,161465,Western Pacific
China,11-03-2020,306698,2424,469,306229,Western Pacific
China,11-03-2020,232862,106,687,232175,Western Pacific
China,11-03-2020,412613,1569,382,412231,Western Pacific
Colombia,11-03-2020,57393,636,49,57344,Americas
Congo (Brazzaville),11-03-2020,65480,1689,1036,64444,Africa
Congo (Kinshasa),11-03-2020,296438,2400,915,295523,Africa
Costa Rica,11-03-2020,373298,102,848,372450,Americas
Cote d'Ivoire,11-03-2020,375398,1110,935,374463,Africa
Croatia,11-03-2020,270700,301,218,270482,Europe
Cuba,11-03-2020,249413,280,463,248950,Americas
Cyprus,11-03-2020,101210,403,361,100849,Europe
Czechia,11-03-2020,345370,2057,891,344479,Europe
Denmark,11-03-2020,102026,129,643,101383,Europe
Greenland,11-03-2020,220204,526,303,219901,Europe
Denmark,11-03-2020,174081,2167,821,173260,Europe
Djibouti,11-03-2020,338461,1943,295,338166,Eastern Mediterranean
Dominican Republic,11-03-2020,26903,745,95,26808,Americas
Ecuador,11-03-2020,289605,1518,61,289544,Americas
Egypt,11-03-2020,367494,447,532,366962,Eastern Mediterranean
El Salvador,11-03-2020,331538,1401,728,330810,Americas
Equatorial Guinea,11-03-2020,181548,177,1067,180481,Africa
Eritrea,11-03-2020,291363,2405,69,291294,Africa
Estonia,11-03-2020,152718,629,127,152591,Europe
Eswatini,11-03-2020,368960,1174,528,368432,Africa
Ethiopia,11-03-2020,168475,249,311,168164,Africa
Fiji,11-03-2020,405386,1258,124,405262,Western Pacific
Finland,11-03-2020,216955,719,915,216040,Europe
France,11-03-2020,299400,958,1112,298288,Europe
France,11-03-2020,30800,203,674,30126,Europe
France,11-03-2020,153499,1428,1117,152382,Europe
France,11-03-2020,350134,1493,50,350084,Europe
France,11-03-2020,286081,1747,542,285539,Europe
France,11-03-2020,430408,1284,880,429528,Europe
France,11-03-2020,326127,1549,412,325715,Europe
France,11-03-2020,444738,115,73,444665,Europe
France,11-03-2020,410581,1129,667,409914,Europe
France,11-03-2020,148177,2189,846,147331,Europe
Gabon,11-03-2020,235768,519,1097,234671,Africa
Gambia,11-03-2020,425944,731,451,425493,Africa
Georgia,11-03-2020,320339,2223,340,319999,Europe
Germany,11-03-2020,96883,1235,197,96686,Europe
Ghana,11-03-2020,127612,424,769,126843,Africa
Greece,11-03-2020,71052,2425,422,70630,Europe
Guatemala,11-03-2020,439154,2299,969,438185,Americas
Guinea,11-03-2020,340203,641,408,339795,Africa
Guyana,11-03-2020,90947,1925,489,90458,Americas
Haiti,11-03-2020,215085,1361,1036,214049,Americas
Holy See,11-03-2020,392059,2205,756,391303,Europe
Honduras,11-03-2020,198845,1941,409,198436,Americas
Hungary,11-03-2020,353058,2130,668,352390,Europe
Iceland,11-03-2020,316595,1101,974,315621,Europe
India,11-03-2020,6444,1537,799,5645,South-East Asia
Indonesia,11-03-2020,46771,1513,131,46640,South-East Asia
Iran,11-03-2020,244695,1830,798,243897,Eastern Mediterranean
Iraq,11-03-2020,168722,455,1159,167563,Eastern Mediterranean
Ireland,11-03-2020,283668,1725,1110,282558,Europe
Israel,11-03-2020,345101,1393,576,344525,Europe
Italy,11-03-2020,99035,522,699,98336,Europe
Jamaica,11-03-2020,133995,1510,744,133251,Americas
Japan,11-03-2020,339641,1299,1234,338407,Western Pacific
Jordan,11-03-2020,225159,817,427,224732,Eastern Mediterranean
Kazakhstan,11-03-2020,69119,2307,706,68413,Europe
Kenya,11-03-2020,181015,100,438,180577,Africa
South Korea,11-03-2020,268994,932,1114,267880,Western Pacific
Kuwait,11-03-2020,4555,1279,31,4524,Eastern Mediterranean
Kyrgyzstan,11-03-2020,392640,1707,29,392611,Europe
Latvia,11-03-2020,426942,1078,163,426779,Europe
Lebanon,11-03-2020,178666,527,1142,177524,Eastern Mediterranean
Liberia,11-03-2020,72650,2490,1102,71548,Africa
Liechtenstein,11-03-2020,260247,307,935,259312,Europe
Lithuania,11-03-2020,92055,966,797,91258,Europe
Luxembourg,11-03-2020,23345,916,1127,22218,Europe
Madagascar,11-03-2020,306589,1739,989,305600,Africa
Malaysia,11-03-2020,192897,1062,781,192116,Western Pacific
Maldives,11-03-2020,24996,2500,932,24064,South-East Asia
Malta,11-03-2020,235040,1245,384,234656,Europe
Mauritania,11-03-2020,151364,900,877,150487,Africa
Mauritius,11-03-2020,13453,1732,234,13219,Africa
Mexico,11-03-2020,166554,1180,814,165740,Americas
Moldova,11-03-2020,169066,1169,398,168668,Europe
Monaco,11-03-2020,293687,1072,469,293218,Europe
Mongolia,11-03-2020,255820,1433,656,255164,Western Pacific
Montenegro,11-03-2020,268204,1235,482,267722,Europe
Morocco,11-03-2020,275394,2388,481,274913,Eastern Mediterranean
Namibia,11-03-2020,38423,705,332,38091,Africa
Nepal,11-03-2020,37941,1255,273,37668,South-East Asia
Netherlands,11-03-2020,323527,1334,364,323163,Europe
Netherlands,11-03-2020,247847,899,647,247200,Europe
Netherlands,11-03-2020,23502,1549,180,23322,Europe
Netherlands,11-03-2020,171261,2413,1238,170023,Europe
New Zealand,11-03-2020,261816,1266,672,261144,Western Pacific
Nicaragua,11-03-2020,375590,1546,483,375107,Americas
Niger,11-03-2020,427959,653,182,427777,Africa
Nigeria,11-03-2020,119657,2266,878,118779,Africa
North Macedonia,11-03-2020,292936,549,1078,291858,Europe
Norway,11-03-2020,38539,2282,7,38532,Europe
Oman,11-03-2020,152910,40,184,152726,Eastern Mediterranean
Pakistan,11-03-2020,84051,1391,1150,82901,Eastern Mediterranean
Panama,11-03-2020,69015,1388,751,68264,Americas
Papua New Guinea,11-03-2020,246744,1228,10,246734,Western Pacific
Paraguay,11-03-2020,76677,48,1146,75531,Americas
Peru,11-03-2020,136069,620,1075,134994,Americas
Philippines,11-03-2020,103259,514,733,102526,Western Pacific
Poland,11-03-2020,381883,701,274,381609,Europe
Portugal,11-03-2020,374697,1582,452,374245,Europe
Qatar,11-03-2020,316099,476,575,315524,Eastern Mediterranean
Romania,11-03-2020,85317,1793,1101,84216,Europe
Russia,11-03-2020,79480,1749,822,78658,Europe
Rwanda,11-03-2020,62087,1643,278,61809,Africa
Saint Lucia,11-03-2020,227112,176,1176,225936,Americas
Saint Vincent and the Grenadines,11-03-2020,240430,938,297,240133,Americas
San Marino,11-03-2020,162455,1831,623,161832,Europe
Saudi Arabia,11-03-2020,45707,610,767,44940,Eastern Mediterranean
Senegal,11-03-2020,359684,624,1083,358601,Africa
Serbia,11-03-2020,111790,1403,297,111493,Europe
Seychelles,11-03-2020,361774,1681,341,361433,Africa
Singapore,11-03-2020,368071,277,1081,366990,Western Pacific
Slovakia,11-03-2020,252931,1517,39,252892,Europe
Slovenia,11-03-2020,3622,1008,175,3447,Europe
Somalia,11-03-2020,221128,1934,1076,220052,Eastern Mediterranean
South Africa,11-03-2020,74707,1670,837,73870,Africa
Spain,11-03-2020,12496,1019,734,11762,Europe
Sri Lanka,11-03-2020,384045,2144,1216,382829,South-East Asia
Sudan,11-03-2020,443245,36,1098,442147,Eastern Mediterranean
Suriname,11-03-2020,60365,2420,593,59772,Americas
Sweden,11-03-2020,365231,215,445,364786,Europe
Switzerland,11-03-2020,115040,2166,304,114736,Europe
Taiwan*,11-03-2020,332873,24,68,332805,Western Pacific
Tanzania,11-03-2020,64961,1440,1046,63915,Africa
Thailand,11-03-2020,178813,1779,988,177825,South-East Asia
Togo,11-03-2020,291775,601,991,290784,Africa
Trinidad and Tobago,11-03-2020,252057,959,119,251938,Americas
Tunisia,11-03-2020,279748,1677,127,279621,Eastern Mediterranean
Turkey,11-03-2020,291510,139,95,291415,Europe
Uganda,11-03-2020,365873,1787,238,365635,Africa
Ukraine,11-03-2020,320416,933,473,319943,Europe
United Arab Emirates,11-03-2020,266710,612,831,265879,Eastern Mediterranean
United Kingdom,11-03-2020,368401,498,588,367813,Europe
United Kingdom,11-03-2020,360882,2279,447,360435,Europe
United Kingdom,11-03-2020,92698,390,1052,91646,Europe
United Kingdom,11-03-2020,46077,578,40,46037,Europe
United Kingdom,11-03-2020,314644,1214,264,314380,Europe
United Kingdom,11-03-2020,378224,1101,687,377537,Europe
United Kingdom,11-03-2020,5512,983,832,4680,Europe
Uruguay,11-03-2020,148397,2,205,148192,Americas
US,11-03-2020,16526,938,654,15872,Americas
Uzbekistan,11-03-2020,289415,1132,952,288463,Europe
Venezuela,11-03-2020,110702,5,612,110090,Americas
Vietnam,11-03-2020,22401,2400,656,21745,Western Pacific
Zambia,11-03-2020,231125,1950,1136,229989,Africa
Zimbabwe,11-03-2020,32316,31,710,31606,Africa
Dominica,11-03-2020,327080,127,114,326966,Americas
Grenada,11-03-2020,179910,1417,1101,178809,Americas
Mozambique,11-03-2020,317442,1127,476,316966,Africa
Syria,11-03-2020,351061,198,194,350867,Eastern Mediterranean
Timor-Leste,11-03-2020,249209,683,403,248806,South-East Asia
Belize,11-03-2020,305214,2399,516,304698,Americas
Laos,11-03-2020,389809,68,286,389523,Western Pacific
Libya,11-03-2020,49797,1721,861,48936,Eastern Mediterranean
West Bank and Gaza,11-03-2020,251002,253,967,250035,Eastern Mediterranean
Guinea-Bissau,11-03-2020,405906,1020,384,405522,Africa
Mali,11-03-2020,357945,1119,752,357193,Africa
Saint Kitts and Nevis,11-03-2020,395905,1477,956,394949,Americas
Canada,11-03-2020,127577,687,1076,126501,Americas
Canada,11-03-2020,316174,1493,1197,314977,Americas
Kosovo,11-03-2020,87746,227,195,87551,Europe
Burma,11-03-2020,373859,427,150,373709,South-East Asia
United Kingdom,11-03-2020,228922,474,1061,227861,Europe
United Kingdom,11-03-2020,69112,1625,348,68764,Europe
United Kingdom,11-03-2020,161174,1998,578,160596,Europe
Botswana,11-03-2020,289322,23,366,288956,Africa
Burundi,11-03-2020,99510,2395,1230,98280,Africa
Sierra Leone,11-03-2020,35634,1385,438,35196,Africa
Malawi,11-03-2020,368383,1054,878,367505,Africa
United Kingdom,11-03-2020,72455,1001,262,72193,Europe
France,11-03-2020,49482,1832,349,49133,Europe
South Sudan,11-03-2020,174772,683,169,174603,Africa
Western Sahara,11-03-2020,125174,2425,846,124328,Africa
Sao Tome and Principe,11-03-2020,400335,1253,1102,399233,Africa
Yemen,11-03-2020,79971,1296,871,79100,Eastern Mediterranean
Comoros,11-03-2020,95202,90,310,94892,Africa
Tajikistan,11-03-2020,3934,1597,923,3011,Europe
Lesotho,11-03-2020,292595,693,713,291882,Africa
Afghanistan,12-03-2020,230347,247,476,229871,Eastern Mediterranean
Albania,12-03-2020,221064,1381,92,220972,Europe
Algeria,12-03-2020,383594,2098,53,383541,Africa
Andorra,12-03-2020,253231,1658,1248,251983,Europe
Angola,12-03-2020,120273,1511,288,119985,Africa
Antigua and Barbuda,12-03-2020,141968,914,1077,140891,Americas
Argentina,12-03-2020,410671,325,828,409843,Americas
Armenia,12-03-2020,219343,944,387,218956,Europe
Australia,12-03-2020,297726,282,1191,296535,Western Pacific
Australia,12-03-2020,140562,312,160,140402,Western Pacific
Australia,12-03-2020,231290,458,548,230742,Western Pacific
Australia,12-03-2020,153105,2370,80,153025,Western Pacific
Australia,12-03-2020,74396,446,449,73947,Western Pacific
Australia,12-03-2020,422609,1080,791,421818,Western Pacific
Australia,12-03-2020,426611,2362,1083,425528,Western Pacific
Australia,12-03-2020,332168,190,1090,331078,Western Pacific
Austria,12-03-2020,93544,567,251,93293,Europe
Azerbaijan,12-03-2020,408805,639,569,408236,Europe
Bahamas,12-03-2020,311682,1964,1087,310595,Americas
Bahrain,12-03-2020,208147,1994,426,207721,Eastern Mediterranean
Bangladesh,12-03-2020,106655,159,468,106187,South-East Asia
Barbados,12-03-2020,312082,1688,849,311233,Americas
Belarus,12-03-2020,342872,83,190,342682,Europe
Belgium,12-03-2020,87914,892,319,87595,Europe
Benin,12-03-2020,434842,622,403,434439,Africa
Bhutan,12-03-2020,417930,1850,1148,416782,South-East Asia
Bolivia,12-03-2020,152257,1530,947,151310,Americas
Bosnia and Herzegovina,12-03-2020,267404,1256,114,267290,Europe
Brazil,12-03-2020,140650,37,1112,139538,Americas
Brunei,12-03-2020,425058,1575,888,424170,Western Pacific
Bulgaria,12-03-2020,431381,2048,296,431085,Europe
Burkina Faso,12-03-2020,248175,1832,775,247400,Africa
Cabo Verde,12-03-2020,267976,2480,447,267529,Africa
Cambodia,12-03-2020,442774,355,899,441875,Western Pacific
Cameroon,12-03-2020,312406,461,259,312147,Africa
Canada,12-03-2020,407725,673,697,407028,Americas
Canada,12-03-2020,244041,568,457,243584,Americas
Canada,12-03-2020,14005,1031,421,13584,Americas
Canada,12-03-2020,60972,1853,1086,59886,Americas
Canada,12-03-2020,162999,734,117,162882,Americas
Canada,12-03-2020,211052,1228,105,210947,Americas
Canada,12-03-2020,115456,840,206,115250,Americas
Canada,12-03-2020,36007,1297,642,35365,Americas
Canada,12-03-2020,205368,2226,865,204503,Americas
Canada,12-03-2020,396206,680,12,396194,Americas
Central African Republic,12-03-2020,254554,2271,1064,253490,Africa
Chad,12-03-2020,345362,1233,510,344852,Africa
Chile,12-03-2020,441202,309,765,440437,Americas
China,12-03-2020,277316,623,591,276725,Western Pacific
China,12-03-2020,205214,2277,673,204541,Western Pacific
China,12-03-2020,410873,687,723,410150,Western Pacific
China,12-03-2020,337421,2283,853,336568,Western Pacific
China,12-03-2020,190737,775,720,190017,Western Pacific
China,12-03-2020,169391,1227,1189,168202,Western Pacific
China,12-03-2020,221313,2141,452,220861,Western Pacific
China,12-03-2020,348047,1784,129,347918,Western Pacific
China,12-03-2020,340684,717,329,340355,Western Pacific
China,12-03-2020,226608,1948,862,225746,Western Pacific
China,12-03-2020,46981,1736,1117,45864,Western Pacific
China,12-03-2020,341911,876,2,341909,Western Pacific
China,12-03-2020,34921,366,474,34447,Western Pacific
China,12-03-2020,94033,46,573,93460,Western Pacific
China,12-03-2020,333185,1977,529,332656,Western Pacific
China,12-03-2020,99521,1793,84,99437,Western Pacific
China,12-03-2020,55866,1435,985,54881,Western Pacific
China,12-03-2020,154474,1980,1165,153309,Western Pacific
China,12-03-2020,276956,2499,78,276878,Western Pacific
China,12-03-2020,146082,2000,180,145902,Western Pacific
China,12-03-2020,7374,1301,80,7294,Western Pacific
China,12-03-2020,371263,693,729,370534,Western Pacific
China,12-03-2020,145280,802,716,144564,Western Pacific
China,12-03-2020,297743,754,448,297295,Western Pacific
China,12-03-2020,447273,1571,557,446716,Western Pacific
China,12-03-2020,60533,1,837,59696,Western Pacific
China,12-03-2020,336170,1970,944,335226,Western Pacific
China,12-03-2020,44811,1669,564,44247,Western Pacific
China,12-03-2020,57585,312,289,57296,Western Pacific
China,12-03-2020,93103,506,256,92847,Western Pacific
China,12-03-2020,420838,314,143,420695,Western Pacific
China,12-03-2020,366911,2292,71,366840,Western Pacific
China,12-03-2020,340682,224,48,340634,Western Pacific
Colombia,12-03-2020,101703,1959,1015,100688,Americas
Congo (Brazzaville),12-03-2020,407877,1403,1103,406774,Africa
Congo (Kinshasa),12-03-2020,51181,2065,37,51144,Africa
Costa Rica,12-03-2020,270258,1463,405,269853,Americas
Cote d'Ivoire,12-03-2020,320227,1501,82,320145,Africa
Croatia,12-03-2020,342892,1040,82,342810,Europe
Cuba,12-03-2020,280288,417,186,280102,Americas
Cyprus,12-03-2020,413054,54,1090,411964,Europe
Czechia,12-03-2020,245093,41,220,244873,Europe
Denmark,12-03-2020,212642,1140,291,212351,Europe
Greenland,12-03-2020,14711,2089,183,14528,Europe
Denmark,12-03-2020,395624,1207,76,395548,Europe
Djibouti,12-03-2020,378349,584,972,377377,Eastern Mediterranean
Dominican Republic,12-03-2020,163092,861,735,162357,Americas
Ecuador,12-03-2020,337614,1745,614,337000,Americas
Egypt,12-03-2020,207748,131,737,207011,Eastern Mediterranean
El Salvador,12-03-2020,261843,1672,145,261698,Americas
Equatorial Guinea,12-03-2020,17864,961,504,17360,Africa
Eritrea,12-03-2020,164862,1192,462,164400,Africa
Estonia,12-03-2020,124252,589,855,123397,Europe
Eswatini,12-03-2020,347051,169,1193,345858,Africa
Ethiopia,12-03-2020,131276,459,159,131117,Africa
Fiji,12-03-2020,27848,674,302,27546,Western Pacific
Finland,12-03-2020,187519,1808,879,186640,Europe
France,12-03-2020,360222,2287,141,360081,Europe
France,12-03-2020,306676,1284,9,306667,Europe
France,12-03-2020,147225,2370,416,146809,Europe
France,12-03-2020,325998,1108,666,325332,Europe
France,12-03-2020,398966,1314,1197,397769,Europe
France,12-03-2020,379878,1095,565,379313,Europe
France,12-03-2020,288370,1174,270,288100,Europe
France,12-03-2020,261288,1153,240,261048,Europe
France,12-03-2020,366804,2030,2,366802,Europe
France,12-03-2020,296273,1667,326,295947,Europe
Gabon,12-03-2020,13165,2494,218,12947,Africa
Gambia,12-03-2020,286924,412,384,286540,Africa
Georgia,12-03-2020,344006,2180,790,343216,Europe
Germany,12-03-2020,266673,235,943,265730,Europe
Ghana,12-03-2020,302087,638,1020,301067,Africa
Greece,12-03-2020,161726,1302,907,160819,Europe
Guatemala,12-03-2020,351968,1890,622,351346,Americas
Guinea,12-03-2020,170548,1342,1035,169513,Africa
Guyana,12-03-2020,162587,181,870,161717,Americas
Haiti,12-03-2020,10063,2453,580,9483,Americas
Holy See,12-03-2020,435278,4,985,434293,Europe
Honduras,12-03-2020,195501,1622,299,195202,Americas
Hungary,12-03-2020,357602,161,62,357540,Europe
Iceland,12-03-2020,106447,1469,667,105780,Europe
India,12-03-2020,425093,1218,1193,423900,South-East Asia
Indonesia,12-03-2020,281861,1703,777,281084,South-East Asia
Iran,12-03-2020,85755,809,924,84831,Eastern Mediterranean
Iraq,12-03-2020,153010,2228,353,152657,Eastern Mediterranean
Ireland,12-03-2020,275860,1211,985,274875,Europe
Israel,12-03-2020,389686,21,991,388695,Europe
Italy,12-03-2020,30665,162,25,30640,Europe
Jamaica,12-03-2020,109213,1954,573,108640,Americas
Japan,12-03-2020,270304,241,1178,269126,Western Pacific
Jordan,12-03-2020,448358,2233,1049,447309,Eastern Mediterranean
Kazakhstan,12-03-2020,232249,1935,490,231759,Europe
Kenya,12-03-2020,14444,208,423,14021,Africa
South Korea,12-03-2020,59259,243,1146,58113,Western Pacific
Kuwait,12-03-2020,373175,1631,898,372277,Eastern Mediterranean
Kyrgyzstan,12-03-2020,417472,2112,1103,416369,Europe
Latvia,12-03-2020,430981,1428,311,430670,Europe
Lebanon,12-03-2020,383080,1455,1205,381875,Eastern Mediterranean
Liberia,12-03-2020,93768,1072,581,93187,Africa
Liechtenstein,12-03-2020,211808,849,866,210942,Europe
Lithuania,12-03-2020,418118,120,563,417555,Europe
Luxembourg,12-03-2020,77598,645,300,77298,Europe
Madagascar,12-03-2020,418637,1339,1075,417562,Africa
Malaysia,12-03-2020,114284,1337,48,114236,Western Pacific
Maldives,12-03-2020,240524,2200,336,240188,South-East Asia
Malta,12-03-2020,236538,1889,783,235755,Europe
Mauritania,12-03-2020,67825,962,909,66916,Africa
Mauritius,12-03-2020,388444,2278,734,387710,Africa
Mexico,12-03-2020,130588,1212,525,130063,Americas
Moldova,12-03-2020,308950,2310,1189,307761,Europe
Monaco,12-03-2020,385312,1080,493,384819,Europe
Mongolia,12-03-2020,90912,590,546,90366,Western Pacific
Montenegro,12-03-2020,339299,2161,392,338907,Europe
Morocco,12-03-2020,311672,522,1003,310669,Eastern Mediterranean
Namibia,12-03-2020,144267,928,242,144025,Africa
Nepal,12-03-2020,103347,555,773,102574,South-East Asia
Netherlands,12-03-2020,120494,1948,524,119970,Europe
Netherlands,12-03-2020,80016,295,540,79476,Europe
Netherlands,12-03-2020,247870,142,391,247479,Europe
Netherlands,12-03-2020,45071,1342,871,44200,Europe
New Zealand,12-03-2020,210771,1069,689,210082,Western Pacific
Nicaragua,12-03-2020,376061,464,808,375253,Americas
Niger,12-03-2020,285251,2393,651,284600,Africa
Nigeria,12-03-2020,416320,2436,1016,415304,Africa
North Macedonia,12-03-2020,121527,890,1025,120502,Europe
Norway,12-03-2020,211332,532,3,211329,Europe
Oman,12-03-2020,123545,304,951,122594,Eastern Mediterranean
Pakistan,12-03-2020,62065,1900,632,61433,Eastern Mediterranean
Panama,12-03-2020,265251,2013,218,265033,Americas
Papua New Guinea,12-03-2020,46398,845,53,46345,Western Pacific
Paraguay,12-03-2020,139799,429,750,139049,Americas
Peru,12-03-2020,247050,767,610,246440,Americas
Philippines,12-03-2020,169128,1742,746,168382,Western Pacific
Poland,12-03-2020,233409,651,952,232457,Europe
Portugal,12-03-2020,180418,1537,861,179557,Europe
Qatar,12-03-2020,233366,1855,385,232981,Eastern Mediterranean
Romania,12-03-2020,347551,670,347,347204,Europe
Russia,12-03-2020,337575,401,1064,336511,Europe
Rwanda,12-03-2020,122985,1296,385,122600,Africa
Saint Lucia,12-03-2020,52749,2363,998,51751,Americas
Saint Vincent and the Grenadines,12-03-2020,204429,510,422,204007,Americas
San Marino,12-03-2020,19380,1462,197,19183,Europe
Saudi Arabia,12-03-2020,351138,1052,1075,350063,Eastern Mediterranean
Senegal,12-03-2020,283459,1691,451,283008,Africa
Serbia,12-03-2020,307393,625,260,307133,Europe
Seychelles,12-03-2020,374051,1213,1215,372836,Africa
Singapore,12-03-2020,313982,196,638,313344,Western Pacific
Slovakia,12-03-2020,409049,638,948,408101,Europe
Slovenia,12-03-2020,150015,1699,1193,148822,Europe
Somalia,12-03-2020,61869,962,979,60890,Eastern Mediterranean
South Africa,12-03-2020,326708,197,1211,325497,Africa
Spain,12-03-2020,152812,1354,570,152242,Europe
Sri Lanka,12-03-2020,220468,2102,1218,219250,South-East Asia
Sudan,12-03-2020,245626,1527,1031,244595,Eastern Mediterranean
Suriname,12-03-2020,241138,1017,1049,240089,Americas
Sweden,12-03-2020,368002,1865,877,367125,Europe
Switzerland,12-03-2020,37999,571,1188,36811,Europe
Taiwan*,12-03-2020,165773,1125,393,165380,Western Pacific
Tanzania,12-03-2020,431119,1971,260,430859,Africa
Thailand,12-03-2020,197376,569,1001,196375,South-East Asia
Togo,12-03-2020,67274,1770,171,67103,Africa
Trinidad and Tobago,12-03-2020,275572,2309,434,275138,Americas
Tunisia,12-03-2020,185727,1635,450,185277,Eastern Mediterranean
Turkey,12-03-2020,9170,1928,152,9018,Europe
Uganda,12-03-2020,176044,1594,529,175515,Africa
Ukraine,12-03-2020,207628,1453,777,206851,Europe
United Arab Emirates,12-03-2020,417126,533,508,416618,Eastern Mediterranean
United Kingdom,12-03-2020,405337,2040,284,405053,Europe
United Kingdom,12-03-2020,381972,1748,493,381479,Europe
United Kingdom,12-03-2020,307745,1884,212,307533,Europe
United Kingdom,12-03-2020,226594,2213,1066,225528,Europe
United Kingdom,12-03-2020,85024,809,1054,83970,Europe
United Kingdom,12-03-2020,30403,1306,607,29796,Europe
United Kingdom,12-03-2020,223936,485,143,223793,Europe
Uruguay,12-03-2020,34151,998,435,33716,Americas
US,12-03-2020,109836,449,848,108988,Americas
Uzbekistan,12-03-2020,411597,1462,434,411163,Europe
Venezuela,12-03-2020,209845,1139,856,208989,Americas
Vietnam,12-03-2020,294627,572,186,294441,Western Pacific
Zambia,12-03-2020,376770,1097,601,376169,Africa
Zimbabwe,12-03-2020,49069,165,877,48192,Africa
Dominica,12-03-2020,287414,2418,538,286876,Americas
Grenada,12-03-2020,317470,1829,836,316634,Americas
Mozambique,12-03-2020,291730,812,1177,290553,Africa
Syria,12-03-2020,144331,133,1021,143310,Eastern Mediterranean
Timor-Leste,12-03-2020,20820,1492,1080,19740,South-East Asia
Belize,12-03-2020,12147,2465,444,11703,Americas
Laos,12-03-2020,255396,1706,140,255256,Western Pacific
Libya,12-03-2020,148565,2425,1097,147468,Eastern Mediterranean
West Bank and Gaza,12-03-2020,70212,340,19,70193,Eastern Mediterranean
Guinea-Bissau,12-03-2020,287542,1122,671,286871,Africa
Mali,12-03-2020,238248,60,300,237948,Africa
Saint Kitts and Nevis,12-03-2020,356635,1152,908,355727,Americas
Canada,12-03-2020,132040,814,230,131810,Americas
Canada,12-03-2020,250717,35,1139,249578,Americas
Kosovo,12-03-2020,209187,1882,277,208910,Europe
Burma,12-03-2020,17312,488,611,16701,South-East Asia
United Kingdom,12-03-2020,186285,83,1068,185217,Europe
United Kingdom,12-03-2020,140477,1900,342,140135,Europe
United Kingdom,12-03-2020,93729,2397,480,93249,Europe
Botswana,12-03-2020,2041,1182,74,1967,Africa
Burundi,12-03-2020,435863,380,102,435761,Africa
Sierra Leone,12-03-2020,51333,1118,230,51103,Africa
Malawi,12-03-2020,214966,2113,693,214273,Africa
United Kingdom,12-03-2020,255245,2060,771,254474,Europe
France,12-03-2020,259081,1749,1093,257988,Europe
South Sudan,12-03-2020,174473,1500,100,174373,Africa
Western Sahara,12-03-2020,379927,718,1103,378824,Africa
Sao Tome and Principe,12-03-2020,178998,1315,931,178067,Africa
Yemen,12-03-2020,258952,883,474,258478,Eastern Mediterranean
Comoros,12-03-2020,78258,65,196,78062,Africa
Tajikistan,12-03-2020,110280,2015,814,109466,Europe
Lesotho,12-03-2020,300414,857,946,299468,Africa
Afghanistan,13-03-2020,312999,2461,1233,311766,Eastern Mediterranean
Albania,13-03-2020,68986,1003,676,68310,Europe
Algeria,13-03-2020,2694,1577,23,2671,Africa
Andorra,13-03-2020,89862,851,257,89605,Europe
Angola,13-03-2020,222796,1063,609,222187,Africa
Antigua and Barbuda,13-03-2020,37759,886,1225,36534,Americas
Argentina,13-03-2020,49294,1918,202,49092,Americas
Armenia,13-03-2020,76118,400,1138,74980,Europe
Australia,13-03-2020,441935,640,817,441118,Western Pacific
Australia,13-03-2020,269989,1781,1056,268933,Western Pacific
Australia,13-03-2020,120173,1559,1184,118989,Western Pacific
Australia,13-03-2020,65989,1226,1035,64954,Western Pacific
Australia,13-03-2020,350280,2176,754,349526,Western Pacific
Australia,13-03-2020,57191,623,617,56574,Western Pacific
Australia,13-03-2020,290139,368,101,290038,Western Pacific
Australia,13-03-2020,40139,148,912,39227,Western Pacific
Austria,13-03-2020,370478,1456,591,369887,Europe
Azerbaijan,13-03-2020,357540,1365,368,357172,Europe
Bahamas,13-03-2020,327229,2305,998,326231,Americas
Bahrain,13-03-2020,94800,647,636,94164,Eastern Mediterranean
Bangladesh,13-03-2020,359876,328,883,358993,South-East Asia
Barbados,13-03-2020,206790,1082,1124,205666,Americas
Belarus,13-03-2020,152717,1895,775,151942,Europe
Belgium,13-03-2020,192932,1136,653,192279,Europe
Benin,13-03-2020,285960,1950,884,285076,Africa
Bhutan,13-03-2020,227953,153,641,227312,South-East Asia
Bolivia,13-03-2020,289490,1826,333,289157,Americas
Bosnia and Herzegovina,13-03-2020,412137,681,289,411848,Europe
Brazil,13-03-2020,359440,1940,192,359248,Americas
Brunei,13-03-2020,223247,299,873,222374,Western Pacific
Bulgaria,13-03-2020,14293,1782,258,14035,Europe
Burkina Faso,13-03-2020,351785,356,398,351387,Africa
Cabo Verde,13-03-2020,385758,1520,348,385410,Africa
Cambodia,13-03-2020,296679,1229,598,296081,Western Pacific
Cameroon,13-03-2020,297133,1615,997,296136,Africa
Canada,13-03-2020,432641,57,905,431736,Americas
Canada,13-03-2020,335622,2454,154,335468,Americas
Canada,13-03-2020,158638,1721,1221,157417,Americas
Canada,13-03-2020,109266,541,595,108671,Americas
Canada,13-03-2020,309626,1633,479,309147,Americas
Canada,13-03-2020,363083,1944,409,362674,Americas
Canada,13-03-2020,218444,2408,877,217567,Americas
Canada,13-03-2020,61520,71,70,61450,Americas
Canada,13-03-2020,125460,916,555,124905,Americas
Canada,13-03-2020,409144,513,356,408788,Americas
Central African Republic,13-03-2020,97023,2288,218,96805,Africa
Chad,13-03-2020,127113,2376,1092,126021,Africa
Chile,13-03-2020,206051,1677,1142,204909,Americas
China,13-03-2020,42654,2239,381,42273,Western Pacific
China,13-03-2020,390289,1122,544,389745,Western Pacific
China,13-03-2020,244582,2452,802,243780,Western Pacific
China,13-03-2020,230453,1922,867,229586,Western Pacific
China,13-03-2020,75355,264,527,74828,Western Pacific
China,13-03-2020,415461,220,108,415353,Western Pacific
China,13-03-2020,306583,74,1117,305466,Western Pacific
China,13-03-2020,131646,128,244,131402,Western Pacific
China,13-03-2020,55822,615,913,54909,Western Pacific
China,13-03-2020,227918,620,577,227341,Western Pacific
China,13-03-2020,138292,1008,761,137531,Western Pacific
China,13-03-2020,96928,1256,747,96181,Western Pacific
China,13-03-2020,362174,304,1235,360939,Western Pacific
China,13-03-2020,213576,619,1004,212572,Western Pacific
China,13-03-2020,309499,2101,644,308855,Western Pacific
China,13-03-2020,401922,1053,504,401418,Western Pacific
China,13-03-2020,231355,895,290,231065,Western Pacific
China,13-03-2020,432602,2463,717,431885,Western Pacific
China,13-03-2020,157873,432,209,157664,Western Pacific
China,13-03-2020,63371,680,595,62776,Western Pacific
China,13-03-2020,355753,881,308,355445,Western Pacific
China,13-03-2020,382840,1662,157,382683,Western Pacific
China,13-03-2020,252951,942,877,252074,Western Pacific
China,13-03-2020,417766,1296,915,416851,Western Pacific
China,13-03-2020,63151,1909,733,62418,Western Pacific
China,13-03-2020,41639,1311,835,40804,Western Pacific
China,13-03-2020,55231,311,365,54866,Western Pacific
China,13-03-2020,414144,357,649,413495,Western Pacific
China,13-03-2020,21264,568,924,20340,Western Pacific
China,13-03-2020,321148,159,1133,320015,Western Pacific
China,13-03-2020,265654,1784,317,265337,Western Pacific
China,13-03-2020,225017,1280,171,224846,Western Pacific
China,13-03-2020,18929,847,628,18301,Western Pacific
Colombia,13-03-2020,411509,763,1168,410341,Americas
Congo (Brazzaville),13-03-2020,100149,434,873,99276,Africa
Congo (Kinshasa),13-03-2020,237443,1033,1228,236215,Africa
Costa Rica,13-03-2020,386258,1239,1047,385211,Americas
Cote d'Ivoire,13-03-2020,266073,979,578,265495,Africa
Croatia,13-03-2020,407977,374,695,407282,Europe
Cuba,13-03-2020,52900,1919,1151,51749,Americas
Cyprus,13-03-2020,410925,1228,372,410553,Europe
Czechia,13-03-2020,448232,663,71,448161,Europe
Denmark,13-03-2020,211450,1477,473,210977,Europe
Greenland,13-03-2020,151898,146,1172,150726,Europe
Denmark,13-03-2020,332523,2453,804,331719,Europe
Djibouti,13-03-2020,301365,2328,306,301059,Eastern Mediterranean
Dominican Republic,13-03-2020,282521,1208,229,282292,Americas
Ecuador,13-03-2020,45494,1831,1048,44446,Americas
Egypt,13-03-2020,320706,2115,1040,319666,Eastern Mediterranean
El Salvador,13-03-2020,307327,557,333,306994,Americas
Equatorial Guinea,13-03-2020,230023,1688,904,229119,Africa
Eritrea,13-03-2020,64511,738,828,63683,Africa
Estonia,13-03-2020,357024,345,388,356636,Europe
Eswatini,13-03-2020,53985,487,1085,52900,Africa
Ethiopia,13-03-2020,284646,2110,421,284225,Africa
Fiji,13-03-2020,264538,170,185,264353,Western Pacific
Finland,13-03-2020,347336,1659,448,346888,Europe
France,13-03-2020,140625,1639,48,140577,Europe
France,13-03-2020,5783,1896,114,5669,Europe
France,13-03-2020,265287,2010,727,264560,Europe
France,13-03-2020,9991,114,565,9426,Europe
France,13-03-2020,164531,947,730,163801,Europe
France,13-03-2020,263497,1019,5,263492,Europe
France,13-03-2020,122684,656,1216,121468,Europe
France,13-03-2020,173226,1129,766,172460,Europe
France,13-03-2020,359425,134,1226,358199,Europe
France,13-03-2020,193291,299,368,192923,Europe
Gabon,13-03-2020,157286,865,1022,156264,Africa
Gambia,13-03-2020,343741,1227,439,343302,Africa
Georgia,13-03-2020,197119,1840,48,197071,Europe
Germany,13-03-2020,412204,558,540,411664,Europe
Ghana,13-03-2020,332112,2461,479,331633,Africa
Greece,13-03-2020,306114,591,238,305876,Europe
Guatemala,13-03-2020,336578,1889,1140,335438,Americas
Guinea,13-03-2020,289437,1375,228,289209,Africa
Guyana,13-03-2020,312694,211,1119,311575,Americas
Haiti,13-03-2020,120874,2493,1019,119855,Americas
Holy See,13-03-2020,274025,1939,322,273703,Europe
Honduras,13-03-2020,268850,1717,106,268744,Americas
Hungary,13-03-2020,379881,1080,805,379076,Europe
Iceland,13-03-2020,392832,261,585,392247,Europe
India,13-03-2020,178440,1629,1212,177228,South-East Asia
Indonesia,13-03-2020,112305,1213,763,111542,South-East Asia
Iran,13-03-2020,333650,854,663,332987,Eastern Mediterranean
Iraq,13-03-2020,130145,1595,588,129557,Eastern Mediterranean
Ireland,13-03-2020,395902,2153,221,395681,Europe
Israel,13-03-2020,371098,1929,1201,369897,Europe
Italy,13-03-2020,145644,2200,468,145176,Europe
Jamaica,13-03-2020,73580,1232,1048,72532,Americas
Japan,13-03-2020,2227,1516,953,1274,Western Pacific
Jordan,13-03-2020,175166,646,601,174565,Eastern Mediterranean
Kazakhstan,13-03-2020,298978,1643,127,298851,Europe
Kenya,13-03-2020,382085,1460,254,381831,Africa
South Korea,13-03-2020,122214,1523,621,121593,Western Pacific
Kuwait,13-03-2020,139513,281,96,139417,Eastern Mediterranean
Kyrgyzstan,13-03-2020,158313,2244,425,157888,Europe
Latvia,13-03-2020,151058,461,441,150617,Europe
Lebanon,13-03-2020,152196,285,230,151966,Eastern Mediterranean
Liberia,13-03-2020,112379,1117,475,111904,Africa
Liechtenstein,13-03-2020,359365,1927,12,359353,Europe
Lithuania,13-03-2020,446892,808,912,445980,Europe
Luxembourg,13-03-2020,74726,1319,348,74378,Europe
Madagascar,13-03-2020,10366,826,810,9556,Africa
Malaysia,13-03-2020,238926,1765,1119,237807,Western Pacific
Maldives,13-03-2020,421694,1008,1025,420669,South-East Asia
Malta,13-03-2020,27167,81,125,27042,Europe
Mauritania,13-03-2020,166420,2432,490,165930,Africa
Mauritius,13-03-2020,293982,1476,990,292992,Africa
Mexico,13-03-2020,76376,211,230,76146,Americas
Moldova,13-03-2020,247208,730,511,246697,Europe
Monaco,13-03-2020,160627,1348,103,160524,Europe
Mongolia,13-03-2020,4998,2383,1084,3914,Western Pacific
Montenegro,13-03-2020,82783,2462,788,81995,Europe
Morocco,13-03-2020,76814,1238,973,75841,Eastern Mediterranean
Namibia,13-03-2020,219597,692,336,219261,Africa
Nepal,13-03-2020,161697,1568,829,160868,South-East Asia
Netherlands,13-03-2020,280232,349,486,279746,Europe
Netherlands,13-03-2020,143828,446,1215,142613,Europe
Netherlands,13-03-2020,363078,1941,822,362256,Europe
Netherlands,13-03-2020,148484,2288,1234,147250,Europe
New Zealand,13-03-2020,13943,593,914,13029,Western Pacific
Nicaragua,13-03-2020,78784,1248,1023,77761,Americas
Niger,13-03-2020,56635,2383,303,56332,Africa
Nigeria,13-03-2020,343886,362,826,343060,Africa
North Macedonia,13-03-2020,65130,326,801,64329,Europe
Norway,13-03-2020,137520,176,518,137002,Europe
Oman,13-03-2020,9204,463,493,8711,Eastern Mediterranean
Pakistan,13-03-2020,113798,1822,503,113295,Eastern Mediterranean
Panama,13-03-2020,373584,1429,24,373560,Americas
Papua New Guinea,13-03-2020,634,961,980,-346,Western Pacific
Paraguay,13-03-2020,103986,1311,1171,102815,Americas
Peru,13-03-2020,126429,552,1204,125225,Americas
Philippines,13-03-2020,412486,1016,1125,411361,Western Pacific
Poland,13-03-2020,9439,868,845,8594,Europe
Portugal,13-03-2020,174798,1157,868,173930,Europe
Qatar,13-03-2020,424377,387,1082,423295,Eastern Mediterranean
Romania,13-03-2020,285510,1334,1100,284410,Europe
Russia,13-03-2020,188688,1512,551,188137,Europe
Rwanda,13-03-2020,217073,2441,143,216930,Africa
Saint Lucia,13-03-2020,410865,2200,674,410191,Americas
Saint Vincent and the Grenadines,13-03-2020,168774,749,10,168764,Americas
San Marino,13-03-2020,235748,218,335,235413,Europe
Saudi Arabia,13-03-2020,239,1889,753,-514,Eastern Mediterranean
Senegal,13-03-2020,182216,1660,869,181347,Africa
Serbia,13-03-2020,95951,1247,510,95441,Europe
Seychelles,13-03-2020,101283,570,1088,100195,Africa
Singapore,13-03-2020,45565,2181,800,44765,Western Pacific
Slovakia,13-03-2020,79248,1028,156,79092,Europe
Slovenia,13-03-2020,388909,1715,719,388190,Europe
Somalia,13-03-2020,44943,2392,750,44193,Eastern Mediterranean
South Africa,13-03-2020,169511,315,1153,168358,Africa
Spain,13-03-2020,253685,1292,433,253252,Europe
Sri Lanka,13-03-2020,318209,1082,954,317255,South-East Asia
Sudan,13-03-2020,94400,393,864,93536,Eastern Mediterranean
Suriname,13-03-2020,61878,683,944,60934,Americas
Sweden,13-03-2020,92329,1956,1229,91100,Europe
Switzerland,13-03-2020,17396,2297,207,17189,Europe
Taiwan*,13-03-2020,10690,1001,629,10061,Western Pacific
Tanzania,13-03-2020,190481,1666,978,189503,Africa
Thailand,13-03-2020,441276,1458,200,441076,South-East Asia
Togo,13-03-2020,85104,1219,1225,83879,Africa
Trinidad and Tobago,13-03-2020,350756,400,112,350644,Americas
Tunisia,13-03-2020,401350,972,1053,400297,Eastern Mediterranean
Turkey,13-03-2020,229479,654,866,228613,Europe
Uganda,13-03-2020,184920,1160,965,183955,Africa
Ukraine,13-03-2020,89768,1004,416,89352,Europe
United Arab Emirates,13-03-2020,355950,713,1202,354748,Eastern Mediterranean
United Kingdom,13-03-2020,59613,1245,494,59119,Europe
United Kingdom,13-03-2020,258961,1805,90,258871,Europe
United Kingdom,13-03-2020,53816,850,610,53206,Europe
United Kingdom,13-03-2020,232004,2382,1028,230976,Europe
United Kingdom,13-03-2020,26043,748,1031,25012,Europe
United Kingdom,13-03-2020,165869,1732,429,165440,Europe
United Kingdom,13-03-2020,186760,1214,286,186474,Europe
Uruguay,13-03-2020,223966,742,1132,222834,Americas
US,13-03-2020,167966,148,40,167926,Americas
Uzbekistan,13-03-2020,97895,936,744,97151,Europe
Venezuela,13-03-2020,71147,2271,118,71029,Americas
Vietnam,13-03-2020,296947,1163,58,296889,Western Pacific
Zambia,13-03-2020,299288,690,975,298313,Africa
Zimbabwe,13-03-2020,50548,759,845,49703,Africa
Dominica,13-03-2020,382934,899,257,382677,Americas
Grenada,13-03-2020,163575,1229,71,163504,Americas
Mozambique,13-03-2020,176290,296,48,176242,Africa
Syria,13-03-2020,304354,336,437,303917,Eastern Mediterranean
Timor-Leste,13-03-2020,287961,1896,128,287833,South-East Asia
Belize,13-03-2020,394903,1024,1158,393745,Americas
Laos,13-03-2020,41489,141,13,41476,Western Pacific
Libya,13-03-2020,426561,2322,280,426281,Eastern Mediterranean
West Bank and Gaza,13-03-2020,382195,2475,1044,381151,Eastern Mediterranean
Guinea-Bissau,13-03-2020,165885,281,906,164979,Africa
Mali,13-03-2020,34693,694,895,33798,Africa
Saint Kitts and Nevis,13-03-2020,402936,491,693,402243,Americas
Canada,13-03-2020,402305,514,355,401950,Americas
Canada,13-03-2020,70844,1571,401,70443,Americas
Kosovo,13-03-2020,39226,2074,833,38393,Europe
Burma,13-03-2020,202872,1653,881,201991,South-East Asia
United Kingdom,13-03-2020,88554,2204,736,87818,Europe
United Kingdom,13-03-2020,419525,2294,41,419484,Europe
United Kingdom,13-03-2020,8556,2176,713,7843,Europe
Botswana,13-03-2020,200904,1739,118,200786,Africa
Burundi,13-03-2020,260698,1079,281,260417,Africa
Sierra Leone,13-03-2020,7591,122,862,6729,Africa
Malawi,13-03-2020,214953,1708,234,214719,Africa
United Kingdom,13-03-2020,47908,876,878,47030,Europe
France,13-03-2020,41132,284,548,40584,Europe
South Sudan,13-03-2020,195625,2178,486,195139,Africa
Western Sahara,13-03-2020,171172,943,1052,170120,Africa
Sao Tome and Principe,13-03-2020,311020,227,15,311005,Africa
Yemen,13-03-2020,304790,234,1236,303554,Eastern Mediterranean
Comoros,13-03-2020,180074,1466,89,179985,Africa
Tajikistan,13-03-2020,16256,479,79,16177,Europe
Lesotho,13-03-2020,122339,1818,379,121960,Africa
Afghanistan,14-03-2020,411048,2392,1113,409935,Eastern Mediterranean
Albania,14-03-2020,347303,1853,647,346656,Europe
Algeria,14-03-2020,442630,583,614,442016,Africa
Andorra,14-03-2020,333235,191,187,333048,Europe
Angola,14-03-2020,176656,1989,944,175712,Africa
Antigua and Barbuda,14-03-2020,193807,1322,1070,192737,Americas
Argentina,14-03-2020,105437,250,494,104943,Americas
Armenia,14-03-2020,407078,1626,279,406799,Europe
Australia,14-03-2020,336923,364,1144,335779,Western Pacific
Australia,14-03-2020,286105,2265,1188,284917,Western Pacific
Australia,14-03-2020,74194,1867,816,73378,Western Pacific
Australia,14-03-2020,14934,2425,751,14183,Western Pacific
Australia,14-03-2020,264373,1937,646,263727,Western Pacific
Australia,14-03-2020,233054,891,342,232712,Western Pacific
Australia,14-03-2020,90435,763,1231,89204,Western Pacific
Australia,14-03-2020,286869,1452,445,286424,Western Pacific
Austria,14-03-2020,78630,1002,76,78554,Europe
Azerbaijan,14-03-2020,414597,1473,820,413777,Europe
Bahamas,14-03-2020,212813,271,1094,211719,Americas
Bahrain,14-03-2020,123736,1164,776,122960,Eastern Mediterranean
Bangladesh,14-03-2020,442164,1800,53,442111,South-East Asia
Barbados,14-03-2020,340502,2344,224,340278,Americas
Belarus,14-03-2020,187344,2408,964,186380,Europe
Belgium,14-03-2020,366844,1998,1080,365764,Europe
Benin,14-03-2020,187703,1644,906,186797,Africa
Bhutan,14-03-2020,148994,1143,101,148893,South-East Asia
Bolivia,14-03-2020,302304,604,727,301577,Americas
Bosnia and Herzegovina,14-03-2020,415207,1501,268,414939,Europe
Brazil,14-03-2020,201468,228,933,200535,Americas
Brunei,14-03-2020,400795,721,126,400669,Western Pacific
Bulgaria,14-03-2020,305636,282,441,305195,Europe
Burkina Faso,14-03-2020,120417,1308,94,120323,Africa
Cabo Verde,14-03-2020,373142,1853,175,372967,Africa
Cambodia,14-03-2020,108435,408,1212,107223,Western Pacific
Cameroon,14-03-2020,428592,499,684,427908,Africa
Canada,14-03-2020,140039,110,57,139982,Americas
Canada,14-03-2020,249254,2025,250,249004,Americas
Canada,14-03-2020,284821,2469,13,284808,Americas
Canada,14-03-2020,176808,1083,475,176333,Americas
Canada,14-03-2020,46450,2181,882,45568,Americas
Canada,14-03-2020,48779,551,770,48009,Americas
Canada,14-03-2020,434368,134,713,433655,Americas
Canada,14-03-2020,262034,1921,793,261241,Americas
Canada,14-03-2020,275351,1944,201,275150,Americas
Canada,14-03-2020,64872,1037,344,64528,Americas
Central African Republic,14-03-2020,107626,1011,656,106970,Africa
Chad,14-03-2020,397211,172,898,396313,Africa
Chile,14-03-2020,236560,1092,762,235798,Americas
China,14-03-2020,293987,1648,465,293522,Western Pacific
China,14-03-2020,240032,1932,147,239885,Western Pacific
China,14-03-2020,225853,413,443,225410,Western Pacific
China,14-03-2020,432232,741,490,431742,Western Pacific
China,14-03-2020,408636,100,696,407940,Western Pacific
China,14-03-2020,413363,619,45,413318,Western Pacific
China,14-03-2020,15452,1069,444,15008,Western Pacific
China,14-03-2020,380352,91,632,379720,Western Pacific
China,14-03-2020,231114,62,1233,229881,Western Pacific
China,14-03-2020,427787,767,702,427085,Western Pacific
China,14-03-2020,281082,1050,193,280889,Western Pacific
China,14-03-2020,339629,1356,628,339001,Western Pacific
China,14-03-2020,228477,2250,115,228362,Western Pacific
China,14-03-2020,297271,633,876,296395,Western Pacific
China,14-03-2020,121945,1343,634,121311,Western Pacific
China,14-03-2020,284565,812,945,283620,Western Pacific
China,14-03-2020,416927,1511,1160,415767,Western Pacific
China,14-03-2020,138335,805,1136,137199,Western Pacific
China,14-03-2020,374525,1656,973,373552,Western Pacific
China,14-03-2020,301091,1062,1019,300072,Western Pacific
China,14-03-2020,287649,2109,1130,286519,Western Pacific
China,14-03-2020,200269,1583,768,199501,Western Pacific
China,14-03-2020,129654,373,15,129639,Western Pacific
China,14-03-2020,56255,768,823,55432,Western Pacific
China,14-03-2020,374334,1948,719,373615,Western Pacific
China,14-03-2020,105125,2487,415,104710,Western Pacific
China,14-03-2020,320924,1143,464,320460,Western Pacific
China,14-03-2020,114515,1833,375,114140,Western Pacific
China,14-03-2020,408219,2493,392,407827,Western Pacific
China,14-03-2020,286663,2240,72,286591,Western Pacific
China,14-03-2020,311630,401,804,310826,Western Pacific
China,14-03-2020,263399,824,505,262894,Western Pacific
China,14-03-2020,883,2356,1086,-203,Western Pacific
Colombia,14-03-2020,140762,1198,178,140584,Americas
Congo (Brazzaville),14-03-2020,224223,1826,70,224153,Africa
Congo (Kinshasa),14-03-2020,382814,304,509,382305,Africa
Costa Rica,14-03-2020,409332,2403,112,409220,Americas
Cote d'Ivoire,14-03-2020,183196,1415,982,182214,Africa
Croatia,14-03-2020,323362,1845,277,323085,Europe
Cuba,14-03-2020,386419,2403,1022,385397,Americas
Cyprus,14-03-2020,357198,2400,1150,356048,Europe
Czechia,14-03-2020,178132,1383,909,177223,Europe
Denmark,14-03-2020,277814,1170,918,276896,Europe
Greenland,14-03-2020,81777,1857,861,80916,Europe
Denmark,14-03-2020,208335,2327,38,208297,Europe
Djibouti,14-03-2020,296920,2455,624,296296,Eastern Mediterranean
Dominican Republic,14-03-2020,338223,2461,1147,337076,Americas
Ecuador,14-03-2020,366956,656,995,365961,Americas
Egypt,14-03-2020,248110,998,592,247518,Eastern Mediterranean
El Salvador,14-03-2020,416597,1795,1059,415538,Americas
Equatorial Guinea,14-03-2020,403578,2147,942,402636,Africa
Eritrea,14-03-2020,112758,1662,152,112606,Africa
Estonia,14-03-2020,83136,1561,267,82869,Europe
Eswatini,14-03-2020,245753,1136,1062,244691,Africa
Ethiopia,14-03-2020,241149,2011,311,240838,Africa
Fiji,14-03-2020,396567,337,705,395862,Western Pacific
Finland,14-03-2020,181883,12,1143,180740,Europe
France,14-03-2020,65213,103,1240,63973,Europe
France,14-03-2020,27710,820,270,27440,Europe
France,14-03-2020,177409,1759,205,177204,Europe
France,14-03-2020,419374,2423,932,418442,Europe
France,14-03-2020,101782,1580,915,100867,Europe
France,14-03-2020,168884,826,1104,167780,Europe
France,14-03-2020,303651,670,1214,302437,Europe
France,14-03-2020,285734,235,187,285547,Europe
France,14-03-2020,122991,879,228,122763,Europe
France,14-03-2020,150863,274,1222,149641,Europe
Gabon,14-03-2020,239290,2024,375,238915,Africa
Gambia,14-03-2020,415472,259,1147,414325,Africa
Georgia,14-03-2020,134361,1927,1203,133158,Europe
Germany,14-03-2020,207059,1011,693,206366,Europe
Ghana,14-03-2020,93081,2476,904,92177,Africa
Greece,14-03-2020,236734,2322,124,236610,Europe
Guatemala,14-03-2020,18065,2016,1000,17065,Americas
Guinea,14-03-2020,16489,1325,894,15595,Africa
Guyana,14-03-2020,84209,1785,889,83320,Americas
Haiti,14-03-2020,132164,223,1200,130964,Americas
Holy See,14-03-2020,227737,1105,487,227250,Europe
Honduras,14-03-2020,24139,1439,843,23296,Americas
Hungary,14-03-2020,186779,829,735,186044,Europe
Iceland,14-03-2020,416515,1761,168,416347,Europe
India,14-03-2020,143394,771,485,142909,South-East Asia
Indonesia,14-03-2020,388499,204,900,387599,South-East Asia
Iran,14-03-2020,313082,672,671,312411,Eastern Mediterranean
Iraq,14-03-2020,104684,600,951,103733,Eastern Mediterranean
Ireland,14-03-2020,355557,2215,907,354650,Europe
Israel,14-03-2020,241654,2479,1103,240551,Europe
Italy,14-03-2020,247349,1818,577,246772,Europe
Jamaica,14-03-2020,130414,833,593,129821,Americas
Japan,14-03-2020,361961,2305,901,361060,Western Pacific
Jordan,14-03-2020,433875,2251,174,433701,Eastern Mediterranean
Kazakhstan,14-03-2020,277077,2332,525,276552,Europe
Kenya,14-03-2020,386702,2171,1023,385679,Africa
South Korea,14-03-2020,409719,2343,238,409481,Western Pacific
Kuwait,14-03-2020,187626,2376,405,187221,Eastern Mediterranean
Kyrgyzstan,14-03-2020,163053,1633,352,162701,Europe
Latvia,14-03-2020,360930,178,469,360461,Europe
Lebanon,14-03-2020,149722,880,25,149697,Eastern Mediterranean
Liberia,14-03-2020,57095,810,498,56597,Africa
Liechtenstein,14-03-2020,78324,2342,978,77346,Europe
Lithuania,14-03-2020,284802,647,891,283911,Europe
Luxembourg,14-03-2020,130111,1849,191,129920,Europe
Madagascar,14-03-2020,49805,2072,183,49622,Africa
Malaysia,14-03-2020,158914,942,657,158257,Western Pacific
Maldives,14-03-2020,143589,2186,1050,142539,South-East Asia
Malta,14-03-2020,88375,1089,740,87635,Europe
Mauritania,14-03-2020,91615,2418,777,90838,Africa
Mauritius,14-03-2020,132073,2274,57,132016,Africa
Mexico,14-03-2020,262116,2110,1227,260889,Americas
Moldova,14-03-2020,228599,914,685,227914,Europe
Monaco,14-03-2020,353840,1575,326,353514,Europe
Mongolia,14-03-2020,424082,2480,1041,423041,Western Pacific
Montenegro,14-03-2020,44816,966,941,43875,Europe
Morocco,14-03-2020,123059,2135,1097,121962,Eastern Mediterranean
Namibia,14-03-2020,162747,2092,392,162355,Africa
Nepal,14-03-2020,245168,291,292,244876,South-East Asia
Netherlands,14-03-2020,30253,2245,695,29558,Europe
Netherlands,14-03-2020,436482,1976,581,435901,Europe
Netherlands,14-03-2020,318391,1863,465,317926,Europe
Netherlands,14-03-2020,249918,42,60,249858,Europe
New Zealand,14-03-2020,133302,640,1120,132182,Western Pacific
Nicaragua,14-03-2020,449346,858,166,449180,Americas
Niger,14-03-2020,160023,1048,461,159562,Africa
Nigeria,14-03-2020,167900,1483,553,167347,Africa
North Macedonia,14-03-2020,242671,1775,990,241681,Europe
Norway,14-03-2020,9542,1560,476,9066,Europe
Oman,14-03-2020,139316,1644,826,138490,Eastern Mediterranean
Pakistan,14-03-2020,220374,1508,668,219706,Eastern Mediterranean
Panama,14-03-2020,312915,626,1128,311787,Americas
Papua New Guinea,14-03-2020,346884,1203,205,346679,Western Pacific
Paraguay,14-03-2020,139329,274,923,138406,Americas
Peru,14-03-2020,396033,1148,463,395570,Americas
Philippines,14-03-2020,327766,2207,329,327437,Western Pacific
Poland,14-03-2020,31290,2389,356,30934,Europe
Portugal,14-03-2020,317401,1559,683,316718,Europe
Qatar,14-03-2020,7431,125,241,7190,Eastern Mediterranean
Romania,14-03-2020,83108,2358,118,82990,Europe
Russia,14-03-2020,74555,908,510,74045,Europe
Rwanda,14-03-2020,56930,1569,943,55987,Africa
Saint Lucia,14-03-2020,227608,1528,332,227276,Americas
Saint Vincent and the Grenadines,14-03-2020,9483,1691,408,9075,Americas
San Marino,14-03-2020,303301,1482,295,303006,Europe
Saudi Arabia,14-03-2020,172741,2082,508,172233,Eastern Mediterranean
Senegal,14-03-2020,12258,689,573,11685,Africa
Serbia,14-03-2020,165515,484,431,165084,Europe
Seychelles,14-03-2020,298989,2133,565,298424,Africa
Singapore,14-03-2020,136820,1126,642,136178,Western Pacific
Slovakia,14-03-2020,72022,2293,402,71620,Europe
Slovenia,14-03-2020,61828,485,639,61189,Europe
Somalia,14-03-2020,19787,598,518,19269,Eastern Mediterranean
South Africa,14-03-2020,197149,896,458,196691,Africa
Spain,14-03-2020,328370,1728,912,327458,Europe
Sri Lanka,14-03-2020,336306,2445,422,335884,South-East Asia
Sudan,14-03-2020,172228,535,268,171960,Eastern Mediterranean
Suriname,14-03-2020,171579,253,953,170626,Americas
Sweden,14-03-2020,202615,2451,258,202357,Europe
Switzerland,14-03-2020,75639,2451,843,74796,Europe
Taiwan*,14-03-2020,384758,2070,677,384081,Western Pacific
Tanzania,14-03-2020,29678,278,1235,28443,Africa
Thailand,14-03-2020,377957,569,502,377455,South-East Asia
Togo,14-03-2020,269403,1047,781,268622,Africa
Trinidad and Tobago,14-03-2020,366597,2196,1022,365575,Americas
Tunisia,14-03-2020,272690,652,812,271878,Eastern Mediterranean
Turkey,14-03-2020,381263,480,566,380697,Europe
Uganda,14-03-2020,272261,53,327,271934,Africa
Ukraine,14-03-2020,449776,1558,724,449052,Europe
United Arab Emirates,14-03-2020,139039,151,1096,137943,Eastern Mediterranean
United Kingdom,14-03-2020,408368,189,191,408177,Europe
United Kingdom,14-03-2020,77318,521,933,76385,Europe
United Kingdom,14-03-2020,66241,1788,163,66078,Europe
United Kingdom,14-03-2020,64266,2223,1235,63031,Europe
United Kingdom,14-03-2020,111881,78,90,111791,Europe
United Kingdom,14-03-2020,356701,1025,1233,355468,Europe
United Kingdom,14-03-2020,427399,545,494,426905,Europe
Uruguay,14-03-2020,226445,2399,1087,225358,Americas
US,14-03-2020,343604,2399,841,342763,Americas
Uzbekistan,14-03-2020,358803,1469,1020,357783,Europe
Venezuela,14-03-2020,355683,1085,28,355655,Americas
Vietnam,14-03-2020,292644,301,885,291759,Western Pacific
Zambia,14-03-2020,145053,1064,639,144414,Africa
Zimbabwe,14-03-2020,21903,1666,1229,20674,Africa
Dominica,14-03-2020,410320,1696,209,410111,Americas
Grenada,14-03-2020,198259,983,513,197746,Americas
Mozambique,14-03-2020,20207,2047,887,19320,Africa
Syria,14-03-2020,323506,2159,101,323405,Eastern Mediterranean
Timor-Leste,14-03-2020,100604,972,893,99711,South-East Asia
Belize,14-03-2020,427813,873,999,426814,Americas
Laos,14-03-2020,190205,998,110,190095,Western Pacific
Libya,14-03-2020,377001,707,526,376475,Eastern Mediterranean
West Bank and Gaza,14-03-2020,437193,1856,1067,436126,Eastern Mediterranean
Guinea-Bissau,14-03-2020,201307,1793,161,201146,Africa
Mali,14-03-2020,55845,920,1081,54764,Africa
Saint Kitts and Nevis,14-03-2020,438204,222,39,438165,Americas
Canada,14-03-2020,104013,1621,678,103335,Americas
Canada,14-03-2020,199942,940,258,199684,Americas
Kosovo,14-03-2020,428049,687,161,427888,Europe
Burma,14-03-2020,34623,2224,1076,33547,South-East Asia
United Kingdom,14-03-2020,318040,1674,1046,316994,Europe
United Kingdom,14-03-2020,129822,1828,1231,128591,Europe
United Kingdom,14-03-2020,238007,2144,834,237173,Europe
Botswana,14-03-2020,269956,265,89,269867,Africa
Burundi,14-03-2020,288947,57,653,288294,Africa
Sierra Leone,14-03-2020,376796,1824,493,376303,Africa
Malawi,14-03-2020,196649,529,654,195995,Africa
United Kingdom,14-03-2020,397628,1042,652,396976,Europe
France,14-03-2020,75376,2164,138,75238,Europe
South Sudan,14-03-2020,292476,2107,1228,291248,Africa
Western Sahara,14-03-2020,20073,1505,648,19425,Africa
Sao Tome and Principe,14-03-2020,24493,1619,463,24030,Africa
Yemen,14-03-2020,216282,417,981,215301,Eastern Mediterranean
Comoros,14-03-2020,388283,1163,1202,387081,Africa
Tajikistan,14-03-2020,209814,907,108,209706,Europe
Lesotho,14-03-2020,284160,394,402,283758,Africa
Afghanistan,15-03-2020,330616,855,749,329867,Eastern Mediterranean
Albania,15-03-2020,5130,566,1013,4117,Europe
Algeria,15-03-2020,298674,1627,373,298301,Africa
Andorra,15-03-2020,308003,1843,358,307645,Europe
Angola,15-03-2020,441063,2419,130,440933,Africa
Antigua and Barbuda,15-03-2020,69185,54,834,68351,Americas
Argentina,15-03-2020,324526,109,1063,323463,Americas
Armenia,15-03-2020,178814,1720,886,177928,Europe
Australia,15-03-2020,402752,1286,765,401987,Western Pacific
Australia,15-03-2020,43003,870,66,42937,Western Pacific
Australia,15-03-2020,105328,462,66,105262,Western Pacific
Australia,15-03-2020,234940,544,1203,233737,Western Pacific
Australia,15-03-2020,413617,1216,206,413411,Western Pacific
Australia,15-03-2020,158089,598,336,157753,Western Pacific
Australia,15-03-2020,57511,1002,1173,56338,Western Pacific
Australia,15-03-2020,347238,787,356,346882,Western Pacific
Austria,15-03-2020,380985,1124,626,380359,Europe
Azerbaijan,15-03-2020,62880,1162,1037,61843,Europe
Bahamas,15-03-2020,221428,524,686,220742,Americas
Bahrain,15-03-2020,217915,1518,1026,216889,Eastern Mediterranean
Bangladesh,15-03-2020,228777,1618,746,228031,South-East Asia
Barbados,15-03-2020,159498,1805,940,158558,Americas
Belarus,15-03-2020,132020,718,1241,130779,Europe
Belgium,15-03-2020,317227,1031,65,317162,Europe
Benin,15-03-2020,320851,1502,1006,319845,Africa
Bhutan,15-03-2020,13049,1973,744,12305,South-East Asia
Bolivia,15-03-2020,419126,667,219,418907,Americas
Bosnia and Herzegovina,15-03-2020,23772,826,377,23395,Europe
Brazil,15-03-2020,85307,382,487,84820,Americas
Brunei,15-03-2020,131564,1951,306,131258,Western Pacific
Bulgaria,15-03-2020,192639,1882,768,191871,Europe
Burkina Faso,15-03-2020,283967,1778,193,283774,Africa
Cabo Verde,15-03-2020,447836,386,736,447100,Africa
Cambodia,15-03-2020,136181,1383,896,135285,Western Pacific
Cameroon,15-03-2020,373940,464,749,373191,Africa
Canada,15-03-2020,429081,469,1163,427918,Americas
Canada,15-03-2020,281266,1657,433,280833,Americas
Canada,15-03-2020,70711,2311,780,69931,Americas
Canada,15-03-2020,442322,1741,1165,441157,Americas
Canada,15-03-2020,146823,567,632,146191,Americas
Canada,15-03-2020,26195,95,634,25561,Americas
Canada,15-03-2020,291711,1653,362,291349,Americas
Canada,15-03-2020,341805,1279,585,341220,Americas
Canada,15-03-2020,257848,2244,861,256987,Americas
Canada,15-03-2020,93821,1897,83,93738,Americas
Central African Republic,15-03-2020,3852,1624,90,3762,Africa
Chad,15-03-2020,283332,2451,512,282820,Africa
Chile,15-03-2020,96601,1916,138,96463,Americas
China,15-03-2020,397161,1939,732,396429,Western Pacific
China,15-03-2020,288706,149,284,288422,Western Pacific
China,15-03-2020,149446,154,625,148821,Western Pacific
China,15-03-2020,419821,1687,892,418929,Western Pacific
China,15-03-2020,99070,1838,56,99014,Western Pacific
China,15-03-2020,115406,1276,909,114497,Western Pacific
China,15-03-2020,400698,2419,253,400445,Western Pacific
China,15-03-2020,118349,1766,981,117368,Western Pacific
China,15-03-2020,9044,390,11,9033,Western Pacific
China,15-03-2020,331677,572,1135,330542,Western Pacific
China,15-03-2020,135820,788,653,135167,Western Pacific
China,15-03-2020,397512,1774,1022,396490,Western Pacific
China,15-03-2020,280774,1243,599,280175,Western Pacific
China,15-03-2020,93296,1104,435,92861,Western Pacific
China,15-03-2020,115168,132,871,114297,Western Pacific
China,15-03-2020,124962,2408,50,124912,Western Pacific
China,15-03-2020,82499,951,1059,81440,Western Pacific
China,15-03-2020,415503,1907,545,414958,Western Pacific
China,15-03-2020,12068,267,307,11761,Western Pacific
China,15-03-2020,46675,780,150,46525,Western Pacific
China,15-03-2020,18223,1534,1128,17095,Western Pacific
China,15-03-2020,275045,104,57,274988,Western Pacific
China,15-03-2020,144776,2125,328,144448,Western Pacific
China,15-03-2020,402670,870,410,402260,Western Pacific
China,15-03-2020,296699,908,855,295844,Western Pacific
China,15-03-2020,90307,1194,1006,89301,Western Pacific
China,15-03-2020,402406,2478,805,401601,Western Pacific
China,15-03-2020,374727,1899,203,374524,Western Pacific
China,15-03-2020,376722,1954,1163,375559,Western Pacific
China,15-03-2020,152743,2323,847,151896,Western Pacific
China,15-03-2020,331447,2026,14,331433,Western Pacific
China,15-03-2020,199888,146,173,199715,Western Pacific
China,15-03-2020,216814,2099,183,216631,Western Pacific
Colombia,15-03-2020,360815,2182,35,360780,Americas
Congo (Brazzaville),15-03-2020,241292,1643,86,241206,Africa
Congo (Kinshasa),15-03-2020,403606,2401,1044,402562,Africa
Costa Rica,15-03-2020,254308,2030,481,253827,Americas
Cote d'Ivoire,15-03-2020,79077,442,557,78520,Africa
Croatia,15-03-2020,385276,1670,277,384999,Europe
Cuba,15-03-2020,241836,1053,7,241829,Americas
Cyprus,15-03-2020,85317,290,1021,84296,Europe
Czechia,15-03-2020,376838,378,531,376307,Europe
Denmark,15-03-2020,230795,500,993,229802,Europe
Greenland,15-03-2020,284772,1156,60,284712,Europe
Denmark,15-03-2020,254171,1789,1166,253005,Europe
Djibouti,15-03-2020,195294,2312,230,195064,Eastern Mediterranean
Dominican Republic,15-03-2020,332739,1898,559,332180,Americas
Ecuador,15-03-2020,93340,1579,993,92347,Americas
Egypt,15-03-2020,201260,2068,767,200493,Eastern Mediterranean
El Salvador,15-03-2020,142512,2061,696,141816,Americas
Equatorial Guinea,15-03-2020,284989,1153,1220,283769,Africa
Eritrea,15-03-2020,407860,2160,1031,406829,Africa
Estonia,15-03-2020,91129,733,776,90353,Europe
Eswatini,15-03-2020,50329,1785,445,49884,Africa
Ethiopia,15-03-2020,5907,1422,633,5274,Africa
Fiji,15-03-2020,214752,2396,19,214733,Western Pacific
Finland,15-03-2020,77765,713,213,77552,Europe
France,15-03-2020,394278,1838,431,393847,Europe
France,15-03-2020,372675,1662,700,371975,Europe
France,15-03-2020,73727,2001,630,73097,Europe
France,15-03-2020,189968,2144,137,189831,Europe
France,15-03-2020,27105,1694,1057,26048,Europe
France,15-03-2020,203423,1495,154,203269,Europe
France,15-03-2020,79742,874,908,78834,Europe
France,15-03-2020,443260,1602,275,442985,Europe
France,15-03-2020,385297,1115,99,385198,Europe
France,15-03-2020,100040,995,31,100009,Europe
Gabon,15-03-2020,185386,868,1041,184345,Africa
Gambia,15-03-2020,365149,289,345,364804,Africa
Georgia,15-03-2020,203869,73,608,203261,Europe
Germany,15-03-2020,300876,1856,545,300331,Europe
Ghana,15-03-2020,187606,1373,853,186753,Africa
Greece,15-03-2020,44937,2242,1149,43788,Europe
Guatemala,15-03-2020,83918,2257,747,83171,Americas
Guinea,15-03-2020,138844,1921,980,137864,Africa
Guyana,15-03-2020,438360,1202,1075,437285,Americas
Haiti,15-03-2020,206236,1237,1087,205149,Americas
Holy See,15-03-2020,26204,2192,1194,25010,Europe
Honduras,15-03-2020,124659,1385,438,124221,Americas
Hungary,15-03-2020,305329,71,340,304989,Europe
Iceland,15-03-2020,194206,1781,473,193733,Europe
India,15-03-2020,99055,1962,1090,97965,South-East Asia
Indonesia,15-03-2020,12092,408,291,11801,South-East Asia
Iran,15-03-2020,153890,840,309,153581,Eastern Mediterranean
Iraq,15-03-2020,53563,2116,382,53181,Eastern Mediterranean
Ireland,15-03-2020,224168,2379,274,223894,Europe
Israel,15-03-2020,275845,1494,578,275267,Europe
Italy,15-03-2020,347138,1228,994,346144,Europe
Jamaica,15-03-2020,124173,875,209,123964,Americas
Japan,15-03-2020,102777,228,246,102531,Western Pacific
Jordan,15-03-2020,353847,2408,294,353553,Eastern Mediterranean
Kazakhstan,15-03-2020,56646,1381,620,56026,Europe
Kenya,15-03-2020,124944,928,1010,123934,Africa
South Korea,15-03-2020,293793,288,1068,292725,Western Pacific
Kuwait,15-03-2020,165660,759,1029,164631,Eastern Mediterranean
Kyrgyzstan,15-03-2020,203663,409,317,203346,Europe
Latvia,15-03-2020,81465,826,456,81009,Europe
Lebanon,15-03-2020,372864,2219,546,372318,Eastern Mediterranean
Liberia,15-03-2020,218584,1329,299,218285,Africa
Liechtenstein,15-03-2020,390263,576,859,389404,Europe
Lithuania,15-03-2020,248086,283,576,247510,Europe
Luxembourg,15-03-2020,288187,1516,898,287289,Europe
Madagascar,15-03-2020,343596,918,744,342852,Africa
Malaysia,15-03-2020,82392,1162,990,81402,Western Pacific
Maldives,15-03-2020,160620,1982,253,160367,South-East Asia
Malta,15-03-2020,266595,146,563,266032,Europe
Mauritania,15-03-2020,246362,939,756,245606,Africa
Mauritius,15-03-2020,284912,152,560,284352,Africa
Mexico,15-03-2020,86406,1238,1041,85365,Americas
Moldova,15-03-2020,307593,1824,802,306791,Europe
Monaco,15-03-2020,145616,780,1026,144590,Europe
Mongolia,15-03-2020,251500,846,538,250962,Western Pacific
Montenegro,15-03-2020,74138,331,903,73235,Europe
Morocco,15-03-2020,314084,325,1169,312915,Eastern Mediterranean
Namibia,15-03-2020,217751,2457,344,217407,Africa
Nepal,15-03-2020,443753,1996,148,443605,South-East Asia
Netherlands,15-03-2020,361590,1331,1076,360514,Europe
Netherlands,15-03-2020,249871,1435,52,249819,Europe
Netherlands,15-03-2020,401772,1574,257,401515,Europe
Netherlands,15-03-2020,41982,2366,184,41798,Europe
New Zealand,15-03-2020,46200,45,1061,45139,Western Pacific
Nicaragua,15-03-2020,146924,2208,256,146668,Americas
Niger,15-03-2020,359466,104,817,358649,Africa
Nigeria,15-03-2020,128627,1818,44,128583,Africa
North Macedonia,15-03-2020,224418,2419,1025,223393,Europe
Norway,15-03-2020,237394,1615,317,237077,Europe
Oman,15-03-2020,310441,802,658,309783,Eastern Mediterranean
Pakistan,15-03-2020,348343,736,1079,347264,Eastern Mediterranean
Panama,15-03-2020,331290,2421,688,330602,Americas
Papua New Guinea,15-03-2020,120626,930,1102,119524,Western Pacific
Paraguay,15-03-2020,252661,1908,446,252215,Americas
Peru,15-03-2020,393894,673,1108,392786,Americas
Philippines,15-03-2020,15465,127,387,15078,Western Pacific
Poland,15-03-2020,426359,99,501,425858,Europe
Portugal,15-03-2020,327068,587,593,326475,Europe
Qatar,15-03-2020,195065,1181,678,194387,Eastern Mediterranean
Romania,15-03-2020,123667,1225,608,123059,Europe
Russia,15-03-2020,52281,545,167,52114,Europe
Rwanda,15-03-2020,304227,1994,1061,303166,Africa
Saint Lucia,15-03-2020,169667,1037,1160,168507,Americas
Saint Vincent and the Grenadines,15-03-2020,218112,134,665,217447,Americas
San Marino,15-03-2020,288951,631,482,288469,Europe
Saudi Arabia,15-03-2020,210466,2015,650,209816,Eastern Mediterranean
Senegal,15-03-2020,305031,1434,635,304396,Africa
Serbia,15-03-2020,245929,434,604,245325,Europe
Seychelles,15-03-2020,401893,2428,1161,400732,Africa
Singapore,15-03-2020,400476,118,804,399672,Western Pacific
Slovakia,15-03-2020,163137,125,94,163043,Europe
Slovenia,15-03-2020,320447,1777,98,320349,Europe
Somalia,15-03-2020,247862,1386,624,247238,Eastern Mediterranean
South Africa,15-03-2020,144957,1811,731,144226,Africa
Spain,15-03-2020,151397,2047,344,151053,Europe
Sri Lanka,15-03-2020,227395,1772,1211,226184,South-East Asia
Sudan,15-03-2020,51653,2420,127,51526,Eastern Mediterranean
Suriname,15-03-2020,69964,1829,855,69109,Americas
Sweden,15-03-2020,368111,737,183,367928,Europe
Switzerland,15-03-2020,8143,2415,1023,7120,Europe
Taiwan*,15-03-2020,139166,2116,594,138572,Western Pacific
Tanzania,15-03-2020,205868,692,121,205747,Africa
Thailand,15-03-2020,118760,1658,338,118422,South-East Asia
Togo,15-03-2020,81234,516,46,81188,Africa
Trinidad and Tobago,15-03-2020,316239,1827,953,315286,Americas
Tunisia,15-03-2020,67493,469,1135,66358,Eastern Mediterranean
Turkey,15-03-2020,299922,155,1241,298681,Europe
Uganda,15-03-2020,332401,2170,856,331545,Africa
Ukraine,15-03-2020,50325,693,228,50097,Europe
United Arab Emirates,15-03-2020,185790,1528,841,184949,Eastern Mediterranean
United Kingdom,15-03-2020,412423,627,405,412018,Europe
United Kingdom,15-03-2020,79876,343,131,79745,Europe
United Kingdom,15-03-2020,332093,344,1086,331007,Europe
United Kingdom,15-03-2020,270120,1618,258,269862,Europe
United Kingdom,15-03-2020,423485,2211,676,422809,Europe
United Kingdom,15-03-2020,308090,1344,44,308046,Europe
United Kingdom,15-03-2020,442432,432,668,441764,Europe
Uruguay,15-03-2020,392155,1926,724,391431,Americas
US,15-03-2020,162167,471,126,162041,Americas
Uzbekistan,15-03-2020,79992,1155,125,79867,Europe
Venezuela,15-03-2020,367910,825,218,367692,Americas
Vietnam,15-03-2020,307162,1120,776,306386,Western Pacific
Zambia,15-03-2020,57972,260,542,57430,Africa
Zimbabwe,15-03-2020,223371,2373,527,222844,Africa
Dominica,15-03-2020,285320,1560,882,284438,Americas
Grenada,15-03-2020,193022,1038,691,192331,Americas
Mozambique,15-03-2020,71851,979,742,71109,Africa
Syria,15-03-2020,283737,2321,735,283002,Eastern Mediterranean
Timor-Leste,15-03-2020,402035,244,465,401570,South-East Asia
Belize,15-03-2020,13133,334,372,12761,Americas
Laos,15-03-2020,100204,344,578,99626,Western Pacific
Libya,15-03-2020,390363,419,1124,389239,Eastern Mediterranean
West Bank and Gaza,15-03-2020,319222,2481,646,318576,Eastern Mediterranean
Guinea-Bissau,15-03-2020,172048,1022,1236,170812,Africa
Mali,15-03-2020,399188,602,252,398936,Africa
Saint Kitts and Nevis,15-03-2020,146131,2215,1132,144999,Americas
Canada,15-03-2020,206955,1136,1084,205871,Americas
Canada,15-03-2020,411920,88,421,411499,Americas
Kosovo,15-03-2020,305235,781,988,304247,Europe
Burma,15-03-2020,294609,807,1137,293472,South-East Asia
United Kingdom,15-03-2020,324334,1012,83,324251,Europe
United Kingdom,15-03-2020,219136,419,465,218671,Europe
United Kingdom,15-03-2020,447022,2188,1214,445808,Europe
Botswana,15-03-2020,163621,1520,618,163003,Africa
Burundi,15-03-2020,437242,1287,98,437144,Africa
Sierra Leone,15-03-2020,62004,502,214,61790,Africa
Malawi,15-03-2020,216388,280,373,216015,Africa
United Kingdom,15-03-2020,191193,1327,891,190302,Europe
France,15-03-2020,359510,1689,1096,358414,Europe
South Sudan,15-03-2020,357752,1917,471,357281,Africa
Western Sahara,15-03-2020,210736,1289,311,210425,Africa
Sao Tome and Principe,15-03-2020,254046,580,1098,252948,Africa
Yemen,15-03-2020,230221,407,358,229863,Eastern Mediterranean
Comoros,15-03-2020,419124,2012,860,418264,Africa
Tajikistan,15-03-2020,292520,1100,769,291751,Europe
Lesotho,15-03-2020,289497,1763,846,288651,Africa
Afghanistan,16-03-2020,394758,592,621,394137,Eastern Mediterranean
Albania,16-03-2020,439517,471,317,439200,Europe
Algeria,16-03-2020,356218,490,889,355329,Africa
Andorra,16-03-2020,130669,522,488,130181,Europe
Angola,16-03-2020,91829,1652,1007,90822,Africa
Antigua and Barbuda,16-03-2020,339553,1434,972,338581,Americas
Argentina,16-03-2020,397062,51,110,396952,Americas
Armenia,16-03-2020,303210,2001,999,302211,Europe
Australia,16-03-2020,56754,1489,1113,55641,Western Pacific
Australia,16-03-2020,326765,1632,377,326388,Western Pacific
Australia,16-03-2020,449931,2059,1178,448753,Western Pacific
Australia,16-03-2020,245042,2417,645,244397,Western Pacific
Australia,16-03-2020,25777,1644,55,25722,Western Pacific
Australia,16-03-2020,48421,478,37,48384,Western Pacific
Australia,16-03-2020,169414,1747,746,168668,Western Pacific
Australia,16-03-2020,262757,1093,305,262452,Western Pacific
Austria,16-03-2020,373664,701,873,372791,Europe
Azerbaijan,16-03-2020,32902,2438,75,32827,Europe
Bahamas,16-03-2020,20283,1267,976,19307,Americas
Bahrain,16-03-2020,136319,987,210,136109,Eastern Mediterranean
Bangladesh,16-03-2020,140479,827,455,140024,South-East Asia
Barbados,16-03-2020,260398,340,171,260227,Americas
Belarus,16-03-2020,93626,1219,360,93266,Europe
Belgium,16-03-2020,169110,708,39,169071,Europe
Benin,16-03-2020,340180,416,1180,339000,Africa
Bhutan,16-03-2020,58252,945,1026,57226,South-East Asia
Bolivia,16-03-2020,118609,2398,1056,117553,Americas
Bosnia and Herzegovina,16-03-2020,192599,276,859,191740,Europe
Brazil,16-03-2020,77802,130,49,77753,Americas
Brunei,16-03-2020,315317,1545,1051,314266,Western Pacific
Bulgaria,16-03-2020,8903,2039,416,8487,Europe
Burkina Faso,16-03-2020,48954,1099,842,48112,Africa
Cabo Verde,16-03-2020,304016,1005,84,303932,Africa
Cambodia,16-03-2020,70500,2350,483,70017,Western Pacific
Cameroon,16-03-2020,298686,1053,365,298321,Africa
Canada,16-03-2020,128554,630,400,128154,Americas
Canada,16-03-2020,10868,163,1045,9823,Americas
Canada,16-03-2020,179481,1111,187,179294,Americas
Canada,16-03-2020,269503,752,11,269492,Americas
Canada,16-03-2020,408821,1054,388,408433,Americas
Canada,16-03-2020,33910,555,213,33697,Americas
Canada,16-03-2020,105053,690,266,104787,Americas
Canada,16-03-2020,59478,2101,918,58560,Americas
Canada,16-03-2020,360640,800,249,360391,Americas
Canada,16-03-2020,334505,2478,68,334437,Americas
Central African Republic,16-03-2020,357595,380,126,357469,Africa
Chad,16-03-2020,70227,1405,75,70152,Africa
Chile,16-03-2020,87667,2033,69,87598,Americas
China,16-03-2020,13974,937,655,13319,Western Pacific
China,16-03-2020,143893,1864,1224,142669,Western Pacific
China,16-03-2020,8620,1585,336,8284,Western Pacific
China,16-03-2020,87891,2311,559,87332,Western Pacific
China,16-03-2020,314925,211,194,314731,Western Pacific
China,16-03-2020,26665,1003,66,26599,Western Pacific
China,16-03-2020,163491,712,73,163418,Western Pacific
China,16-03-2020,268658,1982,179,268479,Western Pacific
China,16-03-2020,162771,558,1142,161629,Western Pacific
China,16-03-2020,280593,246,768,279825,Western Pacific
China,16-03-2020,23949,941,838,23111,Western Pacific
China,16-03-2020,315388,830,740,314648,Western Pacific
China,16-03-2020,406581,304,492,406089,Western Pacific
China,16-03-2020,94844,1755,758,94086,Western Pacific
China,16-03-2020,381339,2210,546,380793,Western Pacific
China,16-03-2020,213953,249,235,213718,Western Pacific
China,16-03-2020,269748,126,1047,268701,Western Pacific
China,16-03-2020,153264,1349,74,153190,Western Pacific
China,16-03-2020,384590,829,977,383613,Western Pacific
China,16-03-2020,440176,800,526,439650,Western Pacific
China,16-03-2020,145540,279,401,145139,Western Pacific
China,16-03-2020,223396,1038,470,222926,Western Pacific
China,16-03-2020,207134,2480,154,206980,Western Pacific
China,16-03-2020,375352,1183,1154,374198,Western Pacific
China,16-03-2020,90278,1461,1119,89159,Western Pacific
China,16-03-2020,117484,1294,792,116692,Western Pacific
China,16-03-2020,378118,282,888,377230,Western Pacific
China,16-03-2020,56382,429,1223,55159,Western Pacific
China,16-03-2020,384627,2381,1204,383423,Western Pacific
China,16-03-2020,147690,1467,215,147475,Western Pacific
China,16-03-2020,94802,2212,116,94686,Western Pacific
China,16-03-2020,431040,399,1015,430025,Western Pacific
China,16-03-2020,427772,173,209,427563,Western Pacific
Colombia,16-03-2020,315308,679,1070,314238,Americas
Congo (Brazzaville),16-03-2020,29043,1695,140,28903,Africa
Congo (Kinshasa),16-03-2020,91848,124,300,91548,Africa
Costa Rica,16-03-2020,192647,95,375,192272,Americas
Cote d'Ivoire,16-03-2020,181828,760,565,181263,Africa
Croatia,16-03-2020,110240,1633,82,110158,Europe
Cuba,16-03-2020,128563,604,879,127684,Americas
Cyprus,16-03-2020,122891,1492,129,122762,Europe
Czechia,16-03-2020,169395,63,843,168552,Europe
Denmark,16-03-2020,291216,272,881,290335,Europe
Greenland,16-03-2020,19295,588,429,18866,Europe
Denmark,16-03-2020,282929,1586,1138,281791,Europe
Djibouti,16-03-2020,177462,2421,560,176902,Eastern Mediterranean
Dominican Republic,16-03-2020,236568,2302,587,235981,Americas
Ecuador,16-03-2020,279240,1620,1089,278151,Americas
Egypt,16-03-2020,235606,1095,153,235453,Eastern Mediterranean
El Salvador,16-03-2020,389709,2103,142,389567,Americas
Equatorial Guinea,16-03-2020,11727,181,591,11136,Africa
Eritrea,16-03-2020,382450,2490,860,381590,Africa
Estonia,16-03-2020,419379,888,1106,418273,Europe
Eswatini,16-03-2020,387971,1484,1104,386867,Africa
Ethiopia,16-03-2020,446352,1424,311,446041,Africa
Fiji,16-03-2020,119985,1571,966,119019,Western Pacific
Finland,16-03-2020,121466,1200,1134,120332,Europe
France,16-03-2020,308309,548,1061,307248,Europe
France,16-03-2020,244148,2016,599,243549,Europe
France,16-03-2020,45731,947,383,45348,Europe
France,16-03-2020,6343,2271,955,5388,Europe
France,16-03-2020,167114,1329,306,166808,Europe
France,16-03-2020,168206,1507,1220,166986,Europe
France,16-03-2020,255378,1651,547,254831,Europe
France,16-03-2020,223962,222,1019,222943,Europe
France,16-03-2020,148811,1693,137,148674,Europe
France,16-03-2020,434282,138,547,433735,Europe
Gabon,16-03-2020,195290,1107,306,194984,Africa
Gambia,16-03-2020,210876,2113,301,210575,Africa
Georgia,16-03-2020,190654,758,301,190353,Europe
Germany,16-03-2020,323758,691,1241,322517,Europe
Ghana,16-03-2020,323795,1948,914,322881,Africa
Greece,16-03-2020,289717,156,156,289561,Europe
Guatemala,16-03-2020,204277,1698,775,203502,Americas
Guinea,16-03-2020,111448,1839,274,111174,Africa
Guyana,16-03-2020,73526,762,258,73268,Americas
Haiti,16-03-2020,403489,1471,580,402909,Americas
Holy See,16-03-2020,329250,218,615,328635,Europe
Honduras,16-03-2020,176450,1411,794,175656,Americas
Hungary,16-03-2020,110436,1843,953,109483,Europe
Iceland,16-03-2020,424121,1426,550,423571,Europe
India,16-03-2020,328341,1032,799,327542,South-East Asia
Indonesia,16-03-2020,342784,1143,1046,341738,South-East Asia
Iran,16-03-2020,205129,102,201,204928,Eastern Mediterranean
Iraq,16-03-2020,55955,1595,811,55144,Eastern Mediterranean
Ireland,16-03-2020,127990,2403,799,127191,Europe
Israel,16-03-2020,413130,129,760,412370,Europe
Italy,16-03-2020,118533,1362,374,118159,Europe
Jamaica,16-03-2020,135211,744,1195,134016,Americas
Japan,16-03-2020,206396,1900,653,205743,Western Pacific
Jordan,16-03-2020,160184,1113,52,160132,Eastern Mediterranean
Kazakhstan,16-03-2020,37887,1778,77,37810,Europe
Kenya,16-03-2020,245944,2104,1173,244771,Africa
South Korea,16-03-2020,212430,579,1099,211331,Western Pacific
Kuwait,16-03-2020,102621,311,177,102444,Eastern Mediterranean
Kyrgyzstan,16-03-2020,262344,2408,470,261874,Europe
Latvia,16-03-2020,86121,971,148,85973,Europe
Lebanon,16-03-2020,201834,355,3,201831,Eastern Mediterranean
Liberia,16-03-2020,165445,2432,180,165265,Africa
Liechtenstein,16-03-2020,148701,519,26,148675,Europe
Lithuania,16-03-2020,305236,1113,366,304870,Europe
Luxembourg,16-03-2020,213325,1433,570,212755,Europe
Madagascar,16-03-2020,197115,834,16,197099,Africa
Malaysia,16-03-2020,227747,523,396,227351,Western Pacific
Maldives,16-03-2020,303654,2417,598,303056,South-East Asia
Malta,16-03-2020,48500,512,623,47877,Europe
Mauritania,16-03-2020,360121,1834,198,359923,Africa
Mauritius,16-03-2020,15507,1450,671,14836,Africa
Mexico,16-03-2020,418873,1287,661,418212,Americas
Moldova,16-03-2020,427299,1889,1198,426101,Europe
Monaco,16-03-2020,365302,582,83,365219,Europe
Mongolia,16-03-2020,85558,2293,1164,84394,Western Pacific
Montenegro,16-03-2020,299135,2134,283,298852,Europe
Morocco,16-03-2020,254179,1636,481,253698,Eastern Mediterranean
Namibia,16-03-2020,128683,2163,1053,127630,Africa
Nepal,16-03-2020,433960,215,885,433075,South-East Asia
Netherlands,16-03-2020,126042,1059,508,125534,Europe
Netherlands,16-03-2020,43829,1900,211,43618,Europe
Netherlands,16-03-2020,376522,2120,162,376360,Europe
Netherlands,16-03-2020,389313,2224,1208,388105,Europe
New Zealand,16-03-2020,338426,484,1024,337402,Western Pacific
Nicaragua,16-03-2020,225935,1368,782,225153,Americas
Niger,16-03-2020,186014,2212,1148,184866,Africa
Nigeria,16-03-2020,120717,1238,173,120544,Africa
North Macedonia,16-03-2020,263981,2006,182,263799,Europe
Norway,16-03-2020,252902,2158,97,252805,Europe
Oman,16-03-2020,58416,598,105,58311,Eastern Mediterranean
Pakistan,16-03-2020,282340,2294,149,282191,Eastern Mediterranean
Panama,16-03-2020,404338,1796,532,403806,Americas
Papua New Guinea,16-03-2020,30696,565,926,29770,Western Pacific
Paraguay,16-03-2020,143534,2294,447,143087,Americas
Peru,16-03-2020,417515,2458,675,416840,Americas
Philippines,16-03-2020,77914,1681,328,77586,Western Pacific
Poland,16-03-2020,348931,998,1043,347888,Europe
Portugal,16-03-2020,174057,2464,812,173245,Europe
Qatar,16-03-2020,268616,487,991,267625,Eastern Mediterranean
Romania,16-03-2020,154363,2330,326,154037,Europe
Russia,16-03-2020,280095,2462,502,279593,Europe
Rwanda,16-03-2020,104623,166,490,104133,Africa
Saint Lucia,16-03-2020,299187,723,669,298518,Americas
Saint Vincent and the Grenadines,16-03-2020,103965,993,622,103343,Americas
San Marino,16-03-2020,78385,1124,911,77474,Europe
Saudi Arabia,16-03-2020,385616,789,113,385503,Eastern Mediterranean
Senegal,16-03-2020,121200,873,728,120472,Africa
Serbia,16-03-2020,202778,317,722,202056,Europe
Seychelles,16-03-2020,382115,1831,829,381286,Africa
Singapore,16-03-2020,5776,1307,477,5299,Western Pacific
Slovakia,16-03-2020,287026,840,848,286178,Europe
Slovenia,16-03-2020,202742,2006,25,202717,Europe
Somalia,16-03-2020,194120,1214,302,193818,Eastern Mediterranean
South Africa,16-03-2020,190635,281,162,190473,Africa
Spain,16-03-2020,244184,1290,361,243823,Europe
Sri Lanka,16-03-2020,90901,1524,332,90569,South-East Asia
Sudan,16-03-2020,315202,1877,822,314380,Eastern Mediterranean
Suriname,16-03-2020,336797,1205,278,336519,Americas
Sweden,16-03-2020,416194,1334,1069,415125,Europe
Switzerland,16-03-2020,193694,1159,555,193139,Europe
Taiwan*,16-03-2020,324873,1544,429,324444,Western Pacific
Tanzania,16-03-2020,441140,412,391,440749,Africa
Thailand,16-03-2020,383015,58,712,382303,South-East Asia
Togo,16-03-2020,84803,869,548,84255,Africa
Trinidad and Tobago,16-03-2020,378482,1001,233,378249,Americas
Tunisia,16-03-2020,402179,1434,1008,401171,Eastern Mediterranean
Turkey,16-03-2020,351427,1360,691,350736,Europe
Uganda,16-03-2020,272180,951,558,271622,Africa
Ukraine,16-03-2020,221554,1174,173,221381,Europe
United Arab Emirates,16-03-2020,120318,2427,763,119555,Eastern Mediterranean
United Kingdom,16-03-2020,381691,2438,708,380983,Europe
United Kingdom,16-03-2020,224429,2348,784,223645,Europe
United Kingdom,16-03-2020,58281,2456,1143,57138,Europe
United Kingdom,16-03-2020,434760,28,1145,433615,Europe
United Kingdom,16-03-2020,309407,966,673,308734,Europe
United Kingdom,16-03-2020,354846,2318,854,353992,Europe
United Kingdom,16-03-2020,54649,472,22,54627,Europe
Uruguay,16-03-2020,156751,1287,330,156421,Americas
US,16-03-2020,218365,75,216,218149,Americas
Uzbekistan,16-03-2020,357494,2196,1195,356299,Europe
Venezuela,16-03-2020,19000,1005,823,18177,Americas
Vietnam,16-03-2020,46474,386,537,45937,Western Pacific
Zambia,16-03-2020,272923,2394,561,272362,Africa
Zimbabwe,16-03-2020,162180,1980,479,161701,Africa
Dominica,16-03-2020,353012,765,945,352067,Americas
Grenada,16-03-2020,93784,807,248,93536,Americas
Mozambique,16-03-2020,175962,1811,88,175874,Africa
Syria,16-03-2020,316136,1465,1022,315114,Eastern Mediterranean
Timor-Leste,16-03-2020,379622,465,412,379210,South-East Asia
Belize,16-03-2020,436606,1245,10,436596,Americas
Laos,16-03-2020,290131,2064,185,289946,Western Pacific
Libya,16-03-2020,100218,2492,818,99400,Eastern Mediterranean
West Bank and Gaza,16-03-2020,312447,592,121,312326,Eastern Mediterranean
Guinea-Bissau,16-03-2020,24389,1349,453,23936,Africa
Mali,16-03-2020,337972,601,676,337296,Africa
Saint Kitts and Nevis,16-03-2020,71423,2453,712,70711,Americas
Canada,16-03-2020,95455,1258,969,94486,Americas
Canada,16-03-2020,227806,193,32,227774,Americas
Kosovo,16-03-2020,380490,2451,257,380233,Europe
Burma,16-03-2020,299199,2086,1058,298141,South-East Asia
United Kingdom,16-03-2020,204805,1987,250,204555,Europe
United Kingdom,16-03-2020,318116,1515,1197,316919,Europe
United Kingdom,16-03-2020,411853,513,549,411304,Europe
Botswana,16-03-2020,430452,390,720,429732,Africa
Burundi,16-03-2020,88947,2333,89,88858,Africa
Sierra Leone,16-03-2020,85513,805,98,85415,Africa
Malawi,16-03-2020,408672,334,458,408214,Africa
United Kingdom,16-03-2020,384437,61,1180,383257,Europe
France,16-03-2020,401053,1648,893,400160,Europe
South Sudan,16-03-2020,326914,1261,1125,325789,Africa
Western Sahara,16-03-2020,345092,241,509,344583,Africa
Sao Tome and Principe,16-03-2020,328788,773,551,328237,Africa
Yemen,16-03-2020,15644,783,540,15104,Eastern Mediterranean
Comoros,16-03-2020,432834,1594,264,432570,Africa
Tajikistan,16-03-2020,293957,652,1139,292818,Europe
Lesotho,16-03-2020,307388,515,961,306427,Africa
Afghanistan,17-03-2020,231802,2326,293,231509,Eastern Mediterranean
Albania,17-03-2020,285480,668,1008,284472,Europe
Algeria,17-03-2020,179190,208,1245,177945,Africa
Andorra,17-03-2020,436670,2412,50,436620,Europe
Angola,17-03-2020,143974,2033,1079,142895,Africa
Antigua and Barbuda,17-03-2020,244977,1062,101,244876,Americas
Argentina,17-03-2020,446597,1868,240,446357,Americas
Armenia,17-03-2020,49680,266,1236,48444,Europe
Australia,17-03-2020,345610,1974,149,345461,Western Pacific
Australia,17-03-2020,440491,2073,618,439873,Western Pacific
Australia,17-03-2020,139002,1765,38,138964,Western Pacific
Australia,17-03-2020,166952,1845,989,165963,Western Pacific
Australia,17-03-2020,142458,522,68,142390,Western Pacific
Australia,17-03-2020,382668,419,438,382230,Western Pacific
Australia,17-03-2020,47913,1033,1228,46685,Western Pacific
Australia,17-03-2020,311191,1871,589,310602,Western Pacific
Austria,17-03-2020,380319,1230,925,379394,Europe
Azerbaijan,17-03-2020,430704,988,149,430555,Europe
Bahamas,17-03-2020,83194,2493,714,82480,Americas
Bahrain,17-03-2020,93708,130,808,92900,Eastern Mediterranean
Bangladesh,17-03-2020,129219,968,1067,128152,South-East Asia
Barbados,17-03-2020,328054,65,834,327220,Americas
Belarus,17-03-2020,91259,1134,1030,90229,Europe
Belgium,17-03-2020,77146,786,1020,76126,Europe
Benin,17-03-2020,96889,1539,388,96501,Africa
Bhutan,17-03-2020,413049,413,996,412053,South-East Asia
Bolivia,17-03-2020,107903,1067,938,106965,Americas
Bosnia and Herzegovina,17-03-2020,158149,827,364,157785,Europe
Brazil,17-03-2020,415598,2459,1031,414567,Americas
Brunei,17-03-2020,34106,1316,293,33813,Western Pacific
Bulgaria,17-03-2020,212304,1996,359,211945,Europe
Burkina Faso,17-03-2020,377897,1964,475,377422,Africa
Cabo Verde,17-03-2020,325656,1136,794,324862,Africa
Cambodia,17-03-2020,165813,2214,911,164902,Western Pacific
Cameroon,17-03-2020,267589,1711,459,267130,Africa
Canada,17-03-2020,349437,549,498,348939,Americas
Canada,17-03-2020,76565,966,263,76302,Americas
Canada,17-03-2020,125397,1141,888,124509,Americas
Canada,17-03-2020,69453,1755,853,68600,Americas
Canada,17-03-2020,223098,1604,346,222752,Americas
Canada,17-03-2020,78490,1767,191,78299,Americas
Canada,17-03-2020,105017,1472,793,104224,Americas
Canada,17-03-2020,109314,2025,940,108374,Americas
Canada,17-03-2020,156459,401,504,155955,Americas
Canada,17-03-2020,140603,1700,1084,139519,Americas
Central African Republic,17-03-2020,248717,750,847,247870,Africa
Chad,17-03-2020,17200,2384,304,16896,Africa
Chile,17-03-2020,317410,323,728,316682,Americas
China,17-03-2020,265136,1138,979,264157,Western Pacific
China,17-03-2020,373696,160,592,373104,Western Pacific
China,17-03-2020,235100,764,112,234988,Western Pacific
China,17-03-2020,372063,170,914,371149,Western Pacific
China,17-03-2020,163226,1689,40,163186,Western Pacific
China,17-03-2020,234741,1697,815,233926,Western Pacific
China,17-03-2020,404209,865,356,403853,Western Pacific
China,17-03-2020,358756,2136,585,358171,Western Pacific
China,17-03-2020,253633,2029,1250,252383,Western Pacific
China,17-03-2020,374217,1120,526,373691,Western Pacific
China,17-03-2020,425773,36,130,425643,Western Pacific
China,17-03-2020,340006,1737,874,339132,Western Pacific
China,17-03-2020,399833,487,412,399421,Western Pacific
China,17-03-2020,207847,2120,381,207466,Western Pacific
China,17-03-2020,418236,135,510,417726,Western Pacific
China,17-03-2020,87663,90,119,87544,Western Pacific
China,17-03-2020,34660,623,1149,33511,Western Pacific
China,17-03-2020,286741,1874,421,286320,Western Pacific
China,17-03-2020,31548,1343,192,31356,Western Pacific
China,17-03-2020,333435,835,765,332670,Western Pacific
China,17-03-2020,226295,1978,951,225344,Western Pacific
China,17-03-2020,36114,572,43,36071,Western Pacific
China,17-03-2020,213121,304,961,212160,Western Pacific
China,17-03-2020,436350,361,1016,435334,Western Pacific
China,17-03-2020,219587,2466,465,219122,Western Pacific
China,17-03-2020,24656,1072,133,24523,Western Pacific
China,17-03-2020,428799,1649,511,428288,Western Pacific
China,17-03-2020,271309,1988,793,270516,Western Pacific
China,17-03-2020,280755,450,378,280377,Western Pacific
China,17-03-2020,148958,2036,550,148408,Western Pacific
China,17-03-2020,52109,426,134,51975,Western Pacific
China,17-03-2020,383486,1665,225,383261,Western Pacific
China,17-03-2020,137257,519,414,136843,Western Pacific
Colombia,17-03-2020,322900,800,298,322602,Americas
Congo (Brazzaville),17-03-2020,123425,2403,936,122489,Africa
Congo (Kinshasa),17-03-2020,204966,295,376,204590,Africa
Costa Rica,17-03-2020,193899,1273,746,193153,Americas
Cote d'Ivoire,17-03-2020,76415,2337,580,75835,Africa
Croatia,17-03-2020,320314,150,913,319401,Europe
Cuba,17-03-2020,403413,243,1080,402333,Americas
Cyprus,17-03-2020,142069,2217,663,141406,Europe
Czechia,17-03-2020,443273,2186,772,442501,Europe
Denmark,17-03-2020,188227,2243,304,187923,Europe
Greenland,17-03-2020,104693,449,281,104412,Europe
Denmark,17-03-2020,363165,1977,20,363145,Europe
Djibouti,17-03-2020,81902,1024,60,81842,Eastern Mediterranean
Dominican Republic,17-03-2020,269212,2297,925,268287,Americas
Ecuador,17-03-2020,290041,726,1002,289039,Americas
Egypt,17-03-2020,253186,2423,381,252805,Eastern Mediterranean
El Salvador,17-03-2020,68658,1033,778,67880,Americas
Equatorial Guinea,17-03-2020,402086,1714,1028,401058,Africa
Eritrea,17-03-2020,110175,928,265,109910,Africa
Estonia,17-03-2020,403936,1722,321,403615,Europe
Eswatini,17-03-2020,119439,1713,1100,118339,Africa
Ethiopia,17-03-2020,176202,2362,368,175834,Africa
Fiji,17-03-2020,134477,1457,869,133608,Western Pacific
Finland,17-03-2020,387757,910,1075,386682,Europe
France,17-03-2020,186681,1954,675,186006,Europe
France,17-03-2020,172291,136,311,171980,Europe
France,17-03-2020,398597,1167,307,398290,Europe
France,17-03-2020,273734,1420,230,273504,Europe
France,17-03-2020,167625,298,523,167102,Europe
France,17-03-2020,67006,1992,892,66114,Europe
France,17-03-2020,118260,597,539,117721,Europe
France,17-03-2020,34084,1873,602,33482,Europe
France,17-03-2020,105640,299,252,105388,Europe
France,17-03-2020,20233,528,240,19993,Europe
Gabon,17-03-2020,293297,2273,59,293238,Africa
Gambia,17-03-2020,190286,1812,16,190270,Africa
Georgia,17-03-2020,177621,1533,1183,176438,Europe
Germany,17-03-2020,6248,1798,1134,5114,Europe
Ghana,17-03-2020,186903,987,364,186539,Africa
Greece,17-03-2020,108407,1829,473,107934,Europe
Guatemala,17-03-2020,337983,378,324,337659,Americas
Guinea,17-03-2020,279764,2202,152,279612,Africa
Guyana,17-03-2020,214796,436,685,214111,Americas
Haiti,17-03-2020,167379,54,190,167189,Americas
Holy See,17-03-2020,398089,1250,595,397494,Europe
Honduras,17-03-2020,392855,287,1217,391638,Americas
Hungary,17-03-2020,4462,45,843,3619,Europe
Iceland,17-03-2020,80235,1474,1212,79023,Europe
India,17-03-2020,430010,176,345,429665,South-East Asia
Indonesia,17-03-2020,246837,763,978,245859,South-East Asia
Iran,17-03-2020,48309,971,304,48005,Eastern Mediterranean
Iraq,17-03-2020,157557,628,139,157418,Eastern Mediterranean
Ireland,17-03-2020,36107,1471,101,36006,Europe
Israel,17-03-2020,168639,493,103,168536,Europe
Italy,17-03-2020,156849,2495,1241,155608,Europe
Jamaica,17-03-2020,69234,1431,635,68599,Americas
Japan,17-03-2020,106348,1305,589,105759,Western Pacific
Jordan,17-03-2020,13017,1838,0,13017,Eastern Mediterranean
Kazakhstan,17-03-2020,156584,70,699,155885,Europe
Kenya,17-03-2020,341807,210,1169,340638,Africa
South Korea,17-03-2020,116102,1667,1022,115080,Western Pacific
Kuwait,17-03-2020,260964,2011,1206,259758,Eastern Mediterranean
Kyrgyzstan,17-03-2020,200240,1607,963,199277,Europe
Latvia,17-03-2020,216151,887,432,215719,Europe
Lebanon,17-03-2020,128586,1016,1147,127439,Eastern Mediterranean
Liberia,17-03-2020,133884,1195,186,133698,Africa
Liechtenstein,17-03-2020,296663,1267,460,296203,Europe
Lithuania,17-03-2020,370200,122,377,369823,Europe
Luxembourg,17-03-2020,391613,2131,228,391385,Europe
Madagascar,17-03-2020,246786,1434,715,246071,Africa
Malaysia,17-03-2020,18962,996,931,18031,Western Pacific
Maldives,17-03-2020,180405,2422,520,179885,South-East Asia
Malta,17-03-2020,177896,571,1240,176656,Europe
Mauritania,17-03-2020,440519,2417,1096,439423,Africa
Mauritius,17-03-2020,52997,2217,1118,51879,Africa
Mexico,17-03-2020,385392,2322,605,384787,Americas
Moldova,17-03-2020,143271,2051,1077,142194,Europe
Monaco,17-03-2020,28163,300,1095,27068,Europe
Mongolia,17-03-2020,125419,1577,921,124498,Western Pacific
Montenegro,17-03-2020,352142,1620,366,351776,Europe
Morocco,17-03-2020,27440,742,379,27061,Eastern Mediterranean
Namibia,17-03-2020,114976,2124,568,114408,Africa
Nepal,17-03-2020,133479,519,189,133290,South-East Asia
Netherlands,17-03-2020,53202,2026,228,52974,Europe
Netherlands,17-03-2020,77333,157,297,77036,Europe
Netherlands,17-03-2020,406895,768,798,406097,Europe
Netherlands,17-03-2020,318045,729,863,317182,Europe
New Zealand,17-03-2020,269530,685,562,268968,Western Pacific
Nicaragua,17-03-2020,30342,1987,609,29733,Americas
Niger,17-03-2020,153921,510,790,153131,Africa
Nigeria,17-03-2020,22388,303,1080,21308,Africa
North Macedonia,17-03-2020,370966,1827,1239,369727,Europe
Norway,17-03-2020,364861,463,1075,363786,Europe
Oman,17-03-2020,230820,472,382,230438,Eastern Mediterranean
Pakistan,17-03-2020,265377,339,580,264797,Eastern Mediterranean
Panama,17-03-2020,199164,2012,716,198448,Americas
Papua New Guinea,17-03-2020,22240,2073,173,22067,Western Pacific
Paraguay,17-03-2020,38701,1923,1042,37659,Americas
Peru,17-03-2020,218328,259,924,217404,Americas
Philippines,17-03-2020,169856,431,124,169732,Western Pacific
Poland,17-03-2020,75474,1448,1245,74229,Europe
Portugal,17-03-2020,149292,744,649,148643,Europe
Qatar,17-03-2020,209474,625,730,208744,Eastern Mediterranean
Romania,17-03-2020,246998,422,899,246099,Europe
Russia,17-03-2020,392130,2188,544,391586,Europe
Rwanda,17-03-2020,264161,1890,1013,263148,Africa
Saint Lucia,17-03-2020,270400,639,118,270282,Americas
Saint Vincent and the Grenadines,17-03-2020,440976,1097,712,440264,Americas
San Marino,17-03-2020,247018,393,387,246631,Europe
Saudi Arabia,17-03-2020,227292,855,987,226305,Eastern Mediterranean
Senegal,17-03-2020,182214,491,472,181742,Africa
Serbia,17-03-2020,59681,295,817,58864,Europe
Seychelles,17-03-2020,438295,945,638,437657,Africa
Singapore,17-03-2020,162325,2299,188,162137,Western Pacific
Slovakia,17-03-2020,73549,799,585,72964,Europe
Slovenia,17-03-2020,346235,244,619,345616,Europe
Somalia,17-03-2020,108018,164,311,107707,Eastern Mediterranean
South Africa,17-03-2020,269422,387,1217,268205,Africa
Spain,17-03-2020,193966,433,450,193516,Europe
Sri Lanka,17-03-2020,140226,1030,374,139852,South-East Asia
Sudan,17-03-2020,20112,2007,419,19693,Eastern Mediterranean
Suriname,17-03-2020,386987,168,1162,385825,Americas
Sweden,17-03-2020,355942,860,652,355290,Europe
Switzerland,17-03-2020,402263,524,190,402073,Europe
Taiwan*,17-03-2020,46210,2102,93,46117,Western Pacific
Tanzania,17-03-2020,275062,46,1036,274026,Africa
Thailand,17-03-2020,8168,1355,833,7335,South-East Asia
Togo,17-03-2020,267078,1845,582,266496,Africa
Trinidad and Tobago,17-03-2020,6199,360,444,5755,Americas
Tunisia,17-03-2020,198845,1410,501,198344,Eastern Mediterranean
Turkey,17-03-2020,433511,1438,1133,432378,Europe
Uganda,17-03-2020,212265,25,777,211488,Africa
Ukraine,17-03-2020,121038,237,1040,119998,Europe
United Arab Emirates,17-03-2020,205781,1034,664,205117,Eastern Mediterranean
United Kingdom,17-03-2020,157057,1243,543,156514,Europe
United Kingdom,17-03-2020,54407,439,466,53941,Europe
United Kingdom,17-03-2020,301612,735,661,300951,Europe
United Kingdom,17-03-2020,106285,53,927,105358,Europe
United Kingdom,17-03-2020,139490,1847,1004,138486,Europe
United Kingdom,17-03-2020,313310,160,392,312918,Europe
United Kingdom,17-03-2020,252422,2250,371,252051,Europe
Uruguay,17-03-2020,399188,1025,564,398624,Americas
US,17-03-2020,332959,2008,1078,331881,Americas
Uzbekistan,17-03-2020,46348,2313,255,46093,Europe
Venezuela,17-03-2020,89658,1893,421,89237,Americas
Vietnam,17-03-2020,158092,1788,658,157434,Western Pacific
Zambia,17-03-2020,414911,1317,530,414381,Africa
Zimbabwe,17-03-2020,91371,397,721,90650,Africa
Dominica,17-03-2020,222730,222,562,222168,Americas
Grenada,17-03-2020,148462,1042,267,148195,Americas
Mozambique,17-03-2020,315257,1276,992,314265,Africa
Syria,17-03-2020,66954,1820,1050,65904,Eastern Mediterranean
Timor-Leste,17-03-2020,43794,2091,426,43368,South-East Asia
Belize,17-03-2020,195054,957,770,194284,Americas
Laos,17-03-2020,295210,777,1229,293981,Western Pacific
Libya,17-03-2020,11856,1300,1195,10661,Eastern Mediterranean
West Bank and Gaza,17-03-2020,199080,569,1206,197874,Eastern Mediterranean
Guinea-Bissau,17-03-2020,373716,1718,764,372952,Africa
Mali,17-03-2020,79107,1196,1194,77913,Africa
Saint Kitts and Nevis,17-03-2020,420545,1560,471,420074,Americas
Canada,17-03-2020,196937,1276,1220,195717,Americas
Canada,17-03-2020,49386,1775,736,48650,Americas
Kosovo,17-03-2020,322010,618,351,321659,Europe
Burma,17-03-2020,35202,210,683,34519,South-East Asia
United Kingdom,17-03-2020,18048,483,1012,17036,Europe
United Kingdom,17-03-2020,28953,761,117,28836,Europe
United Kingdom,17-03-2020,419791,726,860,418931,Europe
Botswana,17-03-2020,395205,1152,300,394905,Africa
Burundi,17-03-2020,169843,2053,780,169063,Africa
Sierra Leone,17-03-2020,120899,235,930,119969,Africa
Malawi,17-03-2020,348465,1484,455,348010,Africa
United Kingdom,17-03-2020,416148,809,805,415343,Europe
France,17-03-2020,218955,1194,234,218721,Europe
South Sudan,17-03-2020,225355,2484,244,225111,Africa
Western Sahara,17-03-2020,225953,1568,1079,224874,Africa
Sao Tome and Principe,17-03-2020,155877,1476,1242,154635,Africa
Yemen,17-03-2020,87679,951,391,87288,Eastern Mediterranean
Comoros,17-03-2020,347886,590,505,347381,Africa
Tajikistan,17-03-2020,375599,2298,908,374691,Europe
Lesotho,17-03-2020,351630,113,561,351069,Africa
Afghanistan,18-03-2020,291278,319,581,290697,Eastern Mediterranean
Albania,18-03-2020,181256,631,380,180876,Europe
Algeria,18-03-2020,438880,53,789,438091,Africa
Andorra,18-03-2020,102678,2110,978,101700,Europe
Angola,18-03-2020,198562,1218,897,197665,Africa
Antigua and Barbuda,18-03-2020,188567,1194,350,188217,Americas
Argentina,18-03-2020,381762,736,582,381180,Americas
Armenia,18-03-2020,237010,1310,20,236990,Europe
Australia,18-03-2020,242198,900,393,241805,Western Pacific
Australia,18-03-2020,207459,319,320,207139,Western Pacific
Australia,18-03-2020,55373,2019,757,54616,Western Pacific
Australia,18-03-2020,71805,1705,1193,70612,Western Pacific
Australia,18-03-2020,365498,815,77,365421,Western Pacific
Australia,18-03-2020,143403,1066,1184,142219,Western Pacific
Australia,18-03-2020,300090,499,911,299179,Western Pacific
Australia,18-03-2020,269993,826,1016,268977,Western Pacific
Austria,18-03-2020,144007,956,388,143619,Europe
Azerbaijan,18-03-2020,363880,1151,973,362907,Europe
Bahamas,18-03-2020,271347,1781,995,270352,Americas
Bahrain,18-03-2020,406005,1583,975,405030,Eastern Mediterranean
Bangladesh,18-03-2020,318922,685,1231,317691,South-East Asia
Barbados,18-03-2020,42015,1397,501,41514,Americas
Belarus,18-03-2020,321124,554,201,320923,Europe
Belgium,18-03-2020,428170,1068,941,427229,Europe
Benin,18-03-2020,378993,220,706,378287,Africa
Bhutan,18-03-2020,247962,2220,125,247837,South-East Asia
Bolivia,18-03-2020,285023,1190,159,284864,Americas
Bosnia and Herzegovina,18-03-2020,30294,1159,417,29877,Europe
Brazil,18-03-2020,377355,670,1187,376168,Americas
Brunei,18-03-2020,218600,1113,1096,217504,Western Pacific
Bulgaria,18-03-2020,224311,1979,208,224103,Europe
Burkina Faso,18-03-2020,8879,1410,40,8839,Africa
Cabo Verde,18-03-2020,370049,2493,333,369716,Africa
Cambodia,18-03-2020,208402,2302,119,208283,Western Pacific
Cameroon,18-03-2020,39273,2408,1022,38251,Africa
Canada,18-03-2020,46907,476,797,46110,Americas
Canada,18-03-2020,255415,314,760,254655,Americas
Canada,18-03-2020,447933,2495,950,446983,Americas
Canada,18-03-2020,438128,2312,1225,436903,Americas
Canada,18-03-2020,165141,562,1035,164106,Americas
Canada,18-03-2020,9967,1297,19,9948,Americas
Canada,18-03-2020,137830,746,1189,136641,Americas
Canada,18-03-2020,93037,1048,120,92917,Americas
Canada,18-03-2020,147402,693,1223,146179,Americas
Canada,18-03-2020,219293,1138,970,218323,Americas
Central African Republic,18-03-2020,346745,1345,969,345776,Africa
Chad,18-03-2020,147187,1157,998,146189,Africa
Chile,18-03-2020,151920,2442,98,151822,Americas
China,18-03-2020,104804,2146,1041,103763,Western Pacific
China,18-03-2020,305352,2463,264,305088,Western Pacific
China,18-03-2020,386079,670,393,385686,Western Pacific
China,18-03-2020,409190,505,606,408584,Western Pacific
China,18-03-2020,147707,1224,1185,146522,Western Pacific
China,18-03-2020,148079,2020,259,147820,Western Pacific
China,18-03-2020,98413,2165,215,98198,Western Pacific
China,18-03-2020,141833,1639,956,140877,Western Pacific
China,18-03-2020,150897,51,245,150652,Western Pacific
China,18-03-2020,38167,1752,897,37270,Western Pacific
China,18-03-2020,141254,1493,1071,140183,Western Pacific
China,18-03-2020,217630,1577,714,216916,Western Pacific
China,18-03-2020,101728,2362,15,101713,Western Pacific
China,18-03-2020,14727,1750,1212,13515,Western Pacific
China,18-03-2020,270892,1807,941,269951,Western Pacific
China,18-03-2020,359191,2247,335,358856,Western Pacific
China,18-03-2020,131139,1863,928,130211,Western Pacific
China,18-03-2020,432628,1922,1237,431391,Western Pacific
China,18-03-2020,390943,2324,475,390468,Western Pacific
China,18-03-2020,3005,371,434,2571,Western Pacific
China,18-03-2020,111327,969,769,110558,Western Pacific
China,18-03-2020,279027,2143,1153,277874,Western Pacific
China,18-03-2020,249930,213,216,249714,Western Pacific
China,18-03-2020,301935,540,1024,300911,Western Pacific
China,18-03-2020,69899,677,1175,68724,Western Pacific
China,18-03-2020,117358,1001,623,116735,Western Pacific
China,18-03-2020,276571,1842,1125,275446,Western Pacific
China,18-03-2020,153495,1313,972,152523,Western Pacific
China,18-03-2020,111822,2305,267,111555,Western Pacific
China,18-03-2020,447132,1203,185,446947,Western Pacific
China,18-03-2020,283651,362,738,282913,Western Pacific
China,18-03-2020,369406,185,175,369231,Western Pacific
China,18-03-2020,52564,2219,105,52459,Western Pacific
Colombia,18-03-2020,397049,44,1028,396021,Americas
Congo (Brazzaville),18-03-2020,327174,1308,910,326264,Africa
Congo (Kinshasa),18-03-2020,234717,623,60,234657,Africa
Costa Rica,18-03-2020,410767,1822,522,410245,Americas
Cote d'Ivoire,18-03-2020,209585,2210,1013,208572,Africa
Croatia,18-03-2020,12347,1979,1151,11196,Europe
Cuba,18-03-2020,276823,1069,1228,275595,Americas
Cyprus,18-03-2020,189905,2110,777,189128,Europe
Czechia,18-03-2020,369448,84,837,368611,Europe
Denmark,18-03-2020,177890,66,1019,176871,Europe
Greenland,18-03-2020,239144,147,67,239077,Europe
Denmark,18-03-2020,214567,2062,257,214310,Europe
Djibouti,18-03-2020,118089,2451,695,117394,Eastern Mediterranean
Dominican Republic,18-03-2020,204237,2027,289,203948,Americas
Ecuador,18-03-2020,111868,1300,796,111072,Americas
Egypt,18-03-2020,332007,554,118,331889,Eastern Mediterranean
El Salvador,18-03-2020,37680,58,579,37101,Americas
Equatorial Guinea,18-03-2020,293188,211,730,292458,Africa
Eritrea,18-03-2020,70927,139,34,70893,Africa
Estonia,18-03-2020,198174,37,550,197624,Europe
Eswatini,18-03-2020,343976,1489,511,343465,Africa
Ethiopia,18-03-2020,347628,1081,492,347136,Africa
Fiji,18-03-2020,412020,1692,299,411721,Western Pacific
Finland,18-03-2020,239398,1929,1063,238335,Europe
France,18-03-2020,329590,344,450,329140,Europe
France,18-03-2020,113939,893,122,113817,Europe
France,18-03-2020,285013,1514,1088,283925,Europe
France,18-03-2020,127257,1484,229,127028,Europe
France,18-03-2020,113843,397,1215,112628,Europe
France,18-03-2020,85883,2087,851,85032,Europe
France,18-03-2020,166549,180,747,165802,Europe
France,18-03-2020,245660,1741,621,245039,Europe
France,18-03-2020,280511,442,618,279893,Europe
France,18-03-2020,258814,1602,1033,257781,Europe
Gabon,18-03-2020,174578,1537,237,174341,Africa
Gambia,18-03-2020,283751,1101,549,283202,Africa
Georgia,18-03-2020,370578,1374,1101,369477,Europe
Germany,18-03-2020,201149,1777,228,200921,Europe
Ghana,18-03-2020,201580,842,258,201322,Africa
Greece,18-03-2020,396901,1308,416,396485,Europe
Guatemala,18-03-2020,209164,2093,139,209025,Americas
Guinea,18-03-2020,172769,1583,1077,171692,Africa
Guyana,18-03-2020,391467,599,697,390770,Americas
Haiti,18-03-2020,172047,2061,671,171376,Americas
Holy See,18-03-2020,8255,1857,1081,7174,Europe
Honduras,18-03-2020,388963,246,101,388862,Americas
Hungary,18-03-2020,437892,1426,150,437742,Europe
Iceland,18-03-2020,248129,825,803,247326,Europe
India,18-03-2020,42946,1953,479,42467,South-East Asia
Indonesia,18-03-2020,35994,31,14,35980,South-East Asia
Iran,18-03-2020,133852,2220,358,133494,Eastern Mediterranean
Iraq,18-03-2020,104110,1357,82,104028,Eastern Mediterranean
Ireland,18-03-2020,396490,133,965,395525,Europe
Israel,18-03-2020,246789,1797,1202,245587,Europe
Italy,18-03-2020,69798,1469,679,69119,Europe
Jamaica,18-03-2020,404418,1002,1075,403343,Americas
Japan,18-03-2020,164987,1851,349,164638,Western Pacific
Jordan,18-03-2020,378885,186,154,378731,Eastern Mediterranean
Kazakhstan,18-03-2020,409331,746,294,409037,Europe
Kenya,18-03-2020,223486,2139,505,222981,Africa
South Korea,18-03-2020,405276,451,682,404594,Western Pacific
Kuwait,18-03-2020,430314,229,773,429541,Eastern Mediterranean
Kyrgyzstan,18-03-2020,298602,95,445,298157,Europe
Latvia,18-03-2020,260510,824,662,259848,Europe
Lebanon,18-03-2020,315810,1185,717,315093,Eastern Mediterranean
Liberia,18-03-2020,310300,2063,97,310203,Africa
Liechtenstein,18-03-2020,401737,1956,1093,400644,Europe
Lithuania,18-03-2020,334205,1941,665,333540,Europe
Luxembourg,18-03-2020,150755,1915,870,149885,Europe
Madagascar,18-03-2020,362218,2373,71,362147,Africa
Malaysia,18-03-2020,307301,2410,1158,306143,Western Pacific
Maldives,18-03-2020,386781,1566,385,386396,South-East Asia
Malta,18-03-2020,227754,1444,525,227229,Europe
Mauritania,18-03-2020,111330,1254,897,110433,Africa
Mauritius,18-03-2020,227603,1604,45,227558,Africa
Mexico,18-03-2020,17667,2331,1027,16640,Americas
Moldova,18-03-2020,163390,1480,768,162622,Europe
Monaco,18-03-2020,187195,750,747,186448,Europe
Mongolia,18-03-2020,29248,2111,228,29020,Western Pacific
Montenegro,18-03-2020,87188,1808,507,86681,Europe
Morocco,18-03-2020,199387,101,878,198509,Eastern Mediterranean
Namibia,18-03-2020,233494,2145,1162,232332,Africa
Nepal,18-03-2020,295853,1316,636,295217,South-East Asia
Netherlands,18-03-2020,122711,248,437,122274,Europe
Netherlands,18-03-2020,111971,2159,347,111624,Europe
Netherlands,18-03-2020,415099,52,194,414905,Europe
Netherlands,18-03-2020,360350,1954,236,360114,Europe
New Zealand,18-03-2020,199277,2196,1159,198118,Western Pacific
Nicaragua,18-03-2020,310535,25,1217,309318,Americas
Niger,18-03-2020,4195,2022,352,3843,Africa
Nigeria,18-03-2020,190668,266,138,190530,Africa
North Macedonia,18-03-2020,141245,309,1026,140219,Europe
Norway,18-03-2020,157833,2402,734,157099,Europe
Oman,18-03-2020,376739,1577,11,376728,Eastern Mediterranean
Pakistan,18-03-2020,217124,146,525,216599,Eastern Mediterranean
Panama,18-03-2020,325229,137,220,325009,Americas
Papua New Guinea,18-03-2020,275637,616,664,274973,Western Pacific
Paraguay,18-03-2020,394764,1795,690,394074,Americas
Peru,18-03-2020,193343,1575,978,192365,Americas
Philippines,18-03-2020,45504,1185,522,44982,Western Pacific
Poland,18-03-2020,68772,1265,1176,67596,Europe
Portugal,18-03-2020,326888,1981,70,326818,Europe
Qatar,18-03-2020,132947,2208,1103,131844,Eastern Mediterranean
Romania,18-03-2020,382391,1848,823,381568,Europe
Russia,18-03-2020,64185,1694,918,63267,Europe
Rwanda,18-03-2020,434461,1908,901,433560,Africa
Saint Lucia,18-03-2020,278811,1899,877,277934,Americas
Saint Vincent and the Grenadines,18-03-2020,213813,1357,706,213107,Americas
San Marino,18-03-2020,66396,1415,354,66042,Europe
Saudi Arabia,18-03-2020,405093,293,926,404167,Eastern Mediterranean
Senegal,18-03-2020,332638,1198,1146,331492,Africa
Serbia,18-03-2020,266731,1,516,266215,Europe
Seychelles,18-03-2020,102159,252,261,101898,Africa
Singapore,18-03-2020,399775,1413,702,399073,Western Pacific
Slovakia,18-03-2020,203504,1491,527,202977,Europe
Slovenia,18-03-2020,293151,2108,830,292321,Europe
Somalia,18-03-2020,35802,1614,277,35525,Eastern Mediterranean
South Africa,18-03-2020,99186,1619,670,98516,Africa
Spain,18-03-2020,226168,943,605,225563,Europe
Sri Lanka,18-03-2020,109549,603,731,108818,South-East Asia
Sudan,18-03-2020,353681,512,1012,352669,Eastern Mediterranean
Suriname,18-03-2020,312674,2382,386,312288,Americas
Sweden,18-03-2020,30129,1394,56,30073,Europe
Switzerland,18-03-2020,82241,1181,72,82169,Europe
Taiwan*,18-03-2020,334479,944,243,334236,Western Pacific
Tanzania,18-03-2020,308065,707,1052,307013,Africa
Thailand,18-03-2020,262464,1594,360,262104,South-East Asia
Togo,18-03-2020,266102,179,789,265313,Africa
Trinidad and Tobago,18-03-2020,168315,1467,25,168290,Americas
Tunisia,18-03-2020,162983,1073,774,162209,Eastern Mediterranean
Turkey,18-03-2020,361880,2299,448,361432,Europe
Uganda,18-03-2020,260585,251,73,260512,Africa
Ukraine,18-03-2020,440312,993,489,439823,Europe
United Arab Emirates,18-03-2020,111164,1399,129,111035,Eastern Mediterranean
United Kingdom,18-03-2020,33554,305,279,33275,Europe
United Kingdom,18-03-2020,379869,1573,1069,378800,Europe
United Kingdom,18-03-2020,276761,2340,556,276205,Europe
United Kingdom,18-03-2020,22985,2374,1174,21811,Europe
United Kingdom,18-03-2020,249909,2231,253,249656,Europe
United Kingdom,18-03-2020,234877,1525,998,233879,Europe
United Kingdom,18-03-2020,32281,2425,810,31471,Europe
Uruguay,18-03-2020,395646,1256,667,394979,Americas
US,18-03-2020,87401,985,354,87047,Americas
Uzbekistan,18-03-2020,56168,2015,493,55675,Europe
Venezuela,18-03-2020,271773,1195,790,270983,Americas
Vietnam,18-03-2020,352993,706,278,352715,Western Pacific
Zambia,18-03-2020,125192,850,626,124566,Africa
Zimbabwe,18-03-2020,252602,805,38,252564,Africa
Dominica,18-03-2020,414340,2309,797,413543,Americas
Grenada,18-03-2020,338397,2268,605,337792,Americas
Mozambique,18-03-2020,170628,2223,229,170399,Africa
Syria,18-03-2020,359082,1090,702,358380,Eastern Mediterranean
Timor-Leste,18-03-2020,429223,58,950,428273,South-East Asia
Belize,18-03-2020,308909,1761,1224,307685,Americas
Laos,18-03-2020,294595,1613,388,294207,Western Pacific
Libya,18-03-2020,251806,2175,1205,250601,Eastern Mediterranean
West Bank and Gaza,18-03-2020,360726,1874,669,360057,Eastern Mediterranean
Guinea-Bissau,18-03-2020,242962,159,426,242536,Africa
Mali,18-03-2020,127035,1541,605,126430,Africa
Saint Kitts and Nevis,18-03-2020,184474,60,537,183937,Americas
Canada,18-03-2020,236838,2161,676,236162,Americas
Canada,18-03-2020,287314,2033,1084,286230,Americas
Kosovo,18-03-2020,239680,1676,421,239259,Europe
Burma,18-03-2020,159918,1157,221,159697,South-East Asia
United Kingdom,18-03-2020,357187,69,271,356916,Europe
United Kingdom,18-03-2020,102735,1660,162,102573,Europe
United Kingdom,18-03-2020,431871,2060,213,431658,Europe
Botswana,18-03-2020,90807,1771,573,90234,Africa
Burundi,18-03-2020,76448,1633,963,75485,Africa
Sierra Leone,18-03-2020,130359,1826,536,129823,Africa
Malawi,18-03-2020,360456,2129,413,360043,Africa
United Kingdom,18-03-2020,215219,96,718,214501,Europe
France,18-03-2020,345585,1835,406,345179,Europe
South Sudan,18-03-2020,39128,699,267,38861,Africa
Western Sahara,18-03-2020,249874,2407,61,249813,Africa
Sao Tome and Principe,18-03-2020,314940,1814,558,314382,Africa
Yemen,18-03-2020,66469,1830,312,66157,Eastern Mediterranean
Comoros,18-03-2020,94979,172,249,94730,Africa
Tajikistan,18-03-2020,188134,245,646,187488,Europe
Lesotho,18-03-2020,133341,585,494,132847,Africa
Afghanistan,19-03-2020,11683,312,398,11285,Eastern Mediterranean
Albania,19-03-2020,154548,703,34,154514,Europe
Algeria,19-03-2020,393850,1544,434,393416,Africa
Andorra,19-03-2020,343240,1962,296,342944,Europe
Angola,19-03-2020,342315,343,719,341596,Africa
Antigua and Barbuda,19-03-2020,114191,1422,1184,113007,Americas
Argentina,19-03-2020,123342,1009,311,123031,Americas
Armenia,19-03-2020,348724,589,786,347938,Europe
Australia,19-03-2020,173916,1394,1233,172683,Western Pacific
Australia,19-03-2020,246581,25,614,245967,Western Pacific
Australia,19-03-2020,73740,1650,687,73053,Western Pacific
Australia,19-03-2020,364661,1533,140,364521,Western Pacific
Australia,19-03-2020,249237,447,105,249132,Western Pacific
Australia,19-03-2020,32964,42,544,32420,Western Pacific
Australia,19-03-2020,297358,2175,817,296541,Western Pacific
Australia,19-03-2020,334468,1571,1036,333432,Western Pacific
Austria,19-03-2020,238880,560,842,238038,Europe
Azerbaijan,19-03-2020,372253,2288,900,371353,Europe
Bahamas,19-03-2020,212343,1027,482,211861,Americas
Bahrain,19-03-2020,48826,317,587,48239,Eastern Mediterranean
Bangladesh,19-03-2020,39688,586,1156,38532,South-East Asia
Barbados,19-03-2020,59376,1717,821,58555,Americas
Belarus,19-03-2020,253999,1027,1234,252765,Europe
Belgium,19-03-2020,80863,1450,368,80495,Europe
Benin,19-03-2020,353386,277,585,352801,Africa
Bhutan,19-03-2020,143902,1942,398,143504,South-East Asia
Bolivia,19-03-2020,35440,2149,406,35034,Americas
Bosnia and Herzegovina,19-03-2020,84115,1612,889,83226,Europe
Brazil,19-03-2020,265557,1590,750,264807,Americas
Brunei,19-03-2020,337824,1157,719,337105,Western Pacific
Bulgaria,19-03-2020,179173,1594,378,178795,Europe
Burkina Faso,19-03-2020,113784,1765,177,113607,Africa
Cabo Verde,19-03-2020,291021,1241,277,290744,Africa
Cambodia,19-03-2020,194630,1478,819,193811,Western Pacific
Cameroon,19-03-2020,153916,1777,1171,152745,Africa
Canada,19-03-2020,154137,406,1246,152891,Americas
Canada,19-03-2020,230847,920,522,230325,Americas
Canada,19-03-2020,338231,455,529,337702,Americas
Canada,19-03-2020,349858,1431,855,349003,Americas
Canada,19-03-2020,219327,1101,719,218608,Americas
Canada,19-03-2020,16958,1090,980,15978,Americas
Canada,19-03-2020,17270,1860,872,16398,Americas
Canada,19-03-2020,215577,1795,1102,214475,Americas
Canada,19-03-2020,378786,1143,698,378088,Americas
Canada,19-03-2020,222023,2472,279,221744,Americas
Central African Republic,19-03-2020,130825,1729,447,130378,Africa
Chad,19-03-2020,211575,499,198,211377,Africa
Chile,19-03-2020,81655,1231,1106,80549,Americas
China,19-03-2020,343559,1068,1098,342461,Western Pacific
China,19-03-2020,136787,476,818,135969,Western Pacific
China,19-03-2020,228151,688,736,227415,Western Pacific
China,19-03-2020,331302,1597,360,330942,Western Pacific
China,19-03-2020,60321,1950,274,60047,Western Pacific
China,19-03-2020,238994,1693,147,238847,Western Pacific
China,19-03-2020,233717,1939,294,233423,Western Pacific
China,19-03-2020,74027,2085,376,73651,Western Pacific
China,19-03-2020,122870,1515,5,122865,Western Pacific
China,19-03-2020,342318,76,949,341369,Western Pacific
China,19-03-2020,373417,1413,39,373378,Western Pacific
China,19-03-2020,428487,2133,512,427975,Western Pacific
China,19-03-2020,319415,965,711,318704,Western Pacific
China,19-03-2020,273344,1155,9,273335,Western Pacific
China,19-03-2020,142005,2467,354,141651,Western Pacific
China,19-03-2020,32382,1129,1202,31180,Western Pacific
China,19-03-2020,228509,1762,1225,227284,Western Pacific
China,19-03-2020,69630,991,1013,68617,Western Pacific
China,19-03-2020,35260,334,889,34371,Western Pacific
China,19-03-2020,179505,2155,304,179201,Western Pacific
China,19-03-2020,21563,1316,968,20595,Western Pacific
China,19-03-2020,361103,92,875,360228,Western Pacific
China,19-03-2020,354497,1071,586,353911,Western Pacific
China,19-03-2020,151478,50,719,150759,Western Pacific
China,19-03-2020,42930,1003,881,42049,Western Pacific
China,19-03-2020,382220,2418,122,382098,Western Pacific
China,19-03-2020,447582,2287,856,446726,Western Pacific
China,19-03-2020,224561,120,840,223721,Western Pacific
China,19-03-2020,68068,601,232,67836,Western Pacific
China,19-03-2020,379161,745,1135,378026,Western Pacific
China,19-03-2020,405338,513,677,404661,Western Pacific
China,19-03-2020,197552,1689,298,197254,Western Pacific
China,19-03-2020,435135,1184,371,434764,Western Pacific
Colombia,19-03-2020,102853,2156,916,101937,Americas
Congo (Brazzaville),19-03-2020,288949,555,301,288648,Africa
Congo (Kinshasa),19-03-2020,407900,740,984,406916,Africa
Costa Rica,19-03-2020,124913,1963,1025,123888,Americas
Cote d'Ivoire,19-03-2020,94825,1498,942,93883,Africa
Croatia,19-03-2020,89923,1167,1182,88741,Europe
Cuba,19-03-2020,376758,2473,981,375777,Americas
Cyprus,19-03-2020,407295,1309,1082,406213,Europe
Czechia,19-03-2020,357045,2308,745,356300,Europe
Denmark,19-03-2020,344261,2069,339,343922,Europe
Greenland,19-03-2020,253633,2395,1215,252418,Europe
Denmark,19-03-2020,315276,1280,645,314631,Europe
Djibouti,19-03-2020,155542,1248,363,155179,Eastern Mediterranean
Dominican Republic,19-03-2020,195578,1074,628,194950,Americas
Ecuador,19-03-2020,410002,484,1167,408835,Americas
Egypt,19-03-2020,144701,966,492,144209,Eastern Mediterranean
El Salvador,19-03-2020,439341,1123,103,439238,Americas
Equatorial Guinea,19-03-2020,382101,528,80,382021,Africa
Eritrea,19-03-2020,367103,330,1225,365878,Africa
Estonia,19-03-2020,21827,431,740,21087,Europe
Eswatini,19-03-2020,312895,1251,637,312258,Africa
Ethiopia,19-03-2020,51927,2383,928,50999,Africa
Fiji,19-03-2020,175165,1138,1147,174018,Western Pacific
Finland,19-03-2020,217375,688,309,217066,Europe
France,19-03-2020,279652,1317,796,278856,Europe
France,19-03-2020,230214,512,1021,229193,Europe
France,19-03-2020,229165,1331,1045,228120,Europe
France,19-03-2020,92220,2285,1173,91047,Europe
France,19-03-2020,264889,1785,1120,263769,Europe
France,19-03-2020,254229,52,42,254187,Europe
France,19-03-2020,403367,357,299,403068,Europe
France,19-03-2020,194342,706,1128,193214,Europe
France,19-03-2020,146055,1821,480,145575,Europe
France,19-03-2020,277117,2059,587,276530,Europe
Gabon,19-03-2020,133626,1956,832,132794,Africa
Gambia,19-03-2020,354960,1559,576,354384,Africa
Georgia,19-03-2020,312461,2394,929,311532,Europe
Germany,19-03-2020,6691,553,201,6490,Europe
Ghana,19-03-2020,324034,239,125,323909,Africa
Greece,19-03-2020,177494,393,1026,176468,Europe
Guatemala,19-03-2020,354605,2058,386,354219,Americas
Guinea,19-03-2020,29657,2376,1102,28555,Africa
Guyana,19-03-2020,272512,711,1063,271449,Americas
Haiti,19-03-2020,181378,2144,546,180832,Americas
Holy See,19-03-2020,239121,353,121,239000,Europe
Honduras,19-03-2020,125815,703,636,125179,Americas
Hungary,19-03-2020,236164,1718,664,235500,Europe
Iceland,19-03-2020,112830,1616,638,112192,Europe
India,19-03-2020,3624,1056,530,3094,South-East Asia
Indonesia,19-03-2020,50634,869,675,49959,South-East Asia
Iran,19-03-2020,229294,764,735,228559,Eastern Mediterranean
Iraq,19-03-2020,302214,716,386,301828,Eastern Mediterranean
Ireland,19-03-2020,22842,935,419,22423,Europe
Israel,19-03-2020,378275,1595,673,377602,Europe
Italy,19-03-2020,11584,1972,327,11257,Europe
Jamaica,19-03-2020,225670,269,1099,224571,Americas
Japan,19-03-2020,431050,1297,320,430730,Western Pacific
Jordan,19-03-2020,104778,1123,811,103967,Eastern Mediterranean
Kazakhstan,19-03-2020,74665,1296,515,74150,Europe
Kenya,19-03-2020,192193,982,564,191629,Africa
South Korea,19-03-2020,343338,2325,236,343102,Western Pacific
Kuwait,19-03-2020,33089,2390,1024,32065,Eastern Mediterranean
Kyrgyzstan,19-03-2020,353141,1413,382,352759,Europe
Latvia,19-03-2020,187663,1363,706,186957,Europe
Lebanon,19-03-2020,100304,255,1118,99186,Eastern Mediterranean
Liberia,19-03-2020,124089,1573,1004,123085,Africa
Liechtenstein,19-03-2020,189162,1750,824,188338,Europe
Lithuania,19-03-2020,308560,168,1201,307359,Europe
Luxembourg,19-03-2020,430188,1840,357,429831,Europe
Madagascar,19-03-2020,385009,40,669,384340,Africa
Malaysia,19-03-2020,207080,2380,433,206647,Western Pacific
Maldives,19-03-2020,246265,776,350,245915,South-East Asia
Malta,19-03-2020,92562,1285,1151,91411,Europe
Mauritania,19-03-2020,18227,230,6,18221,Africa
Mauritius,19-03-2020,170501,968,1116,169385,Africa
Mexico,19-03-2020,164144,622,1058,163086,Americas
Moldova,19-03-2020,198681,2128,85,198596,Europe
Monaco,19-03-2020,153612,118,827,152785,Europe
Mongolia,19-03-2020,449426,585,211,449215,Western Pacific
Montenegro,19-03-2020,348053,153,260,347793,Europe
Morocco,19-03-2020,269124,1403,936,268188,Eastern Mediterranean
Namibia,19-03-2020,210723,556,62,210661,Africa
Nepal,19-03-2020,16634,2382,1213,15421,South-East Asia
Netherlands,19-03-2020,180493,1261,591,179902,Europe
Netherlands,19-03-2020,304886,1768,1035,303851,Europe
Netherlands,19-03-2020,337748,1277,679,337069,Europe
Netherlands,19-03-2020,1943,733,619,1324,Europe
New Zealand,19-03-2020,170325,1905,264,170061,Western Pacific
Nicaragua,19-03-2020,202473,2086,771,201702,Americas
Niger,19-03-2020,77443,168,874,76569,Africa
Nigeria,19-03-2020,423958,2010,157,423801,Africa
North Macedonia,19-03-2020,30790,1689,250,30540,Europe
Norway,19-03-2020,205071,88,749,204322,Europe
Oman,19-03-2020,372840,1485,831,372009,Eastern Mediterranean
Pakistan,19-03-2020,116349,2434,613,115736,Eastern Mediterranean
Panama,19-03-2020,28582,2111,273,28309,Americas
Papua New Guinea,19-03-2020,251911,769,260,251651,Western Pacific
Paraguay,19-03-2020,118154,446,814,117340,Americas
Peru,19-03-2020,77872,1365,202,77670,Americas
Philippines,19-03-2020,359417,1219,1157,358260,Western Pacific
Poland,19-03-2020,162953,1772,274,162679,Europe
Portugal,19-03-2020,131081,1994,630,130451,Europe
Qatar,19-03-2020,340727,839,1242,339485,Eastern Mediterranean
Romania,19-03-2020,110266,1856,388,109878,Europe
Russia,19-03-2020,49857,671,102,49755,Europe
Rwanda,19-03-2020,401431,134,631,400800,Africa
Saint Lucia,19-03-2020,379764,1341,983,378781,Americas
Saint Vincent and the Grenadines,19-03-2020,302044,1757,1168,300876,Americas
San Marino,19-03-2020,46074,693,492,45582,Europe
Saudi Arabia,19-03-2020,168697,460,528,168169,Eastern Mediterranean
Senegal,19-03-2020,78921,761,1128,77793,Africa
Serbia,19-03-2020,345886,733,430,345456,Europe
Seychelles,19-03-2020,442478,2085,719,441759,Africa
Singapore,19-03-2020,328293,2378,694,327599,Western Pacific
Slovakia,19-03-2020,267689,1411,1021,266668,Europe
Slovenia,19-03-2020,371179,2286,317,370862,Europe
Somalia,19-03-2020,40139,2018,1164,38975,Eastern Mediterranean
South Africa,19-03-2020,355076,1651,3,355073,Africa
Spain,19-03-2020,100664,606,1241,99423,Europe
Sri Lanka,19-03-2020,271888,356,171,271717,South-East Asia
Sudan,19-03-2020,99930,2019,1131,98799,Eastern Mediterranean
Suriname,19-03-2020,221765,421,1248,220517,Americas
Sweden,19-03-2020,306765,621,651,306114,Europe
Switzerland,19-03-2020,57067,1852,538,56529,Europe
Taiwan*,19-03-2020,419917,6,829,419088,Western Pacific
Tanzania,19-03-2020,358707,240,1196,357511,Africa
Thailand,19-03-2020,297721,1036,1122,296599,South-East Asia
Togo,19-03-2020,123156,596,104,123052,Africa
Trinidad and Tobago,19-03-2020,281318,1540,1147,280171,Americas
Tunisia,19-03-2020,282688,103,1222,281466,Eastern Mediterranean
Turkey,19-03-2020,294484,351,215,294269,Europe
Uganda,19-03-2020,424930,1830,831,424099,Africa
Ukraine,19-03-2020,51466,963,936,50530,Europe
United Arab Emirates,19-03-2020,85559,796,607,84952,Eastern Mediterranean
United Kingdom,19-03-2020,43152,1534,414,42738,Europe
United Kingdom,19-03-2020,272654,2230,490,272164,Europe
United Kingdom,19-03-2020,63575,1818,362,63213,Europe
United Kingdom,19-03-2020,223264,1137,666,222598,Europe
United Kingdom,19-03-2020,253273,765,70,253203,Europe
United Kingdom,19-03-2020,60867,538,184,60683,Europe
United Kingdom,19-03-2020,315211,1022,587,314624,Europe
Uruguay,19-03-2020,414712,787,502,414210,Americas
US,19-03-2020,226897,2189,140,226757,Americas
Uzbekistan,19-03-2020,230587,1824,956,229631,Europe
Venezuela,19-03-2020,137419,507,651,136768,Americas
Vietnam,19-03-2020,262741,835,472,262269,Western Pacific
Zambia,19-03-2020,43203,793,1060,42143,Africa
Zimbabwe,19-03-2020,143288,792,625,142663,Africa
Dominica,19-03-2020,16447,326,971,15476,Americas
Grenada,19-03-2020,188109,624,380,187729,Americas
Mozambique,19-03-2020,72559,778,931,71628,Africa
Syria,19-03-2020,240559,838,889,239670,Eastern Mediterranean
Timor-Leste,19-03-2020,374706,310,54,374652,South-East Asia
Belize,19-03-2020,409632,1941,807,408825,Americas
Laos,19-03-2020,202517,166,526,201991,Western Pacific
Libya,19-03-2020,413846,1647,111,413735,Eastern Mediterranean
West Bank and Gaza,19-03-2020,365978,2281,540,365438,Eastern Mediterranean
Guinea-Bissau,19-03-2020,101653,202,903,100750,Africa
Mali,19-03-2020,44522,1266,468,44054,Africa
Saint Kitts and Nevis,19-03-2020,224701,981,1053,223648,Americas
Canada,19-03-2020,119675,1583,730,118945,Americas
Canada,19-03-2020,382373,501,444,381929,Americas
Kosovo,19-03-2020,408150,865,966,407184,Europe
Burma,19-03-2020,67299,731,1161,66138,South-East Asia
United Kingdom,19-03-2020,304378,333,330,304048,Europe
United Kingdom,19-03-2020,373735,1716,1066,372669,Europe
United Kingdom,19-03-2020,392246,18,409,391837,Europe
Botswana,19-03-2020,357138,1507,722,356416,Africa
Burundi,19-03-2020,184950,333,750,184200,Africa
Sierra Leone,19-03-2020,222259,1863,181,222078,Africa
Malawi,19-03-2020,371712,1564,1163,370549,Africa
United Kingdom,19-03-2020,192561,827,466,192095,Europe
France,19-03-2020,93816,641,1172,92644,Europe
South Sudan,19-03-2020,144710,872,643,144067,Africa
Western Sahara,19-03-2020,116181,707,388,115793,Africa
Sao Tome and Principe,19-03-2020,411368,2411,461,410907,Africa
Yemen,19-03-2020,282441,2429,450,281991,Eastern Mediterranean
Comoros,19-03-2020,19853,1170,577,19276,Africa
Tajikistan,19-03-2020,4781,1000,1163,3618,Europe
Lesotho,19-03-2020,83053,1753,898,82155,Africa
Afghanistan,20-03-2020,92770,1555,326,92444,Eastern Mediterranean
Albania,20-03-2020,10108,2427,165,9943,Europe
Algeria,20-03-2020,308754,1725,196,308558,Africa
Andorra,20-03-2020,224618,1778,710,223908,Europe
Angola,20-03-2020,216154,2292,913,215241,Africa
Antigua and Barbuda,20-03-2020,356191,1108,777,355414,Americas
Argentina,20-03-2020,273506,1005,620,272886,Americas
Armenia,20-03-2020,368664,273,46,368618,Europe
Australia,20-03-2020,287814,1141,957,286857,Western Pacific
Australia,20-03-2020,151248,1530,38,151210,Western Pacific
Australia,20-03-2020,7660,333,392,7268,Western Pacific
Australia,20-03-2020,330699,123,789,329910,Western Pacific
Australia,20-03-2020,60453,2043,550,59903,Western Pacific
Australia,20-03-2020,318618,998,369,318249,Western Pacific
Australia,20-03-2020,323581,764,983,322598,Western Pacific
Australia,20-03-2020,291396,1322,744,290652,Western Pacific
Austria,20-03-2020,44915,350,901,44014,Europe
Azerbaijan,20-03-2020,300276,41,512,299764,Europe
Bahamas,20-03-2020,271301,831,593,270708,Americas
Bahrain,20-03-2020,135456,690,782,134674,Eastern Mediterranean
Bangladesh,20-03-2020,104951,2249,444,104507,South-East Asia
Barbados,20-03-2020,419562,1586,527,419035,Americas
Belarus,20-03-2020,219987,1860,735,219252,Europe
Belgium,20-03-2020,201090,8,965,200125,Europe
Benin,20-03-2020,131619,969,525,131094,Africa
Bhutan,20-03-2020,152270,929,928,151342,South-East Asia
Bolivia,20-03-2020,165637,247,383,165254,Americas
Bosnia and Herzegovina,20-03-2020,270913,2389,503,270410,Europe
Brazil,20-03-2020,294782,1766,156,294626,Americas
Brunei,20-03-2020,382803,1540,906,381897,Western Pacific
Bulgaria,20-03-2020,261191,156,390,260801,Europe
Burkina Faso,20-03-2020,131754,1424,984,130770,Africa
Cabo Verde,20-03-2020,391777,2426,629,391148,Africa
Cambodia,20-03-2020,430998,1573,338,430660,Western Pacific
Cameroon,20-03-2020,228943,1427,986,227957,Africa
Canada,20-03-2020,279605,321,262,279343,Americas
Canada,20-03-2020,27333,988,552,26781,Americas
Canada,20-03-2020,381751,1320,742,381009,Americas
Canada,20-03-2020,382129,1595,1115,381014,Americas
Canada,20-03-2020,274084,803,970,273114,Americas
Canada,20-03-2020,345590,2008,736,344854,Americas
Canada,20-03-2020,123524,1124,969,122555,Americas
Canada,20-03-2020,279249,1086,821,278428,Americas
Canada,20-03-2020,286098,382,1216,284882,Americas
Canada,20-03-2020,23786,612,480,23306,Americas
Central African Republic,20-03-2020,17021,512,935,16086,Africa
Chad,20-03-2020,342156,1704,476,341680,Africa
Chile,20-03-2020,369065,1897,160,368905,Americas
China,20-03-2020,157186,557,470,156716,Western Pacific
China,20-03-2020,136395,746,243,136152,Western Pacific
China,20-03-2020,83546,1746,600,82946,Western Pacific
China,20-03-2020,154111,1026,629,153482,Western Pacific
China,20-03-2020,372999,361,320,372679,Western Pacific
China,20-03-2020,137184,1622,652,136532,Western Pacific
China,20-03-2020,118498,2322,374,118124,Western Pacific
China,20-03-2020,307422,2244,655,306767,Western Pacific
China,20-03-2020,383624,217,208,383416,Western Pacific
China,20-03-2020,399999,977,566,399433,Western Pacific
China,20-03-2020,315544,1617,246,315298,Western Pacific
China,20-03-2020,159014,1450,18,158996,Western Pacific
China,20-03-2020,162664,147,458,162206,Western Pacific
China,20-03-2020,333797,1519,226,333571,Western Pacific
China,20-03-2020,315455,2198,357,315098,Western Pacific
China,20-03-2020,14400,1005,1029,13371,Western Pacific
China,20-03-2020,27291,1972,753,26538,Western Pacific
China,20-03-2020,20799,1134,816,19983,Western Pacific
China,20-03-2020,27116,1713,1043,26073,Western Pacific
China,20-03-2020,359201,2066,344,358857,Western Pacific
China,20-03-2020,401158,1789,764,400394,Western Pacific
China,20-03-2020,165158,2130,304,164854,Western Pacific
China,20-03-2020,254330,622,903,253427,Western Pacific
China,20-03-2020,407698,275,323,407375,Western Pacific
China,20-03-2020,313294,522,275,313019,Western Pacific
China,20-03-2020,166405,2316,1194,165211,Western Pacific
China,20-03-2020,131202,1498,780,130422,Western Pacific
China,20-03-2020,39930,1441,914,39016,Western Pacific
China,20-03-2020,166153,1552,604,165549,Western Pacific
China,20-03-2020,252235,998,1020,251215,Western Pacific
China,20-03-2020,78604,1404,990,77614,Western Pacific
China,20-03-2020,216578,364,748,215830,Western Pacific
China,20-03-2020,255060,1093,221,254839,Western Pacific
Colombia,20-03-2020,129032,2420,46,128986,Americas
Congo (Brazzaville),20-03-2020,190989,1442,587,190402,Africa
Congo (Kinshasa),20-03-2020,122093,24,594,121499,Africa
Costa Rica,20-03-2020,375704,871,915,374789,Americas
Cote d'Ivoire,20-03-2020,272475,1379,1234,271241,Africa
Croatia,20-03-2020,331094,1760,378,330716,Europe
Cuba,20-03-2020,31856,1479,125,31731,Americas
Cyprus,20-03-2020,432801,26,1049,431752,Europe
Czechia,20-03-2020,380621,1403,848,379773,Europe
Denmark,20-03-2020,155171,1872,776,154395,Europe
Greenland,20-03-2020,102117,1022,720,101397,Europe
Denmark,20-03-2020,173138,1776,957,172181,Europe
Djibouti,20-03-2020,359546,2317,655,358891,Eastern Mediterranean
Dominican Republic,20-03-2020,345941,983,1202,344739,Americas
Ecuador,20-03-2020,112463,1295,408,112055,Americas
Egypt,20-03-2020,172039,1955,1216,170823,Eastern Mediterranean
El Salvador,20-03-2020,34770,1577,1060,33710,Americas
Equatorial Guinea,20-03-2020,23825,1948,1115,22710,Africa
Eritrea,20-03-2020,81323,1297,152,81171,Africa
Estonia,20-03-2020,302585,1532,414,302171,Europe
Eswatini,20-03-2020,99492,446,926,98566,Africa
Ethiopia,20-03-2020,226194,1188,195,225999,Africa
Fiji,20-03-2020,45055,1680,963,44092,Western Pacific
Finland,20-03-2020,436594,2378,651,435943,Europe
France,20-03-2020,59751,1595,553,59198,Europe
France,20-03-2020,10693,2021,195,10498,Europe
France,20-03-2020,384865,2163,956,383909,Europe
France,20-03-2020,321496,822,614,320882,Europe
France,20-03-2020,52049,1594,177,51872,Europe
France,20-03-2020,399333,853,387,398946,Europe
France,20-03-2020,71007,603,339,70668,Europe
France,20-03-2020,154414,2003,1003,153411,Europe
France,20-03-2020,32760,742,1102,31658,Europe
France,20-03-2020,296562,1868,857,295705,Europe
Gabon,20-03-2020,401646,1579,528,401118,Africa
Gambia,20-03-2020,63768,1447,840,62928,Africa
Georgia,20-03-2020,261123,2499,555,260568,Europe
Germany,20-03-2020,253137,700,1010,252127,Europe
Ghana,20-03-2020,272965,184,432,272533,Africa
Greece,20-03-2020,246395,1601,140,246255,Europe
Guatemala,20-03-2020,48510,1442,852,47658,Americas
Guinea,20-03-2020,278883,1282,172,278711,Africa
Guyana,20-03-2020,309263,154,701,308562,Americas
Haiti,20-03-2020,414413,69,530,413883,Americas
Holy See,20-03-2020,357341,546,238,357103,Europe
Honduras,20-03-2020,347221,103,531,346690,Americas
Hungary,20-03-2020,418437,1561,725,417712,Europe
Iceland,20-03-2020,49777,1199,400,49377,Europe
India,20-03-2020,387687,462,11,387676,South-East Asia
Indonesia,20-03-2020,266233,2402,192,266041,South-East Asia
Iran,20-03-2020,153856,2103,93,153763,Eastern Mediterranean
Iraq,20-03-2020,195293,770,252,195041,Eastern Mediterranean
Ireland,20-03-2020,139434,2213,755,138679,Europe
Israel,20-03-2020,153787,466,831,152956,Europe
Italy,20-03-2020,247338,1237,1159,246179,Europe
Jamaica,20-03-2020,124866,1650,629,124237,Americas
Japan,20-03-2020,30264,966,790,29474,Western Pacific
Jordan,20-03-2020,176221,568,798,175423,Eastern Mediterranean
Kazakhstan,20-03-2020,284236,124,651,283585,Europe
Kenya,20-03-2020,116922,1503,23,116899,Africa
South Korea,20-03-2020,154546,916,593,153953,Western Pacific
Kuwait,20-03-2020,107479,637,66,107413,Eastern Mediterranean
Kyrgyzstan,20-03-2020,221170,1325,355,220815,Europe
Latvia,20-03-2020,407763,2423,223,407540,Europe
Lebanon,20-03-2020,379606,2367,62,379544,Eastern Mediterranean
Liberia,20-03-2020,382063,2430,220,381843,Africa
Liechtenstein,20-03-2020,286757,1321,1117,285640,Europe
Lithuania,20-03-2020,351390,936,562,350828,Europe
Luxembourg,20-03-2020,83154,1716,605,82549,Europe
Madagascar,20-03-2020,354551,911,503,354048,Africa
Malaysia,20-03-2020,341363,1307,1202,340161,Western Pacific
Maldives,20-03-2020,191206,2386,927,190279,South-East Asia
Malta,20-03-2020,396884,2264,786,396098,Europe
Mauritania,20-03-2020,114310,1249,678,113632,Africa
Mauritius,20-03-2020,267046,444,109,266937,Africa
Mexico,20-03-2020,9145,1635,1001,8144,Americas
Moldova,20-03-2020,337852,1517,158,337694,Europe
Monaco,20-03-2020,148908,2413,972,147936,Europe
Mongolia,20-03-2020,180474,2008,598,179876,Western Pacific
Montenegro,20-03-2020,401763,531,488,401275,Europe
Morocco,20-03-2020,230213,1751,534,229679,Eastern Mediterranean
Namibia,20-03-2020,384357,160,700,383657,Africa
Nepal,20-03-2020,432663,2484,515,432148,South-East Asia
Netherlands,20-03-2020,141134,1820,778,140356,Europe
Netherlands,20-03-2020,419638,1905,985,418653,Europe
Netherlands,20-03-2020,407610,1822,1094,406516,Europe
Netherlands,20-03-2020,43491,622,131,43360,Europe
New Zealand,20-03-2020,35513,1757,153,35360,Western Pacific
Nicaragua,20-03-2020,10472,1984,933,9539,Americas
Niger,20-03-2020,76001,176,114,75887,Africa
Nigeria,20-03-2020,14469,614,247,14222,Africa
North Macedonia,20-03-2020,207321,2390,126,207195,Europe
Norway,20-03-2020,173746,1493,194,173552,Europe
Oman,20-03-2020,52225,1687,152,52073,Eastern Mediterranean
Pakistan,20-03-2020,179712,505,505,179207,Eastern Mediterranean
Panama,20-03-2020,110187,1355,496,109691,Americas
Papua New Guinea,20-03-2020,112815,508,110,112705,Western Pacific
Paraguay,20-03-2020,13482,435,38,13444,Americas
Peru,20-03-2020,307699,1501,1031,306668,Americas
Philippines,20-03-2020,226638,1393,1044,225594,Western Pacific
Poland,20-03-2020,25069,2219,84,24985,Europe
Portugal,20-03-2020,230826,1040,1062,229764,Europe
Qatar,20-03-2020,300090,1945,489,299601,Eastern Mediterranean
Romania,20-03-2020,396648,2123,375,396273,Europe
Russia,20-03-2020,337947,684,636,337311,Europe
Rwanda,20-03-2020,153160,1807,289,152871,Africa
Saint Lucia,20-03-2020,404574,203,288,404286,Americas
Saint Vincent and the Grenadines,20-03-2020,322562,857,669,321893,Americas
San Marino,20-03-2020,269486,172,827,268659,Europe
Saudi Arabia,20-03-2020,167455,228,712,166743,Eastern Mediterranean
Senegal,20-03-2020,367737,1376,1184,366553,Africa
Serbia,20-03-2020,211619,596,720,210899,Europe
Seychelles,20-03-2020,130387,1376,946,129441,Africa
Singapore,20-03-2020,124136,1883,218,123918,Western Pacific
Slovakia,20-03-2020,175950,2044,1151,174799,Europe
Slovenia,20-03-2020,123999,220,1109,122890,Europe
Somalia,20-03-2020,187550,482,236,187314,Eastern Mediterranean
South Africa,20-03-2020,54937,116,826,54111,Africa
Spain,20-03-2020,381411,1040,896,380515,Europe
Sri Lanka,20-03-2020,7856,837,733,7123,South-East Asia
Sudan,20-03-2020,213871,1720,1202,212669,Eastern Mediterranean
Suriname,20-03-2020,124519,1431,1149,123370,Americas
Sweden,20-03-2020,197037,1178,300,196737,Europe
Switzerland,20-03-2020,303904,1778,350,303554,Europe
Taiwan*,20-03-2020,105457,678,319,105138,Western Pacific
Tanzania,20-03-2020,400397,1871,358,400039,Africa
Thailand,20-03-2020,415082,144,187,414895,South-East Asia
Togo,20-03-2020,223625,1118,61,223564,Africa
Trinidad and Tobago,20-03-2020,139868,2338,966,138902,Americas
Tunisia,20-03-2020,307260,51,810,306450,Eastern Mediterranean
Turkey,20-03-2020,195068,1900,1200,193868,Europe
Uganda,20-03-2020,33639,2050,1221,32418,Africa
Ukraine,20-03-2020,299455,708,1234,298221,Europe
United Arab Emirates,20-03-2020,170974,91,227,170747,Eastern Mediterranean
United Kingdom,20-03-2020,191308,1846,971,190337,Europe
United Kingdom,20-03-2020,402917,174,39,402878,Europe
United Kingdom,20-03-2020,6273,2122,767,5506,Europe
United Kingdom,20-03-2020,199193,490,1235,197958,Europe
United Kingdom,20-03-2020,52829,2378,909,51920,Europe
United Kingdom,20-03-2020,304951,133,847,304104,Europe
United Kingdom,20-03-2020,276120,868,858,275262,Europe
Uruguay,20-03-2020,229347,879,824,228523,Americas
US,20-03-2020,269934,2306,160,269774,Americas
Uzbekistan,20-03-2020,81833,1668,809,81024,Europe
Venezuela,20-03-2020,374679,1935,612,374067,Americas
Vietnam,20-03-2020,441479,2218,1156,440323,Western Pacific
Zambia,20-03-2020,76011,994,1088,74923,Africa
Zimbabwe,20-03-2020,28833,1409,318,28515,Africa
Dominica,20-03-2020,392509,389,89,392420,Americas
Grenada,20-03-2020,330106,80,1080,329026,Americas
Mozambique,20-03-2020,227095,1049,446,226649,Africa
Syria,20-03-2020,141136,212,117,141019,Eastern Mediterranean
Timor-Leste,20-03-2020,280152,533,941,279211,South-East Asia
Belize,20-03-2020,155284,185,692,154592,Americas
Laos,20-03-2020,351603,2332,1144,350459,Western Pacific
Libya,20-03-2020,335897,2450,87,335810,Eastern Mediterranean
West Bank and Gaza,20-03-2020,361337,155,552,360785,Eastern Mediterranean
Guinea-Bissau,20-03-2020,142590,531,1073,141517,Africa
Mali,20-03-2020,330428,1938,1244,329184,Africa
Saint Kitts and Nevis,20-03-2020,181814,1630,214,181600,Americas
Canada,20-03-2020,35324,244,276,35048,Americas
Canada,20-03-2020,246415,500,727,245688,Americas
Kosovo,20-03-2020,76894,144,626,76268,Europe
Burma,20-03-2020,277469,861,1017,276452,South-East Asia
United Kingdom,20-03-2020,154189,1277,169,154020,Europe
United Kingdom,20-03-2020,352082,225,828,351254,Europe
United Kingdom,20-03-2020,211146,245,346,210800,Europe
Botswana,20-03-2020,26729,713,225,26504,Africa
Burundi,20-03-2020,80512,2171,663,79849,Africa
Sierra Leone,20-03-2020,435087,1730,834,434253,Africa
Malawi,20-03-2020,61381,272,1121,60260,Africa
United Kingdom,20-03-2020,53733,12,570,53163,Europe
France,20-03-2020,190841,1921,1020,189821,Europe
South Sudan,20-03-2020,138114,1670,732,137382,Africa
Western Sahara,20-03-2020,391997,2044,1035,390962,Africa
Sao Tome and Principe,20-03-2020,350195,1237,70,350125,Africa
Yemen,20-03-2020,191009,1789,291,190718,Eastern Mediterranean
Comoros,20-03-2020,411063,1584,888,410175,Africa
Tajikistan,20-03-2020,206271,888,873,205398,Europe
Lesotho,20-03-2020,359440,439,614,358826,Africa
Afghanistan,21-03-2020,372058,2480,1208,370850,Eastern Mediterranean
Albania,21-03-2020,397781,10,292,397489,Europe
Algeria,21-03-2020,172464,1714,464,172000,Africa
Andorra,21-03-2020,85783,530,694,85089,Europe
Angola,21-03-2020,108503,295,482,108021,Africa
Antigua and Barbuda,21-03-2020,439244,864,871,438373,Americas
Argentina,21-03-2020,254696,1620,83,254613,Americas
Armenia,21-03-2020,410805,1099,666,410139,Europe
Australia,21-03-2020,182193,170,1028,181165,Western Pacific
Australia,21-03-2020,324429,2257,1209,323220,Western Pacific
Australia,21-03-2020,427763,2368,1220,426543,Western Pacific
Australia,21-03-2020,104086,1758,861,103225,Western Pacific
Australia,21-03-2020,103568,1360,792,102776,Western Pacific
Australia,21-03-2020,188388,1053,913,187475,Western Pacific
Australia,21-03-2020,117768,2316,915,116853,Western Pacific
Australia,21-03-2020,310905,261,253,310652,Western Pacific
Austria,21-03-2020,280770,2373,685,280085,Europe
Azerbaijan,21-03-2020,1549,1545,10,1539,Europe
Bahamas,21-03-2020,404353,1065,517,403836,Americas
Bahrain,21-03-2020,66540,568,167,66373,Eastern Mediterranean
Bangladesh,21-03-2020,210907,1183,276,210631,South-East Asia
Barbados,21-03-2020,173647,1481,751,172896,Americas
Belarus,21-03-2020,31340,730,856,30484,Europe
Belgium,21-03-2020,16827,280,401,16426,Europe
Benin,21-03-2020,152195,219,368,151827,Africa
Bhutan,21-03-2020,361884,762,1010,360874,South-East Asia
Bolivia,21-03-2020,120991,2004,985,120006,Americas
Bosnia and Herzegovina,21-03-2020,139128,717,164,138964,Europe
Brazil,21-03-2020,372321,872,115,372206,Americas
Brunei,21-03-2020,427690,1207,290,427400,Western Pacific
Bulgaria,21-03-2020,403811,2255,1217,402594,Europe
Burkina Faso,21-03-2020,430028,2247,144,429884,Africa
Cabo Verde,21-03-2020,224473,728,306,224167,Africa
Cambodia,21-03-2020,118986,465,667,118319,Western Pacific
Cameroon,21-03-2020,436960,320,1213,435747,Africa
Canada,21-03-2020,159920,2383,729,159191,Americas
Canada,21-03-2020,102509,631,316,102193,Americas
Canada,21-03-2020,131593,624,298,131295,Americas
Canada,21-03-2020,335540,1845,1184,334356,Americas
Canada,21-03-2020,80275,1857,789,79486,Americas
Canada,21-03-2020,149138,2410,965,148173,Americas
Canada,21-03-2020,446827,2044,1067,445760,Americas
Canada,21-03-2020,423474,1314,1243,422231,Americas
Canada,21-03-2020,224442,395,526,223916,Americas
Canada,21-03-2020,242413,2069,1110,241303,Americas
Central African Republic,21-03-2020,284331,1781,1144,283187,Africa
Chad,21-03-2020,71287,534,956,70331,Africa
Chile,21-03-2020,39707,658,1006,38701,Americas
China,21-03-2020,268076,1400,500,267576,Western Pacific
China,21-03-2020,103050,624,156,102894,Western Pacific
China,21-03-2020,401558,9,1232,400326,Western Pacific
China,21-03-2020,124528,436,385,124143,Western Pacific
China,21-03-2020,124070,501,279,123791,Western Pacific
China,21-03-2020,99150,1325,26,99124,Western Pacific
China,21-03-2020,49898,195,913,48985,Western Pacific
China,21-03-2020,332902,2224,522,332380,Western Pacific
China,21-03-2020,164253,301,580,163673,Western Pacific
China,21-03-2020,394184,105,822,393362,Western Pacific
China,21-03-2020,282343,573,34,282309,Western Pacific
China,21-03-2020,273260,1149,504,272756,Western Pacific
China,21-03-2020,72208,1956,1174,71034,Western Pacific
China,21-03-2020,51110,1077,491,50619,Western Pacific
China,21-03-2020,69975,2029,475,69500,Western Pacific
China,21-03-2020,304751,2246,693,304058,Western Pacific
China,21-03-2020,401567,1953,991,400576,Western Pacific
China,21-03-2020,404956,17,319,404637,Western Pacific
China,21-03-2020,436909,1685,705,436204,Western Pacific
China,21-03-2020,132288,2223,1060,131228,Western Pacific
China,21-03-2020,335158,1603,52,335106,Western Pacific
China,21-03-2020,37981,1002,902,37079,Western Pacific
China,21-03-2020,446615,1929,988,445627,Western Pacific
China,21-03-2020,178069,43,459,177610,Western Pacific
China,21-03-2020,5769,355,947,4822,Western Pacific
China,21-03-2020,283354,1884,778,282576,Western Pacific
China,21-03-2020,153141,1991,5,153136,Western Pacific
China,21-03-2020,298299,2047,975,297324,Western Pacific
China,21-03-2020,231922,1980,361,231561,Western Pacific
China,21-03-2020,435805,1195,800,435005,Western Pacific
China,21-03-2020,379645,464,799,378846,Western Pacific
China,21-03-2020,197532,1556,571,196961,Western Pacific
China,21-03-2020,240371,1198,395,239976,Western Pacific
Colombia,21-03-2020,226587,121,8,226579,Americas
Congo (Brazzaville),21-03-2020,6685,2317,1209,5476,Africa
Congo (Kinshasa),21-03-2020,12094,2376,966,11128,Africa
Costa Rica,21-03-2020,74346,1347,381,73965,Americas
Cote d'Ivoire,21-03-2020,96031,170,1238,94793,Africa
Croatia,21-03-2020,15079,847,243,14836,Europe
Cuba,21-03-2020,346680,897,112,346568,Americas
Cyprus,21-03-2020,406169,2391,861,405308,Europe
Czechia,21-03-2020,140555,2491,355,140200,Europe
Denmark,21-03-2020,38812,1632,553,38259,Europe
Greenland,21-03-2020,291771,1141,1202,290569,Europe
Denmark,21-03-2020,373414,2129,420,372994,Europe
Djibouti,21-03-2020,19848,1544,360,19488,Eastern Mediterranean
Dominican Republic,21-03-2020,428125,819,1029,427096,Americas
Ecuador,21-03-2020,40251,1134,1012,39239,Americas
Egypt,21-03-2020,355827,2165,1119,354708,Eastern Mediterranean
El Salvador,21-03-2020,309234,1946,877,308357,Americas
Equatorial Guinea,21-03-2020,303598,2303,557,303041,Africa
Eritrea,21-03-2020,327699,1231,20,327679,Africa
Estonia,21-03-2020,396422,1831,120,396302,Europe
Eswatini,21-03-2020,20179,1383,883,19296,Africa
Ethiopia,21-03-2020,425142,1359,795,424347,Africa
Fiji,21-03-2020,217729,1878,1123,216606,Western Pacific
Finland,21-03-2020,65167,858,1095,64072,Europe
France,21-03-2020,202661,1683,1170,201491,Europe
France,21-03-2020,176446,832,506,175940,Europe
France,21-03-2020,355700,2451,353,355347,Europe
France,21-03-2020,96381,125,859,95522,Europe
France,21-03-2020,270173,1466,1141,269032,Europe
France,21-03-2020,116730,262,1231,115499,Europe
France,21-03-2020,421741,74,1157,420584,Europe
France,21-03-2020,184401,2458,617,183784,Europe
France,21-03-2020,79126,607,417,78709,Europe
France,21-03-2020,192467,97,249,192218,Europe
Gabon,21-03-2020,370167,428,1198,368969,Africa
Gambia,21-03-2020,138408,499,818,137590,Africa
Georgia,21-03-2020,137173,734,825,136348,Europe
Germany,21-03-2020,283797,1378,594,283203,Europe
Ghana,21-03-2020,372009,1054,948,371061,Africa
Greece,21-03-2020,322064,26,1230,320834,Europe
Guatemala,21-03-2020,80575,2218,482,80093,Americas
Guinea,21-03-2020,253000,2379,1148,251852,Africa
Guyana,21-03-2020,284332,1838,531,283801,Americas
Haiti,21-03-2020,433526,829,529,432997,Americas
Holy See,21-03-2020,83838,2234,826,83012,Europe
Honduras,21-03-2020,124593,902,1142,123451,Americas
Hungary,21-03-2020,169939,2493,289,169650,Europe
Iceland,21-03-2020,44073,2035,1203,42870,Europe
India,21-03-2020,387483,167,287,387196,South-East Asia
Indonesia,21-03-2020,241056,1881,675,240381,South-East Asia
Iran,21-03-2020,141891,1110,232,141659,Eastern Mediterranean
Iraq,21-03-2020,135049,426,589,134460,Eastern Mediterranean
Ireland,21-03-2020,135782,72,861,134921,Europe
Israel,21-03-2020,28719,1759,226,28493,Europe
Italy,21-03-2020,439482,259,968,438514,Europe
Jamaica,21-03-2020,133008,183,731,132277,Americas
Japan,21-03-2020,434630,1171,1007,433623,Western Pacific
Jordan,21-03-2020,383313,1775,1096,382217,Eastern Mediterranean
Kazakhstan,21-03-2020,382248,127,718,381530,Europe
Kenya,21-03-2020,360495,871,412,360083,Africa
South Korea,21-03-2020,405580,1567,1040,404540,Western Pacific
Kuwait,21-03-2020,277092,505,161,276931,Eastern Mediterranean
Kyrgyzstan,21-03-2020,18005,1650,1206,16799,Europe
Latvia,21-03-2020,301431,1634,861,300570,Europe
Lebanon,21-03-2020,359343,711,1168,358175,Eastern Mediterranean
Liberia,21-03-2020,326114,815,1085,325029,Africa
Liechtenstein,21-03-2020,155420,1673,1041,154379,Europe
Lithuania,21-03-2020,437246,767,656,436590,Europe
Luxembourg,21-03-2020,415178,751,426,414752,Europe
Madagascar,21-03-2020,292841,727,923,291918,Africa
Malaysia,21-03-2020,52205,1850,670,51535,Western Pacific
Maldives,21-03-2020,215258,2424,602,214656,South-East Asia
Malta,21-03-2020,105389,987,799,104590,Europe
Mauritania,21-03-2020,42067,1389,32,42035,Africa
Mauritius,21-03-2020,299076,1314,566,298510,Africa
Mexico,21-03-2020,261201,1328,871,260330,Americas
Moldova,21-03-2020,74410,1820,1063,73347,Europe
Monaco,21-03-2020,238631,1824,1007,237624,Europe
Mongolia,21-03-2020,425948,1499,1058,424890,Western Pacific
Montenegro,21-03-2020,78943,2356,336,78607,Europe
Morocco,21-03-2020,282272,233,802,281470,Eastern Mediterranean
Namibia,21-03-2020,38271,2383,437,37834,Africa
Nepal,21-03-2020,183639,1039,505,183134,South-East Asia
Netherlands,21-03-2020,425040,1333,1036,424004,Europe
Netherlands,21-03-2020,436481,1729,990,435491,Europe
Netherlands,21-03-2020,424144,387,955,423189,Europe
Netherlands,21-03-2020,121243,777,412,120831,Europe
New Zealand,21-03-2020,272039,2361,121,271918,Western Pacific
Nicaragua,21-03-2020,262307,1312,264,262043,Americas
Niger,21-03-2020,336447,1904,776,335671,Africa
Nigeria,21-03-2020,145826,958,315,145511,Africa
North Macedonia,21-03-2020,244192,833,461,243731,Europe
Norway,21-03-2020,419833,2485,432,419401,Europe
Oman,21-03-2020,192325,61,1241,191084,Eastern Mediterranean
Pakistan,21-03-2020,49963,1451,1089,48874,Eastern Mediterranean
Panama,21-03-2020,216813,26,7,216806,Americas
Papua New Guinea,21-03-2020,196388,195,432,195956,Western Pacific
Paraguay,21-03-2020,135562,1687,136,135426,Americas
Peru,21-03-2020,28361,872,1138,27223,Americas
Philippines,21-03-2020,305663,1748,636,305027,Western Pacific
Poland,21-03-2020,433820,547,577,433243,Europe
Portugal,21-03-2020,377766,1399,1027,376739,Europe
Qatar,21-03-2020,156020,1851,1199,154821,Eastern Mediterranean
Romania,21-03-2020,201423,2113,324,201099,Europe
Russia,21-03-2020,272260,186,756,271504,Europe
Rwanda,21-03-2020,158827,996,0,158827,Africa
Saint Lucia,21-03-2020,316858,2391,474,316384,Americas
Saint Vincent and the Grenadines,21-03-2020,278441,1382,672,277769,Americas
San Marino,21-03-2020,154353,2146,330,154023,Europe
Saudi Arabia,21-03-2020,155280,1290,811,154469,Eastern Mediterranean
Senegal,21-03-2020,231952,1274,53,231899,Africa
Serbia,21-03-2020,141249,1362,339,140910,Europe
Seychelles,21-03-2020,414164,1694,907,413257,Africa
Singapore,21-03-2020,101786,520,1079,100707,Western Pacific
Slovakia,21-03-2020,137755,451,40,137715,Europe
Slovenia,21-03-2020,19550,1739,672,18878,Europe
Somalia,21-03-2020,210379,1762,212,210167,Eastern Mediterranean
South Africa,21-03-2020,44567,2231,1213,43354,Africa
Spain,21-03-2020,278304,676,783,277521,Europe
Sri Lanka,21-03-2020,434441,1734,821,433620,South-East Asia
Sudan,21-03-2020,198686,934,186,198500,Eastern Mediterranean
Suriname,21-03-2020,416443,2336,563,415880,Americas
Sweden,21-03-2020,437517,1252,1180,436337,Europe
Switzerland,21-03-2020,408408,232,879,407529,Europe
Taiwan*,21-03-2020,230427,2419,1215,229212,Western Pacific
Tanzania,21-03-2020,229364,737,876,228488,Africa
Thailand,21-03-2020,160873,203,186,160687,South-East Asia
Togo,21-03-2020,169473,1279,523,168950,Africa
Trinidad and Tobago,21-03-2020,202575,2102,1062,201513,Americas
Tunisia,21-03-2020,167481,2340,998,166483,Eastern Mediterranean
Turkey,21-03-2020,406197,2448,261,405936,Europe
Uganda,21-03-2020,288851,2212,903,287948,Africa
Ukraine,21-03-2020,32669,2489,633,32036,Europe
United Arab Emirates,21-03-2020,115361,1378,728,114633,Eastern Mediterranean
United Kingdom,21-03-2020,291068,1626,1084,289984,Europe
United Kingdom,21-03-2020,342350,418,439,341911,Europe
United Kingdom,21-03-2020,336703,1497,589,336114,Europe
United Kingdom,21-03-2020,432808,2273,681,432127,Europe
United Kingdom,21-03-2020,331419,1008,1232,330187,Europe
United Kingdom,21-03-2020,365100,2039,750,364350,Europe
United Kingdom,21-03-2020,201528,2437,995,200533,Europe
Uruguay,21-03-2020,435996,703,817,435179,Americas
US,21-03-2020,374601,945,1062,373539,Americas
Uzbekistan,21-03-2020,357952,739,498,357454,Europe
Venezuela,21-03-2020,33154,133,301,32853,Americas
Vietnam,21-03-2020,363194,791,209,362985,Western Pacific
Zambia,21-03-2020,214484,882,665,213819,Africa
Zimbabwe,21-03-2020,199339,1977,1122,198217,Africa
Dominica,21-03-2020,203655,461,117,203538,Americas
Grenada,21-03-2020,307277,112,904,306373,Americas
Mozambique,21-03-2020,68287,1881,27,68260,Africa
Syria,21-03-2020,346856,495,801,346055,Eastern Mediterranean
Timor-Leste,21-03-2020,154617,2222,295,154322,South-East Asia
Belize,21-03-2020,313666,2444,773,312893,Americas
Laos,21-03-2020,97406,230,590,96816,Western Pacific
Libya,21-03-2020,384910,888,748,384162,Eastern Mediterranean
West Bank and Gaza,21-03-2020,128444,1191,975,127469,Eastern Mediterranean
Guinea-Bissau,21-03-2020,307533,2223,877,306656,Africa
Mali,21-03-2020,14777,355,59,14718,Africa
Saint Kitts and Nevis,21-03-2020,377519,431,1124,376395,Americas
Canada,21-03-2020,285427,2140,1158,284269,Americas
Canada,21-03-2020,34692,456,693,33999,Americas
Kosovo,21-03-2020,323122,317,217,322905,Europe
Burma,21-03-2020,305572,9,749,304823,South-East Asia
United Kingdom,21-03-2020,138550,448,235,138315,Europe
United Kingdom,21-03-2020,395359,1112,1018,394341,Europe
United Kingdom,21-03-2020,92299,1513,161,92138,Europe
Botswana,21-03-2020,19653,278,1217,18436,Africa
Burundi,21-03-2020,168645,510,1047,167598,Africa
Sierra Leone,21-03-2020,24949,920,56,24893,Africa
Malawi,21-03-2020,214958,378,95,214863,Africa
United Kingdom,21-03-2020,204269,1771,1104,203165,Europe
France,21-03-2020,333855,1304,574,333281,Europe
South Sudan,21-03-2020,251826,704,964,250862,Africa
Western Sahara,21-03-2020,101907,1046,647,101260,Africa
Sao Tome and Principe,21-03-2020,82045,55,695,81350,Africa
Yemen,21-03-2020,442921,603,1140,441781,Eastern Mediterranean
Comoros,21-03-2020,304003,1185,739,303264,Africa
Tajikistan,21-03-2020,49949,2184,446,49503,Europe
Lesotho,21-03-2020,263689,1412,1096,262593,Africa
Afghanistan,22-03-2020,296004,1520,228,295776,Eastern Mediterranean
Albania,22-03-2020,33660,2181,989,32671,Europe
Algeria,22-03-2020,244203,2279,887,243316,Africa
Andorra,22-03-2020,191393,2431,220,191173,Europe
Angola,22-03-2020,27409,1700,151,27258,Africa
Antigua and Barbuda,22-03-2020,325435,842,749,324686,Americas
Argentina,22-03-2020,87650,607,246,87404,Americas
Armenia,22-03-2020,410738,754,147,410591,Europe
Australia,22-03-2020,260770,1919,337,260433,Western Pacific
Australia,22-03-2020,8315,2254,944,7371,Western Pacific
Australia,22-03-2020,179211,453,516,178695,Western Pacific
Australia,22-03-2020,217472,2383,975,216497,Western Pacific
Australia,22-03-2020,320637,796,378,320259,Western Pacific
Australia,22-03-2020,264159,1323,157,264002,Western Pacific
Australia,22-03-2020,174008,1831,940,173068,Western Pacific
Australia,22-03-2020,160910,1487,621,160289,Western Pacific
Austria,22-03-2020,393373,2114,676,392697,Europe
Azerbaijan,22-03-2020,9452,172,991,8461,Europe
Bahamas,22-03-2020,395162,776,912,394250,Americas
Bahrain,22-03-2020,246058,1542,144,245914,Eastern Mediterranean
Bangladesh,22-03-2020,17249,2393,516,16733,South-East Asia
Barbados,22-03-2020,110419,1540,148,110271,Americas
Belarus,22-03-2020,252189,1910,1176,251013,Europe
Belgium,22-03-2020,331941,1258,471,331470,Europe
Benin,22-03-2020,183651,889,978,182673,Africa
Bhutan,22-03-2020,318294,1623,521,317773,South-East Asia
Bolivia,22-03-2020,431945,1799,739,431206,Americas
Bosnia and Herzegovina,22-03-2020,94446,511,1164,93282,Europe
Brazil,22-03-2020,209248,258,279,208969,Americas
Brunei,22-03-2020,54297,2259,573,53724,Western Pacific
Bulgaria,22-03-2020,401659,139,719,400940,Europe
Burkina Faso,22-03-2020,115585,1476,1095,114490,Africa
Cabo Verde,22-03-2020,10602,1585,290,10312,Africa
Cambodia,22-03-2020,381854,1077,1191,380663,Western Pacific
Cameroon,22-03-2020,360306,1731,5,360301,Africa
Canada,22-03-2020,134020,2475,251,133769,Americas
Canada,22-03-2020,349557,1299,416,349141,Americas
Canada,22-03-2020,249889,2413,521,249368,Americas
Canada,22-03-2020,89078,64,551,88527,Americas
Canada,22-03-2020,130234,121,366,129868,Americas
Canada,22-03-2020,433536,623,628,432908,Americas
Canada,22-03-2020,381357,1820,1212,380145,Americas
Canada,22-03-2020,235571,2427,1205,234366,Americas
Canada,22-03-2020,148657,1725,965,147692,Americas
Canada,22-03-2020,245246,1968,1143,244103,Americas
Central African Republic,22-03-2020,59481,562,515,58966,Africa
Chad,22-03-2020,8223,791,543,7680,Africa
Chile,22-03-2020,298383,2229,1182,297201,Americas
China,22-03-2020,12975,503,708,12267,Western Pacific
China,22-03-2020,435429,1082,535,434894,Western Pacific
China,22-03-2020,280667,333,219,280448,Western Pacific
China,22-03-2020,254316,107,1169,253147,Western Pacific
China,22-03-2020,256903,1624,419,256484,Western Pacific
China,22-03-2020,432420,2162,376,432044,Western Pacific
China,22-03-2020,208999,1268,456,208543,Western Pacific
China,22-03-2020,389897,19,839,389058,Western Pacific
China,22-03-2020,136762,1133,502,136260,Western Pacific
China,22-03-2020,419686,74,129,419557,Western Pacific
China,22-03-2020,145504,498,397,145107,Western Pacific
China,22-03-2020,17197,980,920,16277,Western Pacific
China,22-03-2020,96088,293,814,95274,Western Pacific
China,22-03-2020,89236,2097,212,89024,Western Pacific
China,22-03-2020,103723,1429,504,103219,Western Pacific
China,22-03-2020,37600,101,1108,36492,Western Pacific
China,22-03-2020,361086,2337,285,360801,Western Pacific
China,22-03-2020,375695,317,786,374909,Western Pacific
China,22-03-2020,353010,656,207,352803,Western Pacific
China,22-03-2020,57783,2386,917,56866,Western Pacific
China,22-03-2020,361489,281,1154,360335,Western Pacific
China,22-03-2020,98774,2487,187,98587,Western Pacific
China,22-03-2020,120880,1500,815,120065,Western Pacific
China,22-03-2020,39312,2321,1247,38065,Western Pacific
China,22-03-2020,35416,1326,1152,34264,Western Pacific
China,22-03-2020,237294,2100,106,237188,Western Pacific
China,22-03-2020,94128,1537,1025,93103,Western Pacific
China,22-03-2020,42048,755,163,41885,Western Pacific
China,22-03-2020,447503,1794,281,447222,Western Pacific
China,22-03-2020,23543,985,690,22853,Western Pacific
China,22-03-2020,9431,894,73,9358,Western Pacific
China,22-03-2020,278116,1978,692,277424,Western Pacific
China,22-03-2020,375647,964,1248,374399,Western Pacific
Colombia,22-03-2020,433061,185,413,432648,Americas
Congo (Brazzaville),22-03-2020,206012,2121,870,205142,Africa
Congo (Kinshasa),22-03-2020,263725,1709,595,263130,Africa
Costa Rica,22-03-2020,216839,210,1047,215792,Americas
Cote d'Ivoire,22-03-2020,145941,1101,1066,144875,Africa
Croatia,22-03-2020,189444,471,754,188690,Europe
Cuba,22-03-2020,217622,1669,1093,216529,Americas
Cyprus,22-03-2020,50808,1689,48,50760,Europe
Czechia,22-03-2020,373983,1529,1140,372843,Europe
Denmark,22-03-2020,35468,156,126,35342,Europe
Greenland,22-03-2020,283138,2106,192,282946,Europe
Denmark,22-03-2020,67822,1376,864,66958,Europe
Djibouti,22-03-2020,162313,36,724,161589,Eastern Mediterranean
Dominican Republic,22-03-2020,353271,1131,712,352559,Americas
Ecuador,22-03-2020,271190,1689,73,271117,Americas
Egypt,22-03-2020,396325,1050,1015,395310,Eastern Mediterranean
El Salvador,22-03-2020,329282,2430,252,329030,Americas
Equatorial Guinea,22-03-2020,170204,1062,1244,168960,Africa
Eritrea,22-03-2020,436150,947,367,435783,Africa
Estonia,22-03-2020,30935,2225,342,30593,Europe
Eswatini,22-03-2020,124740,1513,539,124201,Africa
Ethiopia,22-03-2020,341483,1604,244,341239,Africa
Fiji,22-03-2020,43952,1229,327,43625,Western Pacific
Finland,22-03-2020,438902,2211,937,437965,Europe
France,22-03-2020,25463,1893,31,25432,Europe
France,22-03-2020,244509,29,841,243668,Europe
France,22-03-2020,229586,352,908,228678,Europe
France,22-03-2020,163799,1841,686,163113,Europe
France,22-03-2020,136430,2214,676,135754,Europe
France,22-03-2020,396446,117,938,395508,Europe
France,22-03-2020,114103,1884,680,113423,Europe
France,22-03-2020,78780,924,938,77842,Europe
France,22-03-2020,341216,146,255,340961,Europe
France,22-03-2020,335548,2493,51,335497,Europe
Gabon,22-03-2020,78541,819,1127,77414,Africa
Gambia,22-03-2020,244294,812,557,243737,Africa
Georgia,22-03-2020,110341,1072,267,110074,Europe
Germany,22-03-2020,368971,1927,361,368610,Europe
Ghana,22-03-2020,268291,722,851,267440,Africa
Greece,22-03-2020,348604,975,355,348249,Europe
Guatemala,22-03-2020,251725,1948,869,250856,Americas
Guinea,22-03-2020,440280,1919,1057,439223,Africa
Guyana,22-03-2020,301323,1836,943,300380,Americas
Haiti,22-03-2020,336284,1931,41,336243,Americas
Holy See,22-03-2020,36151,768,240,35911,Europe
Honduras,22-03-2020,38284,590,719,37565,Americas
Hungary,22-03-2020,8554,761,425,8129,Europe
Iceland,22-03-2020,43825,6,1211,42614,Europe
India,22-03-2020,20606,385,1065,19541,South-East Asia
Indonesia,22-03-2020,249848,974,16,249832,South-East Asia
Iran,22-03-2020,98624,1652,559,98065,Eastern Mediterranean
Iraq,22-03-2020,305520,1412,358,305162,Eastern Mediterranean
Ireland,22-03-2020,258023,404,294,257729,Europe
Israel,22-03-2020,312990,2160,967,312023,Europe
Italy,22-03-2020,49929,45,115,49814,Europe
Jamaica,22-03-2020,447381,788,40,447341,Americas
Japan,22-03-2020,219658,1242,353,219305,Western Pacific
Jordan,22-03-2020,151018,1671,107,150911,Eastern Mediterranean
Kazakhstan,22-03-2020,288179,1927,260,287919,Europe
Kenya,22-03-2020,182111,1896,349,181762,Africa
South Korea,22-03-2020,166120,2321,75,166045,Western Pacific
Kuwait,22-03-2020,210320,2007,1235,209085,Eastern Mediterranean
Kyrgyzstan,22-03-2020,236555,514,640,235915,Europe
Latvia,22-03-2020,113662,1903,451,113211,Europe
Lebanon,22-03-2020,94291,510,332,93959,Eastern Mediterranean
Liberia,22-03-2020,355973,246,67,355906,Africa
Liechtenstein,22-03-2020,351158,1601,299,350859,Europe
Lithuania,22-03-2020,152209,1217,66,152143,Europe
Luxembourg,22-03-2020,162167,597,614,161553,Europe
Madagascar,22-03-2020,130340,896,768,129572,Africa
Malaysia,22-03-2020,93696,469,405,93291,Western Pacific
Maldives,22-03-2020,405919,2142,575,405344,South-East Asia
Malta,22-03-2020,431000,437,483,430517,Europe
Mauritania,22-03-2020,270870,1456,403,270467,Africa
Mauritius,22-03-2020,118790,1794,1049,117741,Africa
Mexico,22-03-2020,449829,449,1203,448626,Americas
Moldova,22-03-2020,115518,889,894,114624,Europe
Monaco,22-03-2020,371908,2009,1159,370749,Europe
Mongolia,22-03-2020,187186,436,91,187095,Western Pacific
Montenegro,22-03-2020,247437,1563,1105,246332,Europe
Morocco,22-03-2020,245655,655,1202,244453,Eastern Mediterranean
Namibia,22-03-2020,409790,1727,516,409274,Africa
Nepal,22-03-2020,166256,1241,694,165562,South-East Asia
Netherlands,22-03-2020,255525,1143,742,254783,Europe
Netherlands,22-03-2020,414645,1909,174,414471,Europe
Netherlands,22-03-2020,66305,1902,162,66143,Europe
Netherlands,22-03-2020,42615,1029,7,42608,Europe
New Zealand,22-03-2020,356242,1828,423,355819,Western Pacific
Nicaragua,22-03-2020,71778,2369,246,71532,Americas
Niger,22-03-2020,26161,463,355,25806,Africa
Nigeria,22-03-2020,49402,2133,339,49063,Africa
North Macedonia,22-03-2020,245811,757,530,245281,Europe
Norway,22-03-2020,345200,295,504,344696,Europe
Oman,22-03-2020,218759,1869,51,218708,Eastern Mediterranean
Pakistan,22-03-2020,29245,1637,1221,28024,Eastern Mediterranean
Panama,22-03-2020,313137,586,748,312389,Americas
Papua New Guinea,22-03-2020,393194,233,434,392760,Western Pacific
Paraguay,22-03-2020,350034,1869,602,349432,Americas
Peru,22-03-2020,326164,265,719,325445,Americas
Philippines,22-03-2020,321694,2314,680,321014,Western Pacific
Poland,22-03-2020,131170,609,928,130242,Europe
Portugal,22-03-2020,54239,907,187,54052,Europe
Qatar,22-03-2020,25655,752,24,25631,Eastern Mediterranean
Romania,22-03-2020,104485,93,437,104048,Europe
Russia,22-03-2020,365982,1742,890,365092,Europe
Rwanda,22-03-2020,72479,1784,373,72106,Africa
Saint Lucia,22-03-2020,323027,509,1191,321836,Americas
Saint Vincent and the Grenadines,22-03-2020,405517,1393,223,405294,Americas
San Marino,22-03-2020,297015,317,22,296993,Europe
Saudi Arabia,22-03-2020,419840,1732,914,418926,Eastern Mediterranean
Senegal,22-03-2020,95361,1739,783,94578,Africa
Serbia,22-03-2020,27072,1865,343,26729,Europe
Seychelles,22-03-2020,83324,1752,1057,82267,Africa
Singapore,22-03-2020,198585,380,505,198080,Western Pacific
Slovakia,22-03-2020,307238,1988,706,306532,Europe
Slovenia,22-03-2020,120973,921,994,119979,Europe
Somalia,22-03-2020,37197,233,884,36313,Eastern Mediterranean
South Africa,22-03-2020,399086,1636,831,398255,Africa
Spain,22-03-2020,166144,1942,1142,165002,Europe
Sri Lanka,22-03-2020,114889,1620,1044,113845,South-East Asia
Sudan,22-03-2020,20145,1270,95,20050,Eastern Mediterranean
Suriname,22-03-2020,218398,1587,31,218367,Americas
Sweden,22-03-2020,335076,2364,576,334500,Europe
Switzerland,22-03-2020,224861,1434,282,224579,Europe
Taiwan*,22-03-2020,53455,642,570,52885,Western Pacific
Tanzania,22-03-2020,221584,2162,85,221499,Africa
Thailand,22-03-2020,359560,2154,1193,358367,South-East Asia
Togo,22-03-2020,224211,1891,987,223224,Africa
Trinidad and Tobago,22-03-2020,50458,129,475,49983,Americas
Tunisia,22-03-2020,66864,2430,688,66176,Eastern Mediterranean
Turkey,22-03-2020,236957,683,963,235994,Europe
Uganda,22-03-2020,389594,136,366,389228,Africa
Ukraine,22-03-2020,384873,1576,476,384397,Europe
United Arab Emirates,22-03-2020,419405,937,138,419267,Eastern Mediterranean
United Kingdom,22-03-2020,128010,1034,1113,126897,Europe
United Kingdom,22-03-2020,413465,1763,126,413339,Europe
United Kingdom,22-03-2020,374997,1643,554,374443,Europe
United Kingdom,22-03-2020,20201,123,1013,19188,Europe
United Kingdom,22-03-2020,334027,6,757,333270,Europe
United Kingdom,22-03-2020,250505,1741,1079,249426,Europe
United Kingdom,22-03-2020,337233,2285,1100,336133,Europe
Uruguay,22-03-2020,326550,1961,327,326223,Americas
US,22-03-2020,97677,460,1062,96615,Americas
Uzbekistan,22-03-2020,283330,71,1018,282312,Europe
Venezuela,22-03-2020,11651,1693,652,10999,Americas
Vietnam,22-03-2020,29091,1228,910,28181,Western Pacific
Zambia,22-03-2020,131381,1025,1250,130131,Africa
Zimbabwe,22-03-2020,368938,1834,538,368400,Africa
Dominica,22-03-2020,208663,1206,738,207925,Americas
Grenada,22-03-2020,38680,1623,831,37849,Americas
Mozambique,22-03-2020,184093,1103,325,183768,Africa
Syria,22-03-2020,26031,353,663,25368,Eastern Mediterranean
Timor-Leste,22-03-2020,343182,725,192,342990,South-East Asia
Belize,22-03-2020,396261,1590,22,396239,Americas
Laos,22-03-2020,417625,1541,1215,416410,Western Pacific
Libya,22-03-2020,251937,1134,741,251196,Eastern Mediterranean
West Bank and Gaza,22-03-2020,175869,300,660,175209,Eastern Mediterranean
Guinea-Bissau,22-03-2020,437113,2171,449,436664,Africa
Mali,22-03-2020,422743,185,998,421745,Africa
Saint Kitts and Nevis,22-03-2020,87195,1370,838,86357,Americas
Canada,22-03-2020,411161,842,584,410577,Americas
Canada,22-03-2020,396629,1883,556,396073,Americas
Kosovo,22-03-2020,61767,1302,643,61124,Europe
Burma,22-03-2020,74225,255,665,73560,South-East Asia
United Kingdom,22-03-2020,8350,138,316,8034,Europe
United Kingdom,22-03-2020,449317,2248,415,448902,Europe
United Kingdom,22-03-2020,293133,1958,691,292442,Europe
Botswana,22-03-2020,76145,1263,1188,74957,Africa
Burundi,22-03-2020,115336,1084,613,114723,Africa
Sierra Leone,22-03-2020,206424,907,1064,205360,Africa
Malawi,22-03-2020,233708,1539,325,233383,Africa
United Kingdom,22-03-2020,77962,1421,166,77796,Europe
France,22-03-2020,346923,1111,983,345940,Europe
South Sudan,22-03-2020,45485,1423,849,44636,Africa
Western Sahara,22-03-2020,363315,827,663,362652,Africa
Sao Tome and Principe,22-03-2020,238789,1579,848,237941,Africa
Yemen,22-03-2020,18862,1048,1240,17622,Eastern Mediterranean
Comoros,22-03-2020,3559,2134,732,2827,Africa
Tajikistan,22-03-2020,322827,1506,43,322784,Europe
Lesotho,22-03-2020,264386,1759,499,263887,Africa
Afghanistan,23-03-2020,57691,1252,1026,56665,Eastern Mediterranean
Albania,23-03-2020,57659,362,868,56791,Europe
Algeria,23-03-2020,59790,995,989,58801,Africa
Andorra,23-03-2020,156095,821,600,155495,Europe
Angola,23-03-2020,423645,1387,447,423198,Africa
Antigua and Barbuda,23-03-2020,163648,1841,345,163303,Americas
Argentina,23-03-2020,108272,368,778,107494,Americas
Armenia,23-03-2020,395464,542,845,394619,Europe
Australia,23-03-2020,173279,923,513,172766,Western Pacific
Australia,23-03-2020,152302,388,165,152137,Western Pacific
Australia,23-03-2020,99487,860,1138,98349,Western Pacific
Australia,23-03-2020,245777,491,429,245348,Western Pacific
Australia,23-03-2020,420370,1044,389,419981,Western Pacific
Australia,23-03-2020,293552,408,224,293328,Western Pacific
Australia,23-03-2020,352026,908,313,351713,Western Pacific
Australia,23-03-2020,356315,2321,965,355350,Western Pacific
Austria,23-03-2020,303623,1693,1220,302403,Europe
Azerbaijan,23-03-2020,9266,275,335,8931,Europe
Bahamas,23-03-2020,427182,2376,1222,425960,Americas
Bahrain,23-03-2020,282151,2294,127,282024,Eastern Mediterranean
Bangladesh,23-03-2020,221240,839,222,221018,South-East Asia
Barbados,23-03-2020,403672,737,435,403237,Americas
Belarus,23-03-2020,50311,454,1172,49139,Europe
Belgium,23-03-2020,391292,1744,967,390325,Europe
Benin,23-03-2020,9326,569,842,8484,Africa
Bhutan,23-03-2020,380923,1560,1108,379815,South-East Asia
Bolivia,23-03-2020,389597,301,620,388977,Americas
Bosnia and Herzegovina,23-03-2020,203348,727,973,202375,Europe
Brazil,23-03-2020,183352,501,634,182718,Americas
Brunei,23-03-2020,83943,1718,1153,82790,Western Pacific
Bulgaria,23-03-2020,134329,631,1157,133172,Europe
Burkina Faso,23-03-2020,33157,610,1067,32090,Africa
Cabo Verde,23-03-2020,418614,1758,720,417894,Africa
Cambodia,23-03-2020,92362,1508,349,92013,Western Pacific
Cameroon,23-03-2020,316662,342,131,316531,Africa
Canada,23-03-2020,75240,2299,566,74674,Americas
Canada,23-03-2020,288278,2426,1105,287173,Americas
Canada,23-03-2020,84538,160,301,84237,Americas
Canada,23-03-2020,102766,935,834,101932,Americas
Canada,23-03-2020,378166,429,364,377802,Americas
Canada,23-03-2020,368126,2184,476,367650,Americas
Canada,23-03-2020,167639,1872,917,166722,Americas
Canada,23-03-2020,293954,147,906,293048,Americas
Canada,23-03-2020,706,1230,130,576,Americas
Canada,23-03-2020,72690,361,719,71971,Americas
Central African Republic,23-03-2020,7802,1342,745,7057,Africa
Chad,23-03-2020,319192,1473,170,319022,Africa
Chile,23-03-2020,276109,1141,466,275643,Americas
China,23-03-2020,324259,1092,713,323546,Western Pacific
China,23-03-2020,416480,2292,974,415506,Western Pacific
China,23-03-2020,444370,123,647,443723,Western Pacific
China,23-03-2020,93127,493,692,92435,Western Pacific
China,23-03-2020,27983,588,171,27812,Western Pacific
China,23-03-2020,21053,2184,990,20063,Western Pacific
China,23-03-2020,190119,1209,23,190096,Western Pacific
China,23-03-2020,435106,1118,1123,433983,Western Pacific
China,23-03-2020,397133,696,485,396648,Western Pacific
China,23-03-2020,51599,2128,450,51149,Western Pacific
China,23-03-2020,446772,1942,456,446316,Western Pacific
China,23-03-2020,314380,723,1093,313287,Western Pacific
China,23-03-2020,445343,2175,809,444534,Western Pacific
China,23-03-2020,98415,1080,362,98053,Western Pacific
China,23-03-2020,268937,823,1201,267736,Western Pacific
China,23-03-2020,198294,2079,82,198212,Western Pacific
China,23-03-2020,43468,547,654,42814,Western Pacific
China,23-03-2020,252541,351,465,252076,Western Pacific
China,23-03-2020,438925,1093,1231,437694,Western Pacific
China,23-03-2020,27917,286,806,27111,Western Pacific
China,23-03-2020,132097,1172,820,131277,Western Pacific
China,23-03-2020,379302,2022,852,378450,Western Pacific
China,23-03-2020,8632,1009,440,8192,Western Pacific
China,23-03-2020,217480,673,91,217389,Western Pacific
China,23-03-2020,410026,1672,1000,409026,Western Pacific
China,23-03-2020,84735,1781,295,84440,Western Pacific
China,23-03-2020,35546,297,494,35052,Western Pacific
China,23-03-2020,404363,2024,375,403988,Western Pacific
China,23-03-2020,364799,20,172,364627,Western Pacific
China,23-03-2020,431822,1566,665,431157,Western Pacific
China,23-03-2020,198261,2351,800,197461,Western Pacific
China,23-03-2020,370716,199,9,370707,Western Pacific
China,23-03-2020,259981,1506,412,259569,Western Pacific
Colombia,23-03-2020,216572,214,581,215991,Americas
Congo (Brazzaville),23-03-2020,177149,1756,228,176921,Africa
Congo (Kinshasa),23-03-2020,180629,86,1099,179530,Africa
Costa Rica,23-03-2020,41179,2188,593,40586,Americas
Cote d'Ivoire,23-03-2020,290934,714,398,290536,Africa
Croatia,23-03-2020,308998,200,653,308345,Europe
Cuba,23-03-2020,277808,2226,287,277521,Americas
Cyprus,23-03-2020,160127,697,553,159574,Europe
Czechia,23-03-2020,244704,167,612,244092,Europe
Denmark,23-03-2020,20139,405,608,19531,Europe
Greenland,23-03-2020,165506,2263,1189,164317,Europe
Denmark,23-03-2020,281562,2183,883,280679,Europe
Djibouti,23-03-2020,58136,1045,559,57577,Eastern Mediterranean
Dominican Republic,23-03-2020,279735,1299,855,278880,Americas
Ecuador,23-03-2020,440309,2068,993,439316,Americas
Egypt,23-03-2020,388193,893,792,387401,Eastern Mediterranean
El Salvador,23-03-2020,369455,2407,500,368955,Americas
Equatorial Guinea,23-03-2020,195823,2294,174,195649,Africa
Eritrea,23-03-2020,429150,2110,632,428518,Africa
Estonia,23-03-2020,233280,2409,712,232568,Europe
Eswatini,23-03-2020,154050,1287,425,153625,Africa
Ethiopia,23-03-2020,252446,1687,716,251730,Africa
Fiji,23-03-2020,385178,2445,626,384552,Western Pacific
Finland,23-03-2020,58952,1727,1144,57808,Europe
France,23-03-2020,340673,1859,1111,339562,Europe
France,23-03-2020,293886,2480,773,293113,Europe
France,23-03-2020,401661,805,136,401525,Europe
France,23-03-2020,241106,1361,792,240314,Europe
France,23-03-2020,314649,1514,19,314630,Europe
France,23-03-2020,622,2052,127,495,Europe
France,23-03-2020,399989,1506,599,399390,Europe
France,23-03-2020,78552,572,1241,77311,Europe
France,23-03-2020,31410,2276,577,30833,Europe
France,23-03-2020,22463,941,633,21830,Europe
Gabon,23-03-2020,59341,2042,731,58610,Africa
Gambia,23-03-2020,25839,2242,831,25008,Africa
Georgia,23-03-2020,286810,1484,1025,285785,Europe
Germany,23-03-2020,233725,2298,35,233690,Europe
Ghana,23-03-2020,148070,1714,862,147208,Africa
Greece,23-03-2020,290092,1097,840,289252,Europe
Guatemala,23-03-2020,309593,2415,1159,308434,Americas
Guinea,23-03-2020,440666,5,490,440176,Africa
Guyana,23-03-2020,51975,2222,107,51868,Americas
Haiti,23-03-2020,405795,2241,1204,404591,Americas
Holy See,23-03-2020,208524,1159,793,207731,Europe
Honduras,23-03-2020,1247,1811,401,846,Americas
Hungary,23-03-2020,85211,1561,1015,84196,Europe
Iceland,23-03-2020,80785,1647,216,80569,Europe
India,23-03-2020,417577,891,914,416663,South-East Asia
Indonesia,23-03-2020,257607,1786,510,257097,South-East Asia
Iran,23-03-2020,29346,2445,325,29021,Eastern Mediterranean
Iraq,23-03-2020,335007,357,10,334997,Eastern Mediterranean
Ireland,23-03-2020,115836,1691,1058,114778,Europe
Israel,23-03-2020,434646,2270,707,433939,Europe
Italy,23-03-2020,277801,508,611,277190,Europe
Jamaica,23-03-2020,368976,1982,437,368539,Americas
Japan,23-03-2020,329403,1827,729,328674,Western Pacific
Jordan,23-03-2020,414808,1929,1228,413580,Eastern Mediterranean
Kazakhstan,23-03-2020,392173,1305,678,391495,Europe
Kenya,23-03-2020,382222,873,270,381952,Africa
South Korea,23-03-2020,387703,224,443,387260,Western Pacific
Kuwait,23-03-2020,246243,97,1081,245162,Eastern Mediterranean
Kyrgyzstan,23-03-2020,248514,1313,935,247579,Europe
Latvia,23-03-2020,217287,1160,1137,216150,Europe
Lebanon,23-03-2020,296394,166,715,295679,Eastern Mediterranean
Liberia,23-03-2020,44283,649,904,43379,Africa
Liechtenstein,23-03-2020,293862,1784,73,293789,Europe
Lithuania,23-03-2020,357953,108,133,357820,Europe
Luxembourg,23-03-2020,2231,1245,1056,1175,Europe
Madagascar,23-03-2020,135523,1822,252,135271,Africa
Malaysia,23-03-2020,285644,2470,869,284775,Western Pacific
Maldives,23-03-2020,127538,252,67,127471,South-East Asia
Malta,23-03-2020,355195,334,327,354868,Europe
Mauritania,23-03-2020,170548,1821,531,170017,Africa
Mauritius,23-03-2020,372531,812,412,372119,Africa
Mexico,23-03-2020,406879,1147,758,406121,Americas
Moldova,23-03-2020,44636,1115,650,43986,Europe
Monaco,23-03-2020,26030,2326,732,25298,Europe
Mongolia,23-03-2020,67815,2201,984,66831,Western Pacific
Montenegro,23-03-2020,302295,2397,634,301661,Europe
Morocco,23-03-2020,322713,2010,368,322345,Eastern Mediterranean
Namibia,23-03-2020,466,1600,660,-194,Africa
Nepal,23-03-2020,367634,1328,1036,366598,South-East Asia
Netherlands,23-03-2020,151889,734,353,151536,Europe
Netherlands,23-03-2020,309465,1399,917,308548,Europe
Netherlands,23-03-2020,92877,694,116,92761,Europe
Netherlands,23-03-2020,369277,1454,334,368943,Europe
New Zealand,23-03-2020,230759,2193,73,230686,Western Pacific
Nicaragua,23-03-2020,62802,380,917,61885,Americas
Niger,23-03-2020,263166,654,200,262966,Africa
Nigeria,23-03-2020,317362,1248,232,317130,Africa
North Macedonia,23-03-2020,179778,940,977,178801,Europe
Norway,23-03-2020,44843,2255,850,43993,Europe
Oman,23-03-2020,108365,1228,1178,107187,Eastern Mediterranean
Pakistan,23-03-2020,250365,195,947,249418,Eastern Mediterranean
Panama,23-03-2020,299129,30,334,298795,Americas
Papua New Guinea,23-03-2020,285993,1126,686,285307,Western Pacific
Paraguay,23-03-2020,247570,1677,922,246648,Americas
Peru,23-03-2020,265560,1085,206,265354,Americas
Philippines,23-03-2020,444020,1787,41,443979,Western Pacific
Poland,23-03-2020,326587,89,346,326241,Europe
Portugal,23-03-2020,9673,496,1056,8617,Europe
Qatar,23-03-2020,449288,450,787,448501,Eastern Mediterranean
Romania,23-03-2020,160154,1357,282,159872,Europe
Russia,23-03-2020,239238,1780,438,238800,Europe
Rwanda,23-03-2020,380712,2441,646,380066,Africa
Saint Lucia,23-03-2020,443214,1522,133,443081,Americas
Saint Vincent and the Grenadines,23-03-2020,248423,997,635,247788,Americas
San Marino,23-03-2020,208992,1814,1193,207799,Europe
Saudi Arabia,23-03-2020,380686,947,859,379827,Eastern Mediterranean
Senegal,23-03-2020,338396,388,414,337982,Africa
Serbia,23-03-2020,300487,297,591,299896,Europe
Seychelles,23-03-2020,414268,726,200,414068,Africa
Singapore,23-03-2020,210115,705,1083,209032,Western Pacific
Slovakia,23-03-2020,247786,834,1051,246735,Europe
Slovenia,23-03-2020,378298,1250,1181,377117,Europe
Somalia,23-03-2020,331456,461,576,330880,Eastern Mediterranean
South Africa,23-03-2020,358116,1746,935,357181,Africa
Spain,23-03-2020,181348,1227,306,181042,Europe
Sri Lanka,23-03-2020,162545,1455,221,162324,South-East Asia
Sudan,23-03-2020,424519,23,598,423921,Eastern Mediterranean
Suriname,23-03-2020,86697,24,754,85943,Americas
Sweden,23-03-2020,320187,477,1142,319045,Europe
Switzerland,23-03-2020,86226,654,273,85953,Europe
Taiwan*,23-03-2020,211376,359,486,210890,Western Pacific
Tanzania,23-03-2020,408849,966,1127,407722,Africa
Thailand,23-03-2020,263356,589,594,262762,South-East Asia
Togo,23-03-2020,217987,1961,952,217035,Africa
Trinidad and Tobago,23-03-2020,358874,1744,216,358658,Americas
Tunisia,23-03-2020,217778,1586,373,217405,Eastern Mediterranean
Turkey,23-03-2020,215779,2390,680,215099,Europe
Uganda,23-03-2020,334088,819,856,333232,Africa
Ukraine,23-03-2020,51223,1537,893,50330,Europe
United Arab Emirates,23-03-2020,64335,1367,661,63674,Eastern Mediterranean
United Kingdom,23-03-2020,284025,1467,1069,282956,Europe
United Kingdom,23-03-2020,148779,2218,569,148210,Europe
United Kingdom,23-03-2020,134899,1590,750,134149,Europe
United Kingdom,23-03-2020,40115,1227,582,39533,Europe
United Kingdom,23-03-2020,434447,427,351,434096,Europe
United Kingdom,23-03-2020,323213,259,1018,322195,Europe
United Kingdom,23-03-2020,381005,2018,224,380781,Europe
Uruguay,23-03-2020,11532,2128,678,10854,Americas
US,23-03-2020,295584,1641,1206,294378,Americas
Uzbekistan,23-03-2020,417509,2491,1244,416265,Europe
Venezuela,23-03-2020,80634,463,1098,79536,Americas
Vietnam,23-03-2020,241748,1158,774,240974,Western Pacific
Zambia,23-03-2020,345004,112,638,344366,Africa
Zimbabwe,23-03-2020,251335,46,914,250421,Africa
Dominica,23-03-2020,272968,424,1230,271738,Americas
Grenada,23-03-2020,432388,2097,1056,431332,Americas
Mozambique,23-03-2020,137693,1370,1094,136599,Africa
Syria,23-03-2020,125172,487,722,124450,Eastern Mediterranean
Timor-Leste,23-03-2020,294231,2337,484,293747,South-East Asia
Belize,23-03-2020,434853,1951,1244,433609,Americas
Laos,23-03-2020,433413,50,169,433244,Western Pacific
Libya,23-03-2020,190953,9,381,190572,Eastern Mediterranean
West Bank and Gaza,23-03-2020,102801,1344,96,102705,Eastern Mediterranean
Guinea-Bissau,23-03-2020,209911,170,291,209620,Africa
Mali,23-03-2020,281636,1036,464,281172,Africa
Saint Kitts and Nevis,23-03-2020,356899,1188,941,355958,Americas
Canada,23-03-2020,182344,823,199,182145,Americas
Canada,23-03-2020,378700,948,166,378534,Americas
Kosovo,23-03-2020,375709,1511,1110,374599,Europe
Burma,23-03-2020,13884,344,425,13459,South-East Asia
United Kingdom,23-03-2020,141852,1851,725,141127,Europe
United Kingdom,23-03-2020,7213,2195,260,6953,Europe
United Kingdom,23-03-2020,43383,1581,525,42858,Europe
Botswana,23-03-2020,386194,229,90,386104,Africa
Burundi,23-03-2020,339128,383,438,338690,Africa
Sierra Leone,23-03-2020,277002,41,367,276635,Africa
Malawi,23-03-2020,119391,1965,490,118901,Africa
United Kingdom,23-03-2020,320503,1138,65,320438,Europe
France,23-03-2020,66015,2173,301,65714,Europe
South Sudan,23-03-2020,194629,2497,794,193835,Africa
Western Sahara,23-03-2020,216455,1951,1230,215225,Africa
Sao Tome and Principe,23-03-2020,138784,349,626,138158,Africa
Yemen,23-03-2020,119863,2142,267,119596,Eastern Mediterranean
Comoros,23-03-2020,202235,149,399,201836,Africa
Tajikistan,23-03-2020,446258,298,160,446098,Europe
Lesotho,23-03-2020,75979,1757,46,75933,Africa
Afghanistan,24-03-2020,429249,1838,197,429052,Eastern Mediterranean
Albania,24-03-2020,315438,348,960,314478,Europe
Algeria,24-03-2020,136023,149,42,135981,Africa
Andorra,24-03-2020,70508,121,1143,69365,Europe
Angola,24-03-2020,156014,167,1023,154991,Africa
Antigua and Barbuda,24-03-2020,97657,1620,749,96908,Americas
Argentina,24-03-2020,153080,80,1232,151848,Americas
Armenia,24-03-2020,405247,846,362,404885,Europe
Australia,24-03-2020,59765,438,105,59660,Western Pacific
Australia,24-03-2020,370706,2282,387,370319,Western Pacific
Australia,24-03-2020,421623,441,289,421334,Western Pacific
Australia,24-03-2020,276452,997,778,275674,Western Pacific
Australia,24-03-2020,28608,2234,876,27732,Western Pacific
Australia,24-03-2020,37786,1237,654,37132,Western Pacific
Australia,24-03-2020,323607,2160,121,323486,Western Pacific
Australia,24-03-2020,168964,656,340,168624,Western Pacific
Austria,24-03-2020,352661,1941,1001,351660,Europe
Azerbaijan,24-03-2020,233921,1073,630,233291,Europe
Bahamas,24-03-2020,270195,1444,896,269299,Americas
Bahrain,24-03-2020,275954,1875,1233,274721,Eastern Mediterranean
Bangladesh,24-03-2020,371436,901,790,370646,South-East Asia
Barbados,24-03-2020,126105,2489,1156,124949,Americas
Belarus,24-03-2020,397618,861,1247,396371,Europe
Belgium,24-03-2020,406756,1541,845,405911,Europe
Benin,24-03-2020,142323,2208,626,141697,Africa
Bhutan,24-03-2020,343982,1017,1134,342848,South-East Asia
Bolivia,24-03-2020,264588,1092,371,264217,Americas
Bosnia and Herzegovina,24-03-2020,222581,2198,66,222515,Europe
Brazil,24-03-2020,273024,1563,738,272286,Americas
Brunei,24-03-2020,66939,1818,83,66856,Western Pacific
Bulgaria,24-03-2020,196461,744,793,195668,Europe
Burkina Faso,24-03-2020,382267,423,21,382246,Africa
Cabo Verde,24-03-2020,132322,1811,1185,131137,Africa
Cambodia,24-03-2020,63312,2479,190,63122,Western Pacific
Cameroon,24-03-2020,82467,671,707,81760,Africa
Canada,24-03-2020,301447,1,1160,300287,Americas
Canada,24-03-2020,215936,1282,1129,214807,Americas
Canada,24-03-2020,212026,955,699,211327,Americas
Canada,24-03-2020,89145,665,462,88683,Americas
Canada,24-03-2020,355728,1775,995,354733,Americas
Canada,24-03-2020,18751,46,871,17880,Americas
Canada,24-03-2020,316554,1900,21,316533,Americas
Canada,24-03-2020,48039,2498,992,47047,Americas
Canada,24-03-2020,199778,1978,1053,198725,Americas
Canada,24-03-2020,147722,488,51,147671,Americas
Central African Republic,24-03-2020,142195,912,332,141863,Africa
Chad,24-03-2020,48153,2403,687,47466,Africa
Chile,24-03-2020,69308,1205,798,68510,Americas
China,24-03-2020,83907,1858,552,83355,Western Pacific
China,24-03-2020,34806,969,42,34764,Western Pacific
China,24-03-2020,322767,2318,654,322113,Western Pacific
China,24-03-2020,24218,56,300,23918,Western Pacific
China,24-03-2020,214019,762,961,213058,Western Pacific
China,24-03-2020,12323,1130,738,11585,Western Pacific
China,24-03-2020,117715,2184,630,117085,Western Pacific
China,24-03-2020,61198,1381,1084,60114,Western Pacific
China,24-03-2020,383722,1619,1215,382507,Western Pacific
China,24-03-2020,35069,1693,1195,33874,Western Pacific
China,24-03-2020,153647,2154,517,153130,Western Pacific
China,24-03-2020,174216,22,178,174038,Western Pacific
China,24-03-2020,406737,183,705,406032,Western Pacific
China,24-03-2020,250006,2389,918,249088,Western Pacific
China,24-03-2020,173979,1673,921,173058,Western Pacific
China,24-03-2020,1440,2433,495,945,Western Pacific
China,24-03-2020,297440,240,687,296753,Western Pacific
China,24-03-2020,326180,544,173,326007,Western Pacific
China,24-03-2020,372607,1557,531,372076,Western Pacific
China,24-03-2020,192569,313,684,191885,Western Pacific
China,24-03-2020,175804,1902,76,175728,Western Pacific
China,24-03-2020,25352,2290,982,24370,Western Pacific
China,24-03-2020,310587,2403,956,309631,Western Pacific
China,24-03-2020,212357,524,996,211361,Western Pacific
China,24-03-2020,4803,597,1038,3765,Western Pacific
China,24-03-2020,661,619,1012,-351,Western Pacific
China,24-03-2020,432111,2203,1242,430869,Western Pacific
China,24-03-2020,184066,1067,897,183169,Western Pacific
China,24-03-2020,299530,1079,566,298964,Western Pacific
China,24-03-2020,149020,1248,254,148766,Western Pacific
China,24-03-2020,116112,848,1195,114917,Western Pacific
China,24-03-2020,295319,286,567,294752,Western Pacific
China,24-03-2020,10072,143,1031,9041,Western Pacific
Colombia,24-03-2020,299423,1372,94,299329,Americas
Congo (Brazzaville),24-03-2020,268520,1055,285,268235,Africa
Congo (Kinshasa),24-03-2020,228603,1961,767,227836,Africa
Costa Rica,24-03-2020,402466,369,1243,401223,Americas
Cote d'Ivoire,24-03-2020,195045,977,930,194115,Africa
Croatia,24-03-2020,440230,2215,1080,439150,Europe
Cuba,24-03-2020,379876,11,1226,378650,Americas
Cyprus,24-03-2020,96006,2309,245,95761,Europe
Czechia,24-03-2020,257327,2368,241,257086,Europe
Denmark,24-03-2020,429225,401,149,429076,Europe
Greenland,24-03-2020,172542,603,885,171657,Europe
Denmark,24-03-2020,207298,2044,193,207105,Europe
Djibouti,24-03-2020,124474,2465,738,123736,Eastern Mediterranean
Dominican Republic,24-03-2020,317891,379,970,316921,Americas
Ecuador,24-03-2020,55638,1558,1115,54523,Americas
Egypt,24-03-2020,156483,1867,1121,155362,Eastern Mediterranean
El Salvador,24-03-2020,281282,30,4,281278,Americas
Equatorial Guinea,24-03-2020,114822,45,1130,113692,Africa
Eritrea,24-03-2020,88347,835,1222,87125,Africa
Estonia,24-03-2020,58382,1325,818,57564,Europe
Eswatini,24-03-2020,287413,2449,1100,286313,Africa
Ethiopia,24-03-2020,132259,183,476,131783,Africa
Fiji,24-03-2020,90486,1744,90,90396,Western Pacific
Finland,24-03-2020,132520,2354,1247,131273,Europe
France,24-03-2020,373595,606,592,373003,Europe
France,24-03-2020,291125,2336,1043,290082,Europe
France,24-03-2020,99115,227,870,98245,Europe
France,24-03-2020,250800,2093,330,250470,Europe
France,24-03-2020,200991,1682,215,200776,Europe
France,24-03-2020,383756,1846,771,382985,Europe
France,24-03-2020,354674,2209,40,354634,Europe
France,24-03-2020,390529,1017,871,389658,Europe
France,24-03-2020,342842,1077,784,342058,Europe
France,24-03-2020,33680,2150,923,32757,Europe
Gabon,24-03-2020,80138,1435,560,79578,Africa
Gambia,24-03-2020,265993,596,542,265451,Africa
Georgia,24-03-2020,448794,689,1013,447781,Europe
Germany,24-03-2020,292398,2299,330,292068,Europe
Ghana,24-03-2020,20011,993,506,19505,Africa
Greece,24-03-2020,448409,1951,787,447622,Europe
Guatemala,24-03-2020,165829,411,883,164946,Americas
Guinea,24-03-2020,412254,1374,373,411881,Africa
Guyana,24-03-2020,367907,2210,336,367571,Americas
Haiti,24-03-2020,324725,1860,851,323874,Americas
Holy See,24-03-2020,307732,1252,510,307222,Europe
Honduras,24-03-2020,210446,156,266,210180,Americas
Hungary,24-03-2020,414328,1737,1100,413228,Europe
Iceland,24-03-2020,113779,2064,303,113476,Europe
India,24-03-2020,425219,1532,1068,424151,South-East Asia
Indonesia,24-03-2020,152962,2175,127,152835,South-East Asia
Iran,24-03-2020,339999,227,160,339839,Eastern Mediterranean
Iraq,24-03-2020,33786,694,1000,32786,Eastern Mediterranean
Ireland,24-03-2020,272939,382,595,272344,Europe
Israel,24-03-2020,109302,12,1077,108225,Europe
Italy,24-03-2020,335866,867,747,335119,Europe
Jamaica,24-03-2020,220383,533,749,219634,Americas
Japan,24-03-2020,244922,1980,540,244382,Western Pacific
Jordan,24-03-2020,345420,1214,737,344683,Eastern Mediterranean
Kazakhstan,24-03-2020,380956,1940,281,380675,Europe
Kenya,24-03-2020,422134,2341,293,421841,Africa
South Korea,24-03-2020,113080,2046,1001,112079,Western Pacific
Kuwait,24-03-2020,46748,1167,316,46432,Eastern Mediterranean
Kyrgyzstan,24-03-2020,169478,2437,566,168912,Europe
Latvia,24-03-2020,222683,736,385,222298,Europe
Lebanon,24-03-2020,5669,2497,120,5549,Eastern Mediterranean
Liberia,24-03-2020,392974,337,1243,391731,Africa
Liechtenstein,24-03-2020,228877,2029,1210,227667,Europe
Lithuania,24-03-2020,434070,2141,928,433142,Europe
Luxembourg,24-03-2020,144915,1867,166,144749,Europe
Madagascar,24-03-2020,183527,1089,506,183021,Africa
Malaysia,24-03-2020,313511,276,448,313063,Western Pacific
Maldives,24-03-2020,168941,1940,939,168002,South-East Asia
Malta,24-03-2020,352568,1917,59,352509,Europe
Mauritania,24-03-2020,63917,890,261,63656,Africa
Mauritius,24-03-2020,330755,130,117,330638,Africa
Mexico,24-03-2020,326509,897,138,326371,Americas
Moldova,24-03-2020,153266,1584,1102,152164,Europe
Monaco,24-03-2020,398947,172,574,398373,Europe
Mongolia,24-03-2020,438946,1217,1082,437864,Western Pacific
Montenegro,24-03-2020,8296,303,1212,7084,Europe
Morocco,24-03-2020,263457,59,662,262795,Eastern Mediterranean
Namibia,24-03-2020,25358,2002,664,24694,Africa
Nepal,24-03-2020,423895,848,81,423814,South-East Asia
Netherlands,24-03-2020,153388,1006,1152,152236,Europe
Netherlands,24-03-2020,131210,2364,1085,130125,Europe
Netherlands,24-03-2020,358222,1949,1025,357197,Europe
Netherlands,24-03-2020,201974,105,112,201862,Europe
New Zealand,24-03-2020,371814,94,740,371074,Western Pacific
Nicaragua,24-03-2020,230260,300,529,229731,Americas
Niger,24-03-2020,145113,1628,544,144569,Africa
Nigeria,24-03-2020,331068,1962,21,331047,Africa
North Macedonia,24-03-2020,259075,1220,1243,257832,Europe
Norway,24-03-2020,194648,261,287,194361,Europe
Oman,24-03-2020,243588,1753,667,242921,Eastern Mediterranean
Pakistan,24-03-2020,367849,1168,1070,366779,Eastern Mediterranean
Panama,24-03-2020,196714,1652,197,196517,Americas
Papua New Guinea,24-03-2020,432553,2279,269,432284,Western Pacific
Paraguay,24-03-2020,96053,373,507,95546,Americas
Peru,24-03-2020,113357,1862,604,112753,Americas
Philippines,24-03-2020,68662,2062,211,68451,Western Pacific
Poland,24-03-2020,242219,674,303,241916,Europe
Portugal,24-03-2020,314024,1661,594,313430,Europe
Qatar,24-03-2020,391905,2297,666,391239,Eastern Mediterranean
Romania,24-03-2020,382176,977,1187,380989,Europe
Russia,24-03-2020,216079,2222,484,215595,Europe
Rwanda,24-03-2020,332444,361,528,331916,Africa
Saint Lucia,24-03-2020,185323,1905,618,184705,Americas
Saint Vincent and the Grenadines,24-03-2020,413289,1177,777,412512,Americas
San Marino,24-03-2020,190581,2491,240,190341,Europe
Saudi Arabia,24-03-2020,48084,2098,604,47480,Eastern Mediterranean
Senegal,24-03-2020,76501,1627,598,75903,Africa
Serbia,24-03-2020,172727,1433,258,172469,Europe
Seychelles,24-03-2020,344463,380,873,343590,Africa
Singapore,24-03-2020,147242,1196,300,146942,Western Pacific
Slovakia,24-03-2020,431485,1632,1028,430457,Europe
Slovenia,24-03-2020,101023,888,984,100039,Europe
Somalia,24-03-2020,152139,994,814,151325,Eastern Mediterranean
South Africa,24-03-2020,312020,1385,199,311821,Africa
Spain,24-03-2020,84532,1168,1206,83326,Europe
Sri Lanka,24-03-2020,277056,401,300,276756,South-East Asia
Sudan,24-03-2020,382736,1142,897,381839,Eastern Mediterranean
Suriname,24-03-2020,332106,1349,529,331577,Americas
Sweden,24-03-2020,311063,62,372,310691,Europe
Switzerland,24-03-2020,157030,1705,1192,155838,Europe
Taiwan*,24-03-2020,263093,690,270,262823,Western Pacific
Tanzania,24-03-2020,149160,1675,463,148697,Africa
Thailand,24-03-2020,55101,1660,231,54870,South-East Asia
Togo,24-03-2020,270520,132,482,270038,Africa
Trinidad and Tobago,24-03-2020,250069,1568,13,250056,Americas
Tunisia,24-03-2020,327887,2379,94,327793,Eastern Mediterranean
Turkey,24-03-2020,143031,895,1238,141793,Europe
Uganda,24-03-2020,194907,1826,896,194011,Africa
Ukraine,24-03-2020,72381,1704,94,72287,Europe
United Arab Emirates,24-03-2020,266545,2355,1157,265388,Eastern Mediterranean
United Kingdom,24-03-2020,66875,2028,549,66326,Europe
United Kingdom,24-03-2020,426573,1825,758,425815,Europe
United Kingdom,24-03-2020,235324,582,1072,234252,Europe
United Kingdom,24-03-2020,180491,750,1175,179316,Europe
United Kingdom,24-03-2020,21542,178,261,21281,Europe
United Kingdom,24-03-2020,433618,561,1068,432550,Europe
United Kingdom,24-03-2020,158748,2076,821,157927,Europe
Uruguay,24-03-2020,398504,1782,942,397562,Americas
US,24-03-2020,334245,1427,755,333490,Americas
Uzbekistan,24-03-2020,216179,571,444,215735,Europe
Venezuela,24-03-2020,23173,2202,584,22589,Americas
Vietnam,24-03-2020,282575,108,543,282032,Western Pacific
Zambia,24-03-2020,317781,1692,416,317365,Africa
Zimbabwe,24-03-2020,420905,395,933,419972,Africa
Dominica,24-03-2020,85877,294,1100,84777,Americas
Grenada,24-03-2020,85940,777,59,85881,Americas
Mozambique,24-03-2020,378430,852,404,378026,Africa
Syria,24-03-2020,226735,263,974,225761,Eastern Mediterranean
Timor-Leste,24-03-2020,149219,2012,357,148862,South-East Asia
Belize,24-03-2020,372211,446,385,371826,Americas
Laos,24-03-2020,255593,2470,600,254993,Western Pacific
Libya,24-03-2020,398675,1812,1018,397657,Eastern Mediterranean
West Bank and Gaza,24-03-2020,264604,42,546,264058,Eastern Mediterranean
Guinea-Bissau,24-03-2020,179390,2165,1127,178263,Africa
Mali,24-03-2020,350789,2143,383,350406,Africa
Saint Kitts and Nevis,24-03-2020,188813,455,290,188523,Americas
Canada,24-03-2020,339881,1319,855,339026,Americas
Canada,24-03-2020,337949,116,702,337247,Americas
Kosovo,24-03-2020,145260,651,158,145102,Europe
Burma,24-03-2020,291239,1042,614,290625,South-East Asia
United Kingdom,24-03-2020,188619,1821,57,188562,Europe
United Kingdom,24-03-2020,101718,688,726,100992,Europe
United Kingdom,24-03-2020,59508,209,779,58729,Europe
Botswana,24-03-2020,26421,100,644,25777,Africa
Burundi,24-03-2020,262466,2136,813,261653,Africa
Sierra Leone,24-03-2020,359486,784,375,359111,Africa
Malawi,24-03-2020,384481,188,585,383896,Africa
United Kingdom,24-03-2020,415167,1675,319,414848,Europe
France,24-03-2020,116506,834,352,116154,Europe
South Sudan,24-03-2020,116288,649,638,115650,Africa
Western Sahara,24-03-2020,214119,2285,211,213908,Africa
Sao Tome and Principe,24-03-2020,41546,337,519,41027,Africa
Yemen,24-03-2020,386954,1515,1129,385825,Eastern Mediterranean
Comoros,24-03-2020,206973,989,549,206424,Africa
Tajikistan,24-03-2020,63201,671,1228,61973,Europe
Lesotho,24-03-2020,366206,1608,968,365238,Africa
Afghanistan,25-03-2020,377397,2086,401,376996,Eastern Mediterranean
Albania,25-03-2020,376755,602,1180,375575,Europe
Algeria,25-03-2020,71169,704,985,70184,Africa
Andorra,25-03-2020,178938,2010,576,178362,Europe
Angola,25-03-2020,46543,893,1154,45389,Africa
Antigua and Barbuda,25-03-2020,140077,846,582,139495,Americas
Argentina,25-03-2020,163167,909,478,162689,Americas
Armenia,25-03-2020,415505,282,557,414948,Europe
Australia,25-03-2020,10360,2001,1206,9154,Western Pacific
Australia,25-03-2020,292316,1635,807,291509,Western Pacific
Australia,25-03-2020,301450,2448,611,300839,Western Pacific
Australia,25-03-2020,428636,1461,1195,427441,Western Pacific
Australia,25-03-2020,167727,45,965,166762,Western Pacific
Australia,25-03-2020,143814,1516,505,143309,Western Pacific
Australia,25-03-2020,95751,1653,1034,94717,Western Pacific
Australia,25-03-2020,131184,2477,760,130424,Western Pacific
Austria,25-03-2020,24767,912,1092,23675,Europe
Azerbaijan,25-03-2020,58158,2013,592,57566,Europe
Bahamas,25-03-2020,448488,624,1050,447438,Americas
Bahrain,25-03-2020,321112,788,557,320555,Eastern Mediterranean
Bangladesh,25-03-2020,353726,15,1198,352528,South-East Asia
Barbados,25-03-2020,219871,464,623,219248,Americas
Belarus,25-03-2020,121045,2109,646,120399,Europe
Belgium,25-03-2020,421787,279,233,421554,Europe
Benin,25-03-2020,195656,676,764,194892,Africa
Bhutan,25-03-2020,288708,82,899,287809,South-East Asia
Bolivia,25-03-2020,125950,1889,29,125921,Americas
Bosnia and Herzegovina,25-03-2020,225868,862,870,224998,Europe
Brazil,25-03-2020,140962,1563,808,140154,Americas
Brunei,25-03-2020,95420,2272,102,95318,Western Pacific
Bulgaria,25-03-2020,269922,870,1108,268814,Europe
Burkina Faso,25-03-2020,189547,2053,288,189259,Africa
Cabo Verde,25-03-2020,237210,2123,182,237028,Africa
Cambodia,25-03-2020,381007,430,1087,379920,Western Pacific
Cameroon,25-03-2020,226037,2024,1120,224917,Africa
Canada,25-03-2020,252138,1186,410,251728,Americas
Canada,25-03-2020,340936,460,343,340593,Americas
Canada,25-03-2020,176067,1519,61,176006,Americas
Canada,25-03-2020,221907,294,1223,220684,Americas
Canada,25-03-2020,113720,474,455,113265,Americas
Canada,25-03-2020,35831,1039,1041,34790,Americas
Canada,25-03-2020,234434,517,102,234332,Americas
Canada,25-03-2020,145067,864,615,144452,Americas
Canada,25-03-2020,381951,1053,623,381328,Americas
Canada,25-03-2020,370815,1186,974,369841,Americas
Central African Republic,25-03-2020,232607,851,470,232137,Africa
Chad,25-03-2020,49871,1613,129,49742,Africa
Chile,25-03-2020,248467,699,964,247503,Americas
China,25-03-2020,369706,1294,618,369088,Western Pacific
China,25-03-2020,114642,1351,565,114077,Western Pacific
China,25-03-2020,149996,2108,670,149326,Western Pacific
China,25-03-2020,115240,223,212,115028,Western Pacific
China,25-03-2020,340239,2495,816,339423,Western Pacific
China,25-03-2020,360583,1739,829,359754,Western Pacific
China,25-03-2020,124724,1873,375,124349,Western Pacific
China,25-03-2020,288911,1879,1118,287793,Western Pacific
China,25-03-2020,249238,367,872,248366,Western Pacific
China,25-03-2020,279403,1785,87,279316,Western Pacific
China,25-03-2020,171699,787,333,171366,Western Pacific
China,25-03-2020,406759,666,693,406066,Western Pacific
China,25-03-2020,327113,2013,138,326975,Western Pacific
China,25-03-2020,115203,376,796,114407,Western Pacific
China,25-03-2020,222123,200,289,221834,Western Pacific
China,25-03-2020,259040,1586,1059,257981,Western Pacific
China,25-03-2020,98685,1497,748,97937,Western Pacific
China,25-03-2020,366391,294,499,365892,Western Pacific
China,25-03-2020,431263,963,248,431015,Western Pacific
China,25-03-2020,306815,276,212,306603,Western Pacific
China,25-03-2020,407148,1323,982,406166,Western Pacific
China,25-03-2020,384021,578,783,383238,Western Pacific
China,25-03-2020,122704,1525,788,121916,Western Pacific
China,25-03-2020,343309,836,1014,342295,Western Pacific
China,25-03-2020,157599,2358,729,156870,Western Pacific
China,25-03-2020,265080,2374,320,264760,Western Pacific
China,25-03-2020,407697,1722,993,406704,Western Pacific
China,25-03-2020,81864,390,1003,80861,Western Pacific
China,25-03-2020,167835,1456,208,167627,Western Pacific
China,25-03-2020,280188,1213,172,280016,Western Pacific
China,25-03-2020,304595,2,484,304111,Western Pacific
China,25-03-2020,415499,259,744,414755,Western Pacific
China,25-03-2020,106090,2038,102,105988,Western Pacific
Colombia,25-03-2020,355635,1392,905,354730,Americas
Congo (Brazzaville),25-03-2020,365489,965,813,364676,Africa
Congo (Kinshasa),25-03-2020,13934,2479,676,13258,Africa
Costa Rica,25-03-2020,267234,709,393,266841,Americas
Cote d'Ivoire,25-03-2020,369009,681,310,368699,Africa
Croatia,25-03-2020,258376,940,878,257498,Europe
Cuba,25-03-2020,321926,933,418,321508,Americas
Cyprus,25-03-2020,261492,1750,694,260798,Europe
Czechia,25-03-2020,234199,571,86,234113,Europe
Denmark,25-03-2020,82944,1618,663,82281,Europe
Greenland,25-03-2020,114904,246,1037,113867,Europe
Denmark,25-03-2020,40083,553,93,39990,Europe
Djibouti,25-03-2020,421194,910,637,420557,Eastern Mediterranean
Dominican Republic,25-03-2020,273410,2077,915,272495,Americas
Ecuador,25-03-2020,105408,2049,1231,104177,Americas
Egypt,25-03-2020,152596,1084,640,151956,Eastern Mediterranean
El Salvador,25-03-2020,363532,1907,116,363416,Americas
Equatorial Guinea,25-03-2020,400206,1004,669,399537,Africa
Eritrea,25-03-2020,408891,1103,335,408556,Africa
Estonia,25-03-2020,245157,774,116,245041,Europe
Eswatini,25-03-2020,291023,146,1219,289804,Africa
Ethiopia,25-03-2020,411527,649,192,411335,Africa
Fiji,25-03-2020,433107,1598,1103,432004,Western Pacific
Finland,25-03-2020,285004,1151,467,284537,Europe
France,25-03-2020,236985,2324,947,236038,Europe
France,25-03-2020,127140,2277,833,126307,Europe
France,25-03-2020,295688,1288,1179,294509,Europe
France,25-03-2020,54867,1340,1008,53859,Europe
France,25-03-2020,15952,37,580,15372,Europe
France,25-03-2020,415172,2377,402,414770,Europe
France,25-03-2020,212705,665,833,211872,Europe
France,25-03-2020,303905,1402,52,303853,Europe
France,25-03-2020,167225,1482,1160,166065,Europe
France,25-03-2020,379765,418,1052,378713,Europe
Gabon,25-03-2020,77223,370,882,76341,Africa
Gambia,25-03-2020,339102,2259,810,338292,Africa
Georgia,25-03-2020,388282,182,576,387706,Europe
Germany,25-03-2020,200837,622,999,199838,Europe
Ghana,25-03-2020,273076,172,654,272422,Africa
Greece,25-03-2020,116026,1835,580,115446,Europe
Guatemala,25-03-2020,301408,334,447,300961,Americas
Guinea,25-03-2020,228598,200,471,228127,Africa
Guyana,25-03-2020,234807,1590,397,234410,Americas
Haiti,25-03-2020,126818,611,112,126706,Americas
Holy See,25-03-2020,216859,36,1235,215624,Europe
Honduras,25-03-2020,367523,1213,994,366529,Americas
Hungary,25-03-2020,64596,1046,1195,63401,Europe
Iceland,25-03-2020,62837,169,154,62683,Europe
India,25-03-2020,103503,1373,198,103305,South-East Asia
Indonesia,25-03-2020,204877,2271,108,204769,South-East Asia
Iran,25-03-2020,149510,2370,229,149281,Eastern Mediterranean
Iraq,25-03-2020,71153,910,736,70417,Eastern Mediterranean
Ireland,25-03-2020,2869,2295,721,2148,Europe
Israel,25-03-2020,182190,102,1196,180994,Europe
Italy,25-03-2020,367225,2413,527,366698,Europe
Jamaica,25-03-2020,245475,95,740,244735,Americas
Japan,25-03-2020,341232,1534,1044,340188,Western Pacific
Jordan,25-03-2020,231304,1724,1026,230278,Eastern Mediterranean
Kazakhstan,25-03-2020,314982,34,1093,313889,Europe
Kenya,25-03-2020,174298,1798,851,173447,Africa
South Korea,25-03-2020,181988,1465,285,181703,Western Pacific
Kuwait,25-03-2020,434555,1489,287,434268,Eastern Mediterranean
Kyrgyzstan,25-03-2020,109167,192,142,109025,Europe
Latvia,25-03-2020,23068,33,1031,22037,Europe
Lebanon,25-03-2020,23742,1186,789,22953,Eastern Mediterranean
Liberia,25-03-2020,171721,851,563,171158,Africa
Liechtenstein,25-03-2020,37240,2115,1136,36104,Europe
Lithuania,25-03-2020,101220,1537,458,100762,Europe
Luxembourg,25-03-2020,261194,1950,34,261160,Europe
Madagascar,25-03-2020,398329,2121,716,397613,Africa
Malaysia,25-03-2020,334616,62,774,333842,Western Pacific
Maldives,25-03-2020,59242,2092,173,59069,South-East Asia
Malta,25-03-2020,110543,406,117,110426,Europe
Mauritania,25-03-2020,236617,2492,1135,235482,Africa
Mauritius,25-03-2020,348672,707,591,348081,Africa
Mexico,25-03-2020,391697,895,1226,390471,Americas
Moldova,25-03-2020,448825,339,1047,447778,Europe
Monaco,25-03-2020,125577,1083,1131,124446,Europe
Mongolia,25-03-2020,90851,2021,1034,89817,Western Pacific
Montenegro,25-03-2020,101340,841,109,101231,Europe
Morocco,25-03-2020,307851,894,192,307659,Eastern Mediterranean
Namibia,25-03-2020,131013,2466,251,130762,Africa
Nepal,25-03-2020,448651,9,667,447984,South-East Asia
Netherlands,25-03-2020,111187,1126,722,110465,Europe
Netherlands,25-03-2020,151989,2022,352,151637,Europe
Netherlands,25-03-2020,354878,1701,572,354306,Europe
Netherlands,25-03-2020,58886,1152,1032,57854,Europe
New Zealand,25-03-2020,403468,179,1101,402367,Western Pacific
Nicaragua,25-03-2020,226590,2040,932,225658,Americas
Niger,25-03-2020,231902,1014,404,231498,Africa
Nigeria,25-03-2020,337089,1943,744,336345,Africa
North Macedonia,25-03-2020,159264,1593,49,159215,Europe
Norway,25-03-2020,12261,1968,1228,11033,Europe
Oman,25-03-2020,421652,2233,1093,420559,Eastern Mediterranean
Pakistan,25-03-2020,258102,1517,376,257726,Eastern Mediterranean
Panama,25-03-2020,448318,213,4,448314,Americas
Papua New Guinea,25-03-2020,48836,962,1160,47676,Western Pacific
Paraguay,25-03-2020,421423,1085,1133,420290,Americas
Peru,25-03-2020,275910,1582,161,275749,Americas
Philippines,25-03-2020,199029,1504,766,198263,Western Pacific
Poland,25-03-2020,155981,1824,1103,154878,Europe
Portugal,25-03-2020,268260,1528,64,268196,Europe
Qatar,25-03-2020,287862,431,531,287331,Eastern Mediterranean
Romania,25-03-2020,133690,78,615,133075,Europe
Russia,25-03-2020,159184,2168,107,159077,Europe
Rwanda,25-03-2020,295151,400,1086,294065,Africa
Saint Lucia,25-03-2020,246505,1041,72,246433,Americas
Saint Vincent and the Grenadines,25-03-2020,267400,1008,282,267118,Americas
San Marino,25-03-2020,255619,137,921,254698,Europe
Saudi Arabia,25-03-2020,362713,1371,321,362392,Eastern Mediterranean
Senegal,25-03-2020,392752,764,597,392155,Africa
Serbia,25-03-2020,415150,2311,408,414742,Europe
Seychelles,25-03-2020,36774,1528,887,35887,Africa
Singapore,25-03-2020,438334,384,382,437952,Western Pacific
Slovakia,25-03-2020,381354,976,26,381328,Europe
Slovenia,25-03-2020,98216,2342,947,97269,Europe
Somalia,25-03-2020,340404,1198,880,339524,Eastern Mediterranean
South Africa,25-03-2020,177916,730,397,177519,Africa
Spain,25-03-2020,221603,315,42,221561,Europe
Sri Lanka,25-03-2020,421175,1952,718,420457,South-East Asia
Sudan,25-03-2020,367605,221,514,367091,Eastern Mediterranean
Suriname,25-03-2020,370254,804,1195,369059,Americas
Sweden,25-03-2020,431524,2475,959,430565,Europe
Switzerland,25-03-2020,245466,2326,912,244554,Europe
Taiwan*,25-03-2020,433236,1716,1235,432001,Western Pacific
Tanzania,25-03-2020,354846,1324,556,354290,Africa
Thailand,25-03-2020,203800,887,441,203359,South-East Asia
Togo,25-03-2020,79290,898,1205,78085,Africa
Trinidad and Tobago,25-03-2020,256649,948,43,256606,Americas
Tunisia,25-03-2020,317911,828,42,317869,Eastern Mediterranean
Turkey,25-03-2020,53212,1901,878,52334,Europe
Uganda,25-03-2020,398534,1877,601,397933,Africa
Ukraine,25-03-2020,330896,1796,48,330848,Europe
United Arab Emirates,25-03-2020,136482,986,1086,135396,Eastern Mediterranean
United Kingdom,25-03-2020,95849,1138,889,94960,Europe
United Kingdom,25-03-2020,41487,2347,300,41187,Europe
United Kingdom,25-03-2020,128634,1324,510,128124,Europe
United Kingdom,25-03-2020,85083,2006,1054,84029,Europe
United Kingdom,25-03-2020,310802,483,455,310347,Europe
United Kingdom,25-03-2020,163118,121,422,162696,Europe
United Kingdom,25-03-2020,320079,1196,817,319262,Europe
Uruguay,25-03-2020,428611,282,644,427967,Americas
US,25-03-2020,320309,1307,486,319823,Americas
Uzbekistan,25-03-2020,326846,1435,1187,325659,Europe
Venezuela,25-03-2020,273889,99,1249,272640,Americas
Vietnam,25-03-2020,136020,1089,289,135731,Western Pacific
Zambia,25-03-2020,148953,1654,425,148528,Africa
Zimbabwe,25-03-2020,447883,1401,695,447188,Africa
Dominica,25-03-2020,169074,2258,1099,167975,Americas
Grenada,25-03-2020,33145,1698,450,32695,Americas
Mozambique,25-03-2020,54909,771,649,54260,Africa
Syria,25-03-2020,343996,573,37,343959,Eastern Mediterranean
Timor-Leste,25-03-2020,85977,2409,393,85584,South-East Asia
Belize,25-03-2020,117142,32,742,116400,Americas
Laos,25-03-2020,168541,1077,863,167678,Western Pacific
Libya,25-03-2020,134218,1655,1036,133182,Eastern Mediterranean
West Bank and Gaza,25-03-2020,386825,713,1229,385596,Eastern Mediterranean
Guinea-Bissau,25-03-2020,438265,936,909,437356,Africa
Mali,25-03-2020,323075,2367,832,322243,Africa
Saint Kitts and Nevis,25-03-2020,304776,370,884,303892,Americas
Canada,25-03-2020,174496,1266,582,173914,Americas
Canada,25-03-2020,128620,2216,189,128431,Americas
Kosovo,25-03-2020,267669,1805,435,267234,Europe
Burma,25-03-2020,93064,1479,140,92924,South-East Asia
United Kingdom,25-03-2020,190622,2188,271,190351,Europe
United Kingdom,25-03-2020,397289,283,1034,396255,Europe
United Kingdom,25-03-2020,60409,14,545,59864,Europe
Botswana,25-03-2020,261563,912,157,261406,Africa
Burundi,25-03-2020,93477,2387,658,92819,Africa
Sierra Leone,25-03-2020,232440,2019,367,232073,Africa
Malawi,25-03-2020,156715,1339,827,155888,Africa
United Kingdom,25-03-2020,343832,1355,506,343326,Europe
France,25-03-2020,226466,1405,757,225709,Europe
South Sudan,25-03-2020,348926,227,324,348602,Africa
Western Sahara,25-03-2020,143047,1482,403,142644,Africa
Sao Tome and Principe,25-03-2020,297522,496,962,296560,Africa
Yemen,25-03-2020,97365,1351,391,96974,Eastern Mediterranean
Comoros,25-03-2020,219225,979,264,218961,Africa
Tajikistan,25-03-2020,325687,1372,343,325344,Europe
Lesotho,25-03-2020,266984,655,982,266002,Africa
Afghanistan,26-03-2020,177985,587,603,177382,Eastern Mediterranean
Albania,26-03-2020,265523,863,1087,264436,Europe
Algeria,26-03-2020,393224,1309,59,393165,Africa
Andorra,26-03-2020,105629,962,908,104721,Europe
Angola,26-03-2020,348526,949,831,347695,Africa
Antigua and Barbuda,26-03-2020,411719,233,310,411409,Americas
Argentina,26-03-2020,51079,2296,1045,50034,Americas
Armenia,26-03-2020,437777,1797,1071,436706,Europe
Australia,26-03-2020,186846,1370,877,185969,Western Pacific
Australia,26-03-2020,61335,1509,202,61133,Western Pacific
Australia,26-03-2020,46461,1295,720,45741,Western Pacific
Australia,26-03-2020,52152,383,1208,50944,Western Pacific
Australia,26-03-2020,379589,675,1041,378548,Western Pacific
Australia,26-03-2020,32675,1783,37,32638,Western Pacific
Australia,26-03-2020,218201,1029,854,217347,Western Pacific
Australia,26-03-2020,73263,236,108,73155,Western Pacific
Austria,26-03-2020,60723,2411,8,60715,Europe
Azerbaijan,26-03-2020,45830,379,955,44875,Europe
Bahamas,26-03-2020,236226,1603,881,235345,Americas
Bahrain,26-03-2020,266955,97,778,266177,Eastern Mediterranean
Bangladesh,26-03-2020,394295,534,441,393854,South-East Asia
Barbados,26-03-2020,240470,2151,1019,239451,Americas
Belarus,26-03-2020,437853,1458,727,437126,Europe
Belgium,26-03-2020,31071,785,1161,29910,Europe
Benin,26-03-2020,278058,1432,1174,276884,Africa
Bhutan,26-03-2020,88674,2494,100,88574,South-East Asia
Bolivia,26-03-2020,335085,1057,137,334948,Americas
Bosnia and Herzegovina,26-03-2020,9955,2269,587,9368,Europe
Brazil,26-03-2020,50976,197,506,50470,Americas
Brunei,26-03-2020,321974,1115,1082,320892,Western Pacific
Bulgaria,26-03-2020,68704,2136,369,68335,Europe
Burkina Faso,26-03-2020,403877,2181,284,403593,Africa
Cabo Verde,26-03-2020,85203,686,420,84783,Africa
Cambodia,26-03-2020,79737,1012,193,79544,Western Pacific
Cameroon,26-03-2020,352569,2448,1198,351371,Africa
Canada,26-03-2020,6925,567,88,6837,Americas
Canada,26-03-2020,330705,2096,389,330316,Americas
Canada,26-03-2020,249757,1856,413,249344,Americas
Canada,26-03-2020,160774,842,699,160075,Americas
Canada,26-03-2020,228915,761,480,228435,Americas
Canada,26-03-2020,1393,1327,534,859,Americas
Canada,26-03-2020,219037,0,749,218288,Americas
Canada,26-03-2020,2846,1389,658,2188,Americas
Canada,26-03-2020,198351,108,1210,197141,Americas
Canada,26-03-2020,326519,444,922,325597,Americas
Central African Republic,26-03-2020,20327,594,378,19949,Africa
Chad,26-03-2020,87533,743,646,86887,Africa
Chile,26-03-2020,422860,92,1089,421771,Americas
China,26-03-2020,359885,2276,659,359226,Western Pacific
China,26-03-2020,40688,173,384,40304,Western Pacific
China,26-03-2020,193887,2396,665,193222,Western Pacific
China,26-03-2020,83676,1418,1213,82463,Western Pacific
China,26-03-2020,124030,1931,780,123250,Western Pacific
China,26-03-2020,439365,2216,27,439338,Western Pacific
China,26-03-2020,338194,1568,57,338137,Western Pacific
China,26-03-2020,29521,738,459,29062,Western Pacific
China,26-03-2020,164022,1382,1141,162881,Western Pacific
China,26-03-2020,410370,2328,666,409704,Western Pacific
China,26-03-2020,233688,600,375,233313,Western Pacific
China,26-03-2020,73946,1969,1066,72880,Western Pacific
China,26-03-2020,283556,340,190,283366,Western Pacific
China,26-03-2020,312420,567,150,312270,Western Pacific
China,26-03-2020,241464,800,1176,240288,Western Pacific
China,26-03-2020,312835,2166,254,312581,Western Pacific
China,26-03-2020,352222,684,125,352097,Western Pacific
China,26-03-2020,396649,820,292,396357,Western Pacific
China,26-03-2020,98300,257,1184,97116,Western Pacific
China,26-03-2020,115813,1993,63,115750,Western Pacific
China,26-03-2020,51373,584,325,51048,Western Pacific
China,26-03-2020,280605,2238,1240,279365,Western Pacific
China,26-03-2020,203211,297,1114,202097,Western Pacific
China,26-03-2020,411772,2096,1213,410559,Western Pacific
China,26-03-2020,211187,735,764,210423,Western Pacific
China,26-03-2020,219204,258,1022,218182,Western Pacific
China,26-03-2020,426626,986,595,426031,Western Pacific
China,26-03-2020,153549,1389,245,153304,Western Pacific
China,26-03-2020,230004,2024,749,229255,Western Pacific
China,26-03-2020,201474,2298,709,200765,Western Pacific
China,26-03-2020,214955,2498,361,214594,Western Pacific
China,26-03-2020,29355,1756,182,29173,Western Pacific
China,26-03-2020,27085,2490,453,26632,Western Pacific
Colombia,26-03-2020,247493,1542,439,247054,Americas
Congo (Brazzaville),26-03-2020,400820,1171,549,400271,Africa
Congo (Kinshasa),26-03-2020,141557,1491,629,140928,Africa
Costa Rica,26-03-2020,197166,1947,1106,196060,Americas
Cote d'Ivoire,26-03-2020,50769,2279,404,50365,Africa
Croatia,26-03-2020,199842,1793,255,199587,Europe
Cuba,26-03-2020,11385,325,694,10691,Americas
Cyprus,26-03-2020,27450,970,286,27164,Europe
Czechia,26-03-2020,397514,1397,1141,396373,Europe
Denmark,26-03-2020,377232,1266,122,377110,Europe
Greenland,26-03-2020,237668,1660,558,237110,Europe
Denmark,26-03-2020,210098,2363,453,209645,Europe
Djibouti,26-03-2020,225053,1008,751,224302,Eastern Mediterranean
Dominican Republic,26-03-2020,95572,842,7,95565,Americas
Ecuador,26-03-2020,64017,2458,672,63345,Americas
Egypt,26-03-2020,28743,918,764,27979,Eastern Mediterranean
El Salvador,26-03-2020,64122,337,1115,63007,Americas
Equatorial Guinea,26-03-2020,134125,1074,160,133965,Africa
Eritrea,26-03-2020,66167,99,948,65219,Africa
Estonia,26-03-2020,41504,2110,761,40743,Europe
Eswatini,26-03-2020,243935,18,955,242980,Africa
Ethiopia,26-03-2020,436548,356,838,435710,Africa
Fiji,26-03-2020,408961,964,1211,407750,Western Pacific
Finland,26-03-2020,385456,2117,670,384786,Europe
France,26-03-2020,36568,341,1132,35436,Europe
France,26-03-2020,264416,2492,1092,263324,Europe
France,26-03-2020,291105,676,1175,289930,Europe
France,26-03-2020,29517,2032,336,29181,Europe
France,26-03-2020,279747,1654,20,279727,Europe
France,26-03-2020,341040,2427,903,340137,Europe
France,26-03-2020,399734,8,1127,398607,Europe
France,26-03-2020,10904,2319,1193,9711,Europe
France,26-03-2020,263311,2145,193,263118,Europe
France,26-03-2020,77190,2082,1153,76037,Europe
Gabon,26-03-2020,53158,1528,276,52882,Africa
Gambia,26-03-2020,371995,1388,1081,370914,Africa
Georgia,26-03-2020,159376,123,1104,158272,Europe
Germany,26-03-2020,341260,1822,104,341156,Europe
Ghana,26-03-2020,186340,93,792,185548,Africa
Greece,26-03-2020,410158,2351,640,409518,Europe
Guatemala,26-03-2020,359937,90,1187,358750,Americas
Guinea,26-03-2020,432221,281,46,432175,Africa
Guyana,26-03-2020,17891,782,323,17568,Americas
Haiti,26-03-2020,102277,861,216,102061,Americas
Holy See,26-03-2020,118052,2265,777,117275,Europe
Honduras,26-03-2020,10887,41,403,10484,Americas
Hungary,26-03-2020,291343,257,794,290549,Europe
Iceland,26-03-2020,376537,2494,996,375541,Europe
India,26-03-2020,167876,1165,714,167162,South-East Asia
Indonesia,26-03-2020,238994,2392,920,238074,South-East Asia
Iran,26-03-2020,9833,1798,390,9443,Eastern Mediterranean
Iraq,26-03-2020,428537,652,350,428187,Eastern Mediterranean
Ireland,26-03-2020,183082,1161,358,182724,Europe
Israel,26-03-2020,188829,2336,66,188763,Europe
Italy,26-03-2020,85219,2148,894,84325,Europe
Jamaica,26-03-2020,351234,1253,867,350367,Americas
Japan,26-03-2020,354694,2476,875,353819,Western Pacific
Jordan,26-03-2020,166087,337,759,165328,Eastern Mediterranean
Kazakhstan,26-03-2020,39275,1652,95,39180,Europe
Kenya,26-03-2020,211065,1105,1080,209985,Africa
South Korea,26-03-2020,86920,2354,668,86252,Western Pacific
Kuwait,26-03-2020,283719,1742,1240,282479,Eastern Mediterranean
Kyrgyzstan,26-03-2020,103980,653,263,103717,Europe
Latvia,26-03-2020,9172,1863,1245,7927,Europe
Lebanon,26-03-2020,199792,359,343,199449,Eastern Mediterranean
Liberia,26-03-2020,31733,2303,694,31039,Africa
Liechtenstein,26-03-2020,288058,1359,824,287234,Europe
Lithuania,26-03-2020,199715,2184,292,199423,Europe
Luxembourg,26-03-2020,63821,772,1066,62755,Europe
Madagascar,26-03-2020,148494,2030,1077,147417,Africa
Malaysia,26-03-2020,336099,1579,340,335759,Western Pacific
Maldives,26-03-2020,446947,319,148,446799,South-East Asia
Malta,26-03-2020,215235,768,1075,214160,Europe
Mauritania,26-03-2020,136919,2050,322,136597,Africa
Mauritius,26-03-2020,121130,324,980,120150,Africa
Mexico,26-03-2020,297673,2124,213,297460,Americas
Moldova,26-03-2020,3953,541,804,3149,Europe
Monaco,26-03-2020,167013,1589,857,166156,Europe
Mongolia,26-03-2020,394498,1412,774,393724,Western Pacific
Montenegro,26-03-2020,108167,475,263,107904,Europe
Morocco,26-03-2020,445840,36,510,445330,Eastern Mediterranean
Namibia,26-03-2020,324642,507,797,323845,Africa
Nepal,26-03-2020,184369,559,337,184032,South-East Asia
Netherlands,26-03-2020,264874,661,549,264325,Europe
Netherlands,26-03-2020,296265,1426,746,295519,Europe
Netherlands,26-03-2020,28480,1256,268,28212,Europe
Netherlands,26-03-2020,255242,939,833,254409,Europe
New Zealand,26-03-2020,62680,994,768,61912,Western Pacific
Nicaragua,26-03-2020,269430,699,706,268724,Americas
Niger,26-03-2020,60348,163,497,59851,Africa
Nigeria,26-03-2020,374510,281,503,374007,Africa
North Macedonia,26-03-2020,224834,358,715,224119,Europe
Norway,26-03-2020,406503,155,256,406247,Europe
Oman,26-03-2020,347512,2262,1138,346374,Eastern Mediterranean
Pakistan,26-03-2020,92260,1252,41,92219,Eastern Mediterranean
Panama,26-03-2020,358007,1492,701,357306,Americas
Papua New Guinea,26-03-2020,240617,1204,825,239792,Western Pacific
Paraguay,26-03-2020,50933,784,292,50641,Americas
Peru,26-03-2020,104302,2498,1087,103215,Americas
Philippines,26-03-2020,195725,2469,720,195005,Western Pacific
Poland,26-03-2020,346798,1945,1042,345756,Europe
Portugal,26-03-2020,275358,411,1100,274258,Europe
Qatar,26-03-2020,367828,1856,617,367211,Eastern Mediterranean
Romania,26-03-2020,44740,1198,133,44607,Europe
Russia,26-03-2020,220057,2353,199,219858,Europe
Rwanda,26-03-2020,83549,1157,432,83117,Africa
Saint Lucia,26-03-2020,393417,867,137,393280,Americas
Saint Vincent and the Grenadines,26-03-2020,391553,2218,66,391487,Americas
San Marino,26-03-2020,20228,2435,1072,19156,Europe
Saudi Arabia,26-03-2020,99544,1124,440,99104,Eastern Mediterranean
Senegal,26-03-2020,342710,1049,1122,341588,Africa
Serbia,26-03-2020,79019,1206,640,78379,Europe
Seychelles,26-03-2020,364049,1051,858,363191,Africa
Singapore,26-03-2020,139924,1164,578,139346,Western Pacific
Slovakia,26-03-2020,90339,1060,1102,89237,Europe
Slovenia,26-03-2020,417524,2399,338,417186,Europe
Somalia,26-03-2020,97059,1511,494,96565,Eastern Mediterranean
South Africa,26-03-2020,226614,1202,1203,225411,Africa
Spain,26-03-2020,254743,1589,344,254399,Europe
Sri Lanka,26-03-2020,372137,2290,3,372134,South-East Asia
Sudan,26-03-2020,363532,2379,946,362586,Eastern Mediterranean
Suriname,26-03-2020,108107,2385,411,107696,Americas
Sweden,26-03-2020,421663,631,14,421649,Europe
Switzerland,26-03-2020,390667,1213,789,389878,Europe
Taiwan*,26-03-2020,183834,2279,466,183368,Western Pacific
Tanzania,26-03-2020,279233,670,84,279149,Africa
Thailand,26-03-2020,307059,319,449,306610,South-East Asia
Togo,26-03-2020,350590,1077,200,350390,Africa
Trinidad and Tobago,26-03-2020,398211,393,596,397615,Americas
Tunisia,26-03-2020,400952,590,508,400444,Eastern Mediterranean
Turkey,26-03-2020,353876,2120,1195,352681,Europe
Uganda,26-03-2020,431645,1963,1250,430395,Africa
Ukraine,26-03-2020,26755,2492,1238,25517,Europe
United Arab Emirates,26-03-2020,267038,92,236,266802,Eastern Mediterranean
United Kingdom,26-03-2020,142436,699,702,141734,Europe
United Kingdom,26-03-2020,234312,1629,811,233501,Europe
United Kingdom,26-03-2020,341291,2462,714,340577,Europe
United Kingdom,26-03-2020,192662,1803,1074,191588,Europe
United Kingdom,26-03-2020,153418,1842,707,152711,Europe
United Kingdom,26-03-2020,444790,847,881,443909,Europe
United Kingdom,26-03-2020,427878,2033,152,427726,Europe
Uruguay,26-03-2020,99740,2262,373,99367,Americas
US,26-03-2020,49087,268,862,48225,Americas
Uzbekistan,26-03-2020,141917,2399,973,140944,Europe
Venezuela,26-03-2020,60908,565,1051,59857,Americas
Vietnam,26-03-2020,155419,244,318,155101,Western Pacific
Zambia,26-03-2020,164567,2028,238,164329,Africa
Zimbabwe,26-03-2020,140921,50,817,140104,Africa
Dominica,26-03-2020,237574,1346,622,236952,Americas
Grenada,26-03-2020,369945,1002,468,369477,Americas
Mozambique,26-03-2020,45539,22,147,45392,Africa
Syria,26-03-2020,226505,2341,649,225856,Eastern Mediterranean
Timor-Leste,26-03-2020,207206,426,3,207203,South-East Asia
Belize,26-03-2020,100160,563,556,99604,Americas
Laos,26-03-2020,39483,2453,459,39024,Western Pacific
Libya,26-03-2020,37035,992,1200,35835,Eastern Mediterranean
West Bank and Gaza,26-03-2020,204049,1764,1126,202923,Eastern Mediterranean
Guinea-Bissau,26-03-2020,159123,1062,853,158270,Africa
Mali,26-03-2020,432678,1367,834,431844,Africa
Saint Kitts and Nevis,26-03-2020,337320,503,942,336378,Americas
Canada,26-03-2020,246066,1798,633,245433,Americas
Canada,26-03-2020,42474,758,663,41811,Americas
Kosovo,26-03-2020,100977,2119,1005,99972,Europe
Burma,26-03-2020,448853,2240,649,448204,South-East Asia
United Kingdom,26-03-2020,243377,528,842,242535,Europe
United Kingdom,26-03-2020,25251,302,692,24559,Europe
United Kingdom,26-03-2020,105388,20,656,104732,Europe
Botswana,26-03-2020,222861,1018,998,221863,Africa
Burundi,26-03-2020,407855,2045,585,407270,Africa
Sierra Leone,26-03-2020,177375,1934,527,176848,Africa
Malawi,26-03-2020,252253,2101,155,252098,Africa
United Kingdom,26-03-2020,377784,2143,315,377469,Europe
France,26-03-2020,348256,2382,447,347809,Europe
South Sudan,26-03-2020,449781,1632,860,448921,Africa
Western Sahara,26-03-2020,127113,2376,378,126735,Africa
Sao Tome and Principe,26-03-2020,132166,1174,578,131588,Africa
Yemen,26-03-2020,414674,1794,850,413824,Eastern Mediterranean
Comoros,26-03-2020,30846,2378,869,29977,Africa
Tajikistan,26-03-2020,16274,905,1127,15147,Europe
Lesotho,26-03-2020,162574,674,288,162286,Africa
Afghanistan,27-03-2020,11124,59,54,11070,Eastern Mediterranean
Albania,27-03-2020,369839,1656,1145,368694,Europe
Algeria,27-03-2020,347764,1641,585,347179,Africa
Andorra,27-03-2020,275539,1094,490,275049,Europe
Angola,27-03-2020,434899,1995,967,433932,Africa
Antigua and Barbuda,27-03-2020,281852,1806,363,281489,Americas
Argentina,27-03-2020,35187,1292,675,34512,Americas
Armenia,27-03-2020,442824,1005,921,441903,Europe
Australia,27-03-2020,15611,568,34,15577,Western Pacific
Australia,27-03-2020,365352,1408,886,364466,Western Pacific
Australia,27-03-2020,6922,2086,255,6667,Western Pacific
Australia,27-03-2020,360100,288,890,359210,Western Pacific
Australia,27-03-2020,405960,2390,471,405489,Western Pacific
Australia,27-03-2020,291385,2096,745,290640,Western Pacific
Australia,27-03-2020,198228,675,85,198143,Western Pacific
Australia,27-03-2020,325114,2403,605,324509,Western Pacific
Austria,27-03-2020,49501,394,66,49435,Europe
Azerbaijan,27-03-2020,145291,92,305,144986,Europe
Bahamas,27-03-2020,300794,7,542,300252,Americas
Bahrain,27-03-2020,175885,1264,130,175755,Eastern Mediterranean
Bangladesh,27-03-2020,281823,2321,240,281583,South-East Asia
Barbados,27-03-2020,329322,703,968,328354,Americas
Belarus,27-03-2020,62043,1254,425,61618,Europe
Belgium,27-03-2020,87315,2006,360,86955,Europe
Benin,27-03-2020,259781,1512,96,259685,Africa
Bhutan,27-03-2020,20580,1663,702,19878,South-East Asia
Bolivia,27-03-2020,143642,2092,90,143552,Americas
Bosnia and Herzegovina,27-03-2020,226488,1947,1029,225459,Europe
Brazil,27-03-2020,73380,63,262,73118,Americas
Brunei,27-03-2020,111404,1155,920,110484,Western Pacific
Bulgaria,27-03-2020,28481,83,1037,27444,Europe
Burkina Faso,27-03-2020,102145,1904,1238,100907,Africa
Cabo Verde,27-03-2020,229529,2155,801,228728,Africa
Cambodia,27-03-2020,129698,912,594,129104,Western Pacific
Cameroon,27-03-2020,424940,1330,983,423957,Africa
Canada,27-03-2020,138905,887,715,138190,Americas
Canada,27-03-2020,19325,281,342,18983,Americas
Canada,27-03-2020,441977,957,171,441806,Americas
Canada,27-03-2020,419615,649,1222,418393,Americas
Canada,27-03-2020,290031,161,1060,288971,Americas
Canada,27-03-2020,431717,1661,722,430995,Americas
Canada,27-03-2020,196586,582,1245,195341,Americas
Canada,27-03-2020,65590,1108,755,64835,Americas
Canada,27-03-2020,447414,1903,63,447351,Americas
Canada,27-03-2020,47784,1526,1197,46587,Americas
Central African Republic,27-03-2020,149993,2249,1100,148893,Africa
Chad,27-03-2020,70424,625,591,69833,Africa
Chile,27-03-2020,388389,2275,443,387946,Americas
China,27-03-2020,15131,1635,73,15058,Western Pacific
China,27-03-2020,17756,355,1219,16537,Western Pacific
China,27-03-2020,383317,1830,1131,382186,Western Pacific
China,27-03-2020,183724,1032,360,183364,Western Pacific
China,27-03-2020,43389,1963,964,42425,Western Pacific
China,27-03-2020,316631,891,1136,315495,Western Pacific
China,27-03-2020,213119,409,584,212535,Western Pacific
China,27-03-2020,324563,2011,346,324217,Western Pacific
China,27-03-2020,111047,2089,251,110796,Western Pacific
China,27-03-2020,212397,61,721,211676,Western Pacific
China,27-03-2020,351365,961,623,350742,Western Pacific
China,27-03-2020,139929,1642,1052,138877,Western Pacific
China,27-03-2020,365887,53,704,365183,Western Pacific
China,27-03-2020,289402,2498,992,288410,Western Pacific
China,27-03-2020,286674,433,962,285712,Western Pacific
China,27-03-2020,374122,149,905,373217,Western Pacific
China,27-03-2020,217480,1595,1204,216276,Western Pacific
China,27-03-2020,215602,1110,1079,214523,Western Pacific
China,27-03-2020,110763,901,307,110456,Western Pacific
China,27-03-2020,166511,584,137,166374,Western Pacific
China,27-03-2020,260706,126,1184,259522,Western Pacific
China,27-03-2020,74535,2492,1034,73501,Western Pacific
China,27-03-2020,377524,488,840,376684,Western Pacific
China,27-03-2020,229275,2435,659,228616,Western Pacific
China,27-03-2020,18380,1829,6,18374,Western Pacific
China,27-03-2020,38600,1271,892,37708,Western Pacific
China,27-03-2020,118519,1592,13,118506,Western Pacific
China,27-03-2020,335497,1226,826,334671,Western Pacific
China,27-03-2020,303257,238,54,303203,Western Pacific
China,27-03-2020,161796,582,987,160809,Western Pacific
China,27-03-2020,225273,376,567,224706,Western Pacific
China,27-03-2020,248786,1408,525,248261,Western Pacific
China,27-03-2020,121010,1107,1231,119779,Western Pacific
Colombia,27-03-2020,91817,1835,615,91202,Americas
Congo (Brazzaville),27-03-2020,191095,1264,1032,190063,Africa
Congo (Kinshasa),27-03-2020,4266,509,741,3525,Africa
Costa Rica,27-03-2020,68804,1038,130,68674,Americas
Cote d'Ivoire,27-03-2020,116514,2127,1181,115333,Africa
Croatia,27-03-2020,243811,865,1243,242568,Europe
Cuba,27-03-2020,255991,901,243,255748,Americas
Cyprus,27-03-2020,64870,2195,168,64702,Europe
Czechia,27-03-2020,250758,960,262,250496,Europe
Denmark,27-03-2020,143309,23,1248,142061,Europe
Greenland,27-03-2020,291298,1578,356,290942,Europe
Denmark,27-03-2020,422672,639,161,422511,Europe
Djibouti,27-03-2020,271482,1801,628,270854,Eastern Mediterranean
Dominican Republic,27-03-2020,65966,1361,1163,64803,Americas
Ecuador,27-03-2020,107760,1781,633,107127,Americas
Egypt,27-03-2020,202709,544,848,201861,Eastern Mediterranean
El Salvador,27-03-2020,174501,2286,1110,173391,Americas
Equatorial Guinea,27-03-2020,160988,1194,975,160013,Africa
Eritrea,27-03-2020,366141,1845,1036,365105,Africa
Estonia,27-03-2020,145205,2496,329,144876,Europe
Eswatini,27-03-2020,255864,1062,1144,254720,Africa
Ethiopia,27-03-2020,97187,87,847,96340,Africa
Fiji,27-03-2020,276264,1436,311,275953,Western Pacific
Finland,27-03-2020,128660,2028,180,128480,Europe
France,27-03-2020,126600,1734,1057,125543,Europe
France,27-03-2020,208836,1721,253,208583,Europe
France,27-03-2020,143602,1438,693,142909,Europe
France,27-03-2020,97486,217,351,97135,Europe
France,27-03-2020,156770,1998,109,156661,Europe
France,27-03-2020,301740,431,276,301464,Europe
France,27-03-2020,401047,1718,1169,399878,Europe
France,27-03-2020,98823,1070,111,98712,Europe
France,27-03-2020,335260,2202,932,334328,Europe
France,27-03-2020,315858,1836,1016,314842,Europe
Gabon,27-03-2020,405820,382,329,405491,Africa
Gambia,27-03-2020,120527,684,244,120283,Africa
Georgia,27-03-2020,423859,651,167,423692,Europe
Germany,27-03-2020,312370,428,313,312057,Europe
Ghana,27-03-2020,25107,1928,457,24650,Africa
Greece,27-03-2020,113908,1288,116,113792,Europe
Guatemala,27-03-2020,389100,242,644,388456,Americas
Guinea,27-03-2020,413610,3,1236,412374,Africa
Guyana,27-03-2020,80758,1768,719,80039,Americas
Haiti,27-03-2020,352497,1718,886,351611,Americas
Holy See,27-03-2020,110213,1720,542,109671,Europe
Honduras,27-03-2020,138800,717,82,138718,Americas
Hungary,27-03-2020,313963,663,860,313103,Europe
Iceland,27-03-2020,369864,1055,145,369719,Europe
India,27-03-2020,31578,276,299,31279,South-East Asia
Indonesia,27-03-2020,364278,1472,1106,363172,South-East Asia
Iran,27-03-2020,312910,1036,46,312864,Eastern Mediterranean
Iraq,27-03-2020,139704,729,596,139108,Eastern Mediterranean
Ireland,27-03-2020,299245,1050,996,298249,Europe
Israel,27-03-2020,241046,205,364,240682,Europe
Italy,27-03-2020,152406,1017,487,151919,Europe
Jamaica,27-03-2020,325448,523,346,325102,Americas
Japan,27-03-2020,263526,2356,465,263061,Western Pacific
Jordan,27-03-2020,196042,1643,369,195673,Eastern Mediterranean
Kazakhstan,27-03-2020,302763,170,668,302095,Europe
Kenya,27-03-2020,191580,2016,226,191354,Africa
South Korea,27-03-2020,159713,2036,987,158726,Western Pacific
Kuwait,27-03-2020,80947,617,1015,79932,Eastern Mediterranean
Kyrgyzstan,27-03-2020,143135,149,828,142307,Europe
Latvia,27-03-2020,59095,348,234,58861,Europe
Lebanon,27-03-2020,113316,1223,530,112786,Eastern Mediterranean
Liberia,27-03-2020,420134,1876,553,419581,Africa
Liechtenstein,27-03-2020,253980,2332,419,253561,Europe
Lithuania,27-03-2020,31548,473,658,30890,Europe
Luxembourg,27-03-2020,349909,1004,870,349039,Europe
Madagascar,27-03-2020,6649,907,187,6462,Africa
Malaysia,27-03-2020,320244,1143,436,319808,Western Pacific
Maldives,27-03-2020,82397,326,741,81656,South-East Asia
Malta,27-03-2020,198455,1666,890,197565,Europe
Mauritania,27-03-2020,131783,1091,1215,130568,Africa
Mauritius,27-03-2020,130710,1232,711,129999,Africa
Mexico,27-03-2020,447554,1898,1134,446420,Americas
Moldova,27-03-2020,259881,1292,1015,258866,Europe
Monaco,27-03-2020,350933,1220,676,350257,Europe
Mongolia,27-03-2020,348236,257,1142,347094,Western Pacific
Montenegro,27-03-2020,220791,1127,119,220672,Europe
Morocco,27-03-2020,240654,1078,1135,239519,Eastern Mediterranean
Namibia,27-03-2020,281351,1229,1021,280330,Africa
Nepal,27-03-2020,255038,1216,369,254669,South-East Asia
Netherlands,27-03-2020,137045,1008,782,136263,Europe
Netherlands,27-03-2020,19270,82,1044,18226,Europe
Netherlands,27-03-2020,222317,1149,660,221657,Europe
Netherlands,27-03-2020,218435,299,122,218313,Europe
New Zealand,27-03-2020,200012,68,903,199109,Western Pacific
Nicaragua,27-03-2020,336111,2006,72,336039,Americas
Niger,27-03-2020,64276,2136,1196,63080,Africa
Nigeria,27-03-2020,31634,812,315,31319,Africa
North Macedonia,27-03-2020,23858,1964,127,23731,Europe
Norway,27-03-2020,256636,2007,427,256209,Europe
Oman,27-03-2020,38057,1279,440,37617,Eastern Mediterranean
Pakistan,27-03-2020,104231,1613,968,103263,Eastern Mediterranean
Panama,27-03-2020,360260,1774,323,359937,Americas
Papua New Guinea,27-03-2020,308080,974,285,307795,Western Pacific
Paraguay,27-03-2020,314364,1377,178,314186,Americas
Peru,27-03-2020,429506,36,126,429380,Americas
Philippines,27-03-2020,215428,515,671,214757,Western Pacific
Poland,27-03-2020,207325,2497,704,206621,Europe
Portugal,27-03-2020,264947,2363,103,264844,Europe
Qatar,27-03-2020,139602,1583,972,138630,Eastern Mediterranean
Romania,27-03-2020,265648,558,649,264999,Europe
Russia,27-03-2020,255270,1258,377,254893,Europe
Rwanda,27-03-2020,253308,1976,483,252825,Africa
Saint Lucia,27-03-2020,431618,749,607,431011,Americas
Saint Vincent and the Grenadines,27-03-2020,192512,42,391,192121,Americas
San Marino,27-03-2020,126675,1252,1206,125469,Europe
Saudi Arabia,27-03-2020,306278,519,710,305568,Eastern Mediterranean
Senegal,27-03-2020,273678,722,560,273118,Africa
Serbia,27-03-2020,267726,2345,916,266810,Europe
Seychelles,27-03-2020,201058,1000,364,200694,Africa
Singapore,27-03-2020,389574,1798,640,388934,Western Pacific
Slovakia,27-03-2020,383355,2017,1107,382248,Europe
Slovenia,27-03-2020,139847,644,384,139463,Europe
Somalia,27-03-2020,442231,1800,1226,441005,Eastern Mediterranean
South Africa,27-03-2020,308697,661,397,308300,Africa
Spain,27-03-2020,260643,2210,110,260533,Europe
Sri Lanka,27-03-2020,376038,241,902,375136,South-East Asia
Sudan,27-03-2020,407628,1661,444,407184,Eastern Mediterranean
Suriname,27-03-2020,247793,558,473,247320,Americas
Sweden,27-03-2020,114729,1626,649,114080,Europe
Switzerland,27-03-2020,403505,1289,891,402614,Europe
Taiwan*,27-03-2020,295278,2292,27,295251,Western Pacific
Tanzania,27-03-2020,414453,376,413,414040,Africa
Thailand,27-03-2020,361520,309,243,361277,South-East Asia
Togo,27-03-2020,357938,1427,438,357500,Africa
Trinidad and Tobago,27-03-2020,329873,2070,270,329603,Americas
Tunisia,27-03-2020,174979,705,146,174833,Eastern Mediterranean
Turkey,27-03-2020,339905,32,928,338977,Europe
Uganda,27-03-2020,144116,1900,292,143824,Africa
Ukraine,27-03-2020,138995,1898,133,138862,Europe
United Arab Emirates,27-03-2020,22036,1010,548,21488,Eastern Mediterranean
United Kingdom,27-03-2020,437338,2305,975,436363,Europe
United Kingdom,27-03-2020,16781,1909,551,16230,Europe
United Kingdom,27-03-2020,281113,2210,182,280931,Europe
United Kingdom,27-03-2020,132066,821,282,131784,Europe
United Kingdom,27-03-2020,262080,955,1250,260830,Europe
United Kingdom,27-03-2020,5247,1020,620,4627,Europe
United Kingdom,27-03-2020,169502,531,550,168952,Europe
Uruguay,27-03-2020,193430,592,1211,192219,Americas
US,27-03-2020,92882,2469,1018,91864,Americas
Uzbekistan,27-03-2020,172526,980,758,171768,Europe
Venezuela,27-03-2020,36361,1494,16,36345,Americas
Vietnam,27-03-2020,436253,163,343,435910,Western Pacific
Zambia,27-03-2020,358308,2301,242,358066,Africa
Zimbabwe,27-03-2020,77185,1345,1085,76100,Africa
Dominica,27-03-2020,397969,2311,744,397225,Americas
Grenada,27-03-2020,132736,71,407,132329,Americas
Mozambique,27-03-2020,82915,591,262,82653,Africa
Syria,27-03-2020,180782,1514,27,180755,Eastern Mediterranean
Timor-Leste,27-03-2020,300189,1338,796,299393,South-East Asia
Belize,27-03-2020,362691,167,249,362442,Americas
Laos,27-03-2020,243239,1542,555,242684,Western Pacific
Libya,27-03-2020,397233,656,1117,396116,Eastern Mediterranean
West Bank and Gaza,27-03-2020,94730,523,934,93796,Eastern Mediterranean
Guinea-Bissau,27-03-2020,50060,2052,281,49779,Africa
Mali,27-03-2020,85957,367,470,85487,Africa
Saint Kitts and Nevis,27-03-2020,214470,2324,255,214215,Americas
Canada,27-03-2020,56085,2498,1192,54893,Americas
Canada,27-03-2020,75702,2119,839,74863,Americas
Kosovo,27-03-2020,377383,2464,76,377307,Europe
Burma,27-03-2020,34272,1874,580,33692,South-East Asia
United Kingdom,27-03-2020,70075,1485,596,69479,Europe
United Kingdom,27-03-2020,289072,2082,1049,288023,Europe
United Kingdom,27-03-2020,351966,1282,1018,350948,Europe
Botswana,27-03-2020,628,125,320,308,Africa
Burundi,27-03-2020,204950,726,342,204608,Africa
Sierra Leone,27-03-2020,98332,1990,147,98185,Africa
Malawi,27-03-2020,218505,1760,480,218025,Africa
United Kingdom,27-03-2020,426125,2336,1019,425106,Europe
France,27-03-2020,298801,1894,1038,297763,Europe
South Sudan,27-03-2020,262699,1524,727,261972,Africa
Western Sahara,27-03-2020,387923,982,275,387648,Africa
Sao Tome and Principe,27-03-2020,413254,1936,1149,412105,Africa
Yemen,27-03-2020,243624,2004,479,243145,Eastern Mediterranean
Comoros,27-03-2020,285150,2174,402,284748,Africa
Tajikistan,27-03-2020,362114,185,455,361659,Europe
Lesotho,27-03-2020,279658,226,1226,278432,Africa
Afghanistan,28-03-2020,171559,1046,942,170617,Eastern Mediterranean
Albania,28-03-2020,28005,133,73,27932,Europe
Algeria,28-03-2020,192545,567,944,191601,Africa
Andorra,28-03-2020,41087,916,718,40369,Europe
Angola,28-03-2020,233240,1600,744,232496,Africa
Antigua and Barbuda,28-03-2020,141353,1577,301,141052,Americas
Argentina,28-03-2020,292412,2078,333,292079,Americas
Armenia,28-03-2020,150734,1515,587,150147,Europe
Australia,28-03-2020,54990,2186,758,54232,Western Pacific
Australia,28-03-2020,77714,2479,897,76817,Western Pacific
Australia,28-03-2020,262930,1325,455,262475,Western Pacific
Australia,28-03-2020,263810,2156,1171,262639,Western Pacific
Australia,28-03-2020,3424,1363,287,3137,Western Pacific
Australia,28-03-2020,310615,708,210,310405,Western Pacific
Australia,28-03-2020,77475,2101,1059,76416,Western Pacific
Australia,28-03-2020,362965,1974,1203,361762,Western Pacific
Austria,28-03-2020,248510,2300,1247,247263,Europe
Azerbaijan,28-03-2020,22332,395,726,21606,Europe
Bahamas,28-03-2020,340165,838,789,339376,Americas
Bahrain,28-03-2020,435651,2193,417,435234,Eastern Mediterranean
Bangladesh,28-03-2020,123055,1260,497,122558,South-East Asia
Barbados,28-03-2020,363132,2307,65,363067,Americas
Belarus,28-03-2020,160919,2151,789,160130,Europe
Belgium,28-03-2020,342980,354,986,341994,Europe
Benin,28-03-2020,4152,1490,1056,3096,Africa
Bhutan,28-03-2020,433220,1564,1089,432131,South-East Asia
Bolivia,28-03-2020,86519,664,205,86314,Americas
Bosnia and Herzegovina,28-03-2020,23980,289,495,23485,Europe
Brazil,28-03-2020,425170,762,575,424595,Americas
Brunei,28-03-2020,262407,1127,228,262179,Western Pacific
Bulgaria,28-03-2020,445345,1386,1160,444185,Europe
Burkina Faso,28-03-2020,263999,285,1023,262976,Africa
Cabo Verde,28-03-2020,287713,2471,787,286926,Africa
Cambodia,28-03-2020,158633,68,707,157926,Western Pacific
Cameroon,28-03-2020,429550,14,214,429336,Africa
Canada,28-03-2020,129166,2288,988,128178,Americas
Canada,28-03-2020,97184,550,940,96244,Americas
Canada,28-03-2020,136856,246,672,136184,Americas
Canada,28-03-2020,246251,243,1105,245146,Americas
Canada,28-03-2020,35728,1571,654,35074,Americas
Canada,28-03-2020,225857,1537,663,225194,Americas
Canada,28-03-2020,226369,1853,270,226099,Americas
Canada,28-03-2020,396266,2401,83,396183,Americas
Canada,28-03-2020,330645,431,1002,329643,Americas
Canada,28-03-2020,346618,550,258,346360,Americas
Central African Republic,28-03-2020,376796,1037,296,376500,Africa
Chad,28-03-2020,33660,317,1172,32488,Africa
Chile,28-03-2020,205270,312,1036,204234,Americas
China,28-03-2020,94350,1656,313,94037,Western Pacific
China,28-03-2020,199321,1085,1238,198083,Western Pacific
China,28-03-2020,11945,1438,912,11033,Western Pacific
China,28-03-2020,94035,1559,645,93390,Western Pacific
China,28-03-2020,384558,1315,508,384050,Western Pacific
China,28-03-2020,102083,561,500,101583,Western Pacific
China,28-03-2020,212955,1884,533,212422,Western Pacific
China,28-03-2020,448667,251,79,448588,Western Pacific
China,28-03-2020,104130,24,637,103493,Western Pacific
China,28-03-2020,338596,2349,609,337987,Western Pacific
China,28-03-2020,10870,2200,1165,9705,Western Pacific
China,28-03-2020,741,1850,850,-109,Western Pacific
China,28-03-2020,311046,2081,188,310858,Western Pacific
China,28-03-2020,406661,1612,151,406510,Western Pacific
China,28-03-2020,158082,440,1224,156858,Western Pacific
China,28-03-2020,46517,272,721,45796,Western Pacific
China,28-03-2020,86713,1670,328,86385,Western Pacific
China,28-03-2020,271155,2259,679,270476,Western Pacific
China,28-03-2020,9884,1920,1199,8685,Western Pacific
China,28-03-2020,77246,925,1217,76029,Western Pacific
China,28-03-2020,317579,2247,583,316996,Western Pacific
China,28-03-2020,126208,752,312,125896,Western Pacific
China,28-03-2020,302654,504,256,302398,Western Pacific
China,28-03-2020,143171,737,437,142734,Western Pacific
China,28-03-2020,112522,781,169,112353,Western Pacific
China,28-03-2020,179292,1695,39,179253,Western Pacific
China,28-03-2020,315516,2349,0,315516,Western Pacific
China,28-03-2020,376890,403,517,376373,Western Pacific
China,28-03-2020,417906,534,115,417791,Western Pacific
China,28-03-2020,106318,2295,55,106263,Western Pacific
China,28-03-2020,59556,1272,425,59131,Western Pacific
China,28-03-2020,37102,1522,1130,35972,Western Pacific
China,28-03-2020,241555,1978,697,240858,Western Pacific
Colombia,28-03-2020,395963,2,238,395725,Americas
Congo (Brazzaville),28-03-2020,405880,2432,883,404997,Africa
Congo (Kinshasa),28-03-2020,267584,1890,1161,266423,Africa
Costa Rica,28-03-2020,338599,332,441,338158,Americas
Cote d'Ivoire,28-03-2020,51419,600,401,51018,Africa
Croatia,28-03-2020,251569,918,382,251187,Europe
Cuba,28-03-2020,91184,2447,1136,90048,Americas
Cyprus,28-03-2020,316119,392,660,315459,Europe
Czechia,28-03-2020,280135,256,483,279652,Europe
Denmark,28-03-2020,54271,949,894,53377,Europe
Greenland,28-03-2020,178111,692,1216,176895,Europe
Denmark,28-03-2020,109737,959,475,109262,Europe
Djibouti,28-03-2020,122225,1552,213,122012,Eastern Mediterranean
Dominican Republic,28-03-2020,260982,98,563,260419,Americas
Ecuador,28-03-2020,359215,187,10,359205,Americas
Egypt,28-03-2020,369109,1358,304,368805,Eastern Mediterranean
El Salvador,28-03-2020,422962,487,867,422095,Americas
Equatorial Guinea,28-03-2020,144159,1829,165,143994,Africa
Eritrea,28-03-2020,299301,2360,1095,298206,Africa
Estonia,28-03-2020,108357,254,82,108275,Europe
Eswatini,28-03-2020,225714,713,1190,224524,Africa
Ethiopia,28-03-2020,373528,513,1138,372390,Africa
Fiji,28-03-2020,343111,680,406,342705,Western Pacific
Finland,28-03-2020,272497,2260,124,272373,Europe
France,28-03-2020,325384,1993,554,324830,Europe
France,28-03-2020,70767,1551,703,70064,Europe
France,28-03-2020,428801,1066,1079,427722,Europe
France,28-03-2020,404112,491,426,403686,Europe
France,28-03-2020,182713,585,1175,181538,Europe
France,28-03-2020,253583,756,1224,252359,Europe
France,28-03-2020,312099,272,637,311462,Europe
France,28-03-2020,338039,498,557,337482,Europe
France,28-03-2020,311766,1397,638,311128,Europe
France,28-03-2020,188483,541,212,188271,Europe
Gabon,28-03-2020,167946,271,652,167294,Africa
Gambia,28-03-2020,295918,140,193,295725,Africa
Georgia,28-03-2020,91467,1905,948,90519,Europe
Germany,28-03-2020,92801,1782,968,91833,Europe
Ghana,28-03-2020,15522,1600,660,14862,Africa
Greece,28-03-2020,419078,1851,1042,418036,Europe
Guatemala,28-03-2020,25445,2357,555,24890,Americas
Guinea,28-03-2020,271864,2336,234,271630,Africa
Guyana,28-03-2020,260741,255,1226,259515,Americas
Haiti,28-03-2020,289559,786,490,289069,Americas
Holy See,28-03-2020,162403,834,807,161596,Europe
Honduras,28-03-2020,298507,2157,786,297721,Americas
Hungary,28-03-2020,389533,2035,1071,388462,Europe
Iceland,28-03-2020,27329,540,671,26658,Europe
India,28-03-2020,38716,23,721,37995,South-East Asia
Indonesia,28-03-2020,23775,1229,884,22891,South-East Asia
Iran,28-03-2020,29241,1844,533,28708,Eastern Mediterranean
Iraq,28-03-2020,17492,2299,658,16834,Eastern Mediterranean
Ireland,28-03-2020,419216,2129,691,418525,Europe
Israel,28-03-2020,54461,438,381,54080,Europe
Italy,28-03-2020,77752,1705,728,77024,Europe
Jamaica,28-03-2020,355211,1810,224,354987,Americas
Japan,28-03-2020,172094,204,376,171718,Western Pacific
Jordan,28-03-2020,367792,48,1108,366684,Eastern Mediterranean
Kazakhstan,28-03-2020,392254,1581,403,391851,Europe
Kenya,28-03-2020,380327,420,704,379623,Africa
South Korea,28-03-2020,407741,932,654,407087,Western Pacific
Kuwait,28-03-2020,153010,241,444,152566,Eastern Mediterranean
Kyrgyzstan,28-03-2020,265826,2331,1165,264661,Europe
Latvia,28-03-2020,158870,872,450,158420,Europe
Lebanon,28-03-2020,172290,761,690,171600,Eastern Mediterranean
Liberia,28-03-2020,159004,2349,60,158944,Africa
Liechtenstein,28-03-2020,429009,2154,197,428812,Europe
Lithuania,28-03-2020,345561,610,928,344633,Europe
Luxembourg,28-03-2020,180561,2144,818,179743,Europe
Madagascar,28-03-2020,226439,2347,1195,225244,Africa
Malaysia,28-03-2020,242130,832,893,241237,Western Pacific
Maldives,28-03-2020,197939,688,406,197533,South-East Asia
Malta,28-03-2020,8167,2307,883,7284,Europe
Mauritania,28-03-2020,40015,2074,1123,38892,Africa
Mauritius,28-03-2020,340570,1900,529,340041,Africa
Mexico,28-03-2020,367214,751,42,367172,Americas
Moldova,28-03-2020,228705,274,886,227819,Europe
Monaco,28-03-2020,200686,301,1225,199461,Europe
Mongolia,28-03-2020,130886,80,555,130331,Western Pacific
Montenegro,28-03-2020,201914,1995,1228,200686,Europe
Morocco,28-03-2020,60019,207,805,59214,Eastern Mediterranean
Namibia,28-03-2020,317648,1448,1155,316493,Africa
Nepal,28-03-2020,339709,2432,336,339373,South-East Asia
Netherlands,28-03-2020,243411,1633,1151,242260,Europe
Netherlands,28-03-2020,384405,1004,214,384191,Europe
Netherlands,28-03-2020,395794,728,1043,394751,Europe
Netherlands,28-03-2020,255695,942,867,254828,Europe
New Zealand,28-03-2020,173193,868,1,173192,Western Pacific
Nicaragua,28-03-2020,438428,1936,992,437436,Americas
Niger,28-03-2020,281590,2118,1006,280584,Africa
Nigeria,28-03-2020,156312,2289,994,155318,Africa
North Macedonia,28-03-2020,432359,651,867,431492,Europe
Norway,28-03-2020,310659,1384,262,310397,Europe
Oman,28-03-2020,155237,2228,967,154270,Eastern Mediterranean
Pakistan,28-03-2020,240692,1784,1048,239644,Eastern Mediterranean
Panama,28-03-2020,8400,704,134,8266,Americas
Papua New Guinea,28-03-2020,51648,1839,309,51339,Western Pacific
Paraguay,28-03-2020,426434,1728,634,425800,Americas
Peru,28-03-2020,78907,815,737,78170,Americas
Philippines,28-03-2020,302561,1102,188,302373,Western Pacific
Poland,28-03-2020,278423,192,691,277732,Europe
Portugal,28-03-2020,169421,1048,140,169281,Europe
Qatar,28-03-2020,137200,1398,899,136301,Eastern Mediterranean
Romania,28-03-2020,448656,1259,498,448158,Europe
Russia,28-03-2020,38203,475,483,37720,Europe
Rwanda,28-03-2020,392804,2391,404,392400,Africa
Saint Lucia,28-03-2020,2704,288,1151,1553,Americas
Saint Vincent and the Grenadines,28-03-2020,362113,1578,683,361430,Americas
San Marino,28-03-2020,292887,631,592,292295,Europe
Saudi Arabia,28-03-2020,174757,2388,306,174451,Eastern Mediterranean
Senegal,28-03-2020,357479,1695,993,356486,Africa
Serbia,28-03-2020,223340,220,1091,222249,Europe
Seychelles,28-03-2020,104444,576,1069,103375,Africa
Singapore,28-03-2020,155227,1782,43,155184,Western Pacific
Slovakia,28-03-2020,1416,2374,203,1213,Europe
Slovenia,28-03-2020,62683,524,1159,61524,Europe
Somalia,28-03-2020,252157,545,531,251626,Eastern Mediterranean
South Africa,28-03-2020,89782,1553,262,89520,Africa
Spain,28-03-2020,25992,715,999,24993,Europe
Sri Lanka,28-03-2020,46832,1445,341,46491,South-East Asia
Sudan,28-03-2020,353371,56,499,352872,Eastern Mediterranean
Suriname,28-03-2020,49631,2375,1048,48583,Americas
Sweden,28-03-2020,154407,1894,613,153794,Europe
Switzerland,28-03-2020,26602,205,538,26064,Europe
Taiwan*,28-03-2020,212133,1096,766,211367,Western Pacific
Tanzania,28-03-2020,249947,536,2,249945,Africa
Thailand,28-03-2020,221713,1974,666,221047,South-East Asia
Togo,28-03-2020,109673,1352,698,108975,Africa
Trinidad and Tobago,28-03-2020,190565,298,704,189861,Americas
Tunisia,28-03-2020,412767,2285,588,412179,Eastern Mediterranean
Turkey,28-03-2020,355151,655,127,355024,Europe
Uganda,28-03-2020,34012,2108,991,33021,Africa
Ukraine,28-03-2020,350049,2355,370,349679,Europe
United Arab Emirates,28-03-2020,158352,304,918,157434,Eastern Mediterranean
United Kingdom,28-03-2020,278987,440,1234,277753,Europe
United Kingdom,28-03-2020,246267,498,874,245393,Europe
United Kingdom,28-03-2020,435099,110,646,434453,Europe
United Kingdom,28-03-2020,380728,354,74,380654,Europe
United Kingdom,28-03-2020,346065,2346,58,346007,Europe
United Kingdom,28-03-2020,93277,2301,151,93126,Europe
United Kingdom,28-03-2020,260807,1674,1156,259651,Europe
Uruguay,28-03-2020,321792,1990,758,321034,Americas
US,28-03-2020,7798,79,164,7634,Americas
Uzbekistan,28-03-2020,162633,260,828,161805,Europe
Venezuela,28-03-2020,425695,1929,1207,424488,Americas
Vietnam,28-03-2020,155871,1309,256,155615,Western Pacific
Zambia,28-03-2020,379491,895,994,378497,Africa
Zimbabwe,28-03-2020,110182,1524,318,109864,Africa
Dominica,28-03-2020,217778,942,510,217268,Americas
Grenada,28-03-2020,445582,1364,191,445391,Americas
Mozambique,28-03-2020,157380,1691,845,156535,Africa
Syria,28-03-2020,43660,790,430,43230,Eastern Mediterranean
Timor-Leste,28-03-2020,299496,1347,362,299134,South-East Asia
Belize,28-03-2020,162322,996,959,161363,Americas
Laos,28-03-2020,99428,813,726,98702,Western Pacific
Libya,28-03-2020,76423,466,368,76055,Eastern Mediterranean
West Bank and Gaza,28-03-2020,210711,1679,1245,209466,Eastern Mediterranean
Guinea-Bissau,28-03-2020,42130,1805,91,42039,Africa
Mali,28-03-2020,91820,774,616,91204,Africa
Saint Kitts and Nevis,28-03-2020,199499,2290,827,198672,Americas
Canada,28-03-2020,225490,1013,979,224511,Americas
Canada,28-03-2020,83752,1754,1132,82620,Americas
Kosovo,28-03-2020,207786,85,663,207123,Europe
Burma,28-03-2020,329072,2299,153,328919,South-East Asia
United Kingdom,28-03-2020,279411,933,944,278467,Europe
United Kingdom,28-03-2020,201908,1457,780,201128,Europe
United Kingdom,28-03-2020,140777,144,724,140053,Europe
Botswana,28-03-2020,444336,168,1088,443248,Africa
Burundi,28-03-2020,292755,1287,872,291883,Africa
Sierra Leone,28-03-2020,377250,1215,451,376799,Africa
Malawi,28-03-2020,53409,1107,547,52862,Africa
United Kingdom,28-03-2020,46456,761,157,46299,Europe
France,28-03-2020,83600,1158,514,83086,Europe
South Sudan,28-03-2020,146476,1922,833,145643,Africa
Western Sahara,28-03-2020,56476,237,51,56425,Africa
Sao Tome and Principe,28-03-2020,435274,588,489,434785,Africa
Yemen,28-03-2020,367042,1982,545,366497,Eastern Mediterranean
Comoros,28-03-2020,305542,485,48,305494,Africa
Tajikistan,28-03-2020,26338,1861,788,25550,Europe
Lesotho,28-03-2020,47092,1665,1197,45895,Africa
Afghanistan,29-03-2020,247722,1297,1203,246519,Eastern Mediterranean
Albania,29-03-2020,282448,287,992,281456,Europe
Algeria,29-03-2020,358874,2274,1213,357661,Africa
Andorra,29-03-2020,100796,2361,696,100100,Europe
Angola,29-03-2020,90116,2446,1243,88873,Africa
Antigua and Barbuda,29-03-2020,407296,666,542,406754,Americas
Argentina,29-03-2020,367613,744,761,366852,Americas
Armenia,29-03-2020,213110,942,308,212802,Europe
Australia,29-03-2020,445427,1246,521,444906,Western Pacific
Australia,29-03-2020,19082,1604,786,18296,Western Pacific
Australia,29-03-2020,207546,1921,289,207257,Western Pacific
Australia,29-03-2020,276637,819,8,276629,Western Pacific
Australia,29-03-2020,312228,1956,341,311887,Western Pacific
Australia,29-03-2020,90178,1408,1027,89151,Western Pacific
Australia,29-03-2020,381910,729,371,381539,Western Pacific
Australia,29-03-2020,296926,1688,1213,295713,Western Pacific
Austria,29-03-2020,181235,546,393,180842,Europe
Azerbaijan,29-03-2020,112865,109,477,112388,Europe
Bahamas,29-03-2020,374979,1179,490,374489,Americas
Bahrain,29-03-2020,200144,1141,1089,199055,Eastern Mediterranean
Bangladesh,29-03-2020,31241,1057,1135,30106,South-East Asia
Barbados,29-03-2020,343886,2051,833,343053,Americas
Belarus,29-03-2020,131423,1764,819,130604,Europe
Belgium,29-03-2020,134497,1625,824,133673,Europe
Benin,29-03-2020,355319,1619,466,354853,Africa
Bhutan,29-03-2020,367153,2207,456,366697,South-East Asia
Bolivia,29-03-2020,139519,1462,507,139012,Americas
Bosnia and Herzegovina,29-03-2020,349097,1854,813,348284,Europe
Brazil,29-03-2020,191100,1008,1177,189923,Americas
Brunei,29-03-2020,233391,1434,654,232737,Western Pacific
Bulgaria,29-03-2020,273024,389,900,272124,Europe
Burkina Faso,29-03-2020,145665,1426,433,145232,Africa
Cabo Verde,29-03-2020,192846,1764,946,191900,Africa
Cambodia,29-03-2020,310673,2355,1121,309552,Western Pacific
Cameroon,29-03-2020,158954,432,361,158593,Africa
Canada,29-03-2020,209035,2093,253,208782,Americas
Canada,29-03-2020,95382,767,893,94489,Americas
Canada,29-03-2020,299571,1904,302,299269,Americas
Canada,29-03-2020,82561,1422,1154,81407,Americas
Canada,29-03-2020,105629,6,621,105008,Americas
Canada,29-03-2020,15848,623,778,15070,Americas
Canada,29-03-2020,69790,960,1053,68737,Americas
Canada,29-03-2020,416134,2198,1095,415039,Americas
Canada,29-03-2020,449258,847,1047,448211,Americas
Canada,29-03-2020,385298,545,970,384328,Americas
Central African Republic,29-03-2020,347820,685,901,346919,Africa
Chad,29-03-2020,277459,1600,1019,276440,Africa
Chile,29-03-2020,158499,1551,22,158477,Americas
China,29-03-2020,176590,218,414,176176,Western Pacific
China,29-03-2020,90976,2234,628,90348,Western Pacific
China,29-03-2020,212924,2432,602,212322,Western Pacific
China,29-03-2020,169832,428,34,169798,Western Pacific
China,29-03-2020,246447,2076,826,245621,Western Pacific
China,29-03-2020,377262,1032,911,376351,Western Pacific
China,29-03-2020,66941,2219,152,66789,Western Pacific
China,29-03-2020,417730,637,913,416817,Western Pacific
China,29-03-2020,43588,533,801,42787,Western Pacific
China,29-03-2020,366765,1092,995,365770,Western Pacific
China,29-03-2020,60123,827,954,59169,Western Pacific
China,29-03-2020,406732,2125,464,406268,Western Pacific
China,29-03-2020,275127,22,121,275006,Western Pacific
China,29-03-2020,35462,1943,792,34670,Western Pacific
China,29-03-2020,207116,2413,822,206294,Western Pacific
China,29-03-2020,123112,972,200,122912,Western Pacific
China,29-03-2020,284020,2114,499,283521,Western Pacific
China,29-03-2020,373085,1464,55,373030,Western Pacific
China,29-03-2020,286417,2251,471,285946,Western Pacific
China,29-03-2020,244072,185,622,243450,Western Pacific
China,29-03-2020,326446,148,595,325851,Western Pacific
China,29-03-2020,211046,2086,163,210883,Western Pacific
China,29-03-2020,156465,601,1196,155269,Western Pacific
China,29-03-2020,410470,846,0,410470,Western Pacific
China,29-03-2020,131702,946,1189,130513,Western Pacific
China,29-03-2020,257099,1335,717,256382,Western Pacific
China,29-03-2020,416516,743,909,415607,Western Pacific
China,29-03-2020,48656,1744,507,48149,Western Pacific
China,29-03-2020,391410,59,98,391312,Western Pacific
China,29-03-2020,128320,816,857,127463,Western Pacific
China,29-03-2020,127031,791,1093,125938,Western Pacific
China,29-03-2020,15874,492,343,15531,Western Pacific
China,29-03-2020,313963,433,1043,312920,Western Pacific
Colombia,29-03-2020,108373,190,650,107723,Americas
Congo (Brazzaville),29-03-2020,306253,136,1222,305031,Africa
Congo (Kinshasa),29-03-2020,214243,491,107,214136,Africa
Costa Rica,29-03-2020,433556,2181,46,433510,Americas
Cote d'Ivoire,29-03-2020,62297,451,11,62286,Africa
Croatia,29-03-2020,283010,980,299,282711,Europe
Cuba,29-03-2020,275780,487,537,275243,Americas
Cyprus,29-03-2020,254878,2370,844,254034,Europe
Czechia,29-03-2020,70822,964,208,70614,Europe
Denmark,29-03-2020,312987,2295,1056,311931,Europe
Greenland,29-03-2020,188968,981,990,187978,Europe
Denmark,29-03-2020,24649,632,1003,23646,Europe
Djibouti,29-03-2020,256182,875,1013,255169,Eastern Mediterranean
Dominican Republic,29-03-2020,125192,1793,60,125132,Americas
Ecuador,29-03-2020,310874,2130,281,310593,Americas
Egypt,29-03-2020,310264,1578,315,309949,Eastern Mediterranean
El Salvador,29-03-2020,251871,1209,42,251829,Americas
Equatorial Guinea,29-03-2020,86975,1635,678,86297,Africa
Eritrea,29-03-2020,273710,1077,34,273676,Africa
Estonia,29-03-2020,252930,2156,466,252464,Europe
Eswatini,29-03-2020,40303,357,672,39631,Africa
Ethiopia,29-03-2020,178372,694,493,177879,Africa
Fiji,29-03-2020,163063,2196,72,162991,Western Pacific
Finland,29-03-2020,315874,886,958,314916,Europe
France,29-03-2020,280212,640,539,279673,Europe
France,29-03-2020,250904,1315,568,250336,Europe
France,29-03-2020,141728,1079,992,140736,Europe
France,29-03-2020,242642,2098,313,242329,Europe
France,29-03-2020,61923,1124,767,61156,Europe
France,29-03-2020,185777,1341,585,185192,Europe
France,29-03-2020,381423,296,149,381274,Europe
France,29-03-2020,216131,1237,612,215519,Europe
France,29-03-2020,447436,1250,804,446632,Europe
France,29-03-2020,110252,721,773,109479,Europe
Gabon,29-03-2020,200491,589,649,199842,Africa
Gambia,29-03-2020,181168,1753,156,181012,Africa
Georgia,29-03-2020,37235,1118,579,36656,Europe
Germany,29-03-2020,132013,1273,614,131399,Europe
Ghana,29-03-2020,248886,1770,259,248627,Africa
Greece,29-03-2020,140568,1535,1237,139331,Europe
Guatemala,29-03-2020,261104,584,763,260341,Americas
Guinea,29-03-2020,309817,634,1122,308695,Africa
Guyana,29-03-2020,108455,235,1152,107303,Americas
Haiti,29-03-2020,314711,1153,135,314576,Americas
Holy See,29-03-2020,266839,1582,239,266600,Europe
Honduras,29-03-2020,223205,1503,570,222635,Americas
Hungary,29-03-2020,88791,113,791,88000,Europe
Iceland,29-03-2020,211436,626,711,210725,Europe
India,29-03-2020,43092,1933,344,42748,South-East Asia
Indonesia,29-03-2020,248974,786,693,248281,South-East Asia
Iran,29-03-2020,319014,144,1227,317787,Eastern Mediterranean
Iraq,29-03-2020,302990,2041,902,302088,Eastern Mediterranean
Ireland,29-03-2020,311783,2455,114,311669,Europe
Israel,29-03-2020,382541,1781,1185,381356,Europe
Italy,29-03-2020,371400,1497,1236,370164,Europe
Jamaica,29-03-2020,134788,771,730,134058,Americas
Japan,29-03-2020,40832,1878,6,40826,Western Pacific
Jordan,29-03-2020,389524,1031,1098,388426,Eastern Mediterranean
Kazakhstan,29-03-2020,405289,2175,957,404332,Europe
Kenya,29-03-2020,321874,1987,5,321869,Africa
South Korea,29-03-2020,303926,959,1060,302866,Western Pacific
Kuwait,29-03-2020,274291,2387,1054,273237,Eastern Mediterranean
Kyrgyzstan,29-03-2020,352591,58,639,351952,Europe
Latvia,29-03-2020,122997,366,945,122052,Europe
Lebanon,29-03-2020,68906,1608,886,68020,Eastern Mediterranean
Liberia,29-03-2020,190545,2124,779,189766,Africa
Liechtenstein,29-03-2020,183605,110,1110,182495,Europe
Lithuania,29-03-2020,19312,1240,67,19245,Europe
Luxembourg,29-03-2020,17629,608,800,16829,Europe
Madagascar,29-03-2020,230683,226,82,230601,Africa
Malaysia,29-03-2020,60309,2188,1134,59175,Western Pacific
Maldives,29-03-2020,313313,938,255,313058,South-East Asia
Malta,29-03-2020,50515,605,634,49881,Europe
Mauritania,29-03-2020,186365,422,501,185864,Africa
Mauritius,29-03-2020,237971,2111,328,237643,Africa
Mexico,29-03-2020,114826,851,926,113900,Americas
Moldova,29-03-2020,167285,1855,839,166446,Europe
Monaco,29-03-2020,249609,300,196,249413,Europe
Mongolia,29-03-2020,384464,112,224,384240,Western Pacific
Montenegro,29-03-2020,316646,525,197,316449,Europe
Morocco,29-03-2020,384500,2212,602,383898,Eastern Mediterranean
Namibia,29-03-2020,293007,1468,587,292420,Africa
Nepal,29-03-2020,440711,773,220,440491,South-East Asia
Netherlands,29-03-2020,151699,1072,340,151359,Europe
Netherlands,29-03-2020,365022,1519,526,364496,Europe
Netherlands,29-03-2020,94858,1940,643,94215,Europe
Netherlands,29-03-2020,60214,1753,1103,59111,Europe
New Zealand,29-03-2020,397393,699,1037,396356,Western Pacific
Nicaragua,29-03-2020,441131,905,220,440911,Americas
Niger,29-03-2020,60829,904,211,60618,Africa
Nigeria,29-03-2020,375870,930,492,375378,Africa
North Macedonia,29-03-2020,394672,943,15,394657,Europe
Norway,29-03-2020,38534,537,10,38524,Europe
Oman,29-03-2020,182106,2250,1111,180995,Eastern Mediterranean
Pakistan,29-03-2020,376745,1882,161,376584,Eastern Mediterranean
Panama,29-03-2020,27007,1539,37,26970,Americas
Papua New Guinea,29-03-2020,1042,1391,954,88,Western Pacific
Paraguay,29-03-2020,153272,823,389,152883,Americas
Peru,29-03-2020,126454,1872,734,125720,Americas
Philippines,29-03-2020,93118,2062,709,92409,Western Pacific
Poland,29-03-2020,24390,1384,651,23739,Europe
Portugal,29-03-2020,134656,2439,211,134445,Europe
Qatar,29-03-2020,203409,1711,293,203116,Eastern Mediterranean
Romania,29-03-2020,41008,186,795,40213,Europe
Russia,29-03-2020,303708,515,674,303034,Europe
Rwanda,29-03-2020,441842,1816,965,440877,Africa
Saint Lucia,29-03-2020,370483,92,1200,369283,Americas
Saint Vincent and the Grenadines,29-03-2020,23324,946,679,22645,Americas
San Marino,29-03-2020,292940,1884,749,292191,Europe
Saudi Arabia,29-03-2020,350683,543,317,350366,Eastern Mediterranean
Senegal,29-03-2020,234930,637,523,234407,Africa
Serbia,29-03-2020,352275,332,1176,351099,Europe
Seychelles,29-03-2020,311405,1728,1065,310340,Africa
Singapore,29-03-2020,203150,1858,53,203097,Western Pacific
Slovakia,29-03-2020,342141,819,784,341357,Europe
Slovenia,29-03-2020,69139,715,1217,67922,Europe
Somalia,29-03-2020,350347,2276,424,349923,Eastern Mediterranean
South Africa,29-03-2020,243663,2273,634,243029,Africa
Spain,29-03-2020,301121,2424,761,300360,Europe
Sri Lanka,29-03-2020,74268,2340,586,73682,South-East Asia
Sudan,29-03-2020,383177,830,150,383027,Eastern Mediterranean
Suriname,29-03-2020,113505,1841,1034,112471,Americas
Sweden,29-03-2020,190874,2203,401,190473,Europe
Switzerland,29-03-2020,314166,1017,984,313182,Europe
Taiwan*,29-03-2020,127169,1161,576,126593,Western Pacific
Tanzania,29-03-2020,335095,732,737,334358,Africa
Thailand,29-03-2020,269056,853,315,268741,South-East Asia
Togo,29-03-2020,117683,1078,172,117511,Africa
Trinidad and Tobago,29-03-2020,305833,1287,1049,304784,Americas
Tunisia,29-03-2020,449379,1263,98,449281,Eastern Mediterranean
Turkey,29-03-2020,20146,1103,243,19903,Europe
Uganda,29-03-2020,245738,1904,582,245156,Africa
Ukraine,29-03-2020,125001,599,497,124504,Europe
United Arab Emirates,29-03-2020,404656,39,1099,403557,Eastern Mediterranean
United Kingdom,29-03-2020,225018,515,718,224300,Europe
United Kingdom,29-03-2020,325055,1694,579,324476,Europe
United Kingdom,29-03-2020,54670,1339,503,54167,Europe
United Kingdom,29-03-2020,223249,1785,284,222965,Europe
United Kingdom,29-03-2020,301428,1352,666,300762,Europe
United Kingdom,29-03-2020,8425,1899,339,8086,Europe
United Kingdom,29-03-2020,351530,1739,985,350545,Europe
Uruguay,29-03-2020,327795,1402,1101,326694,Americas
US,29-03-2020,296050,2140,655,295395,Americas
Uzbekistan,29-03-2020,325451,1027,1021,324430,Europe
Venezuela,29-03-2020,57794,904,634,57160,Americas
Vietnam,29-03-2020,238960,1190,66,238894,Western Pacific
Zambia,29-03-2020,283727,497,845,282882,Africa
Zimbabwe,29-03-2020,93528,2430,888,92640,Africa
Dominica,29-03-2020,393755,1162,680,393075,Americas
Grenada,29-03-2020,303868,2333,1177,302691,Americas
Mozambique,29-03-2020,161778,2102,469,161309,Africa
Syria,29-03-2020,414220,2423,454,413766,Eastern Mediterranean
Timor-Leste,29-03-2020,198173,1038,1165,197008,South-East Asia
Belize,29-03-2020,242421,258,1198,241223,Americas
Laos,29-03-2020,232436,1940,521,231915,Western Pacific
Libya,29-03-2020,321866,802,441,321425,Eastern Mediterranean
West Bank and Gaza,29-03-2020,405357,2077,256,405101,Eastern Mediterranean
Guinea-Bissau,29-03-2020,381669,2164,902,380767,Africa
Mali,29-03-2020,347211,1475,1135,346076,Africa
Saint Kitts and Nevis,29-03-2020,374262,1074,1074,373188,Americas
Canada,29-03-2020,87489,2117,746,86743,Americas
Canada,29-03-2020,327463,969,804,326659,Americas
Kosovo,29-03-2020,2878,1255,966,1912,Europe
Burma,29-03-2020,137259,1735,614,136645,South-East Asia
United Kingdom,29-03-2020,320286,826,780,319506,Europe
United Kingdom,29-03-2020,431443,403,413,431030,Europe
United Kingdom,29-03-2020,165801,87,868,164933,Europe
Botswana,29-03-2020,324036,2449,1084,322952,Africa
Burundi,29-03-2020,362770,1489,342,362428,Africa
Sierra Leone,29-03-2020,12376,188,1132,11244,Africa
Malawi,29-03-2020,268169,827,409,267760,Africa
United Kingdom,29-03-2020,285037,436,731,284306,Europe
France,29-03-2020,396870,141,1087,395783,Europe
South Sudan,29-03-2020,101404,1348,534,100870,Africa
Western Sahara,29-03-2020,311826,1889,1051,310775,Africa
Sao Tome and Principe,29-03-2020,363972,220,869,363103,Africa
Yemen,29-03-2020,132333,1379,1076,131257,Eastern Mediterranean
Comoros,29-03-2020,170135,502,1134,169001,Africa
Tajikistan,29-03-2020,840,394,528,312,Europe
Lesotho,29-03-2020,344613,1930,776,343837,Africa
Afghanistan,30-03-2020,351002,1638,153,350849,Eastern Mediterranean
Albania,30-03-2020,405052,1327,60,404992,Europe
Algeria,30-03-2020,294155,1326,1222,292933,Africa
Andorra,30-03-2020,241613,1001,641,240972,Europe
Angola,30-03-2020,432918,709,1165,431753,Africa
Antigua and Barbuda,30-03-2020,30750,2287,1186,29564,Americas
Argentina,30-03-2020,190973,1148,1032,189941,Americas
Armenia,30-03-2020,79269,2172,606,78663,Europe
Australia,30-03-2020,434488,230,555,433933,Western Pacific
Australia,30-03-2020,434135,1901,657,433478,Western Pacific
Australia,30-03-2020,249225,1283,298,248927,Western Pacific
Australia,30-03-2020,212893,479,1045,211848,Western Pacific
Australia,30-03-2020,424303,389,1237,423066,Western Pacific
Australia,30-03-2020,224974,2202,953,224021,Western Pacific
Australia,30-03-2020,71114,2040,183,70931,Western Pacific
Australia,30-03-2020,138894,1053,517,138377,Western Pacific
Austria,30-03-2020,18525,666,1226,17299,Europe
Azerbaijan,30-03-2020,317109,470,1190,315919,Europe
Bahamas,30-03-2020,6413,1193,935,5478,Americas
Bahrain,30-03-2020,108281,1539,902,107379,Eastern Mediterranean
Bangladesh,30-03-2020,399735,241,1183,398552,South-East Asia
Barbados,30-03-2020,136342,1300,987,135355,Americas
Belarus,30-03-2020,9251,846,284,8967,Europe
Belgium,30-03-2020,268059,1799,935,267124,Europe
Benin,30-03-2020,233121,571,1029,232092,Africa
Bhutan,30-03-2020,263267,35,1239,262028,South-East Asia
Bolivia,30-03-2020,94775,678,300,94475,Americas
Bosnia and Herzegovina,30-03-2020,447133,2157,883,446250,Europe
Brazil,30-03-2020,400326,816,1101,399225,Americas
Brunei,30-03-2020,315449,1076,1085,314364,Western Pacific
Bulgaria,30-03-2020,280009,155,1108,278901,Europe
Burkina Faso,30-03-2020,241669,2429,462,241207,Africa
Cabo Verde,30-03-2020,106486,1292,355,106131,Africa
Cambodia,30-03-2020,268794,1274,629,268165,Western Pacific
Cameroon,30-03-2020,165493,368,1160,164333,Africa
Canada,30-03-2020,303374,601,388,302986,Americas
Canada,30-03-2020,362106,2146,385,361721,Americas
Canada,30-03-2020,378051,385,344,377707,Americas
Canada,30-03-2020,71328,1061,334,70994,Americas
Canada,30-03-2020,225994,1250,926,225068,Americas
Canada,30-03-2020,449393,1381,777,448616,Americas
Canada,30-03-2020,336749,2051,1236,335513,Americas
Canada,30-03-2020,48189,1967,260,47929,Americas
Canada,30-03-2020,99588,170,512,99076,Americas
Canada,30-03-2020,149003,213,102,148901,Americas
Central African Republic,30-03-2020,204341,2184,987,203354,Africa
Chad,30-03-2020,351332,60,43,351289,Africa
Chile,30-03-2020,32807,398,659,32148,Americas
China,30-03-2020,311076,1213,1135,309941,Western Pacific
China,30-03-2020,382169,1995,620,381549,Western Pacific
China,30-03-2020,321784,1339,1019,320765,Western Pacific
China,30-03-2020,233848,1031,832,233016,Western Pacific
China,30-03-2020,143898,1351,1083,142815,Western Pacific
China,30-03-2020,338838,1963,1168,337670,Western Pacific
China,30-03-2020,392086,889,644,391442,Western Pacific
China,30-03-2020,116065,985,945,115120,Western Pacific
China,30-03-2020,209137,400,340,208797,Western Pacific
China,30-03-2020,156690,1020,27,156663,Western Pacific
China,30-03-2020,206335,1294,291,206044,Western Pacific
China,30-03-2020,339378,1283,330,339048,Western Pacific
China,30-03-2020,183974,1060,728,183246,Western Pacific
China,30-03-2020,200210,699,1068,199142,Western Pacific
China,30-03-2020,395353,1783,1208,394145,Western Pacific
China,30-03-2020,300474,140,738,299736,Western Pacific
China,30-03-2020,256199,2318,690,255509,Western Pacific
China,30-03-2020,298450,2006,699,297751,Western Pacific
China,30-03-2020,339244,1979,939,338305,Western Pacific
China,30-03-2020,266367,1229,169,266198,Western Pacific
China,30-03-2020,176849,809,1184,175665,Western Pacific
China,30-03-2020,335164,113,1216,333948,Western Pacific
China,30-03-2020,273722,384,847,272875,Western Pacific
China,30-03-2020,49797,1556,964,48833,Western Pacific
China,30-03-2020,413082,490,432,412650,Western Pacific
China,30-03-2020,54438,2486,613,53825,Western Pacific
China,30-03-2020,38531,753,156,38375,Western Pacific
China,30-03-2020,231376,1563,860,230516,Western Pacific
China,30-03-2020,218884,1240,214,218670,Western Pacific
China,30-03-2020,114200,641,272,113928,Western Pacific
China,30-03-2020,265257,1969,859,264398,Western Pacific
China,30-03-2020,34804,655,727,34077,Western Pacific
China,30-03-2020,255249,1842,448,254801,Western Pacific
Colombia,30-03-2020,28438,424,734,27704,Americas
Congo (Brazzaville),30-03-2020,364895,1190,1172,363723,Africa
Congo (Kinshasa),30-03-2020,289132,93,1206,287926,Africa
Costa Rica,30-03-2020,229222,1200,308,228914,Americas
Cote d'Ivoire,30-03-2020,297495,1992,60,297435,Africa
Croatia,30-03-2020,302717,2452,532,302185,Europe
Cuba,30-03-2020,65398,1365,876,64522,Americas
Cyprus,30-03-2020,213288,1406,881,212407,Europe
Czechia,30-03-2020,120623,2240,1179,119444,Europe
Denmark,30-03-2020,369578,1302,696,368882,Europe
Greenland,30-03-2020,273597,361,1129,272468,Europe
Denmark,30-03-2020,301845,953,13,301832,Europe
Djibouti,30-03-2020,18726,799,862,17864,Eastern Mediterranean
Dominican Republic,30-03-2020,61695,2248,103,61592,Americas
Ecuador,30-03-2020,142433,2437,778,141655,Americas
Egypt,30-03-2020,61702,114,736,60966,Eastern Mediterranean
El Salvador,30-03-2020,110754,2256,920,109834,Americas
Equatorial Guinea,30-03-2020,82598,2194,1096,81502,Africa
Eritrea,30-03-2020,416026,1400,968,415058,Africa
Estonia,30-03-2020,68853,2071,38,68815,Europe
Eswatini,30-03-2020,40291,1973,99,40192,Africa
Ethiopia,30-03-2020,77473,68,330,77143,Africa
Fiji,30-03-2020,276271,1241,962,275309,Western Pacific
Finland,30-03-2020,117095,841,1205,115890,Europe
France,30-03-2020,185184,2165,888,184296,Europe
France,30-03-2020,192435,1888,768,191667,Europe
France,30-03-2020,209059,2367,663,208396,Europe
France,30-03-2020,420777,2151,1045,419732,Europe
France,30-03-2020,268394,1318,483,267911,Europe
France,30-03-2020,353545,967,789,352756,Europe
France,30-03-2020,369283,801,543,368740,Europe
France,30-03-2020,412031,255,832,411199,Europe
France,30-03-2020,396051,113,95,395956,Europe
France,30-03-2020,112608,321,1109,111499,Europe
Gabon,30-03-2020,443759,1229,611,443148,Africa
Gambia,30-03-2020,430463,1891,652,429811,Africa
Georgia,30-03-2020,109674,1441,36,109638,Europe
Germany,30-03-2020,277703,1394,713,276990,Europe
Ghana,30-03-2020,367205,395,652,366553,Africa
Greece,30-03-2020,112660,727,1152,111508,Europe
Guatemala,30-03-2020,51150,726,896,50254,Americas
Guinea,30-03-2020,173136,544,551,172585,Africa
Guyana,30-03-2020,345474,1170,190,345284,Americas
Haiti,30-03-2020,42075,2116,126,41949,Americas
Holy See,30-03-2020,95272,1704,562,94710,Europe
Honduras,30-03-2020,400066,284,1047,399019,Americas
Hungary,30-03-2020,139984,1556,458,139526,Europe
Iceland,30-03-2020,138703,753,511,138192,Europe
India,30-03-2020,333830,988,123,333707,South-East Asia
Indonesia,30-03-2020,14618,1643,223,14395,South-East Asia
Iran,30-03-2020,306356,1292,935,305421,Eastern Mediterranean
Iraq,30-03-2020,372789,1467,827,371962,Eastern Mediterranean
Ireland,30-03-2020,341316,295,1191,340125,Europe
Israel,30-03-2020,115033,2107,402,114631,Europe
Italy,30-03-2020,87776,1141,285,87491,Europe
Jamaica,30-03-2020,14830,1475,26,14804,Americas
Japan,30-03-2020,205354,2023,913,204441,Western Pacific
Jordan,30-03-2020,331231,1075,60,331171,Eastern Mediterranean
Kazakhstan,30-03-2020,79953,2176,791,79162,Europe
Kenya,30-03-2020,125890,1218,1167,124723,Africa
South Korea,30-03-2020,32248,1128,302,31946,Western Pacific
Kuwait,30-03-2020,102750,2169,636,102114,Eastern Mediterranean
Kyrgyzstan,30-03-2020,43346,165,1159,42187,Europe
Latvia,30-03-2020,121725,1206,343,121382,Europe
Lebanon,30-03-2020,199458,1465,915,198543,Eastern Mediterranean
Liberia,30-03-2020,294245,1167,448,293797,Africa
Liechtenstein,30-03-2020,430284,317,1233,429051,Europe
Lithuania,30-03-2020,319616,2380,668,318948,Europe
Luxembourg,30-03-2020,5088,863,222,4866,Europe
Madagascar,30-03-2020,91909,1650,622,91287,Africa
Malaysia,30-03-2020,340409,1967,173,340236,Western Pacific
Maldives,30-03-2020,67208,1864,370,66838,South-East Asia
Malta,30-03-2020,312012,12,391,311621,Europe
Mauritania,30-03-2020,223770,2268,1094,222676,Africa
Mauritius,30-03-2020,7299,70,1042,6257,Africa
Mexico,30-03-2020,335933,1543,231,335702,Americas
Moldova,30-03-2020,201056,978,646,200410,Europe
Monaco,30-03-2020,300609,300,496,300113,Europe
Mongolia,30-03-2020,36409,436,282,36127,Western Pacific
Montenegro,30-03-2020,314060,26,981,313079,Europe
Morocco,30-03-2020,282053,2308,1097,280956,Eastern Mediterranean
Namibia,30-03-2020,300957,2320,1113,299844,Africa
Nepal,30-03-2020,204722,1205,1047,203675,South-East Asia
Netherlands,30-03-2020,7081,523,361,6720,Europe
Netherlands,30-03-2020,71951,1825,266,71685,Europe
Netherlands,30-03-2020,229584,479,1203,228381,Europe
Netherlands,30-03-2020,163258,592,1075,162183,Europe
New Zealand,30-03-2020,253351,1849,132,253219,Western Pacific
Nicaragua,30-03-2020,300003,2101,955,299048,Americas
Niger,30-03-2020,31700,2454,1211,30489,Africa
Nigeria,30-03-2020,444592,2425,139,444453,Africa
North Macedonia,30-03-2020,162040,1329,906,161134,Europe
Norway,30-03-2020,31982,1465,162,31820,Europe
Oman,30-03-2020,23573,1622,340,23233,Eastern Mediterranean
Pakistan,30-03-2020,39362,1286,837,38525,Eastern Mediterranean
Panama,30-03-2020,345188,808,11,345177,Americas
Papua New Guinea,30-03-2020,304835,1892,1179,303656,Western Pacific
Paraguay,30-03-2020,168271,1520,517,167754,Americas
Peru,30-03-2020,185857,2248,850,185007,Americas
Philippines,30-03-2020,330961,1048,1079,329882,Western Pacific
Poland,30-03-2020,274325,176,434,273891,Europe
Portugal,30-03-2020,309821,722,280,309541,Europe
Qatar,30-03-2020,24573,905,131,24442,Eastern Mediterranean
Romania,30-03-2020,227578,2034,373,227205,Europe
Russia,30-03-2020,137647,1384,469,137178,Europe
Rwanda,30-03-2020,419000,1327,697,418303,Africa
Saint Lucia,30-03-2020,177101,646,132,176969,Americas
Saint Vincent and the Grenadines,30-03-2020,147310,1484,1123,146187,Americas
San Marino,30-03-2020,224885,1543,942,223943,Europe
Saudi Arabia,30-03-2020,410820,1572,475,410345,Eastern Mediterranean
Senegal,30-03-2020,419457,1512,1168,418289,Africa
Serbia,30-03-2020,255364,1943,317,255047,Europe
Seychelles,30-03-2020,58371,1023,586,57785,Africa
Singapore,30-03-2020,18079,1918,806,17273,Western Pacific
Slovakia,30-03-2020,229499,134,1075,228424,Europe
Slovenia,30-03-2020,364908,1268,837,364071,Europe
Somalia,30-03-2020,412616,84,633,411983,Eastern Mediterranean
South Africa,30-03-2020,309690,538,951,308739,Africa
Spain,30-03-2020,252248,2396,804,251444,Europe
Sri Lanka,30-03-2020,199127,592,73,199054,South-East Asia
Sudan,30-03-2020,298452,2115,1006,297446,Eastern Mediterranean
Suriname,30-03-2020,213678,1047,142,213536,Americas
Sweden,30-03-2020,157202,655,1173,156029,Europe
Switzerland,30-03-2020,284567,1514,15,284552,Europe
Taiwan*,30-03-2020,110295,497,666,109629,Western Pacific
Tanzania,30-03-2020,152757,833,1045,151712,Africa
Thailand,30-03-2020,269977,1416,977,269000,South-East Asia
Togo,30-03-2020,316073,973,764,315309,Africa
Trinidad and Tobago,30-03-2020,172440,2150,756,171684,Americas
Tunisia,30-03-2020,368581,1610,1108,367473,Eastern Mediterranean
Turkey,30-03-2020,417402,667,80,417322,Europe
Uganda,30-03-2020,292906,1211,648,292258,Africa
Ukraine,30-03-2020,357714,2430,393,357321,Europe
United Arab Emirates,30-03-2020,61290,148,635,60655,Eastern Mediterranean
United Kingdom,30-03-2020,411349,784,153,411196,Europe
United Kingdom,30-03-2020,206474,1285,801,205673,Europe
United Kingdom,30-03-2020,169276,1162,199,169077,Europe
United Kingdom,30-03-2020,444820,2214,424,444396,Europe
United Kingdom,30-03-2020,231857,2131,941,230916,Europe
United Kingdom,30-03-2020,104284,994,1182,103102,Europe
United Kingdom,30-03-2020,26586,2013,91,26495,Europe
Uruguay,30-03-2020,146904,166,371,146533,Americas
US,30-03-2020,417745,1252,388,417357,Americas
Uzbekistan,30-03-2020,405917,1170,424,405493,Europe
Venezuela,30-03-2020,100740,2089,1043,99697,Americas
Vietnam,30-03-2020,219122,567,1231,217891,Western Pacific
Zambia,30-03-2020,75792,360,1250,74542,Africa
Zimbabwe,30-03-2020,274421,1376,1112,273309,Africa
Dominica,30-03-2020,113643,1656,823,112820,Americas
Grenada,30-03-2020,127979,2275,160,127819,Americas
Mozambique,30-03-2020,179976,1477,13,179963,Africa
Syria,30-03-2020,359091,1980,913,358178,Eastern Mediterranean
Timor-Leste,30-03-2020,202586,112,643,201943,South-East Asia
Belize,30-03-2020,313641,1599,587,313054,Americas
Laos,30-03-2020,195834,1284,255,195579,Western Pacific
Libya,30-03-2020,323135,1794,688,322447,Eastern Mediterranean
West Bank and Gaza,30-03-2020,257047,1064,177,256870,Eastern Mediterranean
Guinea-Bissau,30-03-2020,419874,126,998,418876,Africa
Mali,30-03-2020,216889,2495,125,216764,Africa
Saint Kitts and Nevis,30-03-2020,361402,1873,112,361290,Americas
Canada,30-03-2020,365033,2397,953,364080,Americas
Canada,30-03-2020,164369,1838,79,164290,Americas
Kosovo,30-03-2020,243667,1915,263,243404,Europe
Burma,30-03-2020,275732,906,344,275388,South-East Asia
United Kingdom,30-03-2020,422634,2252,635,421999,Europe
United Kingdom,30-03-2020,60437,1969,129,60308,Europe
United Kingdom,30-03-2020,106387,832,1169,105218,Europe
Botswana,30-03-2020,111860,1171,625,111235,Africa
Burundi,30-03-2020,108828,1458,640,108188,Africa
Sierra Leone,30-03-2020,108010,2009,159,107851,Africa
Malawi,30-03-2020,346993,865,685,346308,Africa
United Kingdom,30-03-2020,234065,273,318,233747,Europe
France,30-03-2020,382902,225,146,382756,Europe
South Sudan,30-03-2020,4527,438,460,4067,Africa
Western Sahara,30-03-2020,297070,2083,139,296931,Africa
Sao Tome and Principe,30-03-2020,414045,1149,779,413266,Africa
Yemen,30-03-2020,348995,1848,1202,347793,Eastern Mediterranean
Comoros,30-03-2020,215285,1594,902,214383,Africa
Tajikistan,30-03-2020,124522,562,788,123734,Europe
Lesotho,30-03-2020,245041,42,106,244935,Africa
Afghanistan,31-03-2020,442234,1932,993,441241,Eastern Mediterranean
Albania,31-03-2020,163591,215,605,162986,Europe
Algeria,31-03-2020,99198,367,1089,98109,Africa
Andorra,31-03-2020,439773,2309,112,439661,Europe
Angola,31-03-2020,221061,706,165,220896,Africa
Antigua and Barbuda,31-03-2020,93215,1343,1023,92192,Americas
Argentina,31-03-2020,256579,1385,140,256439,Americas
Armenia,31-03-2020,35964,1257,749,35215,Europe
Australia,31-03-2020,118833,929,86,118747,Western Pacific
Australia,31-03-2020,251794,1116,654,251140,Western Pacific
Australia,31-03-2020,320058,1277,519,319539,Western Pacific
Australia,31-03-2020,340968,346,22,340946,Western Pacific
Australia,31-03-2020,118733,1722,177,118556,Western Pacific
Australia,31-03-2020,301172,1972,158,301014,Western Pacific
Australia,31-03-2020,40473,170,38,40435,Western Pacific
Australia,31-03-2020,282624,1457,825,281799,Western Pacific
Austria,31-03-2020,255382,1282,440,254942,Europe
Azerbaijan,31-03-2020,122695,1448,624,122071,Europe
Bahamas,31-03-2020,258119,971,1034,257085,Americas
Bahrain,31-03-2020,326586,786,769,325817,Eastern Mediterranean
Bangladesh,31-03-2020,330606,843,507,330099,South-East Asia
Barbados,31-03-2020,407596,687,189,407407,Americas
Belarus,31-03-2020,391719,2273,382,391337,Europe
Belgium,31-03-2020,139232,1791,903,138329,Europe
Benin,31-03-2020,206783,1027,733,206050,Africa
Bhutan,31-03-2020,93897,1655,917,92980,South-East Asia
Bolivia,31-03-2020,64590,286,169,64421,Americas
Bosnia and Herzegovina,31-03-2020,66137,2260,160,65977,Europe
Brazil,31-03-2020,302215,453,1161,301054,Americas
Brunei,31-03-2020,207156,2356,412,206744,Western Pacific
Bulgaria,31-03-2020,379840,1906,531,379309,Europe
Burkina Faso,31-03-2020,448006,946,594,447412,Africa
Cabo Verde,31-03-2020,117908,1986,729,117179,Africa
Cambodia,31-03-2020,165959,1818,110,165849,Western Pacific
Cameroon,31-03-2020,162409,541,731,161678,Africa
Canada,31-03-2020,134590,1503,808,133782,Americas
Canada,31-03-2020,110883,2344,884,109999,Americas
Canada,31-03-2020,302791,2457,317,302474,Americas
Canada,31-03-2020,368627,337,588,368039,Americas
Canada,31-03-2020,159175,1242,1215,157960,Americas
Canada,31-03-2020,140183,869,1086,139097,Americas
Canada,31-03-2020,434382,1718,916,433466,Americas
Canada,31-03-2020,362642,369,55,362587,Americas
Canada,31-03-2020,132591,392,793,131798,Americas
Canada,31-03-2020,307309,1092,208,307101,Americas
Central African Republic,31-03-2020,6031,2007,576,5455,Africa
Chad,31-03-2020,166266,1750,214,166052,Africa
Chile,31-03-2020,291796,2,1234,290562,Americas
China,31-03-2020,145349,215,905,144444,Western Pacific
China,31-03-2020,134809,2014,124,134685,Western Pacific
China,31-03-2020,435822,1509,971,434851,Western Pacific
China,31-03-2020,356186,99,10,356176,Western Pacific
China,31-03-2020,189275,1303,1077,188198,Western Pacific
China,31-03-2020,149530,651,731,148799,Western Pacific
China,31-03-2020,197857,1807,574,197283,Western Pacific
China,31-03-2020,56416,140,133,56283,Western Pacific
China,31-03-2020,3412,994,1035,2377,Western Pacific
China,31-03-2020,393870,1621,325,393545,Western Pacific
China,31-03-2020,74274,1922,808,73466,Western Pacific
China,31-03-2020,206381,1006,1092,205289,Western Pacific
China,31-03-2020,65175,1535,387,64788,Western Pacific
China,31-03-2020,442896,336,144,442752,Western Pacific
China,31-03-2020,324163,201,2,324161,Western Pacific
China,31-03-2020,444148,915,1143,443005,Western Pacific
China,31-03-2020,351702,357,979,350723,Western Pacific
China,31-03-2020,302475,1378,589,301886,Western Pacific
China,31-03-2020,198485,106,177,198308,Western Pacific
China,31-03-2020,41469,1236,238,41231,Western Pacific
China,31-03-2020,359799,1333,404,359395,Western Pacific
China,31-03-2020,322393,1320,455,321938,Western Pacific
China,31-03-2020,379378,980,94,379284,Western Pacific
China,31-03-2020,55078,393,448,54630,Western Pacific
China,31-03-2020,385851,1862,576,385275,Western Pacific
China,31-03-2020,322777,3,1002,321775,Western Pacific
China,31-03-2020,147937,2100,657,147280,Western Pacific
China,31-03-2020,8585,1997,1234,7351,Western Pacific
China,31-03-2020,68732,2448,565,68167,Western Pacific
China,31-03-2020,335630,2447,1044,334586,Western Pacific
China,31-03-2020,293949,1381,1059,292890,Western Pacific
China,31-03-2020,185035,429,220,184815,Western Pacific
China,31-03-2020,161421,2028,648,160773,Western Pacific
Colombia,31-03-2020,390021,982,80,389941,Americas
Congo (Brazzaville),31-03-2020,442292,772,788,441504,Africa
Congo (Kinshasa),31-03-2020,305541,1207,189,305352,Africa
Costa Rica,31-03-2020,421504,1521,47,421457,Americas
Cote d'Ivoire,31-03-2020,55757,1467,1044,54713,Africa
Croatia,31-03-2020,318499,1838,444,318055,Europe
Cuba,31-03-2020,222445,1038,179,222266,Americas
Cyprus,31-03-2020,79632,1042,354,79278,Europe
Czechia,31-03-2020,16096,784,379,15717,Europe
Denmark,31-03-2020,244992,60,1129,243863,Europe
Greenland,31-03-2020,334024,1518,734,333290,Europe
Denmark,31-03-2020,339542,1557,1,339541,Europe
Djibouti,31-03-2020,256764,332,619,256145,Eastern Mediterranean
Dominican Republic,31-03-2020,130801,249,902,129899,Americas
Ecuador,31-03-2020,262874,1017,1083,261791,Americas
Egypt,31-03-2020,101901,1470,371,101530,Eastern Mediterranean
El Salvador,31-03-2020,78774,385,679,78095,Americas
Equatorial Guinea,31-03-2020,38328,2360,389,37939,Africa
Eritrea,31-03-2020,264965,1908,119,264846,Africa
Estonia,31-03-2020,294111,1516,95,294016,Europe
Eswatini,31-03-2020,164130,33,240,163890,Africa
Ethiopia,31-03-2020,290039,1105,396,289643,Africa
Fiji,31-03-2020,347018,1656,388,346630,Western Pacific
Finland,31-03-2020,23331,1268,340,22991,Europe
France,31-03-2020,366613,2179,90,366523,Europe
France,31-03-2020,215524,1285,1242,214282,Europe
France,31-03-2020,215728,1595,1073,214655,Europe
France,31-03-2020,292759,2077,741,292018,Europe
France,31-03-2020,25197,320,1211,23986,Europe
France,31-03-2020,448136,2022,660,447476,Europe
France,31-03-2020,410402,615,480,409922,Europe
France,31-03-2020,361516,2410,123,361393,Europe
France,31-03-2020,53844,948,724,53120,Europe
France,31-03-2020,246409,1671,161,246248,Europe
Gabon,31-03-2020,437782,1413,900,436882,Africa
Gambia,31-03-2020,242119,111,53,242066,Africa
Georgia,31-03-2020,285208,2229,52,285156,Europe
Germany,31-03-2020,412534,195,443,412091,Europe
Ghana,31-03-2020,166558,405,463,166095,Africa
Greece,31-03-2020,317353,391,671,316682,Europe
Guatemala,31-03-2020,208929,726,274,208655,Americas
Guinea,31-03-2020,400807,1346,1016,399791,Africa
Guyana,31-03-2020,207901,292,1162,206739,Americas
Haiti,31-03-2020,432945,348,998,431947,Americas
Holy See,31-03-2020,180000,98,1181,178819,Europe
Honduras,31-03-2020,113639,2013,764,112875,Americas
Hungary,31-03-2020,295262,514,595,294667,Europe
Iceland,31-03-2020,34462,1236,1062,33400,Europe
India,31-03-2020,52776,1238,130,52646,South-East Asia
Indonesia,31-03-2020,213295,1094,1074,212221,South-East Asia
Iran,31-03-2020,375942,2310,963,374979,Eastern Mediterranean
Iraq,31-03-2020,201923,1653,303,201620,Eastern Mediterranean
Ireland,31-03-2020,261366,1903,372,260994,Europe
Israel,31-03-2020,179195,2434,850,178345,Europe
Italy,31-03-2020,332520,1661,381,332139,Europe
Jamaica,31-03-2020,236306,2137,188,236118,Americas
Japan,31-03-2020,237579,963,865,236714,Western Pacific
Jordan,31-03-2020,156797,2469,529,156268,Eastern Mediterranean
Kazakhstan,31-03-2020,243749,461,580,243169,Europe
Kenya,31-03-2020,334592,880,574,334018,Africa
South Korea,31-03-2020,178041,2191,132,177909,Western Pacific
Kuwait,31-03-2020,109441,1968,408,109033,Eastern Mediterranean
Kyrgyzstan,31-03-2020,378184,1882,1191,376993,Europe
Latvia,31-03-2020,25032,278,14,25018,Europe
Lebanon,31-03-2020,227168,1299,493,226675,Eastern Mediterranean
Liberia,31-03-2020,288004,365,540,287464,Africa
Liechtenstein,31-03-2020,168188,1046,313,167875,Europe
Lithuania,31-03-2020,90246,620,1096,89150,Europe
Luxembourg,31-03-2020,198444,1123,1060,197384,Europe
Madagascar,31-03-2020,391344,1756,201,391143,Africa
Malaysia,31-03-2020,70775,1197,94,70681,Western Pacific
Maldives,31-03-2020,305916,242,317,305599,South-East Asia
Malta,31-03-2020,414998,1417,1117,413881,Europe
Mauritania,31-03-2020,311822,1301,964,310858,Africa
Mauritius,31-03-2020,447112,5,449,446663,Africa
Mexico,31-03-2020,389843,1399,1170,388673,Americas
Moldova,31-03-2020,345915,293,340,345575,Europe
Monaco,31-03-2020,446167,704,908,445259,Europe
Mongolia,31-03-2020,276590,401,206,276384,Western Pacific
Montenegro,31-03-2020,109935,2104,413,109522,Europe
Morocco,31-03-2020,321078,620,469,320609,Eastern Mediterranean
Namibia,31-03-2020,429815,1563,463,429352,Africa
Nepal,31-03-2020,131622,854,505,131117,South-East Asia
Netherlands,31-03-2020,115800,1478,773,115027,Europe
Netherlands,31-03-2020,246335,1359,736,245599,Europe
Netherlands,31-03-2020,246173,1944,155,246018,Europe
Netherlands,31-03-2020,16273,2393,884,15389,Europe
New Zealand,31-03-2020,68609,1463,1208,67401,Western Pacific
Nicaragua,31-03-2020,448706,1430,773,447933,Americas
Niger,31-03-2020,365680,1428,1141,364539,Africa
Nigeria,31-03-2020,218580,1406,760,217820,Africa
North Macedonia,31-03-2020,125546,1841,1035,124511,Europe
Norway,31-03-2020,174453,1919,628,173825,Europe
Oman,31-03-2020,93227,2186,630,92597,Eastern Mediterranean
Pakistan,31-03-2020,233428,1011,805,232623,Eastern Mediterranean
Panama,31-03-2020,13098,1422,649,12449,Americas
Papua New Guinea,31-03-2020,387628,2232,269,387359,Western Pacific
Paraguay,31-03-2020,113420,1826,1087,112333,Americas
Peru,31-03-2020,58266,238,721,57545,Americas
Philippines,31-03-2020,315226,971,356,314870,Western Pacific
Poland,31-03-2020,440746,956,1081,439665,Europe
Portugal,31-03-2020,359476,164,46,359430,Europe
Qatar,31-03-2020,211490,1696,363,211127,Eastern Mediterranean
Romania,31-03-2020,233944,902,503,233441,Europe
Russia,31-03-2020,265860,94,718,265142,Europe
Rwanda,31-03-2020,51729,2429,408,51321,Africa
Saint Lucia,31-03-2020,282231,2249,384,281847,Americas
Saint Vincent and the Grenadines,31-03-2020,336016,374,612,335404,Americas
San Marino,31-03-2020,23236,1364,931,22305,Europe
Saudi Arabia,31-03-2020,225014,641,269,224745,Eastern Mediterranean
Senegal,31-03-2020,148767,1417,698,148069,Africa
Serbia,31-03-2020,207955,515,142,207813,Europe
Seychelles,31-03-2020,118874,1109,538,118336,Africa
Singapore,31-03-2020,432961,1469,672,432289,Western Pacific
Slovakia,31-03-2020,304084,1298,31,304053,Europe
Slovenia,31-03-2020,401236,802,173,401063,Europe
Somalia,31-03-2020,66189,253,967,65222,Eastern Mediterranean
South Africa,31-03-2020,245642,1353,421,245221,Africa
Spain,31-03-2020,330902,1233,580,330322,Europe
Sri Lanka,31-03-2020,403916,1616,1138,402778,South-East Asia
Sudan,31-03-2020,47515,561,84,47431,Eastern Mediterranean
Suriname,31-03-2020,426799,1517,187,426612,Americas
Sweden,31-03-2020,120784,842,24,120760,Europe
Switzerland,31-03-2020,178755,863,368,178387,Europe
Taiwan*,31-03-2020,109205,1539,1109,108096,Western Pacific
Tanzania,31-03-2020,255824,2499,385,255439,Africa
Thailand,31-03-2020,87286,58,803,86483,South-East Asia
Togo,31-03-2020,216860,823,838,216022,Africa
Trinidad and Tobago,31-03-2020,372832,893,1237,371595,Americas
Tunisia,31-03-2020,189208,2007,462,188746,Eastern Mediterranean
Turkey,31-03-2020,374131,127,878,373253,Europe
Uganda,31-03-2020,120012,2124,412,119600,Africa
Ukraine,31-03-2020,449472,627,654,448818,Europe
United Arab Emirates,31-03-2020,431321,584,441,430880,Eastern Mediterranean
United Kingdom,31-03-2020,229942,2274,79,229863,Europe
United Kingdom,31-03-2020,75247,1617,59,75188,Europe
United Kingdom,31-03-2020,59682,52,1025,58657,Europe
United Kingdom,31-03-2020,42540,1540,541,41999,Europe
United Kingdom,31-03-2020,434398,1371,103,434295,Europe
United Kingdom,31-03-2020,231611,1286,301,231310,Europe
United Kingdom,31-03-2020,250954,627,477,250477,Europe
Uruguay,31-03-2020,226747,1062,425,226322,Americas
US,31-03-2020,26959,656,654,26305,Americas
Uzbekistan,31-03-2020,241501,291,338,241163,Europe
Venezuela,31-03-2020,270957,586,1239,269718,Americas
Vietnam,31-03-2020,416617,695,907,415710,Western Pacific
Zambia,31-03-2020,138942,446,52,138890,Africa
Zimbabwe,31-03-2020,36258,2432,462,35796,Africa
Dominica,31-03-2020,352008,1104,407,351601,Americas
Grenada,31-03-2020,39630,854,921,38709,Americas
Mozambique,31-03-2020,70452,156,876,69576,Africa
Syria,31-03-2020,289844,296,1091,288753,Eastern Mediterranean
Timor-Leste,31-03-2020,135874,321,243,135631,South-East Asia
Belize,31-03-2020,405317,1461,638,404679,Americas
Laos,31-03-2020,24072,1337,738,23334,Western Pacific
Libya,31-03-2020,303396,989,611,302785,Eastern Mediterranean
West Bank and Gaza,31-03-2020,92160,1729,320,91840,Eastern Mediterranean
Guinea-Bissau,31-03-2020,32468,1392,874,31594,Africa
Mali,31-03-2020,437107,808,600,436507,Africa
Saint Kitts and Nevis,31-03-2020,336430,723,223,336207,Americas
Canada,31-03-2020,217947,1089,1091,216856,Americas
Canada,31-03-2020,351010,2021,489,350521,Americas
Kosovo,31-03-2020,285915,965,816,285099,Europe
Burma,31-03-2020,253423,1556,1031,252392,South-East Asia
United Kingdom,31-03-2020,609,2271,90,519,Europe
United Kingdom,31-03-2020,253175,1543,192,252983,Europe
United Kingdom,31-03-2020,57198,1179,496,56702,Europe
Botswana,31-03-2020,252187,723,1246,250941,Africa
Burundi,31-03-2020,270623,2062,1070,269553,Africa
Sierra Leone,31-03-2020,295029,1596,426,294603,Africa
Malawi,31-03-2020,59568,563,188,59380,Africa
United Kingdom,31-03-2020,107860,810,57,107803,Europe
France,31-03-2020,78905,1091,477,78428,Europe
South Sudan,31-03-2020,24513,445,881,23632,Africa
Western Sahara,31-03-2020,310809,2414,720,310089,Africa
Sao Tome and Principe,31-03-2020,55565,2337,402,55163,Africa
Yemen,31-03-2020,449550,105,161,449389,Eastern Mediterranean
Comoros,31-03-2020,346464,306,1104,345360,Africa
Tajikistan,31-03-2020,391509,1859,207,391302,Europe
Lesotho,31-03-2020,338140,1488,325,337815,Africa
Afghanistan,01-04-2020,46758,2349,243,46515,Eastern Mediterranean
Albania,01-04-2020,279329,1146,1162,278167,Europe
Algeria,01-04-2020,217010,276,497,216513,Africa
Andorra,01-04-2020,288204,1251,25,288179,Europe
Angola,01-04-2020,350205,1287,247,349958,Africa
Antigua and Barbuda,01-04-2020,69478,540,1146,68332,Americas
Argentina,01-04-2020,69264,1912,1206,68058,Americas
Armenia,01-04-2020,123793,1708,13,123780,Europe
Australia,01-04-2020,444690,469,539,444151,Western Pacific
Australia,01-04-2020,263748,1629,299,263449,Western Pacific
Australia,01-04-2020,308968,2385,733,308235,Western Pacific
Australia,01-04-2020,3730,52,1239,2491,Western Pacific
Australia,01-04-2020,303126,1598,609,302517,Western Pacific
Australia,01-04-2020,362038,150,482,361556,Western Pacific
Australia,01-04-2020,40299,918,274,40025,Western Pacific
Australia,01-04-2020,418896,608,1075,417821,Western Pacific
Austria,01-04-2020,361268,395,1250,360018,Europe
Azerbaijan,01-04-2020,8938,3,1197,7741,Europe
Bahamas,01-04-2020,280168,2178,50,280118,Americas
Bahrain,01-04-2020,357232,1736,237,356995,Eastern Mediterranean
Bangladesh,01-04-2020,345109,1950,329,344780,South-East Asia
Barbados,01-04-2020,376763,2487,289,376474,Americas
Belarus,01-04-2020,234585,38,350,234235,Europe
Belgium,01-04-2020,215112,2129,521,214591,Europe
Benin,01-04-2020,395409,1300,1217,394192,Africa
Bhutan,01-04-2020,158055,934,407,157648,South-East Asia
Bolivia,01-04-2020,144548,684,383,144165,Americas
Bosnia and Herzegovina,01-04-2020,243958,1304,911,243047,Europe
Brazil,01-04-2020,147688,2251,205,147483,Americas
Brunei,01-04-2020,411835,148,647,411188,Western Pacific
Bulgaria,01-04-2020,84943,270,279,84664,Europe
Burkina Faso,01-04-2020,50626,2065,903,49723,Africa
Cabo Verde,01-04-2020,68099,1059,306,67793,Africa
Cambodia,01-04-2020,124720,2365,777,123943,Western Pacific
Cameroon,01-04-2020,36591,2271,627,35964,Africa
Canada,01-04-2020,278242,710,380,277862,Americas
Canada,01-04-2020,30002,212,599,29403,Americas
Canada,01-04-2020,256734,1415,744,255990,Americas
Canada,01-04-2020,176116,2277,237,175879,Americas
Canada,01-04-2020,140057,2124,1145,138912,Americas
Canada,01-04-2020,293065,2441,1038,292027,Americas
Canada,01-04-2020,77466,409,986,76480,Americas
Canada,01-04-2020,79818,1935,325,79493,Americas
Canada,01-04-2020,170085,138,68,170017,Americas
Canada,01-04-2020,152746,2313,458,152288,Americas
Central African Republic,01-04-2020,60383,824,1024,59359,Africa
Chad,01-04-2020,226537,1326,650,225887,Africa
Chile,01-04-2020,12293,2395,658,11635,Americas
China,01-04-2020,411744,2215,246,411498,Western Pacific
China,01-04-2020,100952,283,70,100882,Western Pacific
China,01-04-2020,237379,387,1041,236338,Western Pacific
China,01-04-2020,369133,2321,273,368860,Western Pacific
China,01-04-2020,74553,145,612,73941,Western Pacific
China,01-04-2020,72789,1362,889,71900,Western Pacific
China,01-04-2020,289498,1182,782,288716,Western Pacific
China,01-04-2020,341026,504,13,341013,Western Pacific
China,01-04-2020,226432,765,891,225541,Western Pacific
China,01-04-2020,98998,2174,446,98552,Western Pacific
China,01-04-2020,46440,1289,965,45475,Western Pacific
China,01-04-2020,210066,1813,1134,208932,Western Pacific
China,01-04-2020,153670,1128,1029,152641,Western Pacific
China,01-04-2020,436224,1631,407,435817,Western Pacific
China,01-04-2020,347573,364,204,347369,Western Pacific
China,01-04-2020,67289,1737,741,66548,Western Pacific
China,01-04-2020,145681,819,792,144889,Western Pacific
China,01-04-2020,37656,1094,1022,36634,Western Pacific
China,01-04-2020,311875,2027,442,311433,Western Pacific
China,01-04-2020,153701,2403,655,153046,Western Pacific
China,01-04-2020,404175,935,1207,402968,Western Pacific
China,01-04-2020,94852,966,582,94270,Western Pacific
China,01-04-2020,329184,2365,662,328522,Western Pacific
China,01-04-2020,373672,2132,714,372958,Western Pacific
China,01-04-2020,154440,2188,671,153769,Western Pacific
China,01-04-2020,339554,626,364,339190,Western Pacific
China,01-04-2020,429351,2183,90,429261,Western Pacific
China,01-04-2020,181882,181,24,181858,Western Pacific
China,01-04-2020,32269,712,330,31939,Western Pacific
China,01-04-2020,72621,1216,1051,71570,Western Pacific
China,01-04-2020,219473,2473,44,219429,Western Pacific
China,01-04-2020,54566,553,46,54520,Western Pacific
China,01-04-2020,188633,1965,1013,187620,Western Pacific
Colombia,01-04-2020,363989,2031,1132,362857,Americas
Congo (Brazzaville),01-04-2020,252307,1835,168,252139,Africa
Congo (Kinshasa),01-04-2020,36235,566,259,35976,Africa
Costa Rica,01-04-2020,253489,2368,197,253292,Americas
Cote d'Ivoire,01-04-2020,49234,2261,318,48916,Africa
Croatia,01-04-2020,405864,231,638,405226,Europe
Cuba,01-04-2020,115061,1337,507,114554,Americas
Cyprus,01-04-2020,167655,1768,160,167495,Europe
Czechia,01-04-2020,206607,1537,344,206263,Europe
Denmark,01-04-2020,419759,2192,669,419090,Europe
Greenland,01-04-2020,104967,1732,1229,103738,Europe
Denmark,01-04-2020,82712,939,718,81994,Europe
Djibouti,01-04-2020,379978,1839,387,379591,Eastern Mediterranean
Dominican Republic,01-04-2020,355469,270,1174,354295,Americas
Ecuador,01-04-2020,249398,2481,401,248997,Americas
Egypt,01-04-2020,95145,1088,612,94533,Eastern Mediterranean
El Salvador,01-04-2020,253546,1729,687,252859,Americas
Equatorial Guinea,01-04-2020,214607,431,1120,213487,Africa
Eritrea,01-04-2020,75565,241,402,75163,Africa
Estonia,01-04-2020,77970,315,328,77642,Europe
Eswatini,01-04-2020,247717,1196,999,246718,Africa
Ethiopia,01-04-2020,225749,1390,1246,224503,Africa
Fiji,01-04-2020,328791,2411,813,327978,Western Pacific
Finland,01-04-2020,112936,357,269,112667,Europe
France,01-04-2020,227666,1255,640,227026,Europe
France,01-04-2020,393676,1240,968,392708,Europe
France,01-04-2020,286738,804,952,285786,Europe
France,01-04-2020,340475,1123,949,339526,Europe
France,01-04-2020,196517,930,1250,195267,Europe
France,01-04-2020,167883,1119,509,167374,Europe
France,01-04-2020,399800,319,260,399540,Europe
France,01-04-2020,108259,1091,1077,107182,Europe
France,01-04-2020,347167,422,319,346848,Europe
France,01-04-2020,297574,876,284,297290,Europe
Gabon,01-04-2020,252149,1396,895,251254,Africa
Gambia,01-04-2020,297972,1718,1231,296741,Africa
Georgia,01-04-2020,274435,970,382,274053,Europe
Germany,01-04-2020,167287,2158,959,166328,Europe
Ghana,01-04-2020,146234,585,481,145753,Africa
Greece,01-04-2020,295786,2310,1047,294739,Europe
Guatemala,01-04-2020,296741,2430,193,296548,Americas
Guinea,01-04-2020,158329,88,1051,157278,Africa
Guyana,01-04-2020,112988,595,762,112226,Americas
Haiti,01-04-2020,44700,869,491,44209,Americas
Holy See,01-04-2020,23911,1198,627,23284,Europe
Honduras,01-04-2020,337109,1174,952,336157,Americas
Hungary,01-04-2020,431409,460,389,431020,Europe
Iceland,01-04-2020,347768,2305,1165,346603,Europe
India,01-04-2020,173612,520,541,173071,South-East Asia
Indonesia,01-04-2020,106594,2144,490,106104,South-East Asia
Iran,01-04-2020,240207,2403,246,239961,Eastern Mediterranean
Iraq,01-04-2020,351246,1498,716,350530,Eastern Mediterranean
Ireland,01-04-2020,89167,1253,1231,87936,Europe
Israel,01-04-2020,107777,1993,552,107225,Europe
Italy,01-04-2020,310781,120,385,310396,Europe
Jamaica,01-04-2020,267181,2462,766,266415,Americas
Japan,01-04-2020,62759,2029,591,62168,Western Pacific
Jordan,01-04-2020,88544,2435,553,87991,Eastern Mediterranean
Kazakhstan,01-04-2020,194152,526,804,193348,Europe
Kenya,01-04-2020,395546,2140,365,395181,Africa
South Korea,01-04-2020,329591,902,955,328636,Western Pacific
Kuwait,01-04-2020,54045,2370,124,53921,Eastern Mediterranean
Kyrgyzstan,01-04-2020,397927,2053,1190,396737,Europe
Latvia,01-04-2020,1635,1558,182,1453,Europe
Lebanon,01-04-2020,183728,2464,96,183632,Eastern Mediterranean
Liberia,01-04-2020,211163,1411,115,211048,Africa
Liechtenstein,01-04-2020,51337,3,394,50943,Europe
Lithuania,01-04-2020,404529,975,739,403790,Europe
Luxembourg,01-04-2020,167923,397,302,167621,Europe
Madagascar,01-04-2020,211062,740,673,210389,Africa
Malaysia,01-04-2020,157598,1174,691,156907,Western Pacific
Maldives,01-04-2020,141163,831,962,140201,South-East Asia
Malta,01-04-2020,385991,1701,899,385092,Europe
Mauritania,01-04-2020,274432,646,442,273990,Africa
Mauritius,01-04-2020,446453,1646,60,446393,Africa
Mexico,01-04-2020,379903,80,1135,378768,Americas
Moldova,01-04-2020,122077,184,236,121841,Europe
Monaco,01-04-2020,415644,273,997,414647,Europe
Mongolia,01-04-2020,233747,1317,921,232826,Western Pacific
Montenegro,01-04-2020,352995,1916,72,352923,Europe
Morocco,01-04-2020,164629,1794,377,164252,Eastern Mediterranean
Namibia,01-04-2020,178235,2431,74,178161,Africa
Nepal,01-04-2020,141246,698,971,140275,South-East Asia
Netherlands,01-04-2020,440666,997,852,439814,Europe
Netherlands,01-04-2020,176523,1595,1034,175489,Europe
Netherlands,01-04-2020,107662,140,683,106979,Europe
Netherlands,01-04-2020,337252,375,966,336286,Europe
New Zealand,01-04-2020,283728,1749,216,283512,Western Pacific
Nicaragua,01-04-2020,352590,1271,1098,351492,Americas
Niger,01-04-2020,21959,1129,592,21367,Africa
Nigeria,01-04-2020,448178,1816,555,447623,Africa
North Macedonia,01-04-2020,148601,891,337,148264,Europe
Norway,01-04-2020,52708,1663,539,52169,Europe
Oman,01-04-2020,413660,1262,634,413026,Eastern Mediterranean
Pakistan,01-04-2020,216888,1852,235,216653,Eastern Mediterranean
Panama,01-04-2020,44501,1527,456,44045,Americas
Papua New Guinea,01-04-2020,197137,671,88,197049,Western Pacific
Paraguay,01-04-2020,438031,190,1064,436967,Americas
Peru,01-04-2020,444400,2218,421,443979,Americas
Philippines,01-04-2020,296603,1549,266,296337,Western Pacific
Poland,01-04-2020,266435,1415,643,265792,Europe
Portugal,01-04-2020,43240,1248,1083,42157,Europe
Qatar,01-04-2020,125012,145,398,124614,Eastern Mediterranean
Romania,01-04-2020,165489,1875,828,164661,Europe
Russia,01-04-2020,256612,1703,399,256213,Europe
Rwanda,01-04-2020,414718,474,285,414433,Africa
Saint Lucia,01-04-2020,90338,1792,709,89629,Americas
Saint Vincent and the Grenadines,01-04-2020,12269,388,105,12164,Americas
San Marino,01-04-2020,343482,1673,419,343063,Europe
Saudi Arabia,01-04-2020,59610,2478,603,59007,Eastern Mediterranean
Senegal,01-04-2020,114148,67,1191,112957,Africa
Serbia,01-04-2020,408823,1175,455,408368,Europe
Seychelles,01-04-2020,166842,940,622,166220,Africa
Singapore,01-04-2020,322838,1855,382,322456,Western Pacific
Slovakia,01-04-2020,262542,295,156,262386,Europe
Slovenia,01-04-2020,260651,871,290,260361,Europe
Somalia,01-04-2020,363371,1836,1229,362142,Eastern Mediterranean
South Africa,01-04-2020,252039,1525,1054,250985,Africa
Spain,01-04-2020,69346,2275,176,69170,Europe
Sri Lanka,01-04-2020,439511,1002,770,438741,South-East Asia
Sudan,01-04-2020,337832,895,887,336945,Eastern Mediterranean
Suriname,01-04-2020,241752,1433,74,241678,Americas
Sweden,01-04-2020,398056,2269,350,397706,Europe
Switzerland,01-04-2020,238807,1632,724,238083,Europe
Taiwan*,01-04-2020,57644,203,392,57252,Western Pacific
Tanzania,01-04-2020,196191,1655,209,195982,Africa
Thailand,01-04-2020,126537,139,246,126291,South-East Asia
Togo,01-04-2020,79331,1784,412,78919,Africa
Trinidad and Tobago,01-04-2020,346541,1024,450,346091,Americas
Tunisia,01-04-2020,403809,558,769,403040,Eastern Mediterranean
Turkey,01-04-2020,34671,1400,889,33782,Europe
Uganda,01-04-2020,346936,807,555,346381,Africa
Ukraine,01-04-2020,342672,388,299,342373,Europe
United Arab Emirates,01-04-2020,352013,1557,1246,350767,Eastern Mediterranean
United Kingdom,01-04-2020,406622,1808,1243,405379,Europe
United Kingdom,01-04-2020,16070,981,902,15168,Europe
United Kingdom,01-04-2020,58119,1251,122,57997,Europe
United Kingdom,01-04-2020,57560,1540,144,57416,Europe
United Kingdom,01-04-2020,24150,1936,413,23737,Europe
United Kingdom,01-04-2020,92662,1534,626,92036,Europe
United Kingdom,01-04-2020,313734,1010,322,313412,Europe
Uruguay,01-04-2020,194617,2221,26,194591,Americas
US,01-04-2020,205049,85,36,205013,Americas
Uzbekistan,01-04-2020,84515,121,1066,83449,Europe
Venezuela,01-04-2020,221638,397,481,221157,Americas
Vietnam,01-04-2020,9139,959,802,8337,Western Pacific
Zambia,01-04-2020,195068,773,1098,193970,Africa
Zimbabwe,01-04-2020,367897,2132,100,367797,Africa
Dominica,01-04-2020,141418,1641,943,140475,Americas
Grenada,01-04-2020,422220,2118,879,421341,Americas
Mozambique,01-04-2020,350604,1381,790,349814,Africa
Syria,01-04-2020,102004,1564,548,101456,Eastern Mediterranean
Timor-Leste,01-04-2020,351248,2025,829,350419,South-East Asia
Belize,01-04-2020,391406,1266,968,390438,Americas
Laos,01-04-2020,325052,1550,833,324219,Western Pacific
Libya,01-04-2020,212891,624,860,212031,Eastern Mediterranean
West Bank and Gaza,01-04-2020,166195,44,618,165577,Eastern Mediterranean
Guinea-Bissau,01-04-2020,204627,2430,1115,203512,Africa
Mali,01-04-2020,325889,457,915,324974,Africa
Saint Kitts and Nevis,01-04-2020,292885,1118,968,291917,Americas
Canada,01-04-2020,91901,824,1028,90873,Americas
Canada,01-04-2020,422195,1119,191,422004,Americas
Kosovo,01-04-2020,405618,1706,1023,404595,Europe
Burma,01-04-2020,7595,433,391,7204,South-East Asia
United Kingdom,01-04-2020,203308,2423,354,202954,Europe
United Kingdom,01-04-2020,76073,634,675,75398,Europe
United Kingdom,01-04-2020,431752,318,465,431287,Europe
Botswana,01-04-2020,299850,16,465,299385,Africa
Burundi,01-04-2020,290183,880,902,289281,Africa
Sierra Leone,01-04-2020,423816,2119,298,423518,Africa
Malawi,01-04-2020,436030,1614,26,436004,Africa
United Kingdom,01-04-2020,109425,1437,1039,108386,Europe
France,01-04-2020,96237,857,755,95482,Europe
South Sudan,01-04-2020,179899,1543,633,179266,Africa
Western Sahara,01-04-2020,29463,739,355,29108,Africa
Sao Tome and Principe,01-04-2020,68536,358,528,68008,Africa
Yemen,01-04-2020,7486,2389,1032,6454,Eastern Mediterranean
Comoros,01-04-2020,261088,2262,416,260672,Africa
Tajikistan,01-04-2020,271281,1140,12,271269,Europe
Lesotho,01-04-2020,6326,1038,552,5774,Africa
Afghanistan,02-04-2020,114050,59,578,113472,Eastern Mediterranean
Albania,02-04-2020,180301,679,933,179368,Europe
Algeria,02-04-2020,435255,468,850,434405,Africa
Andorra,02-04-2020,422011,290,395,421616,Europe
Angola,02-04-2020,317993,2325,1131,316862,Africa
Antigua and Barbuda,02-04-2020,315868,1495,707,315161,Americas
Argentina,02-04-2020,375844,2389,586,375258,Americas
Armenia,02-04-2020,382510,1409,1019,381491,Europe
Australia,02-04-2020,200711,1880,352,200359,Western Pacific
Australia,02-04-2020,271023,1946,500,270523,Western Pacific
Australia,02-04-2020,75590,1883,1054,74536,Western Pacific
Australia,02-04-2020,224311,1178,226,224085,Western Pacific
Australia,02-04-2020,448860,270,296,448564,Western Pacific
Australia,02-04-2020,177272,865,534,176738,Western Pacific
Australia,02-04-2020,127252,1264,814,126438,Western Pacific
Australia,02-04-2020,285652,1872,1231,284421,Western Pacific
Austria,02-04-2020,206416,1132,816,205600,Europe
Azerbaijan,02-04-2020,129829,626,42,129787,Europe
Bahamas,02-04-2020,442860,1021,1209,441651,Americas
Bahrain,02-04-2020,19407,402,1136,18271,Eastern Mediterranean
Bangladesh,02-04-2020,276155,493,1080,275075,South-East Asia
Barbados,02-04-2020,32354,2113,215,32139,Americas
Belarus,02-04-2020,314168,635,676,313492,Europe
Belgium,02-04-2020,64795,491,713,64082,Europe
Benin,02-04-2020,6878,1398,1030,5848,Africa
Bhutan,02-04-2020,31071,2121,822,30249,South-East Asia
Bolivia,02-04-2020,166400,81,561,165839,Americas
Bosnia and Herzegovina,02-04-2020,327938,1390,426,327512,Europe
Brazil,02-04-2020,21657,1123,889,20768,Americas
Brunei,02-04-2020,121011,1532,257,120754,Western Pacific
Bulgaria,02-04-2020,288738,1740,1057,287681,Europe
Burkina Faso,02-04-2020,337851,606,416,337435,Africa
Cabo Verde,02-04-2020,272155,2001,29,272126,Africa
Cambodia,02-04-2020,435467,559,95,435372,Western Pacific
Cameroon,02-04-2020,180710,1789,220,180490,Africa
Canada,02-04-2020,154940,171,677,154263,Americas
Canada,02-04-2020,306575,1477,202,306373,Americas
Canada,02-04-2020,65621,607,441,65180,Americas
Canada,02-04-2020,176480,2136,621,175859,Americas
Canada,02-04-2020,398671,1603,1139,397532,Americas
Canada,02-04-2020,434833,1982,640,434193,Americas
Canada,02-04-2020,170356,1538,508,169848,Americas
Canada,02-04-2020,80678,13,1060,79618,Americas
Canada,02-04-2020,275956,221,139,275817,Americas
Canada,02-04-2020,394259,1947,689,393570,Americas
Central African Republic,02-04-2020,414468,847,914,413554,Africa
Chad,02-04-2020,209852,917,1125,208727,Africa
Chile,02-04-2020,367448,496,620,366828,Americas
China,02-04-2020,324784,895,1160,323624,Western Pacific
China,02-04-2020,261616,2257,292,261324,Western Pacific
China,02-04-2020,131924,1172,1241,130683,Western Pacific
China,02-04-2020,402097,2004,812,401285,Western Pacific
China,02-04-2020,303110,114,814,302296,Western Pacific
China,02-04-2020,274007,1278,402,273605,Western Pacific
China,02-04-2020,59126,1383,878,58248,Western Pacific
China,02-04-2020,204028,983,413,203615,Western Pacific
China,02-04-2020,134115,2453,93,134022,Western Pacific
China,02-04-2020,111720,234,163,111557,Western Pacific
China,02-04-2020,260198,2285,419,259779,Western Pacific
China,02-04-2020,311863,1738,1151,310712,Western Pacific
China,02-04-2020,291400,431,1206,290194,Western Pacific
China,02-04-2020,83962,996,873,83089,Western Pacific
China,02-04-2020,341027,2021,1041,339986,Western Pacific
China,02-04-2020,344442,914,1025,343417,Western Pacific
China,02-04-2020,153344,2230,1230,152114,Western Pacific
China,02-04-2020,173111,748,49,173062,Western Pacific
China,02-04-2020,221547,1000,817,220730,Western Pacific
China,02-04-2020,442681,2480,643,442038,Western Pacific
China,02-04-2020,101203,1158,128,101075,Western Pacific
China,02-04-2020,337610,850,1173,336437,Western Pacific
China,02-04-2020,237703,1168,9,237694,Western Pacific
China,02-04-2020,152486,2136,527,151959,Western Pacific
China,02-04-2020,167133,656,217,166916,Western Pacific
China,02-04-2020,350337,1238,856,349481,Western Pacific
China,02-04-2020,260603,850,939,259664,Western Pacific
China,02-04-2020,6184,380,1065,5119,Western Pacific
China,02-04-2020,191757,357,89,191668,Western Pacific
China,02-04-2020,18969,2000,454,18515,Western Pacific
China,02-04-2020,316507,833,257,316250,Western Pacific
China,02-04-2020,160307,1261,222,160085,Western Pacific
China,02-04-2020,331391,1046,565,330826,Western Pacific
Colombia,02-04-2020,126981,522,934,126047,Americas
Congo (Brazzaville),02-04-2020,331706,1243,887,330819,Africa
Congo (Kinshasa),02-04-2020,64605,1122,813,63792,Africa
Costa Rica,02-04-2020,241012,1908,813,240199,Americas
Cote d'Ivoire,02-04-2020,211387,1943,152,211235,Africa
Croatia,02-04-2020,429027,983,172,428855,Europe
Cuba,02-04-2020,28274,1032,743,27531,Americas
Cyprus,02-04-2020,306322,800,30,306292,Europe
Czechia,02-04-2020,439378,2051,963,438415,Europe
Denmark,02-04-2020,48915,2037,691,48224,Europe
Greenland,02-04-2020,237881,494,797,237084,Europe
Denmark,02-04-2020,368765,1119,614,368151,Europe
Djibouti,02-04-2020,113881,1756,1150,112731,Eastern Mediterranean
Dominican Republic,02-04-2020,188617,674,430,188187,Americas
Ecuador,02-04-2020,429636,938,328,429308,Americas
Egypt,02-04-2020,299292,1852,829,298463,Eastern Mediterranean
El Salvador,02-04-2020,3648,2303,1178,2470,Americas
Equatorial Guinea,02-04-2020,98598,339,989,97609,Africa
Eritrea,02-04-2020,307318,2256,1085,306233,Africa
Estonia,02-04-2020,168025,41,104,167921,Europe
Eswatini,02-04-2020,247869,1158,969,246900,Africa
Ethiopia,02-04-2020,30914,1730,98,30816,Africa
Fiji,02-04-2020,269715,1342,276,269439,Western Pacific
Finland,02-04-2020,157386,726,55,157331,Europe
France,02-04-2020,203667,406,1042,202625,Europe
France,02-04-2020,249659,78,637,249022,Europe
France,02-04-2020,116809,812,369,116440,Europe
France,02-04-2020,192082,2160,1117,190965,Europe
France,02-04-2020,117071,1254,1212,115859,Europe
France,02-04-2020,23783,534,388,23395,Europe
France,02-04-2020,203577,2175,1242,202335,Europe
France,02-04-2020,10559,1174,837,9722,Europe
France,02-04-2020,251428,2480,910,250518,Europe
France,02-04-2020,341624,1199,333,341291,Europe
Gabon,02-04-2020,358560,2085,207,358353,Africa
Gambia,02-04-2020,359296,2442,1024,358272,Africa
Georgia,02-04-2020,114642,584,833,113809,Europe
Germany,02-04-2020,414187,924,624,413563,Europe
Ghana,02-04-2020,251648,2105,62,251586,Africa
Greece,02-04-2020,220593,766,1111,219482,Europe
Guatemala,02-04-2020,180170,845,529,179641,Americas
Guinea,02-04-2020,303037,1838,777,302260,Africa
Guyana,02-04-2020,201684,334,1082,200602,Americas
Haiti,02-04-2020,416653,503,709,415944,Americas
Holy See,02-04-2020,437551,432,594,436957,Europe
Honduras,02-04-2020,344498,2261,358,344140,Americas
Hungary,02-04-2020,386430,1334,267,386163,Europe
Iceland,02-04-2020,131993,1462,445,131548,Europe
India,02-04-2020,179526,1161,742,178784,South-East Asia
Indonesia,02-04-2020,131330,2139,277,131053,South-East Asia
Iran,02-04-2020,297630,619,267,297363,Eastern Mediterranean
Iraq,02-04-2020,227788,2478,673,227115,Eastern Mediterranean
Ireland,02-04-2020,266787,133,767,266020,Europe
Israel,02-04-2020,23325,1279,1159,22166,Europe
Italy,02-04-2020,379855,1494,776,379079,Europe
Jamaica,02-04-2020,335730,2284,731,334999,Americas
Japan,02-04-2020,335800,2310,313,335487,Western Pacific
Jordan,02-04-2020,236952,1198,463,236489,Eastern Mediterranean
Kazakhstan,02-04-2020,57650,439,1079,56571,Europe
Kenya,02-04-2020,258957,2273,1157,257800,Africa
South Korea,02-04-2020,107170,1922,587,106583,Western Pacific
Kuwait,02-04-2020,247153,1555,1033,246120,Eastern Mediterranean
Kyrgyzstan,02-04-2020,441987,1729,1234,440753,Europe
Latvia,02-04-2020,100862,2365,250,100612,Europe
Lebanon,02-04-2020,254759,1972,616,254143,Eastern Mediterranean
Liberia,02-04-2020,72806,1193,532,72274,Africa
Liechtenstein,02-04-2020,295846,866,458,295388,Europe
Lithuania,02-04-2020,206855,1050,739,206116,Europe
Luxembourg,02-04-2020,329424,1635,341,329083,Europe
Madagascar,02-04-2020,170789,2001,189,170600,Africa
Malaysia,02-04-2020,220503,1195,205,220298,Western Pacific
Maldives,02-04-2020,329304,1532,606,328698,South-East Asia
Malta,02-04-2020,438979,2455,1210,437769,Europe
Mauritania,02-04-2020,124708,1901,523,124185,Africa
Mauritius,02-04-2020,432383,711,234,432149,Africa
Mexico,02-04-2020,297027,246,811,296216,Americas
Moldova,02-04-2020,131699,2166,843,130856,Europe
Monaco,02-04-2020,403464,2185,637,402827,Europe
Mongolia,02-04-2020,229194,618,554,228640,Western Pacific
Montenegro,02-04-2020,261738,1691,220,261518,Europe
Morocco,02-04-2020,120642,523,586,120056,Eastern Mediterranean
Namibia,02-04-2020,76532,1190,1006,75526,Africa
Nepal,02-04-2020,3949,439,1101,2848,South-East Asia
Netherlands,02-04-2020,421466,1925,949,420517,Europe
Netherlands,02-04-2020,414097,2113,4,414093,Europe
Netherlands,02-04-2020,176698,107,1016,175682,Europe
Netherlands,02-04-2020,411293,515,768,410525,Europe
New Zealand,02-04-2020,281069,1932,324,280745,Western Pacific
Nicaragua,02-04-2020,383974,1602,1045,382929,Americas
Niger,02-04-2020,277517,2377,629,276888,Africa
Nigeria,02-04-2020,349062,1764,562,348500,Africa
North Macedonia,02-04-2020,130855,44,638,130217,Europe
Norway,02-04-2020,17700,994,390,17310,Europe
Oman,02-04-2020,424500,709,29,424471,Eastern Mediterranean
Pakistan,02-04-2020,48614,1949,793,47821,Eastern Mediterranean
Panama,02-04-2020,414332,942,994,413338,Americas
Papua New Guinea,02-04-2020,294032,337,330,293702,Western Pacific
Paraguay,02-04-2020,10607,1260,473,10134,Americas
Peru,02-04-2020,388967,1888,608,388359,Americas
Philippines,02-04-2020,373304,1297,1230,372074,Western Pacific
Poland,02-04-2020,145870,1930,601,145269,Europe
Portugal,02-04-2020,350471,2417,298,350173,Europe
Qatar,02-04-2020,128260,593,924,127336,Eastern Mediterranean
Romania,02-04-2020,273340,1217,515,272825,Europe
Russia,02-04-2020,48299,331,64,48235,Europe
Rwanda,02-04-2020,352048,842,643,351405,Africa
Saint Lucia,02-04-2020,26775,36,539,26236,Americas
Saint Vincent and the Grenadines,02-04-2020,377306,101,1156,376150,Americas
San Marino,02-04-2020,226108,1216,657,225451,Europe
Saudi Arabia,02-04-2020,315570,30,537,315033,Eastern Mediterranean
Senegal,02-04-2020,54071,2405,1204,52867,Africa
Serbia,02-04-2020,277129,1529,424,276705,Europe
Seychelles,02-04-2020,285345,1575,916,284429,Africa
Singapore,02-04-2020,307752,248,745,307007,Western Pacific
Slovakia,02-04-2020,170280,164,726,169554,Europe
Slovenia,02-04-2020,190690,1214,814,189876,Europe
Somalia,02-04-2020,107111,790,705,106406,Eastern Mediterranean
South Africa,02-04-2020,312509,2355,1108,311401,Africa
Spain,02-04-2020,293583,492,1042,292541,Europe
Sri Lanka,02-04-2020,383993,893,310,383683,South-East Asia
Sudan,02-04-2020,26883,2083,1045,25838,Eastern Mediterranean
Suriname,02-04-2020,134032,796,724,133308,Americas
Sweden,02-04-2020,444701,1373,984,443717,Europe
Switzerland,02-04-2020,305515,2235,377,305138,Europe
Taiwan*,02-04-2020,223729,2293,785,222944,Western Pacific
Tanzania,02-04-2020,199528,191,106,199422,Africa
Thailand,02-04-2020,104304,950,945,103359,South-East Asia
Togo,02-04-2020,273839,1514,448,273391,Africa
Trinidad and Tobago,02-04-2020,94725,2253,904,93821,Americas
Tunisia,02-04-2020,203810,882,751,203059,Eastern Mediterranean
Turkey,02-04-2020,434780,1840,1158,433622,Europe
Uganda,02-04-2020,251925,345,543,251382,Africa
Ukraine,02-04-2020,89142,670,1170,87972,Europe
United Arab Emirates,02-04-2020,50571,1866,298,50273,Eastern Mediterranean
United Kingdom,02-04-2020,404831,2261,1079,403752,Europe
United Kingdom,02-04-2020,255814,1222,695,255119,Europe
United Kingdom,02-04-2020,442512,896,205,442307,Europe
United Kingdom,02-04-2020,66662,1785,905,65757,Europe
United Kingdom,02-04-2020,228125,1958,1250,226875,Europe
United Kingdom,02-04-2020,154027,1844,395,153632,Europe
United Kingdom,02-04-2020,292167,2209,55,292112,Europe
Uruguay,02-04-2020,108703,1242,855,107848,Americas
US,02-04-2020,318906,1362,485,318421,Americas
Uzbekistan,02-04-2020,92748,848,239,92509,Europe
Venezuela,02-04-2020,360492,1625,350,360142,Americas
Vietnam,02-04-2020,128179,2124,922,127257,Western Pacific
Zambia,02-04-2020,280219,1619,1095,279124,Africa
Zimbabwe,02-04-2020,131970,263,203,131767,Africa
Dominica,02-04-2020,331138,683,279,330859,Americas
Grenada,02-04-2020,337748,1312,875,336873,Americas
Mozambique,02-04-2020,425392,1252,1238,424154,Africa
Syria,02-04-2020,443568,1766,120,443448,Eastern Mediterranean
Timor-Leste,02-04-2020,402086,893,34,402052,South-East Asia
Belize,02-04-2020,279385,741,699,278686,Americas
Laos,02-04-2020,244561,591,536,244025,Western Pacific
Libya,02-04-2020,73818,907,1218,72600,Eastern Mediterranean
West Bank and Gaza,02-04-2020,196746,1500,856,195890,Eastern Mediterranean
Guinea-Bissau,02-04-2020,144743,585,777,143966,Africa
Mali,02-04-2020,146924,727,627,146297,Africa
Saint Kitts and Nevis,02-04-2020,415402,944,568,414834,Americas
Canada,02-04-2020,390257,2332,619,389638,Americas
Canada,02-04-2020,215432,638,1155,214277,Americas
Kosovo,02-04-2020,184,521,948,-764,Europe
Burma,02-04-2020,157291,437,103,157188,South-East Asia
United Kingdom,02-04-2020,415260,715,299,414961,Europe
United Kingdom,02-04-2020,372245,723,506,371739,Europe
United Kingdom,02-04-2020,375896,1512,19,375877,Europe
Botswana,02-04-2020,421342,543,133,421209,Africa
Burundi,02-04-2020,66666,237,905,65761,Africa
Sierra Leone,02-04-2020,356190,1342,184,356006,Africa
Malawi,02-04-2020,348733,1841,1210,347523,Africa
United Kingdom,02-04-2020,328407,838,981,327426,Europe
France,02-04-2020,275065,2323,300,274765,Europe
South Sudan,02-04-2020,91179,709,1123,90056,Africa
Western Sahara,02-04-2020,157408,1948,779,156629,Africa
Sao Tome and Principe,02-04-2020,95214,1128,1198,94016,Africa
Yemen,02-04-2020,168234,1608,787,167447,Eastern Mediterranean
Comoros,02-04-2020,107970,1568,977,106993,Africa
Tajikistan,02-04-2020,31037,1208,1171,29866,Europe
Lesotho,02-04-2020,240051,36,894,239157,Africa
Afghanistan,03-04-2020,240726,2077,153,240573,Eastern Mediterranean
Albania,03-04-2020,350734,444,1210,349524,Europe
Algeria,03-04-2020,341472,1755,346,341126,Africa
Andorra,03-04-2020,255918,2379,1146,254772,Europe
Angola,03-04-2020,324332,1976,567,323765,Africa
Antigua and Barbuda,03-04-2020,257383,740,156,257227,Americas
Argentina,03-04-2020,258192,1169,260,257932,Americas
Armenia,03-04-2020,380027,1814,275,379752,Europe
Australia,03-04-2020,317950,1797,762,317188,Western Pacific
Australia,03-04-2020,138604,133,979,137625,Western Pacific
Australia,03-04-2020,32749,2462,617,32132,Western Pacific
Australia,03-04-2020,444349,120,116,444233,Western Pacific
Australia,03-04-2020,220851,1020,1168,219683,Western Pacific
Australia,03-04-2020,243042,2057,370,242672,Western Pacific
Australia,03-04-2020,271898,882,412,271486,Western Pacific
Australia,03-04-2020,166854,1297,300,166554,Western Pacific
Austria,03-04-2020,183644,1629,1053,182591,Europe
Azerbaijan,03-04-2020,267015,1167,818,266197,Europe
Bahamas,03-04-2020,125344,2183,116,125228,Americas
Bahrain,03-04-2020,123036,764,997,122039,Eastern Mediterranean
Bangladesh,03-04-2020,366667,2174,1127,365540,South-East Asia
Barbados,03-04-2020,109541,932,786,108755,Americas
Belarus,03-04-2020,19553,218,805,18748,Europe
Belgium,03-04-2020,366928,366,114,366814,Europe
Benin,03-04-2020,99799,1185,846,98953,Africa
Bhutan,03-04-2020,335584,1457,1008,334576,South-East Asia
Bolivia,03-04-2020,140783,271,1131,139652,Americas
Bosnia and Herzegovina,03-04-2020,201382,1327,1095,200287,Europe
Brazil,03-04-2020,129304,1758,1224,128080,Americas
Brunei,03-04-2020,332996,1510,481,332515,Western Pacific
Bulgaria,03-04-2020,66404,1296,892,65512,Europe
Burkina Faso,03-04-2020,175841,550,1184,174657,Africa
Cabo Verde,03-04-2020,131423,414,554,130869,Africa
Cambodia,03-04-2020,75764,1951,237,75527,Western Pacific
Cameroon,03-04-2020,200755,2260,189,200566,Africa
Canada,03-04-2020,404020,934,388,403632,Americas
Canada,03-04-2020,202264,252,498,201766,Americas
Canada,03-04-2020,98206,497,772,97434,Americas
Canada,03-04-2020,323190,611,748,322442,Americas
Canada,03-04-2020,129388,69,43,129345,Americas
Canada,03-04-2020,224683,1444,914,223769,Americas
Canada,03-04-2020,181496,2447,43,181453,Americas
Canada,03-04-2020,406234,1712,444,405790,Americas
Canada,03-04-2020,318381,2116,304,318077,Americas
Canada,03-04-2020,82124,1082,669,81455,Americas
Central African Republic,03-04-2020,235484,1527,1160,234324,Africa
Chad,03-04-2020,78202,904,228,77974,Africa
Chile,03-04-2020,115318,1250,536,114782,Americas
China,03-04-2020,298224,1948,619,297605,Western Pacific
China,03-04-2020,366643,2062,1090,365553,Western Pacific
China,03-04-2020,446525,2283,543,445982,Western Pacific
China,03-04-2020,71162,1369,588,70574,Western Pacific
China,03-04-2020,322360,1076,52,322308,Western Pacific
China,03-04-2020,12985,409,670,12315,Western Pacific
China,03-04-2020,36242,1327,1246,34996,Western Pacific
China,03-04-2020,267703,517,447,267256,Western Pacific
China,03-04-2020,3024,286,1039,1985,Western Pacific
China,03-04-2020,14728,900,731,13997,Western Pacific
China,03-04-2020,357611,787,294,357317,Western Pacific
China,03-04-2020,285253,1305,1190,284063,Western Pacific
China,03-04-2020,445551,734,1041,444510,Western Pacific
China,03-04-2020,154816,1807,907,153909,Western Pacific
China,03-04-2020,397148,1090,142,397006,Western Pacific
China,03-04-2020,225169,2028,612,224557,Western Pacific
China,03-04-2020,385892,2084,670,385222,Western Pacific
China,03-04-2020,99939,1604,935,99004,Western Pacific
China,03-04-2020,266070,1853,1138,264932,Western Pacific
China,03-04-2020,60968,1656,754,60214,Western Pacific
China,03-04-2020,357161,2016,880,356281,Western Pacific
China,03-04-2020,23845,832,675,23170,Western Pacific
China,03-04-2020,317573,130,613,316960,Western Pacific
China,03-04-2020,262342,2337,338,262004,Western Pacific
China,03-04-2020,79328,2086,799,78529,Western Pacific
China,03-04-2020,162244,2248,1087,161157,Western Pacific
China,03-04-2020,130697,2463,142,130555,Western Pacific
China,03-04-2020,54276,380,925,53351,Western Pacific
China,03-04-2020,240324,267,195,240129,Western Pacific
China,03-04-2020,209566,2101,1082,208484,Western Pacific
China,03-04-2020,75122,129,490,74632,Western Pacific
China,03-04-2020,399221,1887,1214,398007,Western Pacific
China,03-04-2020,183423,1785,627,182796,Western Pacific
Colombia,03-04-2020,358591,679,1213,357378,Americas
Congo (Brazzaville),03-04-2020,207322,732,546,206776,Africa
Congo (Kinshasa),03-04-2020,16824,1287,463,16361,Africa
Costa Rica,03-04-2020,336456,784,1183,335273,Americas
Cote d'Ivoire,03-04-2020,239183,1796,826,238357,Africa
Croatia,03-04-2020,163657,1338,923,162734,Europe
Cuba,03-04-2020,258023,1319,1084,256939,Americas
Cyprus,03-04-2020,388448,1389,1159,387289,Europe
Czechia,03-04-2020,392357,2325,598,391759,Europe
Denmark,03-04-2020,170172,411,874,169298,Europe
Greenland,03-04-2020,426731,19,179,426552,Europe
Denmark,03-04-2020,320715,197,422,320293,Europe
Djibouti,03-04-2020,256118,1223,65,256053,Eastern Mediterranean
Dominican Republic,03-04-2020,107379,1012,1152,106227,Americas
Ecuador,03-04-2020,389085,1820,1052,388033,Americas
Egypt,03-04-2020,132595,646,576,132019,Eastern Mediterranean
El Salvador,03-04-2020,183537,2172,948,182589,Americas
Equatorial Guinea,03-04-2020,398578,1429,430,398148,Africa
Eritrea,03-04-2020,362324,439,327,361997,Africa
Estonia,03-04-2020,225459,896,183,225276,Europe
Eswatini,03-04-2020,273410,764,348,273062,Africa
Ethiopia,03-04-2020,68496,2421,686,67810,Africa
Fiji,03-04-2020,192068,450,87,191981,Western Pacific
Finland,03-04-2020,12452,2400,506,11946,Europe
France,03-04-2020,14983,1531,134,14849,Europe
France,03-04-2020,365409,1210,568,364841,Europe
France,03-04-2020,201343,1824,1092,200251,Europe
France,03-04-2020,227961,1774,973,226988,Europe
France,03-04-2020,305811,2009,188,305623,Europe
France,03-04-2020,283713,293,484,283229,Europe
France,03-04-2020,98099,625,1070,97029,Europe
France,03-04-2020,435231,2327,782,434449,Europe
France,03-04-2020,436003,2366,1233,434770,Europe
France,03-04-2020,194600,661,591,194009,Europe
Gabon,03-04-2020,55817,1932,1116,54701,Africa
Gambia,03-04-2020,337081,723,558,336523,Africa
Georgia,03-04-2020,210179,997,2,210177,Europe
Germany,03-04-2020,375960,2259,618,375342,Europe
Ghana,03-04-2020,155945,204,201,155744,Africa
Greece,03-04-2020,215575,1906,679,214896,Europe
Guatemala,03-04-2020,359290,1562,727,358563,Americas
Guinea,03-04-2020,259194,466,613,258581,Africa
Guyana,03-04-2020,251025,2354,1122,249903,Americas
Haiti,03-04-2020,437182,1404,134,437048,Americas
Holy See,03-04-2020,394826,353,987,393839,Europe
Honduras,03-04-2020,237892,1480,1037,236855,Americas
Hungary,03-04-2020,245611,594,1244,244367,Europe
Iceland,03-04-2020,68690,155,658,68032,Europe
India,03-04-2020,359340,2150,1114,358226,South-East Asia
Indonesia,03-04-2020,156108,1089,577,155531,South-East Asia
Iran,03-04-2020,45338,1509,953,44385,Eastern Mediterranean
Iraq,03-04-2020,305087,2419,773,304314,Eastern Mediterranean
Ireland,03-04-2020,83530,1327,194,83336,Europe
Israel,03-04-2020,50151,362,693,49458,Europe
Italy,03-04-2020,221144,1477,600,220544,Europe
Jamaica,03-04-2020,82454,437,79,82375,Americas
Japan,03-04-2020,254718,1164,92,254626,Western Pacific
Jordan,03-04-2020,191413,487,640,190773,Eastern Mediterranean
Kazakhstan,03-04-2020,218792,2285,1077,217715,Europe
Kenya,03-04-2020,76757,1450,264,76493,Africa
South Korea,03-04-2020,52416,688,304,52112,Western Pacific
Kuwait,03-04-2020,404677,1821,608,404069,Eastern Mediterranean
Kyrgyzstan,03-04-2020,361477,1887,460,361017,Europe
Latvia,03-04-2020,113457,2392,924,112533,Europe
Lebanon,03-04-2020,398257,970,41,398216,Eastern Mediterranean
Liberia,03-04-2020,362257,783,0,362257,Africa
Liechtenstein,03-04-2020,97431,490,325,97106,Europe
Lithuania,03-04-2020,109293,2153,421,108872,Europe
Luxembourg,03-04-2020,41021,713,861,40160,Europe
Madagascar,03-04-2020,372131,2199,1028,371103,Africa
Malaysia,03-04-2020,418082,1864,1076,417006,Western Pacific
Maldives,03-04-2020,393269,634,212,393057,South-East Asia
Malta,03-04-2020,305848,2092,730,305118,Europe
Mauritania,03-04-2020,434450,1841,1154,433296,Africa
Mauritius,03-04-2020,351375,1954,310,351065,Africa
Mexico,03-04-2020,345554,454,110,345444,Americas
Moldova,03-04-2020,203540,1918,31,203509,Europe
Monaco,03-04-2020,114463,189,86,114377,Europe
Mongolia,03-04-2020,126667,1516,1159,125508,Western Pacific
Montenegro,03-04-2020,414660,857,459,414201,Europe
Morocco,03-04-2020,102651,1566,559,102092,Eastern Mediterranean
Namibia,03-04-2020,387292,1197,92,387200,Africa
Nepal,03-04-2020,226264,564,146,226118,South-East Asia
Netherlands,03-04-2020,137173,127,361,136812,Europe
Netherlands,03-04-2020,78574,958,88,78486,Europe
Netherlands,03-04-2020,81343,1445,164,81179,Europe
Netherlands,03-04-2020,23513,1629,306,23207,Europe
New Zealand,03-04-2020,336808,128,617,336191,Western Pacific
Nicaragua,03-04-2020,80711,1962,597,80114,Americas
Niger,03-04-2020,233913,1241,380,233533,Africa
Nigeria,03-04-2020,426443,1976,1150,425293,Africa
North Macedonia,03-04-2020,230273,374,505,229768,Europe
Norway,03-04-2020,267173,2146,423,266750,Europe
Oman,03-04-2020,11067,2429,178,10889,Eastern Mediterranean
Pakistan,03-04-2020,65140,383,1226,63914,Eastern Mediterranean
Panama,03-04-2020,335440,1366,1032,334408,Americas
Papua New Guinea,03-04-2020,97056,715,1014,96042,Western Pacific
Paraguay,03-04-2020,147586,1029,528,147058,Americas
Peru,03-04-2020,88575,2223,421,88154,Americas
Philippines,03-04-2020,11564,1501,462,11102,Western Pacific
Poland,03-04-2020,276784,946,910,275874,Europe
Portugal,03-04-2020,294321,1506,317,294004,Europe
Qatar,03-04-2020,404206,1473,33,404173,Eastern Mediterranean
Romania,03-04-2020,350201,729,1072,349129,Europe
Russia,03-04-2020,4940,1595,868,4072,Europe
Rwanda,03-04-2020,358830,1017,79,358751,Africa
Saint Lucia,03-04-2020,433237,2423,1138,432099,Americas
Saint Vincent and the Grenadines,03-04-2020,10144,2105,1120,9024,Americas
San Marino,03-04-2020,385417,563,1179,384238,Europe
Saudi Arabia,03-04-2020,123780,1182,149,123631,Eastern Mediterranean
Senegal,03-04-2020,71477,337,241,71236,Africa
Serbia,03-04-2020,250453,1928,676,249777,Europe
Seychelles,03-04-2020,314318,753,348,313970,Africa
Singapore,03-04-2020,95284,664,329,94955,Western Pacific
Slovakia,03-04-2020,269049,137,203,268846,Europe
Slovenia,03-04-2020,374738,945,159,374579,Europe
Somalia,03-04-2020,198570,959,701,197869,Eastern Mediterranean
South Africa,03-04-2020,394798,466,724,394074,Africa
Spain,03-04-2020,321681,1585,1220,320461,Europe
Sri Lanka,03-04-2020,158046,196,669,157377,South-East Asia
Sudan,03-04-2020,266698,2247,471,266227,Eastern Mediterranean
Suriname,03-04-2020,182765,1893,1073,181692,Americas
Sweden,03-04-2020,264274,1026,419,263855,Europe
Switzerland,03-04-2020,20849,1113,839,20010,Europe
Taiwan*,03-04-2020,214168,1465,802,213366,Western Pacific
Tanzania,03-04-2020,433445,1662,628,432817,Africa
Thailand,03-04-2020,278710,1745,348,278362,South-East Asia
Togo,03-04-2020,10545,365,646,9899,Africa
Trinidad and Tobago,03-04-2020,166620,2145,10,166610,Americas
Tunisia,03-04-2020,433564,2426,123,433441,Eastern Mediterranean
Turkey,03-04-2020,2722,881,449,2273,Europe
Uganda,03-04-2020,81434,1435,833,80601,Africa
Ukraine,03-04-2020,344542,553,447,344095,Europe
United Arab Emirates,03-04-2020,31059,2422,887,30172,Eastern Mediterranean
United Kingdom,03-04-2020,395259,872,123,395136,Europe
United Kingdom,03-04-2020,198673,1965,275,198398,Europe
United Kingdom,03-04-2020,426791,1479,152,426639,Europe
United Kingdom,03-04-2020,351600,906,1152,350448,Europe
United Kingdom,03-04-2020,362316,2056,1192,361124,Europe
United Kingdom,03-04-2020,375765,712,737,375028,Europe
United Kingdom,03-04-2020,381802,2050,410,381392,Europe
Uruguay,03-04-2020,149880,229,1145,148735,Americas
US,03-04-2020,30551,1057,401,30150,Americas
Uzbekistan,03-04-2020,338026,2437,469,337557,Europe
Venezuela,03-04-2020,151041,1203,986,150055,Americas
Vietnam,03-04-2020,189259,602,1133,188126,Western Pacific
Zambia,03-04-2020,38249,567,680,37569,Africa
Zimbabwe,03-04-2020,126903,2167,856,126047,Africa
Dominica,03-04-2020,234427,1519,1181,233246,Americas
Grenada,03-04-2020,121136,1311,663,120473,Americas
Mozambique,03-04-2020,213895,2063,851,213044,Africa
Syria,03-04-2020,317492,2193,698,316794,Eastern Mediterranean
Timor-Leste,03-04-2020,18717,1991,1071,17646,South-East Asia
Belize,03-04-2020,386336,2039,442,385894,Americas
Laos,03-04-2020,141416,920,437,140979,Western Pacific
Libya,03-04-2020,103422,818,188,103234,Eastern Mediterranean
West Bank and Gaza,03-04-2020,87753,2213,1212,86541,Eastern Mediterranean
Guinea-Bissau,03-04-2020,159865,195,398,159467,Africa
Mali,03-04-2020,187868,1845,285,187583,Africa
Saint Kitts and Nevis,03-04-2020,197127,1844,93,197034,Americas
Canada,03-04-2020,142899,2354,154,142745,Americas
Canada,03-04-2020,214219,1328,541,213678,Americas
Kosovo,03-04-2020,124471,2500,296,124175,Europe
Burma,03-04-2020,135267,7,275,134992,South-East Asia
United Kingdom,03-04-2020,335984,1287,460,335524,Europe
United Kingdom,03-04-2020,185499,1444,600,184899,Europe
United Kingdom,03-04-2020,109243,1628,151,109092,Europe
Botswana,03-04-2020,315994,689,366,315628,Africa
Burundi,03-04-2020,185505,1102,452,185053,Africa
Sierra Leone,03-04-2020,131623,726,1055,130568,Africa
Malawi,03-04-2020,198772,868,976,197796,Africa
United Kingdom,03-04-2020,18699,506,671,18028,Europe
France,03-04-2020,419110,1713,829,418281,Europe
South Sudan,03-04-2020,289811,1126,589,289222,Africa
Western Sahara,03-04-2020,154197,239,698,153499,Africa
Sao Tome and Principe,03-04-2020,206745,1103,578,206167,Africa
Yemen,03-04-2020,256180,1034,1139,255041,Eastern Mediterranean
Comoros,03-04-2020,30601,1967,955,29646,Africa
Tajikistan,03-04-2020,71980,1290,390,71590,Europe
Lesotho,03-04-2020,146976,1137,0,146976,Africa
Afghanistan,04-04-2020,218599,329,136,218463,Eastern Mediterranean
Albania,04-04-2020,198537,2246,429,198108,Europe
Algeria,04-04-2020,107336,1230,914,106422,Africa
Andorra,04-04-2020,181754,1215,305,181449,Europe
Angola,04-04-2020,289857,1407,112,289745,Africa
Antigua and Barbuda,04-04-2020,284258,1060,3,284255,Americas
Argentina,04-04-2020,390723,1486,126,390597,Americas
Armenia,04-04-2020,239514,1825,180,239334,Europe
Australia,04-04-2020,76370,2094,426,75944,Western Pacific
Australia,04-04-2020,52680,699,178,52502,Western Pacific
Australia,04-04-2020,95247,2432,805,94442,Western Pacific
Australia,04-04-2020,55183,1638,617,54566,Western Pacific
Australia,04-04-2020,112821,1499,465,112356,Western Pacific
Australia,04-04-2020,142588,1951,1199,141389,Western Pacific
Australia,04-04-2020,316923,2252,1022,315901,Western Pacific
Australia,04-04-2020,278403,1298,163,278240,Western Pacific
Austria,04-04-2020,359751,439,774,358977,Europe
Azerbaijan,04-04-2020,106284,260,832,105452,Europe
Bahamas,04-04-2020,54782,2082,306,54476,Americas
Bahrain,04-04-2020,21714,1559,568,21146,Eastern Mediterranean
Bangladesh,04-04-2020,156876,162,31,156845,South-East Asia
Barbados,04-04-2020,331090,389,927,330163,Americas
Belarus,04-04-2020,430187,1656,161,430026,Europe
Belgium,04-04-2020,298948,2136,26,298922,Europe
Benin,04-04-2020,386331,1398,922,385409,Africa
Bhutan,04-04-2020,252129,109,127,252002,South-East Asia
Bolivia,04-04-2020,4436,1368,208,4228,Americas
Bosnia and Herzegovina,04-04-2020,419711,47,1090,418621,Europe
Brazil,04-04-2020,224891,1065,51,224840,Americas
Brunei,04-04-2020,81106,1096,1199,79907,Western Pacific
Bulgaria,04-04-2020,65934,2128,475,65459,Europe
Burkina Faso,04-04-2020,257286,2420,599,256687,Africa
Cabo Verde,04-04-2020,403040,731,1126,401914,Africa
Cambodia,04-04-2020,393838,262,385,393453,Western Pacific
Cameroon,04-04-2020,1295,2328,164,1131,Africa
Canada,04-04-2020,145810,1580,410,145400,Americas
Canada,04-04-2020,433769,692,302,433467,Americas
Canada,04-04-2020,112581,777,660,111921,Americas
Canada,04-04-2020,172286,1033,785,171501,Americas
Canada,04-04-2020,202582,27,130,202452,Americas
Canada,04-04-2020,88170,1518,155,88015,Americas
Canada,04-04-2020,392040,1373,1123,390917,Americas
Canada,04-04-2020,229652,1198,609,229043,Americas
Canada,04-04-2020,69839,175,375,69464,Americas
Canada,04-04-2020,407145,643,795,406350,Americas
Central African Republic,04-04-2020,230394,1269,1008,229386,Africa
Chad,04-04-2020,383283,1903,1014,382269,Africa
Chile,04-04-2020,1755,848,240,1515,Americas
China,04-04-2020,76375,15,306,76069,Western Pacific
China,04-04-2020,31667,209,335,31332,Western Pacific
China,04-04-2020,344688,244,607,344081,Western Pacific
China,04-04-2020,86517,2449,390,86127,Western Pacific
China,04-04-2020,381969,146,84,381885,Western Pacific
China,04-04-2020,39885,457,616,39269,Western Pacific
China,04-04-2020,185898,2396,1136,184762,Western Pacific
China,04-04-2020,69310,91,1206,68104,Western Pacific
China,04-04-2020,75975,300,864,75111,Western Pacific
China,04-04-2020,160356,1358,472,159884,Western Pacific
China,04-04-2020,332987,1610,679,332308,Western Pacific
China,04-04-2020,445829,1089,1061,444768,Western Pacific
China,04-04-2020,70625,713,735,69890,Western Pacific
China,04-04-2020,164073,1925,1010,163063,Western Pacific
China,04-04-2020,281331,1119,28,281303,Western Pacific
China,04-04-2020,234123,1724,1238,232885,Western Pacific
China,04-04-2020,266343,1143,60,266283,Western Pacific
China,04-04-2020,422549,753,373,422176,Western Pacific
China,04-04-2020,86911,1061,301,86610,Western Pacific
China,04-04-2020,177007,189,944,176063,Western Pacific
China,04-04-2020,95020,342,829,94191,Western Pacific
China,04-04-2020,37999,1388,66,37933,Western Pacific
China,04-04-2020,269413,856,847,268566,Western Pacific
China,04-04-2020,352626,1987,778,351848,Western Pacific
China,04-04-2020,77260,1885,80,77180,Western Pacific
China,04-04-2020,328177,1767,1065,327112,Western Pacific
China,04-04-2020,444928,115,1232,443696,Western Pacific
China,04-04-2020,241945,1353,622,241323,Western Pacific
China,04-04-2020,251490,1125,1154,250336,Western Pacific
China,04-04-2020,97103,940,290,96813,Western Pacific
China,04-04-2020,349123,1649,248,348875,Western Pacific
China,04-04-2020,289401,1906,844,288557,Western Pacific
China,04-04-2020,88062,1822,1180,86882,Western Pacific
Colombia,04-04-2020,218720,1276,1057,217663,Americas
Congo (Brazzaville),04-04-2020,40899,1156,945,39954,Africa
Congo (Kinshasa),04-04-2020,412756,2042,649,412107,Africa
Costa Rica,04-04-2020,207150,879,514,206636,Americas
Cote d'Ivoire,04-04-2020,36516,1710,735,35781,Africa
Croatia,04-04-2020,259597,599,112,259485,Europe
Cuba,04-04-2020,263347,1457,589,262758,Americas
Cyprus,04-04-2020,381247,1036,302,380945,Europe
Czechia,04-04-2020,249409,1495,509,248900,Europe
Denmark,04-04-2020,274168,531,471,273697,Europe
Greenland,04-04-2020,439925,254,397,439528,Europe
Denmark,04-04-2020,296345,594,714,295631,Europe
Djibouti,04-04-2020,98132,113,512,97620,Eastern Mediterranean
Dominican Republic,04-04-2020,305499,1706,959,304540,Americas
Ecuador,04-04-2020,182548,441,656,181892,Americas
Egypt,04-04-2020,349485,2235,1138,348347,Eastern Mediterranean
El Salvador,04-04-2020,406407,1770,402,406005,Americas
Equatorial Guinea,04-04-2020,380672,2076,594,380078,Africa
Eritrea,04-04-2020,343116,1196,222,342894,Africa
Estonia,04-04-2020,240741,5,865,239876,Europe
Eswatini,04-04-2020,150956,2304,377,150579,Africa
Ethiopia,04-04-2020,37811,1420,8,37803,Africa
Fiji,04-04-2020,420213,2309,989,419224,Western Pacific
Finland,04-04-2020,1912,442,1184,728,Europe
France,04-04-2020,347710,1877,740,346970,Europe
France,04-04-2020,364617,663,985,363632,Europe
France,04-04-2020,123050,234,320,122730,Europe
France,04-04-2020,443172,1607,1229,441943,Europe
France,04-04-2020,106059,1568,1156,104903,Europe
France,04-04-2020,253955,1003,659,253296,Europe
France,04-04-2020,390535,1910,1236,389299,Europe
France,04-04-2020,75737,1818,1006,74731,Europe
France,04-04-2020,30702,1019,129,30573,Europe
France,04-04-2020,438871,98,154,438717,Europe
Gabon,04-04-2020,69209,232,1199,68010,Africa
Gambia,04-04-2020,302294,1038,251,302043,Africa
Georgia,04-04-2020,310144,1696,794,309350,Europe
Germany,04-04-2020,365242,175,465,364777,Europe
Ghana,04-04-2020,111853,1106,325,111528,Africa
Greece,04-04-2020,32412,2260,73,32339,Europe
Guatemala,04-04-2020,112000,1955,102,111898,Americas
Guinea,04-04-2020,312696,603,1055,311641,Africa
Guyana,04-04-2020,194578,851,976,193602,Americas
Haiti,04-04-2020,77708,1054,360,77348,Americas
Holy See,04-04-2020,268570,1526,75,268495,Europe
Honduras,04-04-2020,144895,1643,72,144823,Americas
Hungary,04-04-2020,354010,956,656,353354,Europe
Iceland,04-04-2020,187532,1166,742,186790,Europe
India,04-04-2020,301052,484,262,300790,South-East Asia
Indonesia,04-04-2020,40646,285,543,40103,South-East Asia
Iran,04-04-2020,147068,453,1014,146054,Eastern Mediterranean
Iraq,04-04-2020,57701,527,765,56936,Eastern Mediterranean
Ireland,04-04-2020,222174,1600,1112,221062,Europe
Israel,04-04-2020,369934,493,1204,368730,Europe
Italy,04-04-2020,367354,1479,973,366381,Europe
Jamaica,04-04-2020,380275,995,851,379424,Americas
Japan,04-04-2020,169212,1345,978,168234,Western Pacific
Jordan,04-04-2020,124796,2314,1224,123572,Eastern Mediterranean
Kazakhstan,04-04-2020,402995,1530,285,402710,Europe
Kenya,04-04-2020,49099,1633,517,48582,Africa
South Korea,04-04-2020,281144,1134,1038,280106,Western Pacific
Kuwait,04-04-2020,117922,398,1123,116799,Eastern Mediterranean
Kyrgyzstan,04-04-2020,324097,934,1204,322893,Europe
Latvia,04-04-2020,437909,365,224,437685,Europe
Lebanon,04-04-2020,269887,1617,1215,268672,Eastern Mediterranean
Liberia,04-04-2020,445234,2095,52,445182,Africa
Liechtenstein,04-04-2020,63886,1219,921,62965,Europe
Lithuania,04-04-2020,101599,2150,622,100977,Europe
Luxembourg,04-04-2020,11098,1954,562,10536,Europe
Madagascar,04-04-2020,299636,2356,229,299407,Africa
Malaysia,04-04-2020,207917,860,37,207880,Western Pacific
Maldives,04-04-2020,418797,1897,1205,417592,South-East Asia
Malta,04-04-2020,12026,1062,1052,10974,Europe
Mauritania,04-04-2020,440145,405,159,439986,Africa
Mauritius,04-04-2020,358504,94,274,358230,Africa
Mexico,04-04-2020,362411,108,296,362115,Americas
Moldova,04-04-2020,345437,775,558,344879,Europe
Monaco,04-04-2020,121108,876,146,120962,Europe
Mongolia,04-04-2020,165991,251,811,165180,Western Pacific
Montenegro,04-04-2020,352125,1521,595,351530,Europe
Morocco,04-04-2020,120667,2069,1088,119579,Eastern Mediterranean
Namibia,04-04-2020,7954,259,339,7615,Africa
Nepal,04-04-2020,438828,1569,0,438828,South-East Asia
Netherlands,04-04-2020,237856,763,95,237761,Europe
Netherlands,04-04-2020,287219,763,578,286641,Europe
Netherlands,04-04-2020,436977,2357,1031,435946,Europe
Netherlands,04-04-2020,36823,1317,606,36217,Europe
New Zealand,04-04-2020,160791,1675,1094,159697,Western Pacific
Nicaragua,04-04-2020,190109,1041,723,189386,Americas
Niger,04-04-2020,101793,1763,176,101617,Africa
Nigeria,04-04-2020,26236,1517,947,25289,Africa
North Macedonia,04-04-2020,280727,425,1047,279680,Europe
Norway,04-04-2020,1664,1823,979,685,Europe
Oman,04-04-2020,44314,2300,26,44288,Eastern Mediterranean
Pakistan,04-04-2020,221555,580,1065,220490,Eastern Mediterranean
Panama,04-04-2020,59723,1526,954,58769,Americas
Papua New Guinea,04-04-2020,391406,979,216,391190,Western Pacific
Paraguay,04-04-2020,285953,2164,426,285527,Americas
Peru,04-04-2020,327840,1226,342,327498,Americas
Philippines,04-04-2020,313399,753,649,312750,Western Pacific
Poland,04-04-2020,145005,404,895,144110,Europe
Portugal,04-04-2020,86765,499,529,86236,Europe
Qatar,04-04-2020,268555,1238,1017,267538,Eastern Mediterranean
Romania,04-04-2020,195462,1626,238,195224,Europe
Russia,04-04-2020,88403,1093,682,87721,Europe
Rwanda,04-04-2020,225852,1235,1250,224602,Africa
Saint Lucia,04-04-2020,399253,234,986,398267,Americas
Saint Vincent and the Grenadines,04-04-2020,156128,1412,1193,154935,Americas
San Marino,04-04-2020,397206,1769,249,396957,Europe
Saudi Arabia,04-04-2020,397314,1352,423,396891,Eastern Mediterranean
Senegal,04-04-2020,96849,2348,1165,95684,Africa
Serbia,04-04-2020,107747,3,53,107694,Europe
Seychelles,04-04-2020,344288,790,402,343886,Africa
Singapore,04-04-2020,30108,2417,1202,28906,Western Pacific
Slovakia,04-04-2020,122197,92,595,121602,Europe
Slovenia,04-04-2020,201834,1728,691,201143,Europe
Somalia,04-04-2020,441950,458,407,441543,Eastern Mediterranean
South Africa,04-04-2020,283694,1427,248,283446,Africa
Spain,04-04-2020,203280,2439,787,202493,Europe
Sri Lanka,04-04-2020,304797,1766,963,303834,South-East Asia
Sudan,04-04-2020,91280,1946,157,91123,Eastern Mediterranean
Suriname,04-04-2020,236414,1389,544,235870,Americas
Sweden,04-04-2020,399607,2340,61,399546,Europe
Switzerland,04-04-2020,264542,1887,1127,263415,Europe
Taiwan*,04-04-2020,298690,1171,148,298542,Western Pacific
Tanzania,04-04-2020,42426,264,914,41512,Africa
Thailand,04-04-2020,178977,1461,1142,177835,South-East Asia
Togo,04-04-2020,383688,570,328,383360,Africa
Trinidad and Tobago,04-04-2020,346439,1456,1176,345263,Americas
Tunisia,04-04-2020,424528,2050,631,423897,Eastern Mediterranean
Turkey,04-04-2020,417938,1533,674,417264,Europe
Uganda,04-04-2020,133393,1000,564,132829,Africa
Ukraine,04-04-2020,144045,2026,711,143334,Europe
United Arab Emirates,04-04-2020,39731,426,190,39541,Eastern Mediterranean
United Kingdom,04-04-2020,69255,1807,501,68754,Europe
United Kingdom,04-04-2020,24802,1771,743,24059,Europe
United Kingdom,04-04-2020,8385,1310,1129,7256,Europe
United Kingdom,04-04-2020,66258,264,1107,65151,Europe
United Kingdom,04-04-2020,390388,1264,1246,389142,Europe
United Kingdom,04-04-2020,40765,407,446,40319,Europe
United Kingdom,04-04-2020,79891,175,1171,78720,Europe
Uruguay,04-04-2020,331651,1605,81,331570,Americas
US,04-04-2020,319269,1532,1086,318183,Americas
Uzbekistan,04-04-2020,352791,169,40,352751,Europe
Venezuela,04-04-2020,198931,366,706,198225,Americas
Vietnam,04-04-2020,420678,2450,750,419928,Western Pacific
Zambia,04-04-2020,55701,2297,111,55590,Africa
Zimbabwe,04-04-2020,297551,2218,301,297250,Africa
Dominica,04-04-2020,164417,1996,485,163932,Americas
Grenada,04-04-2020,231956,287,1112,230844,Americas
Mozambique,04-04-2020,367655,397,447,367208,Africa
Syria,04-04-2020,144673,986,963,143710,Eastern Mediterranean
Timor-Leste,04-04-2020,419527,2084,840,418687,South-East Asia
Belize,04-04-2020,422588,1990,1119,421469,Americas
Laos,04-04-2020,369313,2176,649,368664,Western Pacific
Libya,04-04-2020,56112,367,58,56054,Eastern Mediterranean
West Bank and Gaza,04-04-2020,275168,1243,1186,273982,Eastern Mediterranean
Guinea-Bissau,04-04-2020,404367,707,919,403448,Africa
Mali,04-04-2020,167703,2217,187,167516,Africa
Saint Kitts and Nevis,04-04-2020,134549,1190,945,133604,Americas
Canada,04-04-2020,223520,1277,1232,222288,Americas
Canada,04-04-2020,31650,1951,935,30715,Americas
Kosovo,04-04-2020,265830,1623,694,265136,Europe
Burma,04-04-2020,96988,1040,280,96708,South-East Asia
United Kingdom,04-04-2020,158840,100,260,158580,Europe
United Kingdom,04-04-2020,157733,1606,967,156766,Europe
United Kingdom,04-04-2020,189184,406,455,188729,Europe
Botswana,04-04-2020,14903,1614,499,14404,Africa
Burundi,04-04-2020,166979,2284,151,166828,Africa
Sierra Leone,04-04-2020,368627,1250,760,367867,Africa
Malawi,04-04-2020,78020,2165,830,77190,Africa
United Kingdom,04-04-2020,191280,2450,864,190416,Europe
France,04-04-2020,203850,2091,104,203746,Europe
South Sudan,04-04-2020,347368,935,770,346598,Africa
Western Sahara,04-04-2020,418165,17,132,418033,Africa
Sao Tome and Principe,04-04-2020,64442,32,483,63959,Africa
Yemen,04-04-2020,36831,175,1073,35758,Eastern Mediterranean
Comoros,04-04-2020,330092,2076,408,329684,Africa
Tajikistan,04-04-2020,110945,2085,450,110495,Europe
Lesotho,04-04-2020,359349,709,611,358738,Africa
Afghanistan,05-04-2020,309439,747,1134,308305,Eastern Mediterranean
Albania,05-04-2020,398956,547,480,398476,Europe
Algeria,05-04-2020,253906,1676,529,253377,Africa
Andorra,05-04-2020,297012,1480,789,296223,Europe
Angola,05-04-2020,181945,1538,361,181584,Africa
Antigua and Barbuda,05-04-2020,197366,1091,1233,196133,Americas
Argentina,05-04-2020,360740,1191,597,360143,Americas
Armenia,05-04-2020,206692,2419,434,206258,Europe
Australia,05-04-2020,135642,1131,23,135619,Western Pacific
Australia,05-04-2020,388055,46,1127,386928,Western Pacific
Australia,05-04-2020,229863,572,632,229231,Western Pacific
Australia,05-04-2020,316422,1955,948,315474,Western Pacific
Australia,05-04-2020,303115,1851,319,302796,Western Pacific
Australia,05-04-2020,276530,16,406,276124,Western Pacific
Australia,05-04-2020,36021,1237,1105,34916,Western Pacific
Australia,05-04-2020,365480,2135,860,364620,Western Pacific
Austria,05-04-2020,325650,1264,187,325463,Europe
Azerbaijan,05-04-2020,215904,826,362,215542,Europe
Bahamas,05-04-2020,121845,1503,324,121521,Americas
Bahrain,05-04-2020,62457,1697,1155,61302,Eastern Mediterranean
Bangladesh,05-04-2020,430199,1645,963,429236,South-East Asia
Barbados,05-04-2020,383448,2069,494,382954,Americas
Belarus,05-04-2020,378530,1355,1060,377470,Europe
Belgium,05-04-2020,167044,2253,502,166542,Europe
Benin,05-04-2020,294651,1939,18,294633,Africa
Bhutan,05-04-2020,217584,2131,938,216646,South-East Asia
Bolivia,05-04-2020,443883,1990,718,443165,Americas
Bosnia and Herzegovina,05-04-2020,316410,1670,749,315661,Europe
Brazil,05-04-2020,22441,2164,415,22026,Americas
Brunei,05-04-2020,253396,808,757,252639,Western Pacific
Bulgaria,05-04-2020,206142,624,777,205365,Europe
Burkina Faso,05-04-2020,319483,2175,1176,318307,Africa
Cabo Verde,05-04-2020,321332,228,1003,320329,Africa
Cambodia,05-04-2020,41079,1803,353,40726,Western Pacific
Cameroon,05-04-2020,308038,2189,1012,307026,Africa
Canada,05-04-2020,272769,1314,32,272737,Americas
Canada,05-04-2020,418054,308,605,417449,Americas
Canada,05-04-2020,207618,1435,383,207235,Americas
Canada,05-04-2020,380340,844,1212,379128,Americas
Canada,05-04-2020,418860,2462,609,418251,Americas
Canada,05-04-2020,435284,1575,1192,434092,Americas
Canada,05-04-2020,299032,2462,835,298197,Americas
Canada,05-04-2020,68285,649,857,67428,Americas
Canada,05-04-2020,105098,2465,814,104284,Americas
Canada,05-04-2020,339531,2221,664,338867,Americas
Central African Republic,05-04-2020,277112,203,1234,275878,Africa
Chad,05-04-2020,160927,1450,948,159979,Africa
Chile,05-04-2020,194193,1715,790,193403,Americas
China,05-04-2020,62153,386,370,61783,Western Pacific
China,05-04-2020,388267,2298,830,387437,Western Pacific
China,05-04-2020,276648,1838,1033,275615,Western Pacific
China,05-04-2020,142812,1427,202,142610,Western Pacific
China,05-04-2020,177368,205,540,176828,Western Pacific
China,05-04-2020,253606,187,962,252644,Western Pacific
China,05-04-2020,146722,2101,873,145849,Western Pacific
China,05-04-2020,264381,748,320,264061,Western Pacific
China,05-04-2020,216811,1865,826,215985,Western Pacific
China,05-04-2020,235852,1345,861,234991,Western Pacific
China,05-04-2020,412356,93,432,411924,Western Pacific
China,05-04-2020,3902,1748,893,3009,Western Pacific
China,05-04-2020,284662,17,857,283805,Western Pacific
China,05-04-2020,218546,1130,970,217576,Western Pacific
China,05-04-2020,54534,912,293,54241,Western Pacific
China,05-04-2020,211634,145,190,211444,Western Pacific
China,05-04-2020,348043,1879,16,348027,Western Pacific
China,05-04-2020,143021,1200,736,142285,Western Pacific
China,05-04-2020,92364,1299,860,91504,Western Pacific
China,05-04-2020,221929,898,1156,220773,Western Pacific
China,05-04-2020,227107,284,151,226956,Western Pacific
China,05-04-2020,194121,565,907,193214,Western Pacific
China,05-04-2020,183727,1658,456,183271,Western Pacific
China,05-04-2020,217189,1787,666,216523,Western Pacific
China,05-04-2020,166247,1048,712,165535,Western Pacific
China,05-04-2020,340108,1939,883,339225,Western Pacific
China,05-04-2020,94800,990,270,94530,Western Pacific
China,05-04-2020,178464,1774,454,178010,Western Pacific
China,05-04-2020,391104,1420,1216,389888,Western Pacific
China,05-04-2020,266215,1264,423,265792,Western Pacific
China,05-04-2020,12649,1805,954,11695,Western Pacific
China,05-04-2020,71612,1871,1115,70497,Western Pacific
China,05-04-2020,406079,1915,548,405531,Western Pacific
Colombia,05-04-2020,58649,1395,80,58569,Americas
Congo (Brazzaville),05-04-2020,275983,605,1143,274840,Africa
Congo (Kinshasa),05-04-2020,46965,689,876,46089,Africa
Costa Rica,05-04-2020,226856,1422,76,226780,Americas
Cote d'Ivoire,05-04-2020,61985,635,702,61283,Africa
Croatia,05-04-2020,211036,1137,589,210447,Europe
Cuba,05-04-2020,117722,1127,865,116857,Americas
Cyprus,05-04-2020,431797,2393,796,431001,Europe
Czechia,05-04-2020,184161,30,443,183718,Europe
Denmark,05-04-2020,414029,2155,254,413775,Europe
Greenland,05-04-2020,73383,1475,426,72957,Europe
Denmark,05-04-2020,45418,1881,60,45358,Europe
Djibouti,05-04-2020,288608,1119,363,288245,Eastern Mediterranean
Dominican Republic,05-04-2020,247419,1177,466,246953,Americas
Ecuador,05-04-2020,71622,1489,867,70755,Americas
Egypt,05-04-2020,316470,572,964,315506,Eastern Mediterranean
El Salvador,05-04-2020,151164,598,1168,149996,Americas
Equatorial Guinea,05-04-2020,166573,1789,118,166455,Africa
Eritrea,05-04-2020,47650,1110,834,46816,Africa
Estonia,05-04-2020,154878,1272,1194,153684,Europe
Eswatini,05-04-2020,258115,2227,389,257726,Africa
Ethiopia,05-04-2020,77273,1961,955,76318,Africa
Fiji,05-04-2020,68719,969,520,68199,Western Pacific
Finland,05-04-2020,149203,2374,150,149053,Europe
France,05-04-2020,97389,1974,1155,96234,Europe
France,05-04-2020,30714,1365,443,30271,Europe
France,05-04-2020,358951,1415,525,358426,Europe
France,05-04-2020,433385,486,678,432707,Europe
France,05-04-2020,177457,1946,419,177038,Europe
France,05-04-2020,25302,838,450,24852,Europe
France,05-04-2020,319142,193,59,319083,Europe
France,05-04-2020,260487,348,705,259782,Europe
France,05-04-2020,26141,1831,18,26123,Europe
France,05-04-2020,122816,103,194,122622,Europe
Gabon,05-04-2020,444827,928,772,444055,Africa
Gambia,05-04-2020,346605,2425,1193,345412,Africa
Georgia,05-04-2020,205296,509,71,205225,Europe
Germany,05-04-2020,67208,1472,1116,66092,Europe
Ghana,05-04-2020,410623,1771,1064,409559,Africa
Greece,05-04-2020,403435,1082,142,403293,Europe
Guatemala,05-04-2020,92999,1007,469,92530,Americas
Guinea,05-04-2020,87310,829,564,86746,Africa
Guyana,05-04-2020,327754,2134,1092,326662,Americas
Haiti,05-04-2020,275836,486,708,275128,Americas
Holy See,05-04-2020,303253,1003,1010,302243,Europe
Honduras,05-04-2020,289201,1447,159,289042,Americas
Hungary,05-04-2020,45246,1546,1069,44177,Europe
Iceland,05-04-2020,255276,1672,1246,254030,Europe
India,05-04-2020,68430,758,847,67583,South-East Asia
Indonesia,05-04-2020,223832,2080,1115,222717,South-East Asia
Iran,05-04-2020,378594,784,897,377697,Eastern Mediterranean
Iraq,05-04-2020,370505,562,471,370034,Eastern Mediterranean
Ireland,05-04-2020,219968,2471,54,219914,Europe
Israel,05-04-2020,192964,844,1120,191844,Europe
Italy,05-04-2020,220592,2151,541,220051,Europe
Jamaica,05-04-2020,132946,467,475,132471,Americas
Japan,05-04-2020,383579,1358,1240,382339,Western Pacific
Jordan,05-04-2020,370188,1761,823,369365,Eastern Mediterranean
Kazakhstan,05-04-2020,107471,941,454,107017,Europe
Kenya,05-04-2020,53796,612,403,53393,Africa
South Korea,05-04-2020,301336,2334,423,300913,Western Pacific
Kuwait,05-04-2020,287027,1317,564,286463,Eastern Mediterranean
Kyrgyzstan,05-04-2020,416245,294,692,415553,Europe
Latvia,05-04-2020,365451,2131,1007,364444,Europe
Lebanon,05-04-2020,106874,1253,29,106845,Eastern Mediterranean
Liberia,05-04-2020,127846,95,528,127318,Africa
Liechtenstein,05-04-2020,427663,1819,696,426967,Europe
Lithuania,05-04-2020,255544,1475,617,254927,Europe
Luxembourg,05-04-2020,202498,5,314,202184,Europe
Madagascar,05-04-2020,43930,687,477,43453,Africa
Malaysia,05-04-2020,365772,1436,436,365336,Western Pacific
Maldives,05-04-2020,3992,323,404,3588,South-East Asia
Malta,05-04-2020,109050,273,424,108626,Europe
Mauritania,05-04-2020,416293,364,823,415470,Africa
Mauritius,05-04-2020,37519,1211,58,37461,Africa
Mexico,05-04-2020,344362,89,779,343583,Americas
Moldova,05-04-2020,189514,2396,1135,188379,Europe
Monaco,05-04-2020,412763,90,95,412668,Europe
Mongolia,05-04-2020,267265,217,1232,266033,Western Pacific
Montenegro,05-04-2020,315273,2253,199,315074,Europe
Morocco,05-04-2020,94088,1412,283,93805,Eastern Mediterranean
Namibia,05-04-2020,196234,1774,238,195996,Africa
Nepal,05-04-2020,250351,1964,294,250057,South-East Asia
Netherlands,05-04-2020,188194,582,502,187692,Europe
Netherlands,05-04-2020,428929,1332,826,428103,Europe
Netherlands,05-04-2020,320415,1013,732,319683,Europe
Netherlands,05-04-2020,198782,1899,891,197891,Europe
New Zealand,05-04-2020,106574,395,329,106245,Western Pacific
Nicaragua,05-04-2020,70119,702,968,69151,Americas
Niger,05-04-2020,320901,1226,910,319991,Africa
Nigeria,05-04-2020,165289,2247,1222,164067,Africa
North Macedonia,05-04-2020,184695,2035,692,184003,Europe
Norway,05-04-2020,170144,1779,1087,169057,Europe
Oman,05-04-2020,27762,1378,93,27669,Eastern Mediterranean
Pakistan,05-04-2020,174622,1847,896,173726,Eastern Mediterranean
Panama,05-04-2020,156550,731,611,155939,Americas
Papua New Guinea,05-04-2020,348649,1965,1188,347461,Western Pacific
Paraguay,05-04-2020,352111,2068,456,351655,Americas
Peru,05-04-2020,64750,1706,844,63906,Americas
Philippines,05-04-2020,347542,1265,409,347133,Western Pacific
Poland,05-04-2020,29736,2208,1242,28494,Europe
Portugal,05-04-2020,362181,88,267,361914,Europe
Qatar,05-04-2020,299261,2218,1108,298153,Eastern Mediterranean
Romania,05-04-2020,262912,874,1008,261904,Europe
Russia,05-04-2020,170816,1856,327,170489,Europe
Rwanda,05-04-2020,136816,2347,405,136411,Africa
Saint Lucia,05-04-2020,441770,539,715,441055,Americas
Saint Vincent and the Grenadines,05-04-2020,283888,2287,587,283301,Americas
San Marino,05-04-2020,143730,1838,118,143612,Europe
Saudi Arabia,05-04-2020,51896,1055,9,51887,Eastern Mediterranean
Senegal,05-04-2020,41851,832,848,41003,Africa
Serbia,05-04-2020,337755,1383,366,337389,Europe
Seychelles,05-04-2020,13188,1770,1004,12184,Africa
Singapore,05-04-2020,401870,2333,416,401454,Western Pacific
Slovakia,05-04-2020,168406,1180,901,167505,Europe
Slovenia,05-04-2020,402791,1721,702,402089,Europe
Somalia,05-04-2020,322715,202,378,322337,Eastern Mediterranean
South Africa,05-04-2020,203110,949,788,202322,Africa
Spain,05-04-2020,392871,85,1222,391649,Europe
Sri Lanka,05-04-2020,43230,3,1155,42075,South-East Asia
Sudan,05-04-2020,70170,257,133,70037,Eastern Mediterranean
Suriname,05-04-2020,76411,897,274,76137,Americas
Sweden,05-04-2020,277985,1462,521,277464,Europe
Switzerland,05-04-2020,348450,1815,1161,347289,Europe
Taiwan*,05-04-2020,17262,1875,894,16368,Western Pacific
Tanzania,05-04-2020,167600,538,1111,166489,Africa
Thailand,05-04-2020,32201,2121,1245,30956,South-East Asia
Togo,05-04-2020,93313,2258,731,92582,Africa
Trinidad and Tobago,05-04-2020,357603,629,58,357545,Americas
Tunisia,05-04-2020,336077,2002,911,335166,Eastern Mediterranean
Turkey,05-04-2020,161318,288,733,160585,Europe
Uganda,05-04-2020,47199,2089,915,46284,Africa
Ukraine,05-04-2020,18508,1946,873,17635,Europe
United Arab Emirates,05-04-2020,274740,70,744,273996,Eastern Mediterranean
United Kingdom,05-04-2020,44874,426,1196,43678,Europe
United Kingdom,05-04-2020,184214,734,982,183232,Europe
United Kingdom,05-04-2020,182687,2319,1070,181617,Europe
United Kingdom,05-04-2020,271015,1003,648,270367,Europe
United Kingdom,05-04-2020,357950,6,372,357578,Europe
United Kingdom,05-04-2020,408916,186,952,407964,Europe
United Kingdom,05-04-2020,356682,1564,934,355748,Europe
Uruguay,05-04-2020,396414,1406,298,396116,Americas
US,05-04-2020,334966,53,1131,333835,Americas
Uzbekistan,05-04-2020,431018,1526,437,430581,Europe
Venezuela,05-04-2020,131592,1159,383,131209,Americas
Vietnam,05-04-2020,153433,160,15,153418,Western Pacific
Zambia,05-04-2020,76496,1481,33,76463,Africa
Zimbabwe,05-04-2020,146999,2350,497,146502,Africa
Dominica,05-04-2020,397664,833,879,396785,Americas
Grenada,05-04-2020,84807,533,730,84077,Americas
Mozambique,05-04-2020,21539,1464,207,21332,Africa
Syria,05-04-2020,233774,2197,285,233489,Eastern Mediterranean
Timor-Leste,05-04-2020,78747,2412,354,78393,South-East Asia
Belize,05-04-2020,438485,2033,581,437904,Americas
Laos,05-04-2020,158279,1220,1205,157074,Western Pacific
Libya,05-04-2020,406730,1748,668,406062,Eastern Mediterranean
West Bank and Gaza,05-04-2020,149106,30,981,148125,Eastern Mediterranean
Guinea-Bissau,05-04-2020,197247,882,392,196855,Africa
Mali,05-04-2020,128225,77,68,128157,Africa
Saint Kitts and Nevis,05-04-2020,372813,972,53,372760,Americas
Canada,05-04-2020,10693,1476,237,10456,Americas
Canada,05-04-2020,67677,1906,192,67485,Americas
Kosovo,05-04-2020,186056,2154,576,185480,Europe
Burma,05-04-2020,243083,390,769,242314,South-East Asia
United Kingdom,05-04-2020,326262,1780,1096,325166,Europe
United Kingdom,05-04-2020,424930,1621,821,424109,Europe
United Kingdom,05-04-2020,114864,1273,22,114842,Europe
Botswana,05-04-2020,127635,849,1159,126476,Africa
Burundi,05-04-2020,247462,2104,630,246832,Africa
Sierra Leone,05-04-2020,223896,299,737,223159,Africa
Malawi,05-04-2020,347717,472,781,346936,Africa
United Kingdom,05-04-2020,56816,1499,766,56050,Europe
France,05-04-2020,18332,1446,130,18202,Europe
South Sudan,05-04-2020,235430,2044,920,234510,Africa
Western Sahara,05-04-2020,221042,1660,3,221039,Africa
Sao Tome and Principe,05-04-2020,366028,529,936,365092,Africa
Yemen,05-04-2020,92622,2007,654,91968,Eastern Mediterranean
Comoros,05-04-2020,64385,1741,510,63875,Africa
Tajikistan,05-04-2020,317362,412,137,317225,Europe
Lesotho,05-04-2020,217183,1808,1104,216079,Africa
Afghanistan,06-04-2020,321618,854,99,321519,Eastern Mediterranean
Albania,06-04-2020,295812,1783,141,295671,Europe
Algeria,06-04-2020,74895,601,6,74889,Africa
Andorra,06-04-2020,278095,1219,417,277678,Europe
Angola,06-04-2020,118007,1075,800,117207,Africa
Antigua and Barbuda,06-04-2020,270246,187,88,270158,Americas
Argentina,06-04-2020,443712,945,1067,442645,Americas
Armenia,06-04-2020,247919,2140,226,247693,Europe
Australia,06-04-2020,302653,619,598,302055,Western Pacific
Australia,06-04-2020,389148,203,847,388301,Western Pacific
Australia,06-04-2020,156715,1325,324,156391,Western Pacific
Australia,06-04-2020,54808,1982,283,54525,Western Pacific
Australia,06-04-2020,282829,1218,935,281894,Western Pacific
Australia,06-04-2020,32050,1492,1036,31014,Western Pacific
Australia,06-04-2020,74954,490,1105,73849,Western Pacific
Australia,06-04-2020,143092,9,1105,141987,Western Pacific
Austria,06-04-2020,433657,2376,974,432683,Europe
Azerbaijan,06-04-2020,255658,2471,543,255115,Europe
Bahamas,06-04-2020,84917,274,146,84771,Americas
Bahrain,06-04-2020,360024,1986,607,359417,Eastern Mediterranean
Bangladesh,06-04-2020,109993,1240,157,109836,South-East Asia
Barbados,06-04-2020,129555,1900,1039,128516,Americas
Belarus,06-04-2020,224746,1649,897,223849,Europe
Belgium,06-04-2020,7361,44,1053,6308,Europe
Benin,06-04-2020,287136,1748,142,286994,Africa
Bhutan,06-04-2020,232501,465,842,231659,South-East Asia
Bolivia,06-04-2020,330502,1515,432,330070,Americas
Bosnia and Herzegovina,06-04-2020,229052,1029,1049,228003,Europe
Brazil,06-04-2020,229491,1006,1051,228440,Americas
Brunei,06-04-2020,263122,88,651,262471,Western Pacific
Bulgaria,06-04-2020,46615,2226,21,46594,Europe
Burkina Faso,06-04-2020,242460,409,333,242127,Africa
Cabo Verde,06-04-2020,270723,2306,208,270515,Africa
Cambodia,06-04-2020,325449,508,796,324653,Western Pacific
Cameroon,06-04-2020,25941,694,376,25565,Africa
Canada,06-04-2020,241773,261,82,241691,Americas
Canada,06-04-2020,9731,1808,665,9066,Americas
Canada,06-04-2020,228635,395,257,228378,Americas
Canada,06-04-2020,406641,429,560,406081,Americas
Canada,06-04-2020,256845,307,587,256258,Americas
Canada,06-04-2020,55331,2159,1106,54225,Americas
Canada,06-04-2020,231596,106,135,231461,Americas
Canada,06-04-2020,116114,1173,255,115859,Americas
Canada,06-04-2020,226891,517,1118,225773,Americas
Canada,06-04-2020,159442,758,887,158555,Americas
Central African Republic,06-04-2020,281191,2432,673,280518,Africa
Chad,06-04-2020,205680,1371,648,205032,Africa
Chile,06-04-2020,191463,1592,1125,190338,Americas
China,06-04-2020,227608,756,896,226712,Western Pacific
China,06-04-2020,207232,443,66,207166,Western Pacific
China,06-04-2020,325237,341,1033,324204,Western Pacific
China,06-04-2020,109740,945,5,109735,Western Pacific
China,06-04-2020,431807,1460,1138,430669,Western Pacific
China,06-04-2020,219957,1320,353,219604,Western Pacific
China,06-04-2020,187914,280,970,186944,Western Pacific
China,06-04-2020,191855,193,437,191418,Western Pacific
China,06-04-2020,387829,1761,1153,386676,Western Pacific
China,06-04-2020,13788,1446,1177,12611,Western Pacific
China,06-04-2020,351728,329,1024,350704,Western Pacific
China,06-04-2020,356063,1970,82,355981,Western Pacific
China,06-04-2020,5426,1972,23,5403,Western Pacific
China,06-04-2020,33483,2022,768,32715,Western Pacific
China,06-04-2020,237991,29,19,237972,Western Pacific
China,06-04-2020,302852,2046,907,301945,Western Pacific
China,06-04-2020,212020,555,811,211209,Western Pacific
China,06-04-2020,342971,1497,734,342237,Western Pacific
China,06-04-2020,41318,439,1166,40152,Western Pacific
China,06-04-2020,445760,658,848,444912,Western Pacific
China,06-04-2020,22271,843,625,21646,Western Pacific
China,06-04-2020,332624,1895,612,332012,Western Pacific
China,06-04-2020,70087,1347,44,70043,Western Pacific
China,06-04-2020,390329,2426,853,389476,Western Pacific
China,06-04-2020,89476,698,133,89343,Western Pacific
China,06-04-2020,148264,1583,679,147585,Western Pacific
China,06-04-2020,432309,930,469,431840,Western Pacific
China,06-04-2020,77511,1623,356,77155,Western Pacific
China,06-04-2020,215795,2182,643,215152,Western Pacific
China,06-04-2020,27852,196,645,27207,Western Pacific
China,06-04-2020,178210,1167,474,177736,Western Pacific
China,06-04-2020,342370,1213,593,341777,Western Pacific
China,06-04-2020,449069,858,414,448655,Western Pacific
Colombia,06-04-2020,129269,1421,416,128853,Americas
Congo (Brazzaville),06-04-2020,156194,1316,140,156054,Africa
Congo (Kinshasa),06-04-2020,246719,90,785,245934,Africa
Costa Rica,06-04-2020,61134,999,518,60616,Americas
Cote d'Ivoire,06-04-2020,319777,181,78,319699,Africa
Croatia,06-04-2020,384751,1393,1209,383542,Europe
Cuba,06-04-2020,300532,1916,1166,299366,Americas
Cyprus,06-04-2020,449783,1808,594,449189,Europe
Czechia,06-04-2020,181142,117,412,180730,Europe
Denmark,06-04-2020,125309,2221,975,124334,Europe
Greenland,06-04-2020,426977,1757,793,426184,Europe
Denmark,06-04-2020,236428,1632,263,236165,Europe
Djibouti,06-04-2020,189493,782,87,189406,Eastern Mediterranean
Dominican Republic,06-04-2020,302030,1713,178,301852,Americas
Ecuador,06-04-2020,397781,788,763,397018,Americas
Egypt,06-04-2020,299680,1692,1077,298603,Eastern Mediterranean
El Salvador,06-04-2020,209885,34,835,209050,Americas
Equatorial Guinea,06-04-2020,422279,766,1030,421249,Africa
Eritrea,06-04-2020,196560,1700,416,196144,Africa
Estonia,06-04-2020,211615,1407,1071,210544,Europe
Eswatini,06-04-2020,314143,1066,1085,313058,Africa
Ethiopia,06-04-2020,207821,1883,1126,206695,Africa
Fiji,06-04-2020,190026,2028,1124,188902,Western Pacific
Finland,06-04-2020,72446,1048,427,72019,Europe
France,06-04-2020,265765,744,1113,264652,Europe
France,06-04-2020,390221,276,632,389589,Europe
France,06-04-2020,154769,1057,398,154371,Europe
France,06-04-2020,172842,1061,591,172251,Europe
France,06-04-2020,449144,1703,100,449044,Europe
France,06-04-2020,41067,712,1068,39999,Europe
France,06-04-2020,107893,1955,493,107400,Europe
France,06-04-2020,161734,2160,345,161389,Europe
France,06-04-2020,443937,211,1210,442727,Europe
France,06-04-2020,94181,2141,1148,93033,Europe
Gabon,06-04-2020,306765,2308,869,305896,Africa
Gambia,06-04-2020,282146,401,694,281452,Africa
Georgia,06-04-2020,301084,2398,1158,299926,Europe
Germany,06-04-2020,87924,341,437,87487,Europe
Ghana,06-04-2020,195094,324,809,194285,Africa
Greece,06-04-2020,355975,1049,219,355756,Europe
Guatemala,06-04-2020,403681,1694,311,403370,Americas
Guinea,06-04-2020,115918,392,704,115214,Africa
Guyana,06-04-2020,71732,1855,1219,70513,Americas
Haiti,06-04-2020,297282,1576,892,296390,Americas
Holy See,06-04-2020,86433,2278,923,85510,Europe
Honduras,06-04-2020,400136,613,1185,398951,Americas
Hungary,06-04-2020,267537,1293,688,266849,Europe
Iceland,06-04-2020,417010,2101,211,416799,Europe
India,06-04-2020,410196,741,249,409947,South-East Asia
Indonesia,06-04-2020,429992,348,13,429979,South-East Asia
Iran,06-04-2020,375718,360,929,374789,Eastern Mediterranean
Iraq,06-04-2020,69441,1697,553,68888,Eastern Mediterranean
Ireland,06-04-2020,376241,736,7,376234,Europe
Israel,06-04-2020,292705,812,765,291940,Europe
Italy,06-04-2020,393608,1792,184,393424,Europe
Jamaica,06-04-2020,369621,1989,584,369037,Americas
Japan,06-04-2020,376279,897,1190,375089,Western Pacific
Jordan,06-04-2020,148931,138,612,148319,Eastern Mediterranean
Kazakhstan,06-04-2020,396735,2076,336,396399,Europe
Kenya,06-04-2020,29316,1731,768,28548,Africa
South Korea,06-04-2020,310563,2370,9,310554,Western Pacific
Kuwait,06-04-2020,94609,819,662,93947,Eastern Mediterranean
Kyrgyzstan,06-04-2020,311037,1679,138,310899,Europe
Latvia,06-04-2020,375714,98,217,375497,Europe
Lebanon,06-04-2020,85333,2048,390,84943,Eastern Mediterranean
Liberia,06-04-2020,412297,1280,769,411528,Africa
Liechtenstein,06-04-2020,210812,1826,1160,209652,Europe
Lithuania,06-04-2020,273443,264,564,272879,Europe
Luxembourg,06-04-2020,197315,589,843,196472,Europe
Madagascar,06-04-2020,292769,2305,1112,291657,Africa
Malaysia,06-04-2020,394381,517,204,394177,Western Pacific
Maldives,06-04-2020,406922,94,704,406218,South-East Asia
Malta,06-04-2020,251805,428,136,251669,Europe
Mauritania,06-04-2020,283265,1500,1201,282064,Africa
Mauritius,06-04-2020,443790,497,195,443595,Africa
Mexico,06-04-2020,289669,1744,510,289159,Americas
Moldova,06-04-2020,110847,1001,823,110024,Europe
Monaco,06-04-2020,182956,420,428,182528,Europe
Mongolia,06-04-2020,116875,905,587,116288,Western Pacific
Montenegro,06-04-2020,333379,23,77,333302,Europe
Morocco,06-04-2020,175123,744,502,174621,Eastern Mediterranean
Namibia,06-04-2020,431062,703,387,430675,Africa
Nepal,06-04-2020,390777,1428,454,390323,South-East Asia
Netherlands,06-04-2020,88337,288,544,87793,Europe
Netherlands,06-04-2020,363510,1240,766,362744,Europe
Netherlands,06-04-2020,88944,40,518,88426,Europe
Netherlands,06-04-2020,83930,194,1226,82704,Europe
New Zealand,06-04-2020,13080,2033,217,12863,Western Pacific
Nicaragua,06-04-2020,112298,1857,578,111720,Americas
Niger,06-04-2020,235124,325,1057,234067,Africa
Nigeria,06-04-2020,391810,1799,28,391782,Africa
North Macedonia,06-04-2020,35864,100,735,35129,Europe
Norway,06-04-2020,390937,262,615,390322,Europe
Oman,06-04-2020,62710,1653,154,62556,Eastern Mediterranean
Pakistan,06-04-2020,250830,2096,150,250680,Eastern Mediterranean
Panama,06-04-2020,319281,1426,535,318746,Americas
Papua New Guinea,06-04-2020,293412,1370,313,293099,Western Pacific
Paraguay,06-04-2020,157806,1158,10,157796,Americas
Peru,06-04-2020,42741,1521,394,42347,Americas
Philippines,06-04-2020,388608,597,777,387831,Western Pacific
Poland,06-04-2020,29536,2073,133,29403,Europe
Portugal,06-04-2020,70807,299,946,69861,Europe
Qatar,06-04-2020,75411,1011,372,75039,Eastern Mediterranean
Romania,06-04-2020,356245,399,322,355923,Europe
Russia,06-04-2020,73824,2252,437,73387,Europe
Rwanda,06-04-2020,78040,685,647,77393,Africa
Saint Lucia,06-04-2020,442711,2024,405,442306,Americas
Saint Vincent and the Grenadines,06-04-2020,162383,2271,165,162218,Americas
San Marino,06-04-2020,347964,2237,848,347116,Europe
Saudi Arabia,06-04-2020,403838,2150,1001,402837,Eastern Mediterranean
Senegal,06-04-2020,73153,328,844,72309,Africa
Serbia,06-04-2020,51796,1300,704,51092,Europe
Seychelles,06-04-2020,138743,536,674,138069,Africa
Singapore,06-04-2020,159403,2104,737,158666,Western Pacific
Slovakia,06-04-2020,280520,1173,651,279869,Europe
Slovenia,06-04-2020,247200,652,993,246207,Europe
Somalia,06-04-2020,295652,1158,635,295017,Eastern Mediterranean
South Africa,06-04-2020,403230,147,188,403042,Africa
Spain,06-04-2020,34858,139,413,34445,Europe
Sri Lanka,06-04-2020,239633,683,1189,238444,South-East Asia
Sudan,06-04-2020,378862,1866,891,377971,Eastern Mediterranean
Suriname,06-04-2020,299023,556,237,298786,Americas
Sweden,06-04-2020,200600,806,460,200140,Europe
Switzerland,06-04-2020,252740,836,485,252255,Europe
Taiwan*,06-04-2020,272886,1137,400,272486,Western Pacific
Tanzania,06-04-2020,116938,1904,80,116858,Africa
Thailand,06-04-2020,283497,2223,23,283474,South-East Asia
Togo,06-04-2020,60310,915,703,59607,Africa
Trinidad and Tobago,06-04-2020,292364,1199,510,291854,Americas
Tunisia,06-04-2020,337927,462,1155,336772,Eastern Mediterranean
Turkey,06-04-2020,84951,2152,868,84083,Europe
Uganda,06-04-2020,389107,1290,1069,388038,Africa
Ukraine,06-04-2020,414753,579,889,413864,Europe
United Arab Emirates,06-04-2020,444395,958,521,443874,Eastern Mediterranean
United Kingdom,06-04-2020,436546,635,151,436395,Europe
United Kingdom,06-04-2020,68186,514,1175,67011,Europe
United Kingdom,06-04-2020,235150,223,54,235096,Europe
United Kingdom,06-04-2020,44370,2245,800,43570,Europe
United Kingdom,06-04-2020,184850,2478,310,184540,Europe
United Kingdom,06-04-2020,338649,9,195,338454,Europe
United Kingdom,06-04-2020,374381,1582,529,373852,Europe
Uruguay,06-04-2020,320755,2324,543,320212,Americas
US,06-04-2020,196908,1273,547,196361,Americas
Uzbekistan,06-04-2020,278288,1720,803,277485,Europe
Venezuela,06-04-2020,161823,116,367,161456,Americas
Vietnam,06-04-2020,397753,433,729,397024,Western Pacific
Zambia,06-04-2020,268399,488,239,268160,Africa
Zimbabwe,06-04-2020,59996,1596,359,59637,Africa
Dominica,06-04-2020,335796,1489,614,335182,Americas
Grenada,06-04-2020,365333,1105,1220,364113,Americas
Mozambique,06-04-2020,341527,1256,189,341338,Africa
Syria,06-04-2020,175644,1191,1162,174482,Eastern Mediterranean
Timor-Leste,06-04-2020,384468,2309,360,384108,South-East Asia
Belize,06-04-2020,46465,1,890,45575,Americas
Laos,06-04-2020,239256,2395,732,238524,Western Pacific
Libya,06-04-2020,445752,487,1129,444623,Eastern Mediterranean
West Bank and Gaza,06-04-2020,348601,871,44,348557,Eastern Mediterranean
Guinea-Bissau,06-04-2020,344667,2182,637,344030,Africa
Mali,06-04-2020,157387,1069,934,156453,Africa
Saint Kitts and Nevis,06-04-2020,73069,172,295,72774,Americas
Canada,06-04-2020,40344,1436,100,40244,Americas
Canada,06-04-2020,127599,1919,662,126937,Americas
Kosovo,06-04-2020,150239,1819,958,149281,Europe
Burma,06-04-2020,188380,2061,126,188254,South-East Asia
United Kingdom,06-04-2020,111033,1924,1077,109956,Europe
United Kingdom,06-04-2020,405711,2050,820,404891,Europe
United Kingdom,06-04-2020,322201,1106,1089,321112,Europe
Botswana,06-04-2020,143586,2347,640,142946,Africa
Burundi,06-04-2020,60213,965,1226,58987,Africa
Sierra Leone,06-04-2020,106478,1696,88,106390,Africa
Malawi,06-04-2020,378289,1831,392,377897,Africa
United Kingdom,06-04-2020,64119,1413,768,63351,Europe
France,06-04-2020,319938,1283,196,319742,Europe
South Sudan,06-04-2020,226617,245,427,226190,Africa
Western Sahara,06-04-2020,327832,2407,358,327474,Africa
Sao Tome and Principe,06-04-2020,32175,492,291,31884,Africa
Yemen,06-04-2020,292361,1761,385,291976,Eastern Mediterranean
Comoros,06-04-2020,136588,542,1225,135363,Africa
Tajikistan,06-04-2020,184802,325,939,183863,Europe
Lesotho,06-04-2020,167902,607,793,167109,Africa
Afghanistan,07-04-2020,67905,312,1162,66743,Eastern Mediterranean
Albania,07-04-2020,30142,2455,1016,29126,Europe
Algeria,07-04-2020,208619,1091,132,208487,Africa
Andorra,07-04-2020,378684,2354,1213,377471,Europe
Angola,07-04-2020,289875,1737,260,289615,Africa
Antigua and Barbuda,07-04-2020,80107,77,172,79935,Americas
Argentina,07-04-2020,65513,326,1131,64382,Americas
Armenia,07-04-2020,221867,859,768,221099,Europe
Australia,07-04-2020,33961,896,965,32996,Western Pacific
Australia,07-04-2020,147915,243,131,147784,Western Pacific
Australia,07-04-2020,37450,671,802,36648,Western Pacific
Australia,07-04-2020,67972,1769,726,67246,Western Pacific
Australia,07-04-2020,85930,261,498,85432,Western Pacific
Australia,07-04-2020,28853,2228,417,28436,Western Pacific
Australia,07-04-2020,84322,1294,650,83672,Western Pacific
Australia,07-04-2020,242652,131,258,242394,Western Pacific
Austria,07-04-2020,372928,1201,253,372675,Europe
Azerbaijan,07-04-2020,333942,387,1044,332898,Europe
Bahamas,07-04-2020,331356,669,181,331175,Americas
Bahrain,07-04-2020,329717,1014,1221,328496,Eastern Mediterranean
Bangladesh,07-04-2020,209009,2210,466,208543,South-East Asia
Barbados,07-04-2020,331526,117,1069,330457,Americas
Belarus,07-04-2020,40482,1929,1151,39331,Europe
Belgium,07-04-2020,97373,1537,455,96918,Europe
Benin,07-04-2020,272504,721,752,271752,Africa
Bhutan,07-04-2020,314330,2472,49,314281,South-East Asia
Bolivia,07-04-2020,27888,2099,1037,26851,Americas
Bosnia and Herzegovina,07-04-2020,158618,2468,600,158018,Europe
Brazil,07-04-2020,124851,1064,649,124202,Americas
Brunei,07-04-2020,437506,885,407,437099,Western Pacific
Bulgaria,07-04-2020,111968,2015,162,111806,Europe
Burkina Faso,07-04-2020,55034,201,692,54342,Africa
Cabo Verde,07-04-2020,104598,1609,428,104170,Africa
Cambodia,07-04-2020,443938,1219,322,443616,Western Pacific
Cameroon,07-04-2020,163981,127,218,163763,Africa
Canada,07-04-2020,154605,1135,1151,153454,Americas
Canada,07-04-2020,174339,160,810,173529,Americas
Canada,07-04-2020,167856,770,600,167256,Americas
Canada,07-04-2020,362989,1865,289,362700,Americas
Canada,07-04-2020,90918,1019,1031,89887,Americas
Canada,07-04-2020,322292,1718,386,321906,Americas
Canada,07-04-2020,154550,218,832,153718,Americas
Canada,07-04-2020,198223,322,600,197623,Americas
Canada,07-04-2020,139785,1768,918,138867,Americas
Canada,07-04-2020,307866,56,498,307368,Americas
Central African Republic,07-04-2020,172358,218,431,171927,Africa
Chad,07-04-2020,75399,2361,504,74895,Africa
Chile,07-04-2020,17071,1743,1159,15912,Americas
China,07-04-2020,57327,2462,245,57082,Western Pacific
China,07-04-2020,418486,795,496,417990,Western Pacific
China,07-04-2020,76351,1740,668,75683,Western Pacific
China,07-04-2020,364362,694,865,363497,Western Pacific
China,07-04-2020,245442,1066,731,244711,Western Pacific
China,07-04-2020,187973,1023,563,187410,Western Pacific
China,07-04-2020,359074,110,892,358182,Western Pacific
China,07-04-2020,144451,124,508,143943,Western Pacific
China,07-04-2020,122506,1493,496,122010,Western Pacific
China,07-04-2020,53572,1585,1144,52428,Western Pacific
China,07-04-2020,61319,1621,1193,60126,Western Pacific
China,07-04-2020,4139,2420,63,4076,Western Pacific
China,07-04-2020,245409,1675,1019,244390,Western Pacific
China,07-04-2020,376071,1396,1236,374835,Western Pacific
China,07-04-2020,195235,854,1084,194151,Western Pacific
China,07-04-2020,178416,1971,472,177944,Western Pacific
China,07-04-2020,219363,18,388,218975,Western Pacific
China,07-04-2020,244653,2175,1235,243418,Western Pacific
China,07-04-2020,232415,509,707,231708,Western Pacific
China,07-04-2020,107135,1762,625,106510,Western Pacific
China,07-04-2020,289266,1019,896,288370,Western Pacific
China,07-04-2020,228604,2071,492,228112,Western Pacific
China,07-04-2020,200318,1262,1157,199161,Western Pacific
China,07-04-2020,55057,2200,812,54245,Western Pacific
China,07-04-2020,148826,1634,87,148739,Western Pacific
China,07-04-2020,485,2273,581,-96,Western Pacific
China,07-04-2020,343254,2150,502,342752,Western Pacific
China,07-04-2020,205902,666,274,205628,Western Pacific
China,07-04-2020,265591,1912,927,264664,Western Pacific
China,07-04-2020,162230,516,734,161496,Western Pacific
China,07-04-2020,444677,175,235,444442,Western Pacific
China,07-04-2020,425259,911,1109,424150,Western Pacific
China,07-04-2020,65241,650,751,64490,Western Pacific
Colombia,07-04-2020,151089,1469,812,150277,Americas
Congo (Brazzaville),07-04-2020,196781,1254,1000,195781,Africa
Congo (Kinshasa),07-04-2020,235139,1050,984,234155,Africa
Costa Rica,07-04-2020,335995,1129,796,335199,Americas
Cote d'Ivoire,07-04-2020,197696,1259,332,197364,Africa
Croatia,07-04-2020,443539,1441,880,442659,Europe
Cuba,07-04-2020,40452,2308,373,40079,Americas
Cyprus,07-04-2020,152675,1227,693,151982,Europe
Czechia,07-04-2020,241145,954,1123,240022,Europe
Denmark,07-04-2020,147879,1917,711,147168,Europe
Greenland,07-04-2020,183348,2260,859,182489,Europe
Denmark,07-04-2020,86256,1354,903,85353,Europe
Djibouti,07-04-2020,19190,1214,858,18332,Eastern Mediterranean
Dominican Republic,07-04-2020,85812,347,1073,84739,Americas
Ecuador,07-04-2020,443629,516,755,442874,Americas
Egypt,07-04-2020,24506,530,1065,23441,Eastern Mediterranean
El Salvador,07-04-2020,137540,1548,400,137140,Americas
Equatorial Guinea,07-04-2020,317671,778,822,316849,Africa
Eritrea,07-04-2020,379733,710,421,379312,Africa
Estonia,07-04-2020,278808,1743,1103,277705,Europe
Eswatini,07-04-2020,7407,1823,334,7073,Africa
Ethiopia,07-04-2020,24679,153,872,23807,Africa
Fiji,07-04-2020,8184,2005,841,7343,Western Pacific
Finland,07-04-2020,377064,901,0,377064,Europe
France,07-04-2020,229765,848,607,229158,Europe
France,07-04-2020,327871,130,179,327692,Europe
France,07-04-2020,157525,1740,1154,156371,Europe
France,07-04-2020,164665,1443,1003,163662,Europe
France,07-04-2020,397502,1069,1029,396473,Europe
France,07-04-2020,187893,690,70,187823,Europe
France,07-04-2020,410036,245,297,409739,Europe
France,07-04-2020,313566,1872,464,313102,Europe
France,07-04-2020,407503,651,1128,406375,Europe
France,07-04-2020,146161,2443,1200,144961,Europe
Gabon,07-04-2020,440543,1420,1218,439325,Africa
Gambia,07-04-2020,132090,125,289,131801,Africa
Georgia,07-04-2020,111339,2160,867,110472,Europe
Germany,07-04-2020,198536,1513,986,197550,Europe
Ghana,07-04-2020,378665,2269,570,378095,Africa
Greece,07-04-2020,321765,220,463,321302,Europe
Guatemala,07-04-2020,443556,1459,720,442836,Americas
Guinea,07-04-2020,261665,788,281,261384,Africa
Guyana,07-04-2020,362582,2241,1209,361373,Americas
Haiti,07-04-2020,267224,1887,714,266510,Americas
Holy See,07-04-2020,423020,2306,418,422602,Europe
Honduras,07-04-2020,360402,1002,412,359990,Americas
Hungary,07-04-2020,109500,948,7,109493,Europe
Iceland,07-04-2020,110926,2159,1026,109900,Europe
India,07-04-2020,178947,1407,946,178001,South-East Asia
Indonesia,07-04-2020,447961,2312,552,447409,South-East Asia
Iran,07-04-2020,103129,1425,1215,101914,Eastern Mediterranean
Iraq,07-04-2020,220957,1564,1214,219743,Eastern Mediterranean
Ireland,07-04-2020,377284,1239,94,377190,Europe
Israel,07-04-2020,417978,2118,947,417031,Europe
Italy,07-04-2020,364927,1818,456,364471,Europe
Jamaica,07-04-2020,67571,598,62,67509,Americas
Japan,07-04-2020,76813,944,174,76639,Western Pacific
Jordan,07-04-2020,417481,835,28,417453,Eastern Mediterranean
Kazakhstan,07-04-2020,2271,232,1205,1066,Europe
Kenya,07-04-2020,411059,1477,577,410482,Africa
South Korea,07-04-2020,368503,1787,798,367705,Western Pacific
Kuwait,07-04-2020,253487,827,95,253392,Eastern Mediterranean
Kyrgyzstan,07-04-2020,295484,1379,924,294560,Europe
Latvia,07-04-2020,37901,432,714,37187,Europe
Lebanon,07-04-2020,138166,37,185,137981,Eastern Mediterranean
Liberia,07-04-2020,281092,2066,151,280941,Africa
Liechtenstein,07-04-2020,282382,1107,1185,281197,Europe
Lithuania,07-04-2020,262688,1012,676,262012,Europe
Luxembourg,07-04-2020,14694,1415,386,14308,Europe
Madagascar,07-04-2020,46358,930,53,46305,Africa
Malaysia,07-04-2020,120470,847,33,120437,Western Pacific
Maldives,07-04-2020,439066,511,808,438258,South-East Asia
Malta,07-04-2020,51167,353,943,50224,Europe
Mauritania,07-04-2020,35489,1010,667,34822,Africa
Mauritius,07-04-2020,58364,541,732,57632,Africa
Mexico,07-04-2020,27597,2254,1171,26426,Americas
Moldova,07-04-2020,4792,446,1239,3553,Europe
Monaco,07-04-2020,165261,1983,540,164721,Europe
Mongolia,07-04-2020,429339,547,606,428733,Western Pacific
Montenegro,07-04-2020,400470,740,1212,399258,Europe
Morocco,07-04-2020,89887,846,232,89655,Eastern Mediterranean
Namibia,07-04-2020,204047,669,102,203945,Africa
Nepal,07-04-2020,273117,756,867,272250,South-East Asia
Netherlands,07-04-2020,141557,433,633,140924,Europe
Netherlands,07-04-2020,349076,1128,481,348595,Europe
Netherlands,07-04-2020,394905,1295,1049,393856,Europe
Netherlands,07-04-2020,374771,1463,18,374753,Europe
New Zealand,07-04-2020,321638,390,1130,320508,Western Pacific
Nicaragua,07-04-2020,311324,990,857,310467,Americas
Niger,07-04-2020,174136,1522,762,173374,Africa
Nigeria,07-04-2020,321124,1248,95,321029,Africa
North Macedonia,07-04-2020,99306,1174,997,98309,Europe
Norway,07-04-2020,349327,1350,217,349110,Europe
Oman,07-04-2020,32060,2286,1147,30913,Eastern Mediterranean
Pakistan,07-04-2020,368616,1849,208,368408,Eastern Mediterranean
Panama,07-04-2020,202947,1378,893,202054,Americas
Papua New Guinea,07-04-2020,349321,2403,405,348916,Western Pacific
Paraguay,07-04-2020,382969,1486,76,382893,Americas
Peru,07-04-2020,174776,1418,1119,173657,Americas
Philippines,07-04-2020,410088,223,65,410023,Western Pacific
Poland,07-04-2020,94384,367,962,93422,Europe
Portugal,07-04-2020,191959,1847,401,191558,Europe
Qatar,07-04-2020,269389,1764,947,268442,Eastern Mediterranean
Romania,07-04-2020,395228,1898,696,394532,Europe
Russia,07-04-2020,135140,2334,624,134516,Europe
Rwanda,07-04-2020,170309,752,228,170081,Africa
Saint Lucia,07-04-2020,443398,327,414,442984,Americas
Saint Vincent and the Grenadines,07-04-2020,229945,1706,271,229674,Americas
San Marino,07-04-2020,50655,1948,198,50457,Europe
Saudi Arabia,07-04-2020,421344,563,1207,420137,Eastern Mediterranean
Senegal,07-04-2020,15476,1530,649,14827,Africa
Serbia,07-04-2020,343882,832,1248,342634,Europe
Seychelles,07-04-2020,271238,327,1066,270172,Africa
Singapore,07-04-2020,281155,867,921,280234,Western Pacific
Slovakia,07-04-2020,127045,913,168,126877,Europe
Slovenia,07-04-2020,328526,812,332,328194,Europe
Somalia,07-04-2020,192723,999,1165,191558,Eastern Mediterranean
South Africa,07-04-2020,5399,1736,1153,4246,Africa
Spain,07-04-2020,148437,1044,1153,147284,Europe
Sri Lanka,07-04-2020,253908,1333,456,253452,South-East Asia
Sudan,07-04-2020,366945,1722,194,366751,Eastern Mediterranean
Suriname,07-04-2020,448640,1553,98,448542,Americas
Sweden,07-04-2020,227806,126,711,227095,Europe
Switzerland,07-04-2020,321517,624,892,320625,Europe
Taiwan*,07-04-2020,389147,198,743,388404,Western Pacific
Tanzania,07-04-2020,45907,2075,1107,44800,Africa
Thailand,07-04-2020,298080,1372,556,297524,South-East Asia
Togo,07-04-2020,53176,1318,980,52196,Africa
Trinidad and Tobago,07-04-2020,193197,2065,102,193095,Americas
Tunisia,07-04-2020,328085,2111,589,327496,Eastern Mediterranean
Turkey,07-04-2020,42217,2079,963,41254,Europe
Uganda,07-04-2020,317920,1670,883,317037,Africa
Ukraine,07-04-2020,218899,1807,420,218479,Europe
United Arab Emirates,07-04-2020,115303,367,957,114346,Eastern Mediterranean
United Kingdom,07-04-2020,427829,1324,1113,426716,Europe
United Kingdom,07-04-2020,104278,145,1089,103189,Europe
United Kingdom,07-04-2020,309000,1440,320,308680,Europe
United Kingdom,07-04-2020,379136,534,960,378176,Europe
United Kingdom,07-04-2020,73925,51,920,73005,Europe
United Kingdom,07-04-2020,289834,2465,75,289759,Europe
United Kingdom,07-04-2020,350302,363,165,350137,Europe
Uruguay,07-04-2020,426022,1788,816,425206,Americas
US,07-04-2020,145437,279,19,145418,Americas
Uzbekistan,07-04-2020,211922,1562,470,211452,Europe
Venezuela,07-04-2020,320745,955,520,320225,Americas
Vietnam,07-04-2020,150909,1129,902,150007,Western Pacific
Zambia,07-04-2020,326405,1897,1160,325245,Africa
Zimbabwe,07-04-2020,338590,673,659,337931,Africa
Dominica,07-04-2020,342671,1046,23,342648,Americas
Grenada,07-04-2020,220977,1226,511,220466,Americas
Mozambique,07-04-2020,357071,1763,1217,355854,Africa
Syria,07-04-2020,314243,144,785,313458,Eastern Mediterranean
Timor-Leste,07-04-2020,120481,17,306,120175,South-East Asia
Belize,07-04-2020,367260,924,650,366610,Americas
Laos,07-04-2020,181408,137,143,181265,Western Pacific
Libya,07-04-2020,269580,1888,829,268751,Eastern Mediterranean
West Bank and Gaza,07-04-2020,294346,686,662,293684,Eastern Mediterranean
Guinea-Bissau,07-04-2020,101241,1422,1149,100092,Africa
Mali,07-04-2020,60023,1523,822,59201,Africa
Saint Kitts and Nevis,07-04-2020,279666,503,437,279229,Americas
Canada,07-04-2020,58660,259,196,58464,Americas
Canada,07-04-2020,94270,2064,659,93611,Americas
Kosovo,07-04-2020,118804,804,700,118104,Europe
Burma,07-04-2020,443846,2463,72,443774,South-East Asia
United Kingdom,07-04-2020,245251,1958,1103,244148,Europe
United Kingdom,07-04-2020,127806,197,1088,126718,Europe
United Kingdom,07-04-2020,399615,1541,425,399190,Europe
Botswana,07-04-2020,78328,2351,250,78078,Africa
Burundi,07-04-2020,418420,350,670,417750,Africa
Sierra Leone,07-04-2020,69518,1305,721,68797,Africa
Malawi,07-04-2020,299312,2448,303,299009,Africa
United Kingdom,07-04-2020,354075,511,1224,352851,Europe
France,07-04-2020,271121,2307,983,270138,Europe
South Sudan,07-04-2020,259650,2244,253,259397,Africa
Western Sahara,07-04-2020,438267,2180,291,437976,Africa
Sao Tome and Principe,07-04-2020,362117,404,12,362105,Africa
Yemen,07-04-2020,354970,2281,1049,353921,Eastern Mediterranean
Comoros,07-04-2020,212404,2015,289,212115,Africa
Tajikistan,07-04-2020,200977,1159,394,200583,Europe
Lesotho,07-04-2020,338407,1457,759,337648,Africa
Afghanistan,08-04-2020,345612,898,1154,344458,Eastern Mediterranean
Albania,08-04-2020,29680,928,319,29361,Europe
Algeria,08-04-2020,325772,1114,583,325189,Africa
Andorra,08-04-2020,301629,2428,29,301600,Europe
Angola,08-04-2020,173560,2228,0,173560,Africa
Antigua and Barbuda,08-04-2020,6925,2408,383,6542,Americas
Argentina,08-04-2020,127508,414,106,127402,Americas
Armenia,08-04-2020,49420,1246,583,48837,Europe
Australia,08-04-2020,282719,561,361,282358,Western Pacific
Australia,08-04-2020,370526,803,1149,369377,Western Pacific
Australia,08-04-2020,13269,1919,751,12518,Western Pacific
Australia,08-04-2020,398931,100,207,398724,Western Pacific
Australia,08-04-2020,58850,2421,260,58590,Western Pacific
Australia,08-04-2020,125901,1159,332,125569,Western Pacific
Australia,08-04-2020,174099,1795,753,173346,Western Pacific
Australia,08-04-2020,116687,2314,1173,115514,Western Pacific
Austria,08-04-2020,119830,66,815,119015,Europe
Azerbaijan,08-04-2020,274335,808,1048,273287,Europe
Bahamas,08-04-2020,346934,1527,639,346295,Americas
Bahrain,08-04-2020,178948,510,471,178477,Eastern Mediterranean
Bangladesh,08-04-2020,362083,2214,912,361171,South-East Asia
Barbados,08-04-2020,307414,1198,1206,306208,Americas
Belarus,08-04-2020,81646,738,855,80791,Europe
Belgium,08-04-2020,293730,929,421,293309,Europe
Benin,08-04-2020,40045,418,211,39834,Africa
Bhutan,08-04-2020,316106,2055,832,315274,South-East Asia
Bolivia,08-04-2020,106806,853,465,106341,Americas
Bosnia and Herzegovina,08-04-2020,436702,2262,1003,435699,Europe
Brazil,08-04-2020,185613,1397,618,184995,Americas
Brunei,08-04-2020,258117,2088,798,257319,Western Pacific
Bulgaria,08-04-2020,349130,1201,1140,347990,Europe
Burkina Faso,08-04-2020,292233,1963,587,291646,Africa
Cabo Verde,08-04-2020,137777,1446,1228,136549,Africa
Cambodia,08-04-2020,50328,885,370,49958,Western Pacific
Cameroon,08-04-2020,123877,1050,479,123398,Africa
Canada,08-04-2020,63184,1715,317,62867,Americas
Canada,08-04-2020,135251,523,180,135071,Americas
Canada,08-04-2020,226119,2497,846,225273,Americas
Canada,08-04-2020,395899,423,772,395127,Americas
Canada,08-04-2020,428192,194,317,427875,Americas
Canada,08-04-2020,271551,602,734,270817,Americas
Canada,08-04-2020,340444,827,271,340173,Americas
Canada,08-04-2020,171248,1114,18,171230,Americas
Canada,08-04-2020,376696,1717,718,375978,Americas
Canada,08-04-2020,121158,1184,806,120352,Americas
Central African Republic,08-04-2020,252770,387,8,252762,Africa
Chad,08-04-2020,89913,754,778,89135,Africa
Chile,08-04-2020,376718,1315,1013,375705,Americas
China,08-04-2020,379767,1163,338,379429,Western Pacific
China,08-04-2020,334292,350,641,333651,Western Pacific
China,08-04-2020,367205,1808,1093,366112,Western Pacific
China,08-04-2020,5037,2468,469,4568,Western Pacific
China,08-04-2020,139738,836,927,138811,Western Pacific
China,08-04-2020,435206,1303,728,434478,Western Pacific
China,08-04-2020,125351,67,64,125287,Western Pacific
China,08-04-2020,378954,1364,437,378517,Western Pacific
China,08-04-2020,386042,1692,761,385281,Western Pacific
China,08-04-2020,243313,480,1119,242194,Western Pacific
China,08-04-2020,342781,2116,686,342095,Western Pacific
China,08-04-2020,408067,473,508,407559,Western Pacific
China,08-04-2020,104586,1729,60,104526,Western Pacific
China,08-04-2020,384864,80,284,384580,Western Pacific
China,08-04-2020,381228,871,613,380615,Western Pacific
China,08-04-2020,212184,2419,1169,211015,Western Pacific
China,08-04-2020,74624,1519,1080,73544,Western Pacific
China,08-04-2020,46775,905,576,46199,Western Pacific
China,08-04-2020,341853,416,703,341150,Western Pacific
China,08-04-2020,190055,2109,661,189394,Western Pacific
China,08-04-2020,137430,817,4,137426,Western Pacific
China,08-04-2020,146690,9,825,145865,Western Pacific
China,08-04-2020,216830,909,1140,215690,Western Pacific
China,08-04-2020,266605,199,462,266143,Western Pacific
China,08-04-2020,431385,2075,120,431265,Western Pacific
China,08-04-2020,246870,337,700,246170,Western Pacific
China,08-04-2020,291251,2378,1169,290082,Western Pacific
China,08-04-2020,442938,493,903,442035,Western Pacific
China,08-04-2020,215429,1483,637,214792,Western Pacific
China,08-04-2020,553,14,1040,-487,Western Pacific
China,08-04-2020,234403,1598,519,233884,Western Pacific
China,08-04-2020,233753,200,113,233640,Western Pacific
China,08-04-2020,354902,335,190,354712,Western Pacific
Colombia,08-04-2020,93075,2205,771,92304,Americas
Congo (Brazzaville),08-04-2020,108986,1630,153,108833,Africa
Congo (Kinshasa),08-04-2020,223244,1570,59,223185,Africa
Costa Rica,08-04-2020,229985,822,237,229748,Americas
Cote d'Ivoire,08-04-2020,185911,566,194,185717,Africa
Croatia,08-04-2020,48290,192,1097,47193,Europe
Cuba,08-04-2020,163521,1802,642,162879,Americas
Cyprus,08-04-2020,126226,54,1175,125051,Europe
Czechia,08-04-2020,94302,1792,792,93510,Europe
Denmark,08-04-2020,366679,1167,421,366258,Europe
Greenland,08-04-2020,102607,2109,348,102259,Europe
Denmark,08-04-2020,137509,248,167,137342,Europe
Djibouti,08-04-2020,279919,1873,367,279552,Eastern Mediterranean
Dominican Republic,08-04-2020,45046,991,679,44367,Americas
Ecuador,08-04-2020,347045,685,310,346735,Americas
Egypt,08-04-2020,367391,68,398,366993,Eastern Mediterranean
El Salvador,08-04-2020,334223,1190,291,333932,Americas
Equatorial Guinea,08-04-2020,85483,1613,490,84993,Africa
Eritrea,08-04-2020,151182,558,1171,150011,Africa
Estonia,08-04-2020,99180,1108,352,98828,Europe
Eswatini,08-04-2020,193640,1288,820,192820,Africa
Ethiopia,08-04-2020,222547,2387,998,221549,Africa
Fiji,08-04-2020,421726,726,1250,420476,Western Pacific
Finland,08-04-2020,332104,946,118,331986,Europe
France,08-04-2020,390942,2375,1084,389858,Europe
France,08-04-2020,228652,166,792,227860,Europe
France,08-04-2020,38340,1809,1125,37215,Europe
France,08-04-2020,406082,2348,807,405275,Europe
France,08-04-2020,256820,1972,1179,255641,Europe
France,08-04-2020,344105,1574,1010,343095,Europe
France,08-04-2020,379017,1705,109,378908,Europe
France,08-04-2020,166746,758,577,166169,Europe
France,08-04-2020,132255,1372,500,131755,Europe
France,08-04-2020,356605,2464,645,355960,Europe
Gabon,08-04-2020,351182,308,934,350248,Africa
Gambia,08-04-2020,91637,972,1110,90527,Africa
Georgia,08-04-2020,70462,2390,7,70455,Europe
Germany,08-04-2020,180283,1773,633,179650,Europe
Ghana,08-04-2020,8873,32,185,8688,Africa
Greece,08-04-2020,423418,754,798,422620,Europe
Guatemala,08-04-2020,290403,811,328,290075,Americas
Guinea,08-04-2020,274740,2017,1218,273522,Africa
Guyana,08-04-2020,345642,16,18,345624,Americas
Haiti,08-04-2020,444153,2331,40,444113,Americas
Holy See,08-04-2020,10763,494,163,10600,Europe
Honduras,08-04-2020,302314,727,712,301602,Americas
Hungary,08-04-2020,80121,1870,1056,79065,Europe
Iceland,08-04-2020,78310,457,508,77802,Europe
India,08-04-2020,273945,354,346,273599,South-East Asia
Indonesia,08-04-2020,234337,2185,1240,233097,South-East Asia
Iran,08-04-2020,229920,359,309,229611,Eastern Mediterranean
Iraq,08-04-2020,222158,1610,436,221722,Eastern Mediterranean
Ireland,08-04-2020,419957,972,221,419736,Europe
Israel,08-04-2020,154851,2047,138,154713,Europe
Italy,08-04-2020,80475,712,810,79665,Europe
Jamaica,08-04-2020,4867,1777,1094,3773,Americas
Japan,08-04-2020,176068,2329,583,175485,Western Pacific
Jordan,08-04-2020,349186,2288,692,348494,Eastern Mediterranean
Kazakhstan,08-04-2020,130832,2001,552,130280,Europe
Kenya,08-04-2020,5184,1182,1095,4089,Africa
South Korea,08-04-2020,401321,1900,737,400584,Western Pacific
Kuwait,08-04-2020,117684,1317,182,117502,Eastern Mediterranean
Kyrgyzstan,08-04-2020,238073,1457,156,237917,Europe
Latvia,08-04-2020,449980,964,1216,448764,Europe
Lebanon,08-04-2020,228805,1228,1036,227769,Eastern Mediterranean
Liberia,08-04-2020,127397,914,153,127244,Africa
Liechtenstein,08-04-2020,231381,196,17,231364,Europe
Lithuania,08-04-2020,382230,1990,323,381907,Europe
Luxembourg,08-04-2020,441857,1449,173,441684,Europe
Madagascar,08-04-2020,211286,839,1010,210276,Africa
Malaysia,08-04-2020,235341,2077,871,234470,Western Pacific
Maldives,08-04-2020,395293,1454,891,394402,South-East Asia
Malta,08-04-2020,218230,1966,1110,217120,Europe
Mauritania,08-04-2020,159515,2227,523,158992,Africa
Mauritius,08-04-2020,276697,1332,550,276147,Africa
Mexico,08-04-2020,380240,1951,18,380222,Americas
Moldova,08-04-2020,242449,1986,66,242383,Europe
Monaco,08-04-2020,250679,1640,1232,249447,Europe
Mongolia,08-04-2020,159367,708,986,158381,Western Pacific
Montenegro,08-04-2020,204543,2090,26,204517,Europe
Morocco,08-04-2020,186858,1373,151,186707,Eastern Mediterranean
Namibia,08-04-2020,70630,632,32,70598,Africa
Nepal,08-04-2020,133255,1464,276,132979,South-East Asia
Netherlands,08-04-2020,354807,1199,4,354803,Europe
Netherlands,08-04-2020,403100,1592,393,402707,Europe
Netherlands,08-04-2020,10223,1927,522,9701,Europe
Netherlands,08-04-2020,273284,39,612,272672,Europe
New Zealand,08-04-2020,193884,348,396,193488,Western Pacific
Nicaragua,08-04-2020,439285,1898,955,438330,Americas
Niger,08-04-2020,185943,1414,771,185172,Africa
Nigeria,08-04-2020,220314,182,141,220173,Africa
North Macedonia,08-04-2020,132100,1151,856,131244,Europe
Norway,08-04-2020,435408,1202,520,434888,Europe
Oman,08-04-2020,189044,1714,706,188338,Eastern Mediterranean
Pakistan,08-04-2020,30381,205,958,29423,Eastern Mediterranean
Panama,08-04-2020,308833,2123,696,308137,Americas
Papua New Guinea,08-04-2020,111091,452,155,110936,Western Pacific
Paraguay,08-04-2020,281454,206,1102,280352,Americas
Peru,08-04-2020,127381,902,114,127267,Americas
Philippines,08-04-2020,404125,1607,1243,402882,Western Pacific
Poland,08-04-2020,45047,2492,709,44338,Europe
Portugal,08-04-2020,238335,1806,1097,237238,Europe
Qatar,08-04-2020,421872,651,859,421013,Eastern Mediterranean
Romania,08-04-2020,192469,960,36,192433,Europe
Russia,08-04-2020,35608,2025,553,35055,Europe
Rwanda,08-04-2020,38455,250,982,37473,Africa
Saint Lucia,08-04-2020,8819,2322,1172,7647,Americas
Saint Vincent and the Grenadines,08-04-2020,186008,867,296,185712,Americas
San Marino,08-04-2020,272636,1876,955,271681,Europe
Saudi Arabia,08-04-2020,287374,227,432,286942,Eastern Mediterranean
Senegal,08-04-2020,325882,518,472,325410,Africa
Serbia,08-04-2020,20985,3,717,20268,Europe
Seychelles,08-04-2020,398211,1343,1151,397060,Africa
Singapore,08-04-2020,128456,2338,482,127974,Western Pacific
Slovakia,08-04-2020,407684,1518,1020,406664,Europe
Slovenia,08-04-2020,294588,1057,567,294021,Europe
Somalia,08-04-2020,311904,663,947,310957,Eastern Mediterranean
South Africa,08-04-2020,165844,728,696,165148,Africa
Spain,08-04-2020,84486,1957,163,84323,Europe
Sri Lanka,08-04-2020,334439,1670,77,334362,South-East Asia
Sudan,08-04-2020,369468,2186,991,368477,Eastern Mediterranean
Suriname,08-04-2020,205686,640,823,204863,Americas
Sweden,08-04-2020,382327,2215,874,381453,Europe
Switzerland,08-04-2020,405082,1359,1127,403955,Europe
Taiwan*,08-04-2020,408822,65,508,408314,Western Pacific
Tanzania,08-04-2020,314393,1018,1100,313293,Africa
Thailand,08-04-2020,294157,661,875,293282,South-East Asia
Togo,08-04-2020,5284,2368,557,4727,Africa
Trinidad and Tobago,08-04-2020,2950,1067,1083,1867,Americas
Tunisia,08-04-2020,150666,8,961,149705,Eastern Mediterranean
Turkey,08-04-2020,137117,1954,885,136232,Europe
Uganda,08-04-2020,355402,1227,880,354522,Africa
Ukraine,08-04-2020,350323,1814,894,349429,Europe
United Arab Emirates,08-04-2020,396354,718,356,395998,Eastern Mediterranean
United Kingdom,08-04-2020,216013,2063,762,215251,Europe
United Kingdom,08-04-2020,425506,893,375,425131,Europe
United Kingdom,08-04-2020,200128,125,768,199360,Europe
United Kingdom,08-04-2020,254618,8,1179,253439,Europe
United Kingdom,08-04-2020,193884,1223,119,193765,Europe
United Kingdom,08-04-2020,283138,1097,612,282526,Europe
United Kingdom,08-04-2020,271945,2080,314,271631,Europe
Uruguay,08-04-2020,322403,921,299,322104,Americas
US,08-04-2020,64768,2151,1140,63628,Americas
Uzbekistan,08-04-2020,187322,1472,661,186661,Europe
Venezuela,08-04-2020,216220,1637,922,215298,Americas
Vietnam,08-04-2020,314669,312,572,314097,Western Pacific
Zambia,08-04-2020,301461,740,988,300473,Africa
Zimbabwe,08-04-2020,40193,1608,767,39426,Africa
Dominica,08-04-2020,417206,2069,12,417194,Americas
Grenada,08-04-2020,281575,2278,456,281119,Americas
Mozambique,08-04-2020,287411,1928,304,287107,Africa
Syria,08-04-2020,344067,1459,9,344058,Eastern Mediterranean
Timor-Leste,08-04-2020,138770,1592,1238,137532,South-East Asia
Belize,08-04-2020,375486,2173,252,375234,Americas
Laos,08-04-2020,151342,695,711,150631,Western Pacific
Libya,08-04-2020,151785,146,57,151728,Eastern Mediterranean
West Bank and Gaza,08-04-2020,394741,2464,129,394612,Eastern Mediterranean
Guinea-Bissau,08-04-2020,174894,2294,151,174743,Africa
Mali,08-04-2020,174234,493,449,173785,Africa
Saint Kitts and Nevis,08-04-2020,205212,532,6,205206,Americas
Canada,08-04-2020,153034,632,985,152049,Americas
Canada,08-04-2020,388699,110,610,388089,Americas
Kosovo,08-04-2020,1830,1607,836,994,Europe
Burma,08-04-2020,190610,2404,230,190380,South-East Asia
United Kingdom,08-04-2020,423984,216,1201,422783,Europe
United Kingdom,08-04-2020,338374,49,848,337526,Europe
United Kingdom,08-04-2020,62260,1851,1120,61140,Europe
Botswana,08-04-2020,222940,1056,768,222172,Africa
Burundi,08-04-2020,342750,1395,982,341768,Africa
Sierra Leone,08-04-2020,428417,554,82,428335,Africa
Malawi,08-04-2020,380241,1289,554,379687,Africa
United Kingdom,08-04-2020,283543,127,186,283357,Europe
France,08-04-2020,285625,336,799,284826,Europe
South Sudan,08-04-2020,155287,1414,689,154598,Africa
Western Sahara,08-04-2020,438249,181,602,437647,Africa
Sao Tome and Principe,08-04-2020,183833,877,75,183758,Africa
Yemen,08-04-2020,366596,1017,61,366535,Eastern Mediterranean
Comoros,08-04-2020,215316,1445,950,214366,Africa
Tajikistan,08-04-2020,38598,2274,77,38521,Europe
Lesotho,08-04-2020,289713,458,802,288911,Africa
Afghanistan,09-04-2020,94616,1939,1070,93546,Eastern Mediterranean
Albania,09-04-2020,1546,2244,1129,417,Europe
Algeria,09-04-2020,154999,398,925,154074,Africa
Andorra,09-04-2020,53188,132,611,52577,Europe
Angola,09-04-2020,390434,1932,73,390361,Africa
Antigua and Barbuda,09-04-2020,228023,1148,408,227615,Americas
Argentina,09-04-2020,347307,559,289,347018,Americas
Armenia,09-04-2020,367302,1891,1054,366248,Europe
Australia,09-04-2020,82613,1631,323,82290,Western Pacific
Australia,09-04-2020,50344,1924,1039,49305,Western Pacific
Australia,09-04-2020,50977,809,990,49987,Western Pacific
Australia,09-04-2020,421543,1083,458,421085,Western Pacific
Australia,09-04-2020,84888,2429,975,83913,Western Pacific
Australia,09-04-2020,41468,260,401,41067,Western Pacific
Australia,09-04-2020,443085,2208,880,442205,Western Pacific
Australia,09-04-2020,382289,1246,1198,381091,Western Pacific
Austria,09-04-2020,45952,1958,169,45783,Europe
Azerbaijan,09-04-2020,269628,894,832,268796,Europe
Bahamas,09-04-2020,43454,1023,841,42613,Americas
Bahrain,09-04-2020,244962,2096,503,244459,Eastern Mediterranean
Bangladesh,09-04-2020,395769,61,65,395704,South-East Asia
Barbados,09-04-2020,418045,254,427,417618,Americas
Belarus,09-04-2020,384903,1080,1029,383874,Europe
Belgium,09-04-2020,75363,149,282,75081,Europe
Benin,09-04-2020,29773,1130,373,29400,Africa
Bhutan,09-04-2020,377973,779,1138,376835,South-East Asia
Bolivia,09-04-2020,425720,73,581,425139,Americas
Bosnia and Herzegovina,09-04-2020,6578,447,924,5654,Europe
Brazil,09-04-2020,52920,1843,696,52224,Americas
Brunei,09-04-2020,245322,373,271,245051,Western Pacific
Bulgaria,09-04-2020,392287,1734,362,391925,Europe
Burkina Faso,09-04-2020,183868,2043,1246,182622,Africa
Cabo Verde,09-04-2020,177230,819,181,177049,Africa
Cambodia,09-04-2020,114579,798,917,113662,Western Pacific
Cameroon,09-04-2020,21907,664,1210,20697,Africa
Canada,09-04-2020,292078,338,2,292076,Americas
Canada,09-04-2020,326902,2256,928,325974,Americas
Canada,09-04-2020,394780,726,790,393990,Americas
Canada,09-04-2020,5236,2106,906,4330,Americas
Canada,09-04-2020,262820,2426,162,262658,Americas
Canada,09-04-2020,349063,725,732,348331,Americas
Canada,09-04-2020,262987,439,441,262546,Americas
Canada,09-04-2020,5782,1110,92,5690,Americas
Canada,09-04-2020,142278,984,684,141594,Americas
Canada,09-04-2020,279067,1467,1039,278028,Americas
Central African Republic,09-04-2020,17076,575,849,16227,Africa
Chad,09-04-2020,144901,2278,484,144417,Africa
Chile,09-04-2020,407193,1936,1055,406138,Americas
China,09-04-2020,441707,916,342,441365,Western Pacific
China,09-04-2020,404636,2255,723,403913,Western Pacific
China,09-04-2020,293038,1781,121,292917,Western Pacific
China,09-04-2020,391649,1985,917,390732,Western Pacific
China,09-04-2020,189310,1321,760,188550,Western Pacific
China,09-04-2020,94363,1713,472,93891,Western Pacific
China,09-04-2020,351203,941,887,350316,Western Pacific
China,09-04-2020,31971,824,216,31755,Western Pacific
China,09-04-2020,336862,1315,353,336509,Western Pacific
China,09-04-2020,440558,1094,1215,439343,Western Pacific
China,09-04-2020,403945,423,882,403063,Western Pacific
China,09-04-2020,80243,614,686,79557,Western Pacific
China,09-04-2020,1017,489,362,655,Western Pacific
China,09-04-2020,287797,2377,923,286874,Western Pacific
China,09-04-2020,88484,54,269,88215,Western Pacific
China,09-04-2020,161920,444,49,161871,Western Pacific
China,09-04-2020,412850,2184,1116,411734,Western Pacific
China,09-04-2020,363375,1781,373,363002,Western Pacific
China,09-04-2020,83986,1152,716,83270,Western Pacific
China,09-04-2020,89712,1266,977,88735,Western Pacific
China,09-04-2020,160033,1994,744,159289,Western Pacific
China,09-04-2020,392015,2408,129,391886,Western Pacific
China,09-04-2020,147690,2462,1032,146658,Western Pacific
China,09-04-2020,250368,211,140,250228,Western Pacific
China,09-04-2020,43036,685,1005,42031,Western Pacific
China,09-04-2020,133083,839,1203,131880,Western Pacific
China,09-04-2020,193059,567,497,192562,Western Pacific
China,09-04-2020,49840,924,48,49792,Western Pacific
China,09-04-2020,82927,2473,974,81953,Western Pacific
China,09-04-2020,202114,781,1164,200950,Western Pacific
China,09-04-2020,412816,2414,420,412396,Western Pacific
China,09-04-2020,232748,676,1043,231705,Western Pacific
China,09-04-2020,46034,109,373,45661,Western Pacific
Colombia,09-04-2020,303239,26,864,302375,Americas
Congo (Brazzaville),09-04-2020,230950,62,480,230470,Africa
Congo (Kinshasa),09-04-2020,391345,1031,742,390603,Africa
Costa Rica,09-04-2020,268463,2497,33,268430,Americas
Cote d'Ivoire,09-04-2020,341432,2420,173,341259,Africa
Croatia,09-04-2020,421079,2146,1065,420014,Europe
Cuba,09-04-2020,286796,1839,1242,285554,Americas
Cyprus,09-04-2020,47655,625,11,47644,Europe
Czechia,09-04-2020,32963,74,473,32490,Europe
Denmark,09-04-2020,184436,1087,905,183531,Europe
Greenland,09-04-2020,377059,2368,413,376646,Europe
Denmark,09-04-2020,135116,1888,1235,133881,Europe
Djibouti,09-04-2020,309785,2406,951,308834,Eastern Mediterranean
Dominican Republic,09-04-2020,46988,1388,276,46712,Americas
Ecuador,09-04-2020,224487,2457,191,224296,Americas
Egypt,09-04-2020,106476,2323,1101,105375,Eastern Mediterranean
El Salvador,09-04-2020,404505,2105,499,404006,Americas
Equatorial Guinea,09-04-2020,438993,2028,128,438865,Africa
Eritrea,09-04-2020,123660,2443,798,122862,Africa
Estonia,09-04-2020,388513,714,552,387961,Europe
Eswatini,09-04-2020,181100,2379,981,180119,Africa
Ethiopia,09-04-2020,130854,403,374,130480,Africa
Fiji,09-04-2020,84078,1458,394,83684,Western Pacific
Finland,09-04-2020,93542,1860,498,93044,Europe
France,09-04-2020,351610,1521,65,351545,Europe
France,09-04-2020,131426,1790,743,130683,Europe
France,09-04-2020,154779,1828,328,154451,Europe
France,09-04-2020,284823,1216,1069,283754,Europe
France,09-04-2020,107381,118,305,107076,Europe
France,09-04-2020,333145,144,547,332598,Europe
France,09-04-2020,106127,1074,1073,105054,Europe
France,09-04-2020,410665,2050,617,410048,Europe
France,09-04-2020,443086,1793,336,442750,Europe
France,09-04-2020,328349,1570,841,327508,Europe
Gabon,09-04-2020,157176,45,311,156865,Africa
Gambia,09-04-2020,92597,1887,1014,91583,Africa
Georgia,09-04-2020,218571,125,32,218539,Europe
Germany,09-04-2020,259486,1950,801,258685,Europe
Ghana,09-04-2020,337446,1408,119,337327,Africa
Greece,09-04-2020,145759,1068,632,145127,Europe
Guatemala,09-04-2020,132625,2282,1156,131469,Americas
Guinea,09-04-2020,371260,2490,56,371204,Africa
Guyana,09-04-2020,220146,897,547,219599,Americas
Haiti,09-04-2020,263636,445,906,262730,Americas
Holy See,09-04-2020,156872,1599,393,156479,Europe
Honduras,09-04-2020,46798,347,298,46500,Americas
Hungary,09-04-2020,9971,1593,355,9616,Europe
Iceland,09-04-2020,60875,1296,737,60138,Europe
India,09-04-2020,320427,2256,1127,319300,South-East Asia
Indonesia,09-04-2020,181369,1324,839,180530,South-East Asia
Iran,09-04-2020,62951,313,1219,61732,Eastern Mediterranean
Iraq,09-04-2020,327224,909,1193,326031,Eastern Mediterranean
Ireland,09-04-2020,160380,2339,417,159963,Europe
Israel,09-04-2020,398651,1099,541,398110,Europe
Italy,09-04-2020,374859,1968,548,374311,Europe
Jamaica,09-04-2020,97507,2004,1034,96473,Americas
Japan,09-04-2020,449076,888,1051,448025,Western Pacific
Jordan,09-04-2020,405394,1583,520,404874,Eastern Mediterranean
Kazakhstan,09-04-2020,441473,804,138,441335,Europe
Kenya,09-04-2020,127999,2405,627,127372,Africa
South Korea,09-04-2020,46080,1023,679,45401,Western Pacific
Kuwait,09-04-2020,241851,1508,720,241131,Eastern Mediterranean
Kyrgyzstan,09-04-2020,34903,638,327,34576,Europe
Latvia,09-04-2020,346915,1031,751,346164,Europe
Lebanon,09-04-2020,416719,1054,1178,415541,Eastern Mediterranean
Liberia,09-04-2020,223692,355,1222,222470,Africa
Liechtenstein,09-04-2020,196154,524,928,195226,Europe
Lithuania,09-04-2020,242621,758,903,241718,Europe
Luxembourg,09-04-2020,235683,2258,411,235272,Europe
Madagascar,09-04-2020,121249,64,424,120825,Africa
Malaysia,09-04-2020,182333,1539,1120,181213,Western Pacific
Maldives,09-04-2020,82529,475,1157,81372,South-East Asia
Malta,09-04-2020,88641,1637,809,87832,Europe
Mauritania,09-04-2020,408599,1529,438,408161,Africa
Mauritius,09-04-2020,229928,2318,604,229324,Africa
Mexico,09-04-2020,70724,111,358,70366,Americas
Moldova,09-04-2020,243096,1053,1234,241862,Europe
Monaco,09-04-2020,233582,925,68,233514,Europe
Mongolia,09-04-2020,85117,1585,586,84531,Western Pacific
Montenegro,09-04-2020,211944,86,282,211662,Europe
Morocco,09-04-2020,11104,33,887,10217,Eastern Mediterranean
Namibia,09-04-2020,182308,1045,875,181433,Africa
Nepal,09-04-2020,298494,1413,336,298158,South-East Asia
Netherlands,09-04-2020,63174,74,454,62720,Europe
Netherlands,09-04-2020,124471,1092,220,124251,Europe
Netherlands,09-04-2020,76313,267,847,75466,Europe
Netherlands,09-04-2020,88700,1495,159,88541,Europe
New Zealand,09-04-2020,423339,1741,671,422668,Western Pacific
Nicaragua,09-04-2020,438958,1651,705,438253,Americas
Niger,09-04-2020,103285,911,917,102368,Africa
Nigeria,09-04-2020,365709,230,502,365207,Africa
North Macedonia,09-04-2020,150569,1390,424,150145,Europe
Norway,09-04-2020,114247,722,385,113862,Europe
Oman,09-04-2020,3906,2,776,3130,Eastern Mediterranean
Pakistan,09-04-2020,94906,1552,510,94396,Eastern Mediterranean
Panama,09-04-2020,84963,811,483,84480,Americas
Papua New Guinea,09-04-2020,232847,2282,567,232280,Western Pacific
Paraguay,09-04-2020,273627,515,123,273504,Americas
Peru,09-04-2020,315190,381,639,314551,Americas
Philippines,09-04-2020,5394,1445,951,4443,Western Pacific
Poland,09-04-2020,296918,2403,805,296113,Europe
Portugal,09-04-2020,102401,1308,1237,101164,Europe
Qatar,09-04-2020,10084,250,325,9759,Eastern Mediterranean
Romania,09-04-2020,189283,994,108,189175,Europe
Russia,09-04-2020,36970,1992,825,36145,Europe
Rwanda,09-04-2020,165192,2181,154,165038,Africa
Saint Lucia,09-04-2020,25517,2143,990,24527,Americas
Saint Vincent and the Grenadines,09-04-2020,443625,198,490,443135,Americas
San Marino,09-04-2020,241238,790,817,240421,Europe
Saudi Arabia,09-04-2020,233716,943,198,233518,Eastern Mediterranean
Senegal,09-04-2020,32737,1131,1027,31710,Africa
Serbia,09-04-2020,104538,354,427,104111,Europe
Seychelles,09-04-2020,113796,2242,424,113372,Africa
Singapore,09-04-2020,196908,657,1142,195766,Western Pacific
Slovakia,09-04-2020,259807,1814,974,258833,Europe
Slovenia,09-04-2020,145325,2490,882,144443,Europe
Somalia,09-04-2020,327309,2245,714,326595,Eastern Mediterranean
South Africa,09-04-2020,417825,2471,56,417769,Africa
Spain,09-04-2020,191632,2034,1154,190478,Europe
Sri Lanka,09-04-2020,256267,937,641,255626,South-East Asia
Sudan,09-04-2020,23354,188,110,23244,Eastern Mediterranean
Suriname,09-04-2020,397846,2032,846,397000,Americas
Sweden,09-04-2020,232618,1344,263,232355,Europe
Switzerland,09-04-2020,226504,1084,437,226067,Europe
Taiwan*,09-04-2020,358034,54,195,357839,Western Pacific
Tanzania,09-04-2020,410235,1962,118,410117,Africa
Thailand,09-04-2020,276894,58,61,276833,South-East Asia
Togo,09-04-2020,370908,201,531,370377,Africa
Trinidad and Tobago,09-04-2020,258274,1241,1229,257045,Americas
Tunisia,09-04-2020,3909,233,1055,2854,Eastern Mediterranean
Turkey,09-04-2020,335427,6,1194,334233,Europe
Uganda,09-04-2020,184310,2114,90,184220,Africa
Ukraine,09-04-2020,331901,840,1066,330835,Europe
United Arab Emirates,09-04-2020,401102,803,634,400468,Eastern Mediterranean
United Kingdom,09-04-2020,71964,2387,1214,70750,Europe
United Kingdom,09-04-2020,254125,2299,93,254032,Europe
United Kingdom,09-04-2020,326251,1969,408,325843,Europe
United Kingdom,09-04-2020,130932,2072,516,130416,Europe
United Kingdom,09-04-2020,195511,1542,735,194776,Europe
United Kingdom,09-04-2020,26360,2485,187,26173,Europe
United Kingdom,09-04-2020,47901,1542,857,47044,Europe
Uruguay,09-04-2020,24403,1161,608,23795,Americas
US,09-04-2020,19333,1716,1183,18150,Americas
Uzbekistan,09-04-2020,252485,287,581,251904,Europe
Venezuela,09-04-2020,127134,562,945,126189,Americas
Vietnam,09-04-2020,132266,2475,1222,131044,Western Pacific
Zambia,09-04-2020,343836,2169,710,343126,Africa
Zimbabwe,09-04-2020,276317,1726,482,275835,Africa
Dominica,09-04-2020,250052,779,128,249924,Americas
Grenada,09-04-2020,373818,1370,1176,372642,Americas
Mozambique,09-04-2020,26909,1201,596,26313,Africa
Syria,09-04-2020,264793,1054,1073,263720,Eastern Mediterranean
Timor-Leste,09-04-2020,378618,517,5,378613,South-East Asia
Belize,09-04-2020,418493,1502,570,417923,Americas
Laos,09-04-2020,139406,453,1196,138210,Western Pacific
Libya,09-04-2020,258119,181,187,257932,Eastern Mediterranean
West Bank and Gaza,09-04-2020,370080,1553,590,369490,Eastern Mediterranean
Guinea-Bissau,09-04-2020,63845,2109,320,63525,Africa
Mali,09-04-2020,153171,2222,13,153158,Africa
Saint Kitts and Nevis,09-04-2020,44803,1951,479,44324,Americas
Canada,09-04-2020,275529,794,436,275093,Americas
Canada,09-04-2020,447076,612,1037,446039,Americas
Kosovo,09-04-2020,286679,993,1235,285444,Europe
Burma,09-04-2020,219804,1654,1220,218584,South-East Asia
United Kingdom,09-04-2020,100034,1398,527,99507,Europe
United Kingdom,09-04-2020,448628,1931,141,448487,Europe
United Kingdom,09-04-2020,156708,2366,57,156651,Europe
Botswana,09-04-2020,127282,1629,1090,126192,Africa
Burundi,09-04-2020,328790,2445,290,328500,Africa
Sierra Leone,09-04-2020,26099,955,446,25653,Africa
Malawi,09-04-2020,120467,552,77,120390,Africa
United Kingdom,09-04-2020,432530,2266,133,432397,Europe
France,09-04-2020,386149,1793,982,385167,Europe
South Sudan,09-04-2020,373727,2301,68,373659,Africa
Western Sahara,09-04-2020,180336,1885,790,179546,Africa
Sao Tome and Principe,09-04-2020,266873,1632,564,266309,Africa
Yemen,09-04-2020,101925,48,516,101409,Eastern Mediterranean
Comoros,09-04-2020,51719,783,210,51509,Africa
Tajikistan,09-04-2020,28554,1160,1102,27452,Europe
Lesotho,09-04-2020,331526,1431,64,331462,Africa
Afghanistan,10-04-2020,364640,1536,1156,363484,Eastern Mediterranean
Albania,10-04-2020,222774,1189,712,222062,Europe
Algeria,10-04-2020,248173,1694,583,247590,Africa
Andorra,10-04-2020,370714,83,354,370360,Europe
Angola,10-04-2020,373252,517,333,372919,Africa
Antigua and Barbuda,10-04-2020,76415,2057,252,76163,Americas
Argentina,10-04-2020,355138,866,623,354515,Americas
Armenia,10-04-2020,206,899,603,-397,Europe
Australia,10-04-2020,230198,272,289,229909,Western Pacific
Australia,10-04-2020,335882,692,114,335768,Western Pacific
Australia,10-04-2020,220934,67,1021,219913,Western Pacific
Australia,10-04-2020,235088,1259,750,234338,Western Pacific
Australia,10-04-2020,304949,2458,317,304632,Western Pacific
Australia,10-04-2020,424823,2453,543,424280,Western Pacific
Australia,10-04-2020,191186,1676,893,190293,Western Pacific
Australia,10-04-2020,401763,314,534,401229,Western Pacific
Austria,10-04-2020,288496,1399,4,288492,Europe
Azerbaijan,10-04-2020,39965,2210,1101,38864,Europe
Bahamas,10-04-2020,343314,21,95,343219,Americas
Bahrain,10-04-2020,159903,1886,1113,158790,Eastern Mediterranean
Bangladesh,10-04-2020,433265,2172,258,433007,South-East Asia
Barbados,10-04-2020,2401,1010,555,1846,Americas
Belarus,10-04-2020,74613,617,946,73667,Europe
Belgium,10-04-2020,282523,2059,37,282486,Europe
Benin,10-04-2020,357148,234,1236,355912,Africa
Bhutan,10-04-2020,202267,589,429,201838,South-East Asia
Bolivia,10-04-2020,282061,1778,1239,280822,Americas
Bosnia and Herzegovina,10-04-2020,369968,1738,775,369193,Europe
Brazil,10-04-2020,73327,1537,291,73036,Americas
Brunei,10-04-2020,213668,1820,714,212954,Western Pacific
Bulgaria,10-04-2020,183711,1561,1036,182675,Europe
Burkina Faso,10-04-2020,119510,1023,1120,118390,Africa
Cabo Verde,10-04-2020,182297,1867,257,182040,Africa
Cambodia,10-04-2020,178649,1617,408,178241,Western Pacific
Cameroon,10-04-2020,36887,1548,179,36708,Africa
Canada,10-04-2020,59896,680,772,59124,Americas
Canada,10-04-2020,395681,2070,518,395163,Americas
Canada,10-04-2020,304307,337,181,304126,Americas
Canada,10-04-2020,275303,1975,1161,274142,Americas
Canada,10-04-2020,303350,1149,315,303035,Americas
Canada,10-04-2020,100529,2462,1192,99337,Americas
Canada,10-04-2020,167535,1906,810,166725,Americas
Canada,10-04-2020,367752,539,554,367198,Americas
Canada,10-04-2020,63297,2342,1069,62228,Americas
Canada,10-04-2020,170135,188,136,169999,Americas
Central African Republic,10-04-2020,410093,2339,935,409158,Africa
Chad,10-04-2020,150993,805,100,150893,Africa
Chile,10-04-2020,275154,511,620,274534,Americas
China,10-04-2020,402518,2427,402,402116,Western Pacific
China,10-04-2020,370917,1776,382,370535,Western Pacific
China,10-04-2020,118693,1434,619,118074,Western Pacific
China,10-04-2020,115973,1978,61,115912,Western Pacific
China,10-04-2020,384857,798,686,384171,Western Pacific
China,10-04-2020,372159,1379,857,371302,Western Pacific
China,10-04-2020,310003,1980,1112,308891,Western Pacific
China,10-04-2020,273956,1130,1107,272849,Western Pacific
China,10-04-2020,93486,752,95,93391,Western Pacific
China,10-04-2020,1685,353,839,846,Western Pacific
China,10-04-2020,290472,766,477,289995,Western Pacific
China,10-04-2020,43075,111,1073,42002,Western Pacific
China,10-04-2020,187146,706,1244,185902,Western Pacific
China,10-04-2020,240322,1057,886,239436,Western Pacific
China,10-04-2020,241883,2114,188,241695,Western Pacific
China,10-04-2020,426022,465,780,425242,Western Pacific
China,10-04-2020,359498,429,1025,358473,Western Pacific
China,10-04-2020,304251,1410,265,303986,Western Pacific
China,10-04-2020,322094,1751,559,321535,Western Pacific
China,10-04-2020,75790,1290,1071,74719,Western Pacific
China,10-04-2020,15550,1010,763,14787,Western Pacific
China,10-04-2020,27196,1980,306,26890,Western Pacific
China,10-04-2020,179451,901,30,179421,Western Pacific
China,10-04-2020,78441,1252,1220,77221,Western Pacific
China,10-04-2020,308683,1521,247,308436,Western Pacific
China,10-04-2020,289137,88,271,288866,Western Pacific
China,10-04-2020,297062,47,1226,295836,Western Pacific
China,10-04-2020,237178,2028,109,237069,Western Pacific
China,10-04-2020,386737,1172,607,386130,Western Pacific
China,10-04-2020,382031,1276,673,381358,Western Pacific
China,10-04-2020,229750,1689,293,229457,Western Pacific
China,10-04-2020,123912,760,1055,122857,Western Pacific
China,10-04-2020,125025,227,379,124646,Western Pacific
Colombia,10-04-2020,239839,1956,1230,238609,Americas
Congo (Brazzaville),10-04-2020,253847,1321,743,253104,Africa
Congo (Kinshasa),10-04-2020,66677,2462,1184,65493,Africa
Costa Rica,10-04-2020,342942,1727,363,342579,Americas
Cote d'Ivoire,10-04-2020,237109,1594,180,236929,Africa
Croatia,10-04-2020,279981,996,903,279078,Europe
Cuba,10-04-2020,286308,1780,501,285807,Americas
Cyprus,10-04-2020,195257,2414,1020,194237,Europe
Czechia,10-04-2020,130700,67,312,130388,Europe
Denmark,10-04-2020,418442,1223,653,417789,Europe
Greenland,10-04-2020,269670,309,249,269421,Europe
Denmark,10-04-2020,332301,1392,227,332074,Europe
Djibouti,10-04-2020,13195,2171,1210,11985,Eastern Mediterranean
Dominican Republic,10-04-2020,102084,474,124,101960,Americas
Ecuador,10-04-2020,12509,1087,258,12251,Americas
Egypt,10-04-2020,188029,1967,31,187998,Eastern Mediterranean
El Salvador,10-04-2020,251638,435,567,251071,Americas
Equatorial Guinea,10-04-2020,136993,1307,1010,135983,Africa
Eritrea,10-04-2020,440083,246,732,439351,Africa
Estonia,10-04-2020,376329,542,224,376105,Europe
Eswatini,10-04-2020,187200,211,1189,186011,Africa
Ethiopia,10-04-2020,137008,2276,819,136189,Africa
Fiji,10-04-2020,207572,1010,635,206937,Western Pacific
Finland,10-04-2020,253972,833,707,253265,Europe
France,10-04-2020,183662,1411,839,182823,Europe
France,10-04-2020,374391,2496,246,374145,Europe
France,10-04-2020,364768,1485,1149,363619,Europe
France,10-04-2020,135629,113,479,135150,Europe
France,10-04-2020,390233,1559,288,389945,Europe
France,10-04-2020,244651,1545,557,244094,Europe
France,10-04-2020,45171,1589,911,44260,Europe
France,10-04-2020,410424,200,1215,409209,Europe
France,10-04-2020,229451,123,988,228463,Europe
France,10-04-2020,21372,2043,1238,20134,Europe
Gabon,10-04-2020,369419,241,100,369319,Africa
Gambia,10-04-2020,19020,1856,1202,17818,Africa
Georgia,10-04-2020,348980,2026,98,348882,Europe
Germany,10-04-2020,436602,610,981,435621,Europe
Ghana,10-04-2020,327710,2354,1129,326581,Africa
Greece,10-04-2020,375678,1514,1129,374549,Europe
Guatemala,10-04-2020,203368,2209,247,203121,Americas
Guinea,10-04-2020,62333,2123,627,61706,Africa
Guyana,10-04-2020,85934,1795,489,85445,Americas
Haiti,10-04-2020,405403,1471,924,404479,Americas
Holy See,10-04-2020,240349,662,217,240132,Europe
Honduras,10-04-2020,79931,86,103,79828,Americas
Hungary,10-04-2020,55102,354,93,55009,Europe
Iceland,10-04-2020,359920,2238,1182,358738,Europe
India,10-04-2020,90897,1448,526,90371,South-East Asia
Indonesia,10-04-2020,191280,1907,926,190354,South-East Asia
Iran,10-04-2020,411270,1866,242,411028,Eastern Mediterranean
Iraq,10-04-2020,23338,653,619,22719,Eastern Mediterranean
Ireland,10-04-2020,109633,575,998,108635,Europe
Israel,10-04-2020,287955,2461,1242,286713,Europe
Italy,10-04-2020,384748,99,45,384703,Europe
Jamaica,10-04-2020,90422,782,671,89751,Americas
Japan,10-04-2020,265647,187,741,264906,Western Pacific
Jordan,10-04-2020,433498,633,521,432977,Eastern Mediterranean
Kazakhstan,10-04-2020,176809,1294,479,176330,Europe
Kenya,10-04-2020,336101,2354,755,335346,Africa
South Korea,10-04-2020,218452,130,515,217937,Western Pacific
Kuwait,10-04-2020,253779,2092,133,253646,Eastern Mediterranean
Kyrgyzstan,10-04-2020,380854,1448,346,380508,Europe
Latvia,10-04-2020,219355,403,334,219021,Europe
Lebanon,10-04-2020,40931,262,188,40743,Eastern Mediterranean
Liberia,10-04-2020,7196,479,89,7107,Africa
Liechtenstein,10-04-2020,232166,2459,1002,231164,Europe
Lithuania,10-04-2020,217201,404,61,217140,Europe
Luxembourg,10-04-2020,9792,1037,778,9014,Europe
Madagascar,10-04-2020,47369,399,208,47161,Africa
Malaysia,10-04-2020,131801,978,1064,130737,Western Pacific
Maldives,10-04-2020,432642,1906,805,431837,South-East Asia
Malta,10-04-2020,81489,1264,1014,80475,Europe
Mauritania,10-04-2020,26628,222,1038,25590,Africa
Mauritius,10-04-2020,311259,1694,1093,310166,Africa
Mexico,10-04-2020,247197,514,476,246721,Americas
Moldova,10-04-2020,261866,427,224,261642,Europe
Monaco,10-04-2020,425843,1143,1029,424814,Europe
Mongolia,10-04-2020,315707,1904,522,315185,Western Pacific
Montenegro,10-04-2020,360142,349,275,359867,Europe
Morocco,10-04-2020,99469,434,1017,98452,Eastern Mediterranean
Namibia,10-04-2020,330875,2440,115,330760,Africa
Nepal,10-04-2020,42100,2130,622,41478,South-East Asia
Netherlands,10-04-2020,439038,612,668,438370,Europe
Netherlands,10-04-2020,395048,2441,1153,393895,Europe
Netherlands,10-04-2020,19094,1707,429,18665,Europe
Netherlands,10-04-2020,55202,1598,523,54679,Europe
New Zealand,10-04-2020,294617,2157,1060,293557,Western Pacific
Nicaragua,10-04-2020,341532,34,20,341512,Americas
Niger,10-04-2020,199352,588,564,198788,Africa
Nigeria,10-04-2020,381368,557,61,381307,Africa
North Macedonia,10-04-2020,134264,1118,193,134071,Europe
Norway,10-04-2020,432734,759,552,432182,Europe
Oman,10-04-2020,325209,1074,1002,324207,Eastern Mediterranean
Pakistan,10-04-2020,106350,512,581,105769,Eastern Mediterranean
Panama,10-04-2020,193014,683,11,193003,Americas
Papua New Guinea,10-04-2020,253110,2143,218,252892,Western Pacific
Paraguay,10-04-2020,136222,1162,262,135960,Americas
Peru,10-04-2020,361069,1196,713,360356,Americas
Philippines,10-04-2020,229674,87,78,229596,Western Pacific
Poland,10-04-2020,109049,2214,836,108213,Europe
Portugal,10-04-2020,258288,1516,386,257902,Europe
Qatar,10-04-2020,102183,203,85,102098,Eastern Mediterranean
Romania,10-04-2020,234231,166,36,234195,Europe
Russia,10-04-2020,204333,708,198,204135,Europe
Rwanda,10-04-2020,66396,1434,765,65631,Africa
Saint Lucia,10-04-2020,148663,102,457,148206,Americas
Saint Vincent and the Grenadines,10-04-2020,13546,2479,801,12745,Americas
San Marino,10-04-2020,110421,1238,119,110302,Europe
Saudi Arabia,10-04-2020,174968,1165,1205,173763,Eastern Mediterranean
Senegal,10-04-2020,330250,242,778,329472,Africa
Serbia,10-04-2020,206244,1293,35,206209,Europe
Seychelles,10-04-2020,48412,1890,1144,47268,Africa
Singapore,10-04-2020,273724,490,1236,272488,Western Pacific
Slovakia,10-04-2020,207388,621,531,206857,Europe
Slovenia,10-04-2020,326755,1231,732,326023,Europe
Somalia,10-04-2020,363617,2464,374,363243,Eastern Mediterranean
South Africa,10-04-2020,402202,1860,782,401420,Africa
Spain,10-04-2020,313070,94,146,312924,Europe
Sri Lanka,10-04-2020,187635,498,154,187481,South-East Asia
Sudan,10-04-2020,148810,755,58,148752,Eastern Mediterranean
Suriname,10-04-2020,11075,1577,65,11010,Americas
Sweden,10-04-2020,27695,1068,371,27324,Europe
Switzerland,10-04-2020,93825,443,1193,92632,Europe
Taiwan*,10-04-2020,19635,1050,1153,18482,Western Pacific
Tanzania,10-04-2020,99172,743,1040,98132,Africa
Thailand,10-04-2020,3761,2051,372,3389,South-East Asia
Togo,10-04-2020,390258,1042,894,389364,Africa
Trinidad and Tobago,10-04-2020,129669,932,659,129010,Americas
Tunisia,10-04-2020,292431,1918,1120,291311,Eastern Mediterranean
Turkey,10-04-2020,205884,1992,97,205787,Europe
Uganda,10-04-2020,156972,230,1071,155901,Africa
Ukraine,10-04-2020,231323,2217,1248,230075,Europe
United Arab Emirates,10-04-2020,87658,1118,301,87357,Eastern Mediterranean
United Kingdom,10-04-2020,186709,1923,338,186371,Europe
United Kingdom,10-04-2020,389805,685,670,389135,Europe
United Kingdom,10-04-2020,258919,2089,235,258684,Europe
United Kingdom,10-04-2020,250445,298,808,249637,Europe
United Kingdom,10-04-2020,265639,2006,299,265340,Europe
United Kingdom,10-04-2020,41963,600,889,41074,Europe
United Kingdom,10-04-2020,319286,2473,214,319072,Europe
Uruguay,10-04-2020,144250,1152,552,143698,Americas
US,10-04-2020,422109,697,186,421923,Americas
Uzbekistan,10-04-2020,9747,1198,562,9185,Europe
Venezuela,10-04-2020,154110,1393,379,153731,Americas
Vietnam,10-04-2020,202138,747,668,201470,Western Pacific
Zambia,10-04-2020,345117,158,215,344902,Africa
Zimbabwe,10-04-2020,240892,1615,128,240764,Africa
Dominica,10-04-2020,93939,1734,226,93713,Americas
Grenada,10-04-2020,257441,7,87,257354,Americas
Mozambique,10-04-2020,9081,954,313,8768,Africa
Syria,10-04-2020,257875,1352,521,257354,Eastern Mediterranean
Timor-Leste,10-04-2020,91611,15,1245,90366,South-East Asia
Belize,10-04-2020,362241,750,240,362001,Americas
Laos,10-04-2020,364401,851,256,364145,Western Pacific
Libya,10-04-2020,223521,1079,77,223444,Eastern Mediterranean
West Bank and Gaza,10-04-2020,7581,2016,894,6687,Eastern Mediterranean
Guinea-Bissau,10-04-2020,170403,1596,1097,169306,Africa
Mali,10-04-2020,118495,2029,760,117735,Africa
Saint Kitts and Nevis,10-04-2020,224367,1905,482,223885,Americas
Canada,10-04-2020,200357,1886,409,199948,Americas
Canada,10-04-2020,225120,782,534,224586,Americas
Kosovo,10-04-2020,13188,1741,802,12386,Europe
Burma,10-04-2020,117787,662,81,117706,South-East Asia
United Kingdom,10-04-2020,9747,1097,1156,8591,Europe
United Kingdom,10-04-2020,100806,1743,613,100193,Europe
United Kingdom,10-04-2020,356628,139,588,356040,Europe
Botswana,10-04-2020,304649,508,320,304329,Africa
Burundi,10-04-2020,59722,1403,723,58999,Africa
Sierra Leone,10-04-2020,448941,1529,1167,447774,Africa
Malawi,10-04-2020,173144,2340,271,172873,Africa
United Kingdom,10-04-2020,387295,1765,862,386433,Europe
France,10-04-2020,292130,1420,865,291265,Europe
South Sudan,10-04-2020,85739,70,1015,84724,Africa
Western Sahara,10-04-2020,325782,2422,365,325417,Africa
Sao Tome and Principe,10-04-2020,64635,1669,1157,63478,Africa
Yemen,10-04-2020,104888,2152,1196,103692,Eastern Mediterranean
Comoros,10-04-2020,193416,1090,931,192485,Africa
Tajikistan,10-04-2020,118041,838,259,117782,Europe
Lesotho,10-04-2020,295689,99,338,295351,Africa
Afghanistan,11-04-2020,390921,1413,590,390331,Eastern Mediterranean
Albania,11-04-2020,446754,814,56,446698,Europe
Algeria,11-04-2020,438982,1549,875,438107,Africa
Andorra,11-04-2020,232773,1769,737,232036,Europe
Angola,11-04-2020,414681,1537,139,414542,Africa
Antigua and Barbuda,11-04-2020,432752,853,947,431805,Americas
Argentina,11-04-2020,416264,1206,544,415720,Americas
Armenia,11-04-2020,369174,406,397,368777,Europe
Australia,11-04-2020,197380,1852,54,197326,Western Pacific
Australia,11-04-2020,31625,1178,249,31376,Western Pacific
Australia,11-04-2020,74988,1815,810,74178,Western Pacific
Australia,11-04-2020,82795,1791,572,82223,Western Pacific
Australia,11-04-2020,44741,745,66,44675,Western Pacific
Australia,11-04-2020,355578,52,1085,354493,Western Pacific
Australia,11-04-2020,283180,1394,1042,282138,Western Pacific
Australia,11-04-2020,286384,2006,853,285531,Western Pacific
Austria,11-04-2020,333033,1638,474,332559,Europe
Azerbaijan,11-04-2020,7119,52,272,6847,Europe
Bahamas,11-04-2020,323711,1597,143,323568,Americas
Bahrain,11-04-2020,2002,170,871,1131,Eastern Mediterranean
Bangladesh,11-04-2020,138522,635,1039,137483,South-East Asia
Barbados,11-04-2020,53105,1305,582,52523,Americas
Belarus,11-04-2020,364646,2122,342,364304,Europe
Belgium,11-04-2020,105105,2252,973,104132,Europe
Benin,11-04-2020,149445,2039,1044,148401,Africa
Bhutan,11-04-2020,192698,1136,874,191824,South-East Asia
Bolivia,11-04-2020,324001,485,758,323243,Americas
Bosnia and Herzegovina,11-04-2020,189326,1064,669,188657,Europe
Brazil,11-04-2020,286618,874,1065,285553,Americas
Brunei,11-04-2020,397043,2139,1141,395902,Western Pacific
Bulgaria,11-04-2020,202329,942,482,201847,Europe
Burkina Faso,11-04-2020,20453,432,1143,19310,Africa
Cabo Verde,11-04-2020,381006,709,818,380188,Africa
Cambodia,11-04-2020,201430,1895,222,201208,Western Pacific
Cameroon,11-04-2020,22703,1818,979,21724,Africa
Canada,11-04-2020,335709,2202,517,335192,Americas
Canada,11-04-2020,95329,490,1020,94309,Americas
Canada,11-04-2020,90869,2409,644,90225,Americas
Canada,11-04-2020,121316,2470,458,120858,Americas
Canada,11-04-2020,307306,2352,885,306421,Americas
Canada,11-04-2020,231252,1966,1175,230077,Americas
Canada,11-04-2020,383101,530,560,382541,Americas
Canada,11-04-2020,289998,1994,104,289894,Americas
Canada,11-04-2020,229460,751,357,229103,Americas
Canada,11-04-2020,230724,1881,46,230678,Americas
Central African Republic,11-04-2020,242220,524,211,242009,Africa
Chad,11-04-2020,56874,219,266,56608,Africa
Chile,11-04-2020,73337,2109,985,72352,Americas
China,11-04-2020,390894,1557,350,390544,Western Pacific
China,11-04-2020,232643,453,359,232284,Western Pacific
China,11-04-2020,270426,1625,477,269949,Western Pacific
China,11-04-2020,359710,1587,12,359698,Western Pacific
China,11-04-2020,402601,1346,211,402390,Western Pacific
China,11-04-2020,187751,294,1082,186669,Western Pacific
China,11-04-2020,300355,1460,574,299781,Western Pacific
China,11-04-2020,243139,1974,671,242468,Western Pacific
China,11-04-2020,350412,2141,1240,349172,Western Pacific
China,11-04-2020,214792,2018,1173,213619,Western Pacific
China,11-04-2020,333450,728,703,332747,Western Pacific
China,11-04-2020,129164,2004,862,128302,Western Pacific
China,11-04-2020,144344,439,867,143477,Western Pacific
China,11-04-2020,368503,2300,1049,367454,Western Pacific
China,11-04-2020,41784,1739,75,41709,Western Pacific
China,11-04-2020,117591,728,133,117458,Western Pacific
China,11-04-2020,376813,1325,553,376260,Western Pacific
China,11-04-2020,95675,1384,1066,94609,Western Pacific
China,11-04-2020,176327,2096,1161,175166,Western Pacific
China,11-04-2020,158424,1147,564,157860,Western Pacific
China,11-04-2020,366057,1961,691,365366,Western Pacific
China,11-04-2020,400952,1522,142,400810,Western Pacific
China,11-04-2020,132270,2255,383,131887,Western Pacific
China,11-04-2020,251476,870,45,251431,Western Pacific
China,11-04-2020,318475,1393,996,317479,Western Pacific
China,11-04-2020,114832,1945,916,113916,Western Pacific
China,11-04-2020,360903,338,780,360123,Western Pacific
China,11-04-2020,168738,519,356,168382,Western Pacific
China,11-04-2020,350509,1337,188,350321,Western Pacific
China,11-04-2020,41749,2001,614,41135,Western Pacific
China,11-04-2020,402996,1655,610,402386,Western Pacific
China,11-04-2020,16265,2127,586,15679,Western Pacific
China,11-04-2020,79640,860,342,79298,Western Pacific
Colombia,11-04-2020,257308,1556,677,256631,Americas
Congo (Brazzaville),11-04-2020,180121,1230,165,179956,Africa
Congo (Kinshasa),11-04-2020,223070,1088,1196,221874,Africa
Costa Rica,11-04-2020,305248,1311,947,304301,Americas
Cote d'Ivoire,11-04-2020,186170,2493,5,186165,Africa
Croatia,11-04-2020,115916,2061,1020,114896,Europe
Cuba,11-04-2020,229864,482,704,229160,Americas
Cyprus,11-04-2020,343894,1271,585,343309,Europe
Czechia,11-04-2020,114471,310,299,114172,Europe
Denmark,11-04-2020,200557,1357,137,200420,Europe
Greenland,11-04-2020,140702,1202,959,139743,Europe
Denmark,11-04-2020,278460,776,397,278063,Europe
Djibouti,11-04-2020,41671,1741,35,41636,Eastern Mediterranean
Dominican Republic,11-04-2020,440249,710,1234,439015,Americas
Ecuador,11-04-2020,50920,171,1091,49829,Americas
Egypt,11-04-2020,227356,2424,926,226430,Eastern Mediterranean
El Salvador,11-04-2020,40921,865,139,40782,Americas
Equatorial Guinea,11-04-2020,63936,2198,1205,62731,Africa
Eritrea,11-04-2020,378792,1896,59,378733,Africa
Estonia,11-04-2020,61597,684,1036,60561,Europe
Eswatini,11-04-2020,195189,123,1239,193950,Africa
Ethiopia,11-04-2020,295396,854,180,295216,Africa
Fiji,11-04-2020,443688,2146,819,442869,Western Pacific
Finland,11-04-2020,221502,1682,459,221043,Europe
France,11-04-2020,92308,655,175,92133,Europe
France,11-04-2020,234201,1022,253,233948,Europe
France,11-04-2020,221053,2140,334,220719,Europe
France,11-04-2020,132653,743,969,131684,Europe
France,11-04-2020,124384,464,14,124370,Europe
France,11-04-2020,151324,666,682,150642,Europe
France,11-04-2020,112607,1399,722,111885,Europe
France,11-04-2020,165024,2085,923,164101,Europe
France,11-04-2020,92477,1537,320,92157,Europe
France,11-04-2020,357849,1495,1073,356776,Europe
Gabon,11-04-2020,159867,619,655,159212,Africa
Gambia,11-04-2020,372965,2398,284,372681,Africa
Georgia,11-04-2020,271657,2441,549,271108,Europe
Germany,11-04-2020,102966,344,796,102170,Europe
Ghana,11-04-2020,353785,594,672,353113,Africa
Greece,11-04-2020,448653,1816,993,447660,Europe
Guatemala,11-04-2020,100521,1516,1245,99276,Americas
Guinea,11-04-2020,270414,606,190,270224,Africa
Guyana,11-04-2020,321404,1431,106,321298,Americas
Haiti,11-04-2020,176642,657,79,176563,Americas
Holy See,11-04-2020,204739,2225,1105,203634,Europe
Honduras,11-04-2020,235465,243,893,234572,Americas
Hungary,11-04-2020,341617,1776,1176,340441,Europe
Iceland,11-04-2020,285261,2171,846,284415,Europe
India,11-04-2020,434633,1062,46,434587,South-East Asia
Indonesia,11-04-2020,99963,479,40,99923,South-East Asia
Iran,11-04-2020,196580,501,149,196431,Eastern Mediterranean
Iraq,11-04-2020,170,1073,133,37,Eastern Mediterranean
Ireland,11-04-2020,122334,664,232,122102,Europe
Israel,11-04-2020,383974,1540,1067,382907,Europe
Italy,11-04-2020,2933,1208,281,2652,Europe
Jamaica,11-04-2020,209263,1444,1111,208152,Americas
Japan,11-04-2020,248491,62,917,247574,Western Pacific
Jordan,11-04-2020,15709,688,1204,14505,Eastern Mediterranean
Kazakhstan,11-04-2020,318851,649,156,318695,Europe
Kenya,11-04-2020,194552,1018,1157,193395,Africa
South Korea,11-04-2020,268626,332,91,268535,Western Pacific
Kuwait,11-04-2020,256069,464,866,255203,Eastern Mediterranean
Kyrgyzstan,11-04-2020,254778,2151,588,254190,Europe
Latvia,11-04-2020,338246,27,814,337432,Europe
Lebanon,11-04-2020,143750,1338,555,143195,Eastern Mediterranean
Liberia,11-04-2020,353618,2169,929,352689,Africa
Liechtenstein,11-04-2020,299735,1938,732,299003,Europe
Lithuania,11-04-2020,80650,1707,392,80258,Europe
Luxembourg,11-04-2020,191839,1283,176,191663,Europe
Madagascar,11-04-2020,241784,243,112,241672,Africa
Malaysia,11-04-2020,35561,1854,636,34925,Western Pacific
Maldives,11-04-2020,129350,2352,498,128852,South-East Asia
Malta,11-04-2020,34084,2209,398,33686,Europe
Mauritania,11-04-2020,108298,1869,765,107533,Africa
Mauritius,11-04-2020,333433,82,220,333213,Africa
Mexico,11-04-2020,374861,530,295,374566,Americas
Moldova,11-04-2020,29249,2297,672,28577,Europe
Monaco,11-04-2020,390809,2189,249,390560,Europe
Mongolia,11-04-2020,327980,192,1185,326795,Western Pacific
Montenegro,11-04-2020,439267,1467,217,439050,Europe
Morocco,11-04-2020,1359,2034,827,532,Eastern Mediterranean
Namibia,11-04-2020,133890,1594,400,133490,Africa
Nepal,11-04-2020,89582,168,1043,88539,South-East Asia
Netherlands,11-04-2020,5648,414,766,4882,Europe
Netherlands,11-04-2020,372607,2296,527,372080,Europe
Netherlands,11-04-2020,166989,534,787,166202,Europe
Netherlands,11-04-2020,71652,1423,72,71580,Europe
New Zealand,11-04-2020,267099,2036,963,266136,Western Pacific
Nicaragua,11-04-2020,360960,2103,67,360893,Americas
Niger,11-04-2020,415581,390,1117,414464,Africa
Nigeria,11-04-2020,251018,672,635,250383,Africa
North Macedonia,11-04-2020,270188,1356,775,269413,Europe
Norway,11-04-2020,122813,1718,1119,121694,Europe
Oman,11-04-2020,105234,1882,1193,104041,Eastern Mediterranean
Pakistan,11-04-2020,391543,907,672,390871,Eastern Mediterranean
Panama,11-04-2020,264991,1509,1162,263829,Americas
Papua New Guinea,11-04-2020,382458,758,371,382087,Western Pacific
Paraguay,11-04-2020,152442,543,409,152033,Americas
Peru,11-04-2020,230200,1026,476,229724,Americas
Philippines,11-04-2020,226304,1141,852,225452,Western Pacific
Poland,11-04-2020,254524,1909,536,253988,Europe
Portugal,11-04-2020,248910,1252,853,248057,Europe
Qatar,11-04-2020,308690,1777,85,308605,Eastern Mediterranean
Romania,11-04-2020,272858,1255,1132,271726,Europe
Russia,11-04-2020,199471,673,671,198800,Europe
Rwanda,11-04-2020,67897,2474,841,67056,Africa
Saint Lucia,11-04-2020,4749,1272,194,4555,Americas
Saint Vincent and the Grenadines,11-04-2020,73260,111,996,72264,Americas
San Marino,11-04-2020,281872,462,1078,280794,Europe
Saudi Arabia,11-04-2020,145606,2304,1138,144468,Eastern Mediterranean
Senegal,11-04-2020,80605,1310,571,80034,Africa
Serbia,11-04-2020,311866,2380,1005,310861,Europe
Seychelles,11-04-2020,32685,2239,304,32381,Africa
Singapore,11-04-2020,431018,190,295,430723,Western Pacific
Slovakia,11-04-2020,282630,2250,235,282395,Europe
Slovenia,11-04-2020,131148,360,103,131045,Europe
Somalia,11-04-2020,111778,1423,471,111307,Eastern Mediterranean
South Africa,11-04-2020,159780,2307,1194,158586,Africa
Spain,11-04-2020,383494,2342,375,383119,Europe
Sri Lanka,11-04-2020,262831,1089,579,262252,South-East Asia
Sudan,11-04-2020,350004,1855,59,349945,Eastern Mediterranean
Suriname,11-04-2020,418593,667,995,417598,Americas
Sweden,11-04-2020,190163,1838,103,190060,Europe
Switzerland,11-04-2020,184256,939,435,183821,Europe
Taiwan*,11-04-2020,19563,735,435,19128,Western Pacific
Tanzania,11-04-2020,155290,1801,212,155078,Africa
Thailand,11-04-2020,97103,1842,1069,96034,South-East Asia
Togo,11-04-2020,311500,1507,435,311065,Africa
Trinidad and Tobago,11-04-2020,429923,2310,1228,428695,Americas
Tunisia,11-04-2020,156942,659,946,155996,Eastern Mediterranean
Turkey,11-04-2020,178520,280,1237,177283,Europe
Uganda,11-04-2020,70681,154,1160,69521,Africa
Ukraine,11-04-2020,441128,1661,247,440881,Europe
United Arab Emirates,11-04-2020,41380,2053,1229,40151,Eastern Mediterranean
United Kingdom,11-04-2020,61037,1077,1050,59987,Europe
United Kingdom,11-04-2020,124587,1311,336,124251,Europe
United Kingdom,11-04-2020,236359,916,377,235982,Europe
United Kingdom,11-04-2020,296180,1583,559,295621,Europe
United Kingdom,11-04-2020,416291,2276,740,415551,Europe
United Kingdom,11-04-2020,106381,1275,133,106248,Europe
United Kingdom,11-04-2020,280701,391,925,279776,Europe
Uruguay,11-04-2020,240222,876,785,239437,Americas
US,11-04-2020,95535,1824,556,94979,Americas
Uzbekistan,11-04-2020,84426,1603,664,83762,Europe
Venezuela,11-04-2020,117847,149,790,117057,Americas
Vietnam,11-04-2020,194361,1939,1165,193196,Western Pacific
Zambia,11-04-2020,205386,355,569,204817,Africa
Zimbabwe,11-04-2020,113533,1675,794,112739,Africa
Dominica,11-04-2020,230982,2360,216,230766,Americas
Grenada,11-04-2020,430606,1028,186,430420,Americas
Mozambique,11-04-2020,339244,1793,475,338769,Africa
Syria,11-04-2020,271723,667,807,270916,Eastern Mediterranean
Timor-Leste,11-04-2020,440984,1866,1237,439747,South-East Asia
Belize,11-04-2020,213722,1255,396,213326,Americas
Laos,11-04-2020,363596,238,935,362661,Western Pacific
Libya,11-04-2020,16827,2002,71,16756,Eastern Mediterranean
West Bank and Gaza,11-04-2020,310937,878,1124,309813,Eastern Mediterranean
Guinea-Bissau,11-04-2020,49531,1337,814,48717,Africa
Mali,11-04-2020,203396,2110,221,203175,Africa
Saint Kitts and Nevis,11-04-2020,183439,2200,839,182600,Americas
Canada,11-04-2020,52993,1409,1069,51924,Americas
Canada,11-04-2020,376621,1933,924,375697,Americas
Kosovo,11-04-2020,177621,1403,1007,176614,Europe
Burma,11-04-2020,18725,1217,835,17890,South-East Asia
United Kingdom,11-04-2020,104375,767,743,103632,Europe
United Kingdom,11-04-2020,375232,2245,1236,373996,Europe
United Kingdom,11-04-2020,46169,952,516,45653,Europe
Botswana,11-04-2020,148902,34,11,148891,Africa
Burundi,11-04-2020,228710,1722,417,228293,Africa
Sierra Leone,11-04-2020,234848,1615,585,234263,Africa
Malawi,11-04-2020,30305,2218,876,29429,Africa
United Kingdom,11-04-2020,406706,1354,1177,405529,Europe
France,11-04-2020,59851,1924,988,58863,Europe
South Sudan,11-04-2020,372392,1879,464,371928,Africa
Western Sahara,11-04-2020,12598,1196,783,11815,Africa
Sao Tome and Principe,11-04-2020,359413,2410,873,358540,Africa
Yemen,11-04-2020,189298,1838,394,188904,Eastern Mediterranean
Comoros,11-04-2020,254937,1606,430,254507,Africa
Tajikistan,11-04-2020,242052,570,478,241574,Europe
Lesotho,11-04-2020,123778,788,16,123762,Africa
Afghanistan,12-04-2020,411782,1028,821,410961,Eastern Mediterranean
Albania,12-04-2020,246340,2221,526,245814,Europe
Algeria,12-04-2020,93620,1196,997,92623,Africa
Andorra,12-04-2020,119323,1772,812,118511,Europe
Angola,12-04-2020,419417,2373,458,418959,Africa
Antigua and Barbuda,12-04-2020,312207,166,433,311774,Americas
Argentina,12-04-2020,249960,1317,117,249843,Americas
Armenia,12-04-2020,138852,294,119,138733,Europe
Australia,12-04-2020,295019,1634,1218,293801,Western Pacific
Australia,12-04-2020,193086,1832,468,192618,Western Pacific
Australia,12-04-2020,272100,1590,135,271965,Western Pacific
Australia,12-04-2020,36116,806,817,35299,Western Pacific
Australia,12-04-2020,172090,1902,1103,170987,Western Pacific
Australia,12-04-2020,360639,1035,386,360253,Western Pacific
Australia,12-04-2020,339808,605,933,338875,Western Pacific
Australia,12-04-2020,61939,987,721,61218,Western Pacific
Austria,12-04-2020,220351,2206,721,219630,Europe
Azerbaijan,12-04-2020,51871,2285,1192,50679,Europe
Bahamas,12-04-2020,116327,1780,1188,115139,Americas
Bahrain,12-04-2020,434231,1368,632,433599,Eastern Mediterranean
Bangladesh,12-04-2020,382966,1647,239,382727,South-East Asia
Barbados,12-04-2020,187867,756,137,187730,Americas
Belarus,12-04-2020,383580,137,95,383485,Europe
Belgium,12-04-2020,114219,2193,714,113505,Europe
Benin,12-04-2020,199534,1275,203,199331,Africa
Bhutan,12-04-2020,97533,1276,426,97107,South-East Asia
Bolivia,12-04-2020,20522,205,591,19931,Americas
Bosnia and Herzegovina,12-04-2020,38696,618,421,38275,Europe
Brazil,12-04-2020,71116,2204,798,70318,Americas
Brunei,12-04-2020,223336,896,725,222611,Western Pacific
Bulgaria,12-04-2020,110535,342,1024,109511,Europe
Burkina Faso,12-04-2020,37494,233,605,36889,Africa
Cabo Verde,12-04-2020,760,1777,328,432,Africa
Cambodia,12-04-2020,48426,2336,395,48031,Western Pacific
Cameroon,12-04-2020,81200,1154,300,80900,Africa
Canada,12-04-2020,367048,1037,1126,365922,Americas
Canada,12-04-2020,52207,182,1013,51194,Americas
Canada,12-04-2020,193432,1821,65,193367,Americas
Canada,12-04-2020,426676,1208,878,425798,Americas
Canada,12-04-2020,187876,1713,780,187096,Americas
Canada,12-04-2020,4632,2170,583,4049,Americas
Canada,12-04-2020,386892,1527,659,386233,Americas
Canada,12-04-2020,408753,1232,1023,407730,Americas
Canada,12-04-2020,291425,1702,352,291073,Americas
Canada,12-04-2020,12667,1546,446,12221,Americas
Central African Republic,12-04-2020,237827,2189,373,237454,Africa
Chad,12-04-2020,441018,377,355,440663,Africa
Chile,12-04-2020,178297,1122,322,177975,Americas
China,12-04-2020,99336,334,604,98732,Western Pacific
China,12-04-2020,196800,2294,240,196560,Western Pacific
China,12-04-2020,123628,212,522,123106,Western Pacific
China,12-04-2020,101569,815,129,101440,Western Pacific
China,12-04-2020,412192,108,1192,411000,Western Pacific
China,12-04-2020,435797,1646,460,435337,Western Pacific
China,12-04-2020,359790,844,62,359728,Western Pacific
China,12-04-2020,443029,396,534,442495,Western Pacific
China,12-04-2020,66889,1968,945,65944,Western Pacific
China,12-04-2020,256191,150,967,255224,Western Pacific
China,12-04-2020,37233,372,571,36662,Western Pacific
China,12-04-2020,48878,834,860,48018,Western Pacific
China,12-04-2020,254673,1020,395,254278,Western Pacific
China,12-04-2020,213850,1870,153,213697,Western Pacific
China,12-04-2020,393313,2055,987,392326,Western Pacific
China,12-04-2020,337157,257,371,336786,Western Pacific
China,12-04-2020,287416,1546,216,287200,Western Pacific
China,12-04-2020,423772,1097,1192,422580,Western Pacific
China,12-04-2020,353281,614,732,352549,Western Pacific
China,12-04-2020,81525,1750,54,81471,Western Pacific
China,12-04-2020,373730,646,270,373460,Western Pacific
China,12-04-2020,123599,1827,268,123331,Western Pacific
China,12-04-2020,9944,470,233,9711,Western Pacific
China,12-04-2020,229155,650,616,228539,Western Pacific
China,12-04-2020,99354,1560,552,98802,Western Pacific
China,12-04-2020,152850,2239,295,152555,Western Pacific
China,12-04-2020,281782,864,925,280857,Western Pacific
China,12-04-2020,104578,684,21,104557,Western Pacific
China,12-04-2020,14239,1277,632,13607,Western Pacific
China,12-04-2020,15019,2450,1037,13982,Western Pacific
China,12-04-2020,271967,2178,681,271286,Western Pacific
China,12-04-2020,15671,46,490,15181,Western Pacific
China,12-04-2020,114275,1448,384,113891,Western Pacific
Colombia,12-04-2020,108381,1856,535,107846,Americas
Congo (Brazzaville),12-04-2020,423987,2455,544,423443,Africa
Congo (Kinshasa),12-04-2020,416122,2378,111,416011,Africa
Costa Rica,12-04-2020,127213,1461,825,126388,Americas
Cote d'Ivoire,12-04-2020,33348,896,544,32804,Africa
Croatia,12-04-2020,418155,2492,654,417501,Europe
Cuba,12-04-2020,108687,1246,864,107823,Americas
Cyprus,12-04-2020,288788,1485,316,288472,Europe
Czechia,12-04-2020,262430,44,639,261791,Europe
Denmark,12-04-2020,143878,546,916,142962,Europe
Greenland,12-04-2020,163645,2270,147,163498,Europe
Denmark,12-04-2020,336619,751,380,336239,Europe
Djibouti,12-04-2020,116041,308,764,115277,Eastern Mediterranean
Dominican Republic,12-04-2020,263399,2378,627,262772,Americas
Ecuador,12-04-2020,287639,1796,176,287463,Americas
Egypt,12-04-2020,375017,2378,1069,373948,Eastern Mediterranean
El Salvador,12-04-2020,169395,1806,463,168932,Americas
Equatorial Guinea,12-04-2020,306153,309,34,306119,Africa
Eritrea,12-04-2020,333975,1989,771,333204,Africa
Estonia,12-04-2020,36287,770,128,36159,Europe
Eswatini,12-04-2020,428539,2350,657,427882,Africa
Ethiopia,12-04-2020,346912,1092,713,346199,Africa
Fiji,12-04-2020,131792,682,375,131417,Western Pacific
Finland,12-04-2020,434812,855,304,434508,Europe
France,12-04-2020,284525,1473,145,284380,Europe
France,12-04-2020,261374,655,1194,260180,Europe
France,12-04-2020,26751,2358,331,26420,Europe
France,12-04-2020,261716,464,733,260983,Europe
France,12-04-2020,161207,126,1135,160072,Europe
France,12-04-2020,422024,1797,557,421467,Europe
France,12-04-2020,204817,575,872,203945,Europe
France,12-04-2020,292145,1927,1207,290938,Europe
France,12-04-2020,154662,1982,610,154052,Europe
France,12-04-2020,25165,2280,505,24660,Europe
Gabon,12-04-2020,37724,1931,1138,36586,Africa
Gambia,12-04-2020,313602,1336,873,312729,Africa
Georgia,12-04-2020,14384,353,1067,13317,Europe
Germany,12-04-2020,383662,1636,447,383215,Europe
Ghana,12-04-2020,201539,806,490,201049,Africa
Greece,12-04-2020,65185,432,1076,64109,Europe
Guatemala,12-04-2020,101373,1892,663,100710,Americas
Guinea,12-04-2020,14136,2092,580,13556,Africa
Guyana,12-04-2020,360145,1667,1250,358895,Americas
Haiti,12-04-2020,44549,109,888,43661,Americas
Holy See,12-04-2020,213120,1946,38,213082,Europe
Honduras,12-04-2020,55002,258,1226,53776,Americas
Hungary,12-04-2020,442914,524,733,442181,Europe
Iceland,12-04-2020,414633,611,845,413788,Europe
India,12-04-2020,351591,2082,177,351414,South-East Asia
Indonesia,12-04-2020,277969,383,1218,276751,South-East Asia
Iran,12-04-2020,45571,1648,147,45424,Eastern Mediterranean
Iraq,12-04-2020,177735,2403,813,176922,Eastern Mediterranean
Ireland,12-04-2020,19454,1921,246,19208,Europe
Israel,12-04-2020,190698,853,1195,189503,Europe
Italy,12-04-2020,157611,1568,239,157372,Europe
Jamaica,12-04-2020,105756,1386,760,104996,Americas
Japan,12-04-2020,143963,1498,581,143382,Western Pacific
Jordan,12-04-2020,415302,876,387,414915,Eastern Mediterranean
Kazakhstan,12-04-2020,79341,287,771,78570,Europe
Kenya,12-04-2020,5735,1469,499,5236,Africa
South Korea,12-04-2020,102227,2271,1209,101018,Western Pacific
Kuwait,12-04-2020,32620,1025,110,32510,Eastern Mediterranean
Kyrgyzstan,12-04-2020,141068,1326,915,140153,Europe
Latvia,12-04-2020,167837,871,451,167386,Europe
Lebanon,12-04-2020,79307,1302,974,78333,Eastern Mediterranean
Liberia,12-04-2020,46295,862,40,46255,Africa
Liechtenstein,12-04-2020,336469,2064,159,336310,Europe
Lithuania,12-04-2020,376064,1928,30,376034,Europe
Luxembourg,12-04-2020,174532,1988,516,174016,Europe
Madagascar,12-04-2020,344275,473,1123,343152,Africa
Malaysia,12-04-2020,423598,1390,391,423207,Western Pacific
Maldives,12-04-2020,20483,958,382,20101,South-East Asia
Malta,12-04-2020,4181,279,502,3679,Europe
Mauritania,12-04-2020,213806,1011,1138,212668,Africa
Mauritius,12-04-2020,388691,2304,125,388566,Africa
Mexico,12-04-2020,232622,41,713,231909,Americas
Moldova,12-04-2020,9241,2417,1223,8018,Europe
Monaco,12-04-2020,209845,2072,168,209677,Europe
Mongolia,12-04-2020,273506,475,915,272591,Western Pacific
Montenegro,12-04-2020,36721,1445,188,36533,Europe
Morocco,12-04-2020,68433,174,38,68395,Eastern Mediterranean
Namibia,12-04-2020,353358,1073,0,353358,Africa
Nepal,12-04-2020,165299,1246,868,164431,South-East Asia
Netherlands,12-04-2020,437949,1123,325,437624,Europe
Netherlands,12-04-2020,7206,2443,307,6899,Europe
Netherlands,12-04-2020,64225,2173,869,63356,Europe
Netherlands,12-04-2020,302644,1546,347,302297,Europe
New Zealand,12-04-2020,136327,1846,230,136097,Western Pacific
Nicaragua,12-04-2020,109721,2473,1021,108700,Americas
Niger,12-04-2020,233125,1263,555,232570,Africa
Nigeria,12-04-2020,219845,1403,564,219281,Africa
North Macedonia,12-04-2020,21306,1320,532,20774,Europe
Norway,12-04-2020,105375,1024,1162,104213,Europe
Oman,12-04-2020,86723,864,1104,85619,Eastern Mediterranean
Pakistan,12-04-2020,265593,540,848,264745,Eastern Mediterranean
Panama,12-04-2020,89795,2011,829,88966,Americas
Papua New Guinea,12-04-2020,28114,2333,270,27844,Western Pacific
Paraguay,12-04-2020,277720,2,888,276832,Americas
Peru,12-04-2020,223537,1672,539,222998,Americas
Philippines,12-04-2020,323734,408,498,323236,Western Pacific
Poland,12-04-2020,224605,2384,505,224100,Europe
Portugal,12-04-2020,14138,471,473,13665,Europe
Qatar,12-04-2020,173587,1388,944,172643,Eastern Mediterranean
Romania,12-04-2020,319682,2080,321,319361,Europe
Russia,12-04-2020,205401,530,238,205163,Europe
Rwanda,12-04-2020,55798,2134,809,54989,Africa
Saint Lucia,12-04-2020,232167,1820,758,231409,Americas
Saint Vincent and the Grenadines,12-04-2020,244318,1225,116,244202,Americas
San Marino,12-04-2020,21316,930,536,20780,Europe
Saudi Arabia,12-04-2020,136902,2103,1153,135749,Eastern Mediterranean
Senegal,12-04-2020,178973,734,603,178370,Africa
Serbia,12-04-2020,20126,1573,692,19434,Europe
Seychelles,12-04-2020,264366,2015,999,263367,Africa
Singapore,12-04-2020,428,1742,297,131,Western Pacific
Slovakia,12-04-2020,419152,612,224,418928,Europe
Slovenia,12-04-2020,382448,2217,738,381710,Europe
Somalia,12-04-2020,283463,354,991,282472,Eastern Mediterranean
South Africa,12-04-2020,98608,1341,929,97679,Africa
Spain,12-04-2020,449651,25,881,448770,Europe
Sri Lanka,12-04-2020,289800,2340,1210,288590,South-East Asia
Sudan,12-04-2020,336962,1457,771,336191,Eastern Mediterranean
Suriname,12-04-2020,377133,479,178,376955,Americas
Sweden,12-04-2020,52270,1190,92,52178,Europe
Switzerland,12-04-2020,186249,809,829,185420,Europe
Taiwan*,12-04-2020,199084,1798,149,198935,Western Pacific
Tanzania,12-04-2020,369336,2177,309,369027,Africa
Thailand,12-04-2020,136905,48,684,136221,South-East Asia
Togo,12-04-2020,61431,1455,917,60514,Africa
Trinidad and Tobago,12-04-2020,411146,794,391,410755,Americas
Tunisia,12-04-2020,215126,1150,274,214852,Eastern Mediterranean
Turkey,12-04-2020,145902,2411,815,145087,Europe
Uganda,12-04-2020,401314,1605,1126,400188,Africa
Ukraine,12-04-2020,365658,122,660,364998,Europe
United Arab Emirates,12-04-2020,438580,2074,80,438500,Eastern Mediterranean
United Kingdom,12-04-2020,211369,1691,579,210790,Europe
United Kingdom,12-04-2020,170621,2199,779,169842,Europe
United Kingdom,12-04-2020,199975,1980,755,199220,Europe
United Kingdom,12-04-2020,239453,1598,1022,238431,Europe
United Kingdom,12-04-2020,20125,156,30,20095,Europe
United Kingdom,12-04-2020,68904,1531,409,68495,Europe
United Kingdom,12-04-2020,25894,1919,61,25833,Europe
Uruguay,12-04-2020,63658,2455,1130,62528,Americas
US,12-04-2020,327862,922,387,327475,Americas
Uzbekistan,12-04-2020,252665,418,599,252066,Europe
Venezuela,12-04-2020,347027,673,455,346572,Americas
Vietnam,12-04-2020,128912,2175,135,128777,Western Pacific
Zambia,12-04-2020,69870,1540,943,68927,Africa
Zimbabwe,12-04-2020,315127,47,1127,314000,Africa
Dominica,12-04-2020,306917,924,586,306331,Americas
Grenada,12-04-2020,395890,1151,1038,394852,Americas
Mozambique,12-04-2020,242018,1520,998,241020,Africa
Syria,12-04-2020,36555,1926,864,35691,Eastern Mediterranean
Timor-Leste,12-04-2020,203589,1246,203,203386,South-East Asia
Belize,12-04-2020,45564,1256,426,45138,Americas
Laos,12-04-2020,176904,952,447,176457,Western Pacific
Libya,12-04-2020,244397,142,683,243714,Eastern Mediterranean
West Bank and Gaza,12-04-2020,1525,238,410,1115,Eastern Mediterranean
Guinea-Bissau,12-04-2020,202696,1558,490,202206,Africa
Mali,12-04-2020,430919,1894,477,430442,Africa
Saint Kitts and Nevis,12-04-2020,64551,31,870,63681,Americas
Canada,12-04-2020,125751,2214,330,125421,Americas
Canada,12-04-2020,210476,1520,328,210148,Americas
Kosovo,12-04-2020,288220,215,207,288013,Europe
Burma,12-04-2020,303903,946,188,303715,South-East Asia
United Kingdom,12-04-2020,373419,1074,434,372985,Europe
United Kingdom,12-04-2020,279679,133,1068,278611,Europe
United Kingdom,12-04-2020,155675,403,729,154946,Europe
Botswana,12-04-2020,177102,620,397,176705,Africa
Burundi,12-04-2020,247415,2434,414,247001,Africa
Sierra Leone,12-04-2020,58333,645,141,58192,Africa
Malawi,12-04-2020,392478,963,490,391988,Africa
United Kingdom,12-04-2020,74164,2117,626,73538,Europe
France,12-04-2020,316216,783,438,315778,Europe
South Sudan,12-04-2020,402062,213,898,401164,Africa
Western Sahara,12-04-2020,210863,1914,643,210220,Africa
Sao Tome and Principe,12-04-2020,332127,1518,503,331624,Africa
Yemen,12-04-2020,159566,647,402,159164,Eastern Mediterranean
Comoros,12-04-2020,350660,1206,267,350393,Africa
Tajikistan,12-04-2020,319463,110,718,318745,Europe
Lesotho,12-04-2020,42415,2034,204,42211,Africa
Afghanistan,13-04-2020,370900,1373,465,370435,Eastern Mediterranean
Albania,13-04-2020,119478,386,580,118898,Europe
Algeria,13-04-2020,55716,547,973,54743,Africa
Andorra,13-04-2020,350813,188,770,350043,Europe
Angola,13-04-2020,48782,1297,833,47949,Africa
Antigua and Barbuda,13-04-2020,300174,2232,366,299808,Americas
Argentina,13-04-2020,421523,2327,725,420798,Americas
Armenia,13-04-2020,221131,1616,586,220545,Europe
Australia,13-04-2020,72569,2289,84,72485,Western Pacific
Australia,13-04-2020,344511,1005,235,344276,Western Pacific
Australia,13-04-2020,196600,221,234,196366,Western Pacific
Australia,13-04-2020,254698,1552,164,254534,Western Pacific
Australia,13-04-2020,122064,1469,412,121652,Western Pacific
Australia,13-04-2020,126357,752,82,126275,Western Pacific
Australia,13-04-2020,438657,1725,1074,437583,Western Pacific
Australia,13-04-2020,212751,2425,36,212715,Western Pacific
Austria,13-04-2020,345845,1663,300,345545,Europe
Azerbaijan,13-04-2020,225060,1636,722,224338,Europe
Bahamas,13-04-2020,133752,540,24,133728,Americas
Bahrain,13-04-2020,221274,1553,796,220478,Eastern Mediterranean
Bangladesh,13-04-2020,133618,143,210,133408,South-East Asia
Barbados,13-04-2020,340211,1472,409,339802,Americas
Belarus,13-04-2020,61881,1388,290,61591,Europe
Belgium,13-04-2020,233184,221,1033,232151,Europe
Benin,13-04-2020,73317,288,295,73022,Africa
Bhutan,13-04-2020,402699,1943,350,402349,South-East Asia
Bolivia,13-04-2020,380588,1842,366,380222,Americas
Bosnia and Herzegovina,13-04-2020,260579,1245,557,260022,Europe
Brazil,13-04-2020,399036,1909,82,398954,Americas
Brunei,13-04-2020,389607,1737,873,388734,Western Pacific
Bulgaria,13-04-2020,346736,1921,382,346354,Europe
Burkina Faso,13-04-2020,222625,1857,1143,221482,Africa
Cabo Verde,13-04-2020,170378,2487,132,170246,Africa
Cambodia,13-04-2020,29296,1180,73,29223,Western Pacific
Cameroon,13-04-2020,430204,980,881,429323,Africa
Canada,13-04-2020,359850,772,578,359272,Americas
Canada,13-04-2020,308600,1536,62,308538,Americas
Canada,13-04-2020,412428,2369,166,412262,Americas
Canada,13-04-2020,296202,1731,783,295419,Americas
Canada,13-04-2020,158790,2341,1054,157736,Americas
Canada,13-04-2020,11261,1750,253,11008,Americas
Canada,13-04-2020,66163,930,656,65507,Americas
Canada,13-04-2020,67130,541,330,66800,Americas
Canada,13-04-2020,38075,588,795,37280,Americas
Canada,13-04-2020,86236,914,674,85562,Americas
Central African Republic,13-04-2020,318249,2272,828,317421,Africa
Chad,13-04-2020,430267,409,1062,429205,Africa
Chile,13-04-2020,185964,1593,1186,184778,Americas
China,13-04-2020,335089,249,608,334481,Western Pacific
China,13-04-2020,380353,1719,606,379747,Western Pacific
China,13-04-2020,200305,1257,1205,199100,Western Pacific
China,13-04-2020,54228,2091,245,53983,Western Pacific
China,13-04-2020,204769,2328,757,204012,Western Pacific
China,13-04-2020,176846,192,6,176840,Western Pacific
China,13-04-2020,17536,2369,449,17087,Western Pacific
China,13-04-2020,213069,2005,1064,212005,Western Pacific
China,13-04-2020,213128,387,244,212884,Western Pacific
China,13-04-2020,127871,1415,496,127375,Western Pacific
China,13-04-2020,157244,911,26,157218,Western Pacific
China,13-04-2020,216744,29,64,216680,Western Pacific
China,13-04-2020,178808,850,206,178602,Western Pacific
China,13-04-2020,411782,1315,141,411641,Western Pacific
China,13-04-2020,184835,1323,992,183843,Western Pacific
China,13-04-2020,176632,1962,1169,175463,Western Pacific
China,13-04-2020,433318,2286,1097,432221,Western Pacific
China,13-04-2020,86387,1781,1013,85374,Western Pacific
China,13-04-2020,365430,1559,629,364801,Western Pacific
China,13-04-2020,169787,1000,906,168881,Western Pacific
China,13-04-2020,431659,860,1143,430516,Western Pacific
China,13-04-2020,189805,555,376,189429,Western Pacific
China,13-04-2020,260460,146,130,260330,Western Pacific
China,13-04-2020,134236,2327,395,133841,Western Pacific
China,13-04-2020,258973,1590,624,258349,Western Pacific
China,13-04-2020,410378,426,841,409537,Western Pacific
China,13-04-2020,116182,507,487,115695,Western Pacific
China,13-04-2020,431791,2296,63,431728,Western Pacific
China,13-04-2020,394190,1535,1003,393187,Western Pacific
China,13-04-2020,225256,773,246,225010,Western Pacific
China,13-04-2020,420048,1638,1059,418989,Western Pacific
China,13-04-2020,213820,2438,653,213167,Western Pacific
China,13-04-2020,254489,1529,1159,253330,Western Pacific
Colombia,13-04-2020,338821,2413,396,338425,Americas
Congo (Brazzaville),13-04-2020,75066,1197,758,74308,Africa
Congo (Kinshasa),13-04-2020,345213,1683,1056,344157,Africa
Costa Rica,13-04-2020,365002,1577,761,364241,Americas
Cote d'Ivoire,13-04-2020,44700,1723,867,43833,Africa
Croatia,13-04-2020,434173,977,151,434022,Europe
Cuba,13-04-2020,49959,1477,628,49331,Americas
Cyprus,13-04-2020,205983,2245,553,205430,Europe
Czechia,13-04-2020,436897,313,310,436587,Europe
Denmark,13-04-2020,211001,2397,918,210083,Europe
Greenland,13-04-2020,231037,1706,656,230381,Europe
Denmark,13-04-2020,302272,1658,497,301775,Europe
Djibouti,13-04-2020,240848,2317,1036,239812,Eastern Mediterranean
Dominican Republic,13-04-2020,381496,305,308,381188,Americas
Ecuador,13-04-2020,401664,1082,65,401599,Americas
Egypt,13-04-2020,62923,487,955,61968,Eastern Mediterranean
El Salvador,13-04-2020,107937,733,180,107757,Americas
Equatorial Guinea,13-04-2020,221867,1662,16,221851,Africa
Eritrea,13-04-2020,387426,1483,31,387395,Africa
Estonia,13-04-2020,369552,412,48,369504,Europe
Eswatini,13-04-2020,330562,2061,1027,329535,Africa
Ethiopia,13-04-2020,277095,2104,321,276774,Africa
Fiji,13-04-2020,377500,825,872,376628,Western Pacific
Finland,13-04-2020,196115,2316,438,195677,Europe
France,13-04-2020,295682,668,284,295398,Europe
France,13-04-2020,84893,1072,797,84096,Europe
France,13-04-2020,22105,461,44,22061,Europe
France,13-04-2020,222849,655,283,222566,Europe
France,13-04-2020,340946,747,312,340634,Europe
France,13-04-2020,30852,2043,298,30554,Europe
France,13-04-2020,69275,343,175,69100,Europe
France,13-04-2020,429387,2365,112,429275,Europe
France,13-04-2020,132449,389,402,132047,Europe
France,13-04-2020,289158,665,743,288415,Europe
Gabon,13-04-2020,191806,625,872,190934,Africa
Gambia,13-04-2020,374507,486,1004,373503,Africa
Georgia,13-04-2020,212480,981,872,211608,Europe
Germany,13-04-2020,387007,1627,993,386014,Europe
Ghana,13-04-2020,204203,1040,1170,203033,Africa
Greece,13-04-2020,320367,2087,1240,319127,Europe
Guatemala,13-04-2020,237728,763,956,236772,Americas
Guinea,13-04-2020,219943,2124,483,219460,Africa
Guyana,13-04-2020,224806,992,153,224653,Americas
Haiti,13-04-2020,65289,38,1021,64268,Americas
Holy See,13-04-2020,182080,2366,361,181719,Europe
Honduras,13-04-2020,425651,325,412,425239,Americas
Hungary,13-04-2020,295532,1574,479,295053,Europe
Iceland,13-04-2020,103556,1811,328,103228,Europe
India,13-04-2020,128281,670,333,127948,South-East Asia
Indonesia,13-04-2020,249435,798,493,248942,South-East Asia
Iran,13-04-2020,299859,2010,168,299691,Eastern Mediterranean
Iraq,13-04-2020,268970,878,425,268545,Eastern Mediterranean
Ireland,13-04-2020,364820,1332,479,364341,Europe
Israel,13-04-2020,412276,43,362,411914,Europe
Italy,13-04-2020,46921,1712,801,46120,Europe
Jamaica,13-04-2020,182395,652,163,182232,Americas
Japan,13-04-2020,431738,1204,855,430883,Western Pacific
Jordan,13-04-2020,420110,1425,414,419696,Eastern Mediterranean
Kazakhstan,13-04-2020,35921,2099,291,35630,Europe
Kenya,13-04-2020,447103,771,809,446294,Africa
South Korea,13-04-2020,119458,936,1134,118324,Western Pacific
Kuwait,13-04-2020,149256,1487,91,149165,Eastern Mediterranean
Kyrgyzstan,13-04-2020,165645,196,276,165369,Europe
Latvia,13-04-2020,13711,618,1104,12607,Europe
Lebanon,13-04-2020,85076,2103,709,84367,Eastern Mediterranean
Liberia,13-04-2020,98076,1245,484,97592,Africa
Liechtenstein,13-04-2020,217005,270,591,216414,Europe
Lithuania,13-04-2020,91848,472,925,90923,Europe
Luxembourg,13-04-2020,353832,1817,1063,352769,Europe
Madagascar,13-04-2020,31319,988,639,30680,Africa
Malaysia,13-04-2020,88380,1576,145,88235,Western Pacific
Maldives,13-04-2020,403108,2086,628,402480,South-East Asia
Malta,13-04-2020,273594,914,1101,272493,Europe
Mauritania,13-04-2020,425029,1093,28,425001,Africa
Mauritius,13-04-2020,403446,774,270,403176,Africa
Mexico,13-04-2020,12574,2217,435,12139,Americas
Moldova,13-04-2020,261364,376,815,260549,Europe
Monaco,13-04-2020,434435,2021,238,434197,Europe
Mongolia,13-04-2020,383236,2318,1084,382152,Western Pacific
Montenegro,13-04-2020,83759,1689,1169,82590,Europe
Morocco,13-04-2020,132511,74,729,131782,Eastern Mediterranean
Namibia,13-04-2020,211643,715,1080,210563,Africa
Nepal,13-04-2020,212695,2092,604,212091,South-East Asia
Netherlands,13-04-2020,77992,2123,188,77804,Europe
Netherlands,13-04-2020,319719,37,785,318934,Europe
Netherlands,13-04-2020,378013,827,1013,377000,Europe
Netherlands,13-04-2020,128623,523,1242,127381,Europe
New Zealand,13-04-2020,71299,2321,277,71022,Western Pacific
Nicaragua,13-04-2020,429385,939,719,428666,Americas
Niger,13-04-2020,122834,229,524,122310,Africa
Nigeria,13-04-2020,268712,555,992,267720,Africa
North Macedonia,13-04-2020,327153,603,1053,326100,Europe
Norway,13-04-2020,54483,738,1022,53461,Europe
Oman,13-04-2020,21849,2168,838,21011,Eastern Mediterranean
Pakistan,13-04-2020,123242,1519,1105,122137,Eastern Mediterranean
Panama,13-04-2020,363696,1463,47,363649,Americas
Papua New Guinea,13-04-2020,221374,1505,965,220409,Western Pacific
Paraguay,13-04-2020,37017,1344,1186,35831,Americas
Peru,13-04-2020,46394,911,489,45905,Americas
Philippines,13-04-2020,189703,2085,464,189239,Western Pacific
Poland,13-04-2020,62688,2066,807,61881,Europe
Portugal,13-04-2020,241341,1657,100,241241,Europe
Qatar,13-04-2020,42562,1754,546,42016,Eastern Mediterranean
Romania,13-04-2020,34390,1010,63,34327,Europe
Russia,13-04-2020,145067,1874,590,144477,Europe
Rwanda,13-04-2020,54471,596,266,54205,Africa
Saint Lucia,13-04-2020,265772,333,1209,264563,Americas
Saint Vincent and the Grenadines,13-04-2020,29296,561,1098,28198,Americas
San Marino,13-04-2020,259737,757,455,259282,Europe
Saudi Arabia,13-04-2020,282419,1925,181,282238,Eastern Mediterranean
Senegal,13-04-2020,419284,132,518,418766,Africa
Serbia,13-04-2020,218506,2105,722,217784,Europe
Seychelles,13-04-2020,277577,1938,336,277241,Africa
Singapore,13-04-2020,127916,2009,1072,126844,Western Pacific
Slovakia,13-04-2020,310644,1777,453,310191,Europe
Slovenia,13-04-2020,192605,2311,104,192501,Europe
Somalia,13-04-2020,254043,2161,1237,252806,Eastern Mediterranean
South Africa,13-04-2020,249352,1286,561,248791,Africa
Spain,13-04-2020,175845,373,548,175297,Europe
Sri Lanka,13-04-2020,433233,1676,31,433202,South-East Asia
Sudan,13-04-2020,166892,694,391,166501,Eastern Mediterranean
Suriname,13-04-2020,85925,1623,670,85255,Americas
Sweden,13-04-2020,50683,2165,1247,49436,Europe
Switzerland,13-04-2020,267056,436,222,266834,Europe
Taiwan*,13-04-2020,359279,1787,441,358838,Western Pacific
Tanzania,13-04-2020,27909,2352,971,26938,Africa
Thailand,13-04-2020,72249,1583,252,71997,South-East Asia
Togo,13-04-2020,71115,2032,973,70142,Africa
Trinidad and Tobago,13-04-2020,261812,516,13,261799,Americas
Tunisia,13-04-2020,15860,25,977,14883,Eastern Mediterranean
Turkey,13-04-2020,285684,1187,318,285366,Europe
Uganda,13-04-2020,2184,2096,599,1585,Africa
Ukraine,13-04-2020,439669,1952,335,439334,Europe
United Arab Emirates,13-04-2020,309360,1761,893,308467,Eastern Mediterranean
United Kingdom,13-04-2020,392103,581,613,391490,Europe
United Kingdom,13-04-2020,356152,1148,1231,354921,Europe
United Kingdom,13-04-2020,251499,2189,96,251403,Europe
United Kingdom,13-04-2020,341202,2289,599,340603,Europe
United Kingdom,13-04-2020,211481,2248,129,211352,Europe
United Kingdom,13-04-2020,12525,1366,1027,11498,Europe
United Kingdom,13-04-2020,420798,1694,92,420706,Europe
Uruguay,13-04-2020,83329,1820,71,83258,Americas
US,13-04-2020,303598,198,459,303139,Americas
Uzbekistan,13-04-2020,4067,1279,883,3184,Europe
Venezuela,13-04-2020,81162,2403,378,80784,Americas
Vietnam,13-04-2020,71590,1847,200,71390,Western Pacific
Zambia,13-04-2020,232344,920,691,231653,Africa
Zimbabwe,13-04-2020,41911,2375,113,41798,Africa
Dominica,13-04-2020,122192,1240,673,121519,Americas
Grenada,13-04-2020,223635,170,731,222904,Americas
Mozambique,13-04-2020,286405,87,660,285745,Africa
Syria,13-04-2020,429955,1527,371,429584,Eastern Mediterranean
Timor-Leste,13-04-2020,151890,2016,88,151802,South-East Asia
Belize,13-04-2020,71202,1043,918,70284,Americas
Laos,13-04-2020,29287,2316,1215,28072,Western Pacific
Libya,13-04-2020,36603,773,1233,35370,Eastern Mediterranean
West Bank and Gaza,13-04-2020,254398,1661,193,254205,Eastern Mediterranean
Guinea-Bissau,13-04-2020,200297,241,570,199727,Africa
Mali,13-04-2020,129460,1657,135,129325,Africa
Saint Kitts and Nevis,13-04-2020,61477,181,91,61386,Americas
Canada,13-04-2020,97543,1459,417,97126,Americas
Canada,13-04-2020,260379,1935,125,260254,Americas
Kosovo,13-04-2020,404805,1399,216,404589,Europe
Burma,13-04-2020,5371,105,265,5106,South-East Asia
United Kingdom,13-04-2020,6994,294,1019,5975,Europe
United Kingdom,13-04-2020,407472,2213,836,406636,Europe
United Kingdom,13-04-2020,364632,1246,798,363834,Europe
Botswana,13-04-2020,411147,1130,691,410456,Africa
Burundi,13-04-2020,139155,1657,700,138455,Africa
Sierra Leone,13-04-2020,231947,1100,1121,230826,Africa
Malawi,13-04-2020,129047,440,857,128190,Africa
United Kingdom,13-04-2020,64401,901,470,63931,Europe
France,13-04-2020,363933,2350,511,363422,Europe
South Sudan,13-04-2020,396851,966,899,395952,Africa
Western Sahara,13-04-2020,423369,1007,792,422577,Africa
Sao Tome and Principe,13-04-2020,195040,1093,339,194701,Africa
Yemen,13-04-2020,443794,226,1091,442703,Eastern Mediterranean
Comoros,13-04-2020,270572,2233,1190,269382,Africa
Tajikistan,13-04-2020,395815,271,748,395067,Europe
Lesotho,13-04-2020,391930,274,578,391352,Africa
Afghanistan,14-04-2020,222944,2462,527,222417,Eastern Mediterranean
Albania,14-04-2020,230385,2497,317,230068,Europe
Algeria,14-04-2020,414381,1435,274,414107,Africa
Andorra,14-04-2020,390994,700,1094,389900,Europe
Angola,14-04-2020,553,82,373,180,Africa
Antigua and Barbuda,14-04-2020,256558,1918,694,255864,Americas
Argentina,14-04-2020,91521,2242,135,91386,Americas
Armenia,14-04-2020,261778,2477,1010,260768,Europe
Australia,14-04-2020,66538,1239,74,66464,Western Pacific
Australia,14-04-2020,49266,94,681,48585,Western Pacific
Australia,14-04-2020,55065,1214,846,54219,Western Pacific
Australia,14-04-2020,428293,2113,158,428135,Western Pacific
Australia,14-04-2020,436948,282,653,436295,Western Pacific
Australia,14-04-2020,208898,1958,87,208811,Western Pacific
Australia,14-04-2020,367551,280,719,366832,Western Pacific
Australia,14-04-2020,325417,298,948,324469,Western Pacific
Austria,14-04-2020,214318,583,274,214044,Europe
Azerbaijan,14-04-2020,335684,1980,261,335423,Europe
Bahamas,14-04-2020,157970,1417,1205,156765,Americas
Bahrain,14-04-2020,298246,551,621,297625,Eastern Mediterranean
Bangladesh,14-04-2020,272020,1353,939,271081,South-East Asia
Barbados,14-04-2020,31604,648,970,30634,Americas
Belarus,14-04-2020,283146,816,613,282533,Europe
Belgium,14-04-2020,251534,2214,626,250908,Europe
Benin,14-04-2020,50721,1999,619,50102,Africa
Bhutan,14-04-2020,439864,1038,897,438967,South-East Asia
Bolivia,14-04-2020,107579,1496,835,106744,Americas
Bosnia and Herzegovina,14-04-2020,433837,1809,239,433598,Europe
Brazil,14-04-2020,18754,1400,318,18436,Americas
Brunei,14-04-2020,290516,2031,1157,289359,Western Pacific
Bulgaria,14-04-2020,436404,2319,1101,435303,Europe
Burkina Faso,14-04-2020,16091,1819,102,15989,Africa
Cabo Verde,14-04-2020,28766,401,756,28010,Africa
Cambodia,14-04-2020,402274,1842,923,401351,Western Pacific
Cameroon,14-04-2020,310478,2157,444,310034,Africa
Canada,14-04-2020,67631,379,489,67142,Americas
Canada,14-04-2020,356028,1817,578,355450,Americas
Canada,14-04-2020,4212,1296,116,4096,Americas
Canada,14-04-2020,88625,1854,373,88252,Americas
Canada,14-04-2020,368027,862,387,367640,Americas
Canada,14-04-2020,417854,247,129,417725,Americas
Canada,14-04-2020,351787,375,336,351451,Americas
Canada,14-04-2020,179492,2380,584,178908,Americas
Canada,14-04-2020,193170,1183,528,192642,Americas
Canada,14-04-2020,131612,1348,576,131036,Americas
Central African Republic,14-04-2020,67263,881,268,66995,Africa
Chad,14-04-2020,154354,1860,168,154186,Africa
Chile,14-04-2020,41950,667,1089,40861,Americas
China,14-04-2020,322526,2185,1125,321401,Western Pacific
China,14-04-2020,246676,1675,191,246485,Western Pacific
China,14-04-2020,175006,2294,952,174054,Western Pacific
China,14-04-2020,90092,811,1154,88938,Western Pacific
China,14-04-2020,222207,1579,643,221564,Western Pacific
China,14-04-2020,432617,2337,399,432218,Western Pacific
China,14-04-2020,36746,295,269,36477,Western Pacific
China,14-04-2020,348538,2419,1201,347337,Western Pacific
China,14-04-2020,148688,1890,523,148165,Western Pacific
China,14-04-2020,389572,256,339,389233,Western Pacific
China,14-04-2020,301734,1561,321,301413,Western Pacific
China,14-04-2020,58730,167,190,58540,Western Pacific
China,14-04-2020,375891,2044,934,374957,Western Pacific
China,14-04-2020,137652,1249,181,137471,Western Pacific
China,14-04-2020,379401,968,985,378416,Western Pacific
China,14-04-2020,192835,880,1171,191664,Western Pacific
China,14-04-2020,8970,888,42,8928,Western Pacific
China,14-04-2020,308522,1638,1153,307369,Western Pacific
China,14-04-2020,359343,1866,1234,358109,Western Pacific
China,14-04-2020,48708,1781,992,47716,Western Pacific
China,14-04-2020,437560,481,8,437552,Western Pacific
China,14-04-2020,166334,1529,431,165903,Western Pacific
China,14-04-2020,72188,433,1153,71035,Western Pacific
China,14-04-2020,31087,169,1022,30065,Western Pacific
China,14-04-2020,330451,994,1241,329210,Western Pacific
China,14-04-2020,218402,1913,1055,217347,Western Pacific
China,14-04-2020,273324,678,32,273292,Western Pacific
China,14-04-2020,443179,669,115,443064,Western Pacific
China,14-04-2020,107308,1191,22,107286,Western Pacific
China,14-04-2020,153958,2448,50,153908,Western Pacific
China,14-04-2020,60231,2407,963,59268,Western Pacific
China,14-04-2020,292833,483,494,292339,Western Pacific
China,14-04-2020,54052,891,504,53548,Western Pacific
Colombia,14-04-2020,66099,2455,997,65102,Americas
Congo (Brazzaville),14-04-2020,23423,985,996,22427,Africa
Congo (Kinshasa),14-04-2020,6291,2377,593,5698,Africa
Costa Rica,14-04-2020,63302,1798,507,62795,Americas
Cote d'Ivoire,14-04-2020,285084,888,1045,284039,Africa
Croatia,14-04-2020,18465,376,815,17650,Europe
Cuba,14-04-2020,5128,253,891,4237,Americas
Cyprus,14-04-2020,145239,1605,418,144821,Europe
Czechia,14-04-2020,145401,553,476,144925,Europe
Denmark,14-04-2020,7844,1191,701,7143,Europe
Greenland,14-04-2020,180418,265,531,179887,Europe
Denmark,14-04-2020,66969,944,314,66655,Europe
Djibouti,14-04-2020,319330,2379,677,318653,Eastern Mediterranean
Dominican Republic,14-04-2020,73814,497,27,73787,Americas
Ecuador,14-04-2020,306930,1186,753,306177,Americas
Egypt,14-04-2020,254575,1258,135,254440,Eastern Mediterranean
El Salvador,14-04-2020,219809,1037,14,219795,Americas
Equatorial Guinea,14-04-2020,79779,2138,384,79395,Africa
Eritrea,14-04-2020,116919,1138,1093,115826,Africa
Estonia,14-04-2020,283856,981,8,283848,Europe
Eswatini,14-04-2020,413090,2106,419,412671,Africa
Ethiopia,14-04-2020,40041,1067,548,39493,Africa
Fiji,14-04-2020,417382,2335,225,417157,Western Pacific
Finland,14-04-2020,162501,1115,180,162321,Europe
France,14-04-2020,18850,2204,453,18397,Europe
France,14-04-2020,106843,1451,336,106507,Europe
France,14-04-2020,407155,1537,1179,405976,Europe
France,14-04-2020,40431,2115,249,40182,Europe
France,14-04-2020,188798,1340,441,188357,Europe
France,14-04-2020,32853,1395,862,31991,Europe
France,14-04-2020,267916,2158,375,267541,Europe
France,14-04-2020,140463,841,302,140161,Europe
France,14-04-2020,444626,1686,4,444622,Europe
France,14-04-2020,212880,996,522,212358,Europe
Gabon,14-04-2020,225660,1166,331,225329,Africa
Gambia,14-04-2020,380472,2115,629,379843,Africa
Georgia,14-04-2020,222442,152,357,222085,Europe
Germany,14-04-2020,399498,1289,1092,398406,Europe
Ghana,14-04-2020,205784,919,474,205310,Africa
Greece,14-04-2020,300132,907,1134,298998,Europe
Guatemala,14-04-2020,364768,1272,248,364520,Americas
Guinea,14-04-2020,151255,1843,59,151196,Africa
Guyana,14-04-2020,267986,1841,574,267412,Americas
Haiti,14-04-2020,175318,694,861,174457,Americas
Holy See,14-04-2020,225322,2294,170,225152,Europe
Honduras,14-04-2020,282066,1623,1227,280839,Americas
Hungary,14-04-2020,362060,402,1221,360839,Europe
Iceland,14-04-2020,161726,1781,771,160955,Europe
India,14-04-2020,222793,527,597,222196,South-East Asia
Indonesia,14-04-2020,400900,2120,854,400046,South-East Asia
Iran,14-04-2020,55,687,887,-832,Eastern Mediterranean
Iraq,14-04-2020,99148,1606,565,98583,Eastern Mediterranean
Ireland,14-04-2020,116041,1478,705,115336,Europe
Israel,14-04-2020,122211,2459,636,121575,Europe
Italy,14-04-2020,432637,792,69,432568,Europe
Jamaica,14-04-2020,104372,1607,499,103873,Americas
Japan,14-04-2020,184091,2244,303,183788,Western Pacific
Jordan,14-04-2020,333705,277,700,333005,Eastern Mediterranean
Kazakhstan,14-04-2020,204306,489,427,203879,Europe
Kenya,14-04-2020,73163,798,644,72519,Africa
South Korea,14-04-2020,383467,494,325,383142,Western Pacific
Kuwait,14-04-2020,243635,2235,1178,242457,Eastern Mediterranean
Kyrgyzstan,14-04-2020,48433,1188,267,48166,Europe
Latvia,14-04-2020,2382,2324,811,1571,Europe
Lebanon,14-04-2020,376045,2204,782,375263,Eastern Mediterranean
Liberia,14-04-2020,265502,1782,1029,264473,Africa
Liechtenstein,14-04-2020,237905,1873,1085,236820,Europe
Lithuania,14-04-2020,226608,1981,254,226354,Europe
Luxembourg,14-04-2020,65828,2461,1238,64590,Europe
Madagascar,14-04-2020,107666,1623,548,107118,Africa
Malaysia,14-04-2020,337199,2137,217,336982,Western Pacific
Maldives,14-04-2020,101349,259,325,101024,South-East Asia
Malta,14-04-2020,369215,1362,89,369126,Europe
Mauritania,14-04-2020,183488,2328,635,182853,Africa
Mauritius,14-04-2020,46571,810,488,46083,Africa
Mexico,14-04-2020,397135,2469,925,396210,Americas
Moldova,14-04-2020,272476,347,254,272222,Europe
Monaco,14-04-2020,193582,2308,830,192752,Europe
Mongolia,14-04-2020,371440,619,190,371250,Western Pacific
Montenegro,14-04-2020,24117,1807,778,23339,Europe
Morocco,14-04-2020,120319,355,18,120301,Eastern Mediterranean
Namibia,14-04-2020,342263,2017,984,341279,Africa
Nepal,14-04-2020,288319,613,1190,287129,South-East Asia
Netherlands,14-04-2020,188443,1080,1036,187407,Europe
Netherlands,14-04-2020,118611,267,53,118558,Europe
Netherlands,14-04-2020,144336,266,563,143773,Europe
Netherlands,14-04-2020,28239,577,433,27806,Europe
New Zealand,14-04-2020,278520,584,61,278459,Western Pacific
Nicaragua,14-04-2020,78942,1210,24,78918,Americas
Niger,14-04-2020,283774,384,577,283197,Africa
Nigeria,14-04-2020,15414,1532,1058,14356,Africa
North Macedonia,14-04-2020,409469,1161,77,409392,Europe
Norway,14-04-2020,257932,694,253,257679,Europe
Oman,14-04-2020,76432,597,1244,75188,Eastern Mediterranean
Pakistan,14-04-2020,150448,1322,97,150351,Eastern Mediterranean
Panama,14-04-2020,170440,1526,1018,169422,Americas
Papua New Guinea,14-04-2020,131545,771,465,131080,Western Pacific
Paraguay,14-04-2020,97532,189,444,97088,Americas
Peru,14-04-2020,51046,2482,589,50457,Americas
Philippines,14-04-2020,376546,14,272,376274,Western Pacific
Poland,14-04-2020,95722,373,96,95626,Europe
Portugal,14-04-2020,258796,2117,589,258207,Europe
Qatar,14-04-2020,241508,2265,796,240712,Eastern Mediterranean
Romania,14-04-2020,308847,2021,674,308173,Europe
Russia,14-04-2020,384048,290,742,383306,Europe
Rwanda,14-04-2020,183175,706,866,182309,Africa
Saint Lucia,14-04-2020,336559,848,565,335994,Americas
Saint Vincent and the Grenadines,14-04-2020,74939,111,576,74363,Americas
San Marino,14-04-2020,370190,1821,743,369447,Europe
Saudi Arabia,14-04-2020,93582,1247,867,92715,Eastern Mediterranean
Senegal,14-04-2020,392576,2122,1046,391530,Africa
Serbia,14-04-2020,49540,1184,31,49509,Europe
Seychelles,14-04-2020,283465,867,988,282477,Africa
Singapore,14-04-2020,340029,1674,708,339321,Western Pacific
Slovakia,14-04-2020,254995,603,609,254386,Europe
Slovenia,14-04-2020,344420,728,466,343954,Europe
Somalia,14-04-2020,96858,2358,202,96656,Eastern Mediterranean
South Africa,14-04-2020,443704,2082,702,443002,Africa
Spain,14-04-2020,347814,848,463,347351,Europe
Sri Lanka,14-04-2020,442731,618,1175,441556,South-East Asia
Sudan,14-04-2020,159175,415,260,158915,Eastern Mediterranean
Suriname,14-04-2020,194654,2181,924,193730,Americas
Sweden,14-04-2020,68761,1009,768,67993,Europe
Switzerland,14-04-2020,428546,327,621,427925,Europe
Taiwan*,14-04-2020,397602,476,586,397016,Western Pacific
Tanzania,14-04-2020,230267,788,854,229413,Africa
Thailand,14-04-2020,171913,1922,572,171341,South-East Asia
Togo,14-04-2020,128632,2173,827,127805,Africa
Trinidad and Tobago,14-04-2020,321048,1629,781,320267,Americas
Tunisia,14-04-2020,199587,638,449,199138,Eastern Mediterranean
Turkey,14-04-2020,400258,1347,1020,399238,Europe
Uganda,14-04-2020,226487,1746,493,225994,Africa
Ukraine,14-04-2020,431175,1905,702,430473,Europe
United Arab Emirates,14-04-2020,173283,1463,939,172344,Eastern Mediterranean
United Kingdom,14-04-2020,420764,559,502,420262,Europe
United Kingdom,14-04-2020,261093,599,1031,260062,Europe
United Kingdom,14-04-2020,368586,1008,794,367792,Europe
United Kingdom,14-04-2020,400121,2241,1082,399039,Europe
United Kingdom,14-04-2020,163368,191,661,162707,Europe
United Kingdom,14-04-2020,338461,2019,1208,337253,Europe
United Kingdom,14-04-2020,267992,737,1161,266831,Europe
Uruguay,14-04-2020,211295,1875,111,211184,Americas
US,14-04-2020,201889,840,896,200993,Americas
Uzbekistan,14-04-2020,271309,965,152,271157,Europe
Venezuela,14-04-2020,81882,1758,428,81454,Americas
Vietnam,14-04-2020,393040,284,938,392102,Western Pacific
Zambia,14-04-2020,269468,559,167,269301,Africa
Zimbabwe,14-04-2020,2238,1769,1109,1129,Africa
Dominica,14-04-2020,121268,292,1135,120133,Americas
Grenada,14-04-2020,71638,1028,221,71417,Americas
Mozambique,14-04-2020,407895,904,378,407517,Africa
Syria,14-04-2020,174413,1401,575,173838,Eastern Mediterranean
Timor-Leste,14-04-2020,402764,2049,87,402677,South-East Asia
Belize,14-04-2020,341507,690,254,341253,Americas
Laos,14-04-2020,153096,1351,278,152818,Western Pacific
Libya,14-04-2020,206680,1806,505,206175,Eastern Mediterranean
West Bank and Gaza,14-04-2020,314292,471,429,313863,Eastern Mediterranean
Guinea-Bissau,14-04-2020,7092,754,875,6217,Africa
Mali,14-04-2020,7362,1343,500,6862,Africa
Saint Kitts and Nevis,14-04-2020,186724,1039,932,185792,Americas
Canada,14-04-2020,211932,2104,176,211756,Americas
Canada,14-04-2020,421168,2295,751,420417,Americas
Kosovo,14-04-2020,93613,1431,325,93288,Europe
Burma,14-04-2020,141667,1916,835,140832,South-East Asia
United Kingdom,14-04-2020,87789,1190,833,86956,Europe
United Kingdom,14-04-2020,225560,1762,449,225111,Europe
United Kingdom,14-04-2020,441952,2396,973,440979,Europe
Botswana,14-04-2020,228475,1768,1221,227254,Africa
Burundi,14-04-2020,388044,1792,149,387895,Africa
Sierra Leone,14-04-2020,253918,1016,552,253366,Africa
Malawi,14-04-2020,434593,814,1040,433553,Africa
United Kingdom,14-04-2020,13445,1505,585,12860,Europe
France,14-04-2020,278250,81,683,277567,Europe
South Sudan,14-04-2020,434088,1037,879,433209,Africa
Western Sahara,14-04-2020,398546,291,648,397898,Africa
Sao Tome and Principe,14-04-2020,126150,858,230,125920,Africa
Yemen,14-04-2020,26730,1113,67,26663,Eastern Mediterranean
Comoros,14-04-2020,63751,628,172,63579,Africa
Tajikistan,14-04-2020,272856,1228,1233,271623,Europe
Lesotho,14-04-2020,28281,1011,1034,27247,Africa
Afghanistan,15-04-2020,42749,1110,36,42713,Eastern Mediterranean
Albania,15-04-2020,52741,179,271,52470,Europe
Algeria,15-04-2020,360282,2206,43,360239,Africa
Andorra,15-04-2020,103598,2267,175,103423,Europe
Angola,15-04-2020,157906,2172,339,157567,Africa
Antigua and Barbuda,15-04-2020,331766,597,468,331298,Americas
Argentina,15-04-2020,222450,306,220,222230,Americas
Armenia,15-04-2020,64675,151,74,64601,Europe
Australia,15-04-2020,314749,2415,882,313867,Western Pacific
Australia,15-04-2020,263343,1611,808,262535,Western Pacific
Australia,15-04-2020,185245,257,1152,184093,Western Pacific
Australia,15-04-2020,187574,978,853,186721,Western Pacific
Australia,15-04-2020,89660,818,56,89604,Western Pacific
Australia,15-04-2020,46361,1013,995,45366,Western Pacific
Australia,15-04-2020,166472,121,1250,165222,Western Pacific
Australia,15-04-2020,399181,333,527,398654,Western Pacific
Austria,15-04-2020,211862,1943,1131,210731,Europe
Azerbaijan,15-04-2020,141415,1880,222,141193,Europe
Bahamas,15-04-2020,446344,2008,1103,445241,Americas
Bahrain,15-04-2020,148702,975,1062,147640,Eastern Mediterranean
Bangladesh,15-04-2020,387394,908,581,386813,South-East Asia
Barbados,15-04-2020,40891,1205,78,40813,Americas
Belarus,15-04-2020,261518,1535,445,261073,Europe
Belgium,15-04-2020,113705,377,460,113245,Europe
Benin,15-04-2020,31295,1858,790,30505,Africa
Bhutan,15-04-2020,57346,865,391,56955,South-East Asia
Bolivia,15-04-2020,235675,2130,154,235521,Americas
Bosnia and Herzegovina,15-04-2020,283810,1625,1099,282711,Europe
Brazil,15-04-2020,187078,831,474,186604,Americas
Brunei,15-04-2020,421623,1500,330,421293,Western Pacific
Bulgaria,15-04-2020,421981,2240,927,421054,Europe
Burkina Faso,15-04-2020,133423,1363,268,133155,Africa
Cabo Verde,15-04-2020,400502,305,673,399829,Africa
Cambodia,15-04-2020,411145,2108,315,410830,Western Pacific
Cameroon,15-04-2020,118511,2449,469,118042,Africa
Canada,15-04-2020,40100,2056,1017,39083,Americas
Canada,15-04-2020,95278,1391,236,95042,Americas
Canada,15-04-2020,53702,2147,886,52816,Americas
Canada,15-04-2020,55216,2371,296,54920,Americas
Canada,15-04-2020,389039,1084,1199,387840,Americas
Canada,15-04-2020,75628,61,821,74807,Americas
Canada,15-04-2020,94218,794,804,93414,Americas
Canada,15-04-2020,212865,1482,1238,211627,Americas
Canada,15-04-2020,36116,1468,835,35281,Americas
Canada,15-04-2020,304815,1214,256,304559,Americas
Central African Republic,15-04-2020,430991,957,1214,429777,Africa
Chad,15-04-2020,234683,2463,559,234124,Africa
Chile,15-04-2020,145343,2392,54,145289,Americas
China,15-04-2020,20176,2299,950,19226,Western Pacific
China,15-04-2020,228221,1288,97,228124,Western Pacific
China,15-04-2020,29663,2007,282,29381,Western Pacific
China,15-04-2020,72465,2167,666,71799,Western Pacific
China,15-04-2020,175430,2227,222,175208,Western Pacific
China,15-04-2020,351177,2296,283,350894,Western Pacific
China,15-04-2020,388697,630,568,388129,Western Pacific
China,15-04-2020,277856,2490,360,277496,Western Pacific
China,15-04-2020,134754,1338,459,134295,Western Pacific
China,15-04-2020,411996,1271,1095,410901,Western Pacific
China,15-04-2020,412222,1916,1190,411032,Western Pacific
China,15-04-2020,100478,1371,534,99944,Western Pacific
China,15-04-2020,155964,959,1150,154814,Western Pacific
China,15-04-2020,309872,1267,704,309168,Western Pacific
China,15-04-2020,436645,1398,378,436267,Western Pacific
China,15-04-2020,339150,999,190,338960,Western Pacific
China,15-04-2020,221627,632,1022,220605,Western Pacific
China,15-04-2020,356411,2079,607,355804,Western Pacific
China,15-04-2020,354507,2208,512,353995,Western Pacific
China,15-04-2020,157275,172,1071,156204,Western Pacific
China,15-04-2020,393166,455,674,392492,Western Pacific
China,15-04-2020,96621,2188,41,96580,Western Pacific
China,15-04-2020,187211,1542,936,186275,Western Pacific
China,15-04-2020,442143,2175,1084,441059,Western Pacific
China,15-04-2020,214757,2191,1113,213644,Western Pacific
China,15-04-2020,63962,1802,452,63510,Western Pacific
China,15-04-2020,207276,269,613,206663,Western Pacific
China,15-04-2020,270415,1432,866,269549,Western Pacific
China,15-04-2020,185469,295,751,184718,Western Pacific
China,15-04-2020,207216,552,540,206676,Western Pacific
China,15-04-2020,382536,773,914,381622,Western Pacific
China,15-04-2020,319239,1571,1212,318027,Western Pacific
China,15-04-2020,446185,2478,326,445859,Western Pacific
Colombia,15-04-2020,299257,946,623,298634,Americas
Congo (Brazzaville),15-04-2020,114988,457,863,114125,Africa
Congo (Kinshasa),15-04-2020,399168,1443,1007,398161,Africa
Costa Rica,15-04-2020,38596,1406,496,38100,Americas
Cote d'Ivoire,15-04-2020,186018,1835,680,185338,Africa
Croatia,15-04-2020,179182,959,338,178844,Europe
Cuba,15-04-2020,67792,2021,916,66876,Americas
Cyprus,15-04-2020,416670,2428,649,416021,Europe
Czechia,15-04-2020,337923,220,654,337269,Europe
Denmark,15-04-2020,239062,2455,1097,237965,Europe
Greenland,15-04-2020,443429,262,1216,442213,Europe
Denmark,15-04-2020,177400,1624,11,177389,Europe
Djibouti,15-04-2020,160329,1346,6,160323,Eastern Mediterranean
Dominican Republic,15-04-2020,290100,262,675,289425,Americas
Ecuador,15-04-2020,317070,197,90,316980,Americas
Egypt,15-04-2020,342204,2250,1014,341190,Eastern Mediterranean
El Salvador,15-04-2020,200080,404,680,199400,Americas
Equatorial Guinea,15-04-2020,164699,1190,719,163980,Africa
Eritrea,15-04-2020,72785,1905,150,72635,Africa
Estonia,15-04-2020,22514,1624,362,22152,Europe
Eswatini,15-04-2020,307440,2178,1118,306322,Africa
Ethiopia,15-04-2020,381615,769,1231,380384,Africa
Fiji,15-04-2020,383341,2477,673,382668,Western Pacific
Finland,15-04-2020,424557,1980,607,423950,Europe
France,15-04-2020,400468,2167,805,399663,Europe
France,15-04-2020,241833,330,673,241160,Europe
France,15-04-2020,309008,1511,1117,307891,Europe
France,15-04-2020,90144,2281,1136,89008,Europe
France,15-04-2020,12268,187,1172,11096,Europe
France,15-04-2020,306599,596,920,305679,Europe
France,15-04-2020,314161,2342,523,313638,Europe
France,15-04-2020,236943,486,596,236347,Europe
France,15-04-2020,235884,1896,1120,234764,Europe
France,15-04-2020,110732,2331,1047,109685,Europe
Gabon,15-04-2020,242966,834,139,242827,Africa
Gambia,15-04-2020,5800,1460,300,5500,Africa
Georgia,15-04-2020,429165,2467,217,428948,Europe
Germany,15-04-2020,281980,699,477,281503,Europe
Ghana,15-04-2020,181826,1151,627,181199,Africa
Greece,15-04-2020,97355,892,1051,96304,Europe
Guatemala,15-04-2020,50253,1431,666,49587,Americas
Guinea,15-04-2020,201527,1783,444,201083,Africa
Guyana,15-04-2020,89852,697,1071,88781,Americas
Haiti,15-04-2020,445869,1996,733,445136,Americas
Holy See,15-04-2020,144132,1306,469,143663,Europe
Honduras,15-04-2020,103971,883,662,103309,Americas
Hungary,15-04-2020,446213,1478,55,446158,Europe
Iceland,15-04-2020,391094,1554,470,390624,Europe
India,15-04-2020,69640,2172,173,69467,South-East Asia
Indonesia,15-04-2020,222311,1792,1104,221207,South-East Asia
Iran,15-04-2020,364056,609,144,363912,Eastern Mediterranean
Iraq,15-04-2020,422287,2281,893,421394,Eastern Mediterranean
Ireland,15-04-2020,312534,532,1066,311468,Europe
Israel,15-04-2020,410283,1682,1169,409114,Europe
Italy,15-04-2020,5330,503,160,5170,Europe
Jamaica,15-04-2020,140108,2319,811,139297,Americas
Japan,15-04-2020,184983,2103,563,184420,Western Pacific
Jordan,15-04-2020,424095,703,778,423317,Eastern Mediterranean
Kazakhstan,15-04-2020,285307,1046,1216,284091,Europe
Kenya,15-04-2020,201104,1230,5,201099,Africa
South Korea,15-04-2020,293285,1098,117,293168,Western Pacific
Kuwait,15-04-2020,308875,121,305,308570,Eastern Mediterranean
Kyrgyzstan,15-04-2020,147785,949,364,147421,Europe
Latvia,15-04-2020,60962,1358,816,60146,Europe
Lebanon,15-04-2020,120491,2065,686,119805,Eastern Mediterranean
Liberia,15-04-2020,12271,1318,192,12079,Africa
Liechtenstein,15-04-2020,430348,546,699,429649,Europe
Lithuania,15-04-2020,84905,2416,1116,83789,Europe
Luxembourg,15-04-2020,441462,1744,943,440519,Europe
Madagascar,15-04-2020,198820,1091,459,198361,Africa
Malaysia,15-04-2020,104183,1748,66,104117,Western Pacific
Maldives,15-04-2020,188773,1114,1128,187645,South-East Asia
Malta,15-04-2020,42811,44,401,42410,Europe
Mauritania,15-04-2020,207824,499,567,207257,Africa
Mauritius,15-04-2020,236412,1897,560,235852,Africa
Mexico,15-04-2020,48981,1304,1192,47789,Americas
Moldova,15-04-2020,32222,515,1134,31088,Europe
Monaco,15-04-2020,161422,166,535,160887,Europe
Mongolia,15-04-2020,416130,466,415,415715,Western Pacific
Montenegro,15-04-2020,266471,371,166,266305,Europe
Morocco,15-04-2020,315257,2103,1222,314035,Eastern Mediterranean
Namibia,15-04-2020,284258,1194,683,283575,Africa
Nepal,15-04-2020,43391,1897,724,42667,South-East Asia
Netherlands,15-04-2020,79631,25,60,79571,Europe
Netherlands,15-04-2020,300302,1022,243,300059,Europe
Netherlands,15-04-2020,353238,2283,124,353114,Europe
Netherlands,15-04-2020,45725,18,1241,44484,Europe
New Zealand,15-04-2020,168087,1806,211,167876,Western Pacific
Nicaragua,15-04-2020,258596,2060,700,257896,Americas
Niger,15-04-2020,151510,1828,1144,150366,Africa
Nigeria,15-04-2020,171567,1231,454,171113,Africa
North Macedonia,15-04-2020,292270,98,498,291772,Europe
Norway,15-04-2020,68648,239,76,68572,Europe
Oman,15-04-2020,259989,1149,361,259628,Eastern Mediterranean
Pakistan,15-04-2020,305998,407,166,305832,Eastern Mediterranean
Panama,15-04-2020,350168,1084,590,349578,Americas
Papua New Guinea,15-04-2020,434219,1996,99,434120,Western Pacific
Paraguay,15-04-2020,128142,1915,1146,126996,Americas
Peru,15-04-2020,133566,774,1011,132555,Americas
Philippines,15-04-2020,44199,163,378,43821,Western Pacific
Poland,15-04-2020,265333,2035,18,265315,Europe
Portugal,15-04-2020,131393,1359,953,130440,Europe
Qatar,15-04-2020,63798,2106,949,62849,Eastern Mediterranean
Romania,15-04-2020,319514,2286,1173,318341,Europe
Russia,15-04-2020,153296,80,773,152523,Europe
Rwanda,15-04-2020,171359,192,487,170872,Africa
Saint Lucia,15-04-2020,317452,708,1004,316448,Americas
Saint Vincent and the Grenadines,15-04-2020,413930,2414,618,413312,Americas
San Marino,15-04-2020,156552,703,376,156176,Europe
Saudi Arabia,15-04-2020,124184,1982,798,123386,Eastern Mediterranean
Senegal,15-04-2020,310089,2418,768,309321,Africa
Serbia,15-04-2020,173176,1466,133,173043,Europe
Seychelles,15-04-2020,296401,1369,610,295791,Africa
Singapore,15-04-2020,124214,2386,567,123647,Western Pacific
Slovakia,15-04-2020,404445,1175,307,404138,Europe
Slovenia,15-04-2020,11194,2215,1102,10092,Europe
Somalia,15-04-2020,329399,1129,666,328733,Eastern Mediterranean
South Africa,15-04-2020,119074,454,58,119016,Africa
Spain,15-04-2020,147555,1305,503,147052,Europe
Sri Lanka,15-04-2020,116293,1936,268,116025,South-East Asia
Sudan,15-04-2020,64970,196,673,64297,Eastern Mediterranean
Suriname,15-04-2020,58309,1262,600,57709,Americas
Sweden,15-04-2020,264237,1024,1010,263227,Europe
Switzerland,15-04-2020,196063,1675,297,195766,Europe
Taiwan*,15-04-2020,282272,104,178,282094,Western Pacific
Tanzania,15-04-2020,190749,1319,1231,189518,Africa
Thailand,15-04-2020,149126,1636,1195,147931,South-East Asia
Togo,15-04-2020,152401,1802,261,152140,Africa
Trinidad and Tobago,15-04-2020,276768,667,1137,275631,Americas
Tunisia,15-04-2020,425372,2097,350,425022,Eastern Mediterranean
Turkey,15-04-2020,189661,1332,1163,188498,Europe
Uganda,15-04-2020,10842,1538,982,9860,Africa
Ukraine,15-04-2020,243231,6,498,242733,Europe
United Arab Emirates,15-04-2020,89265,2273,444,88821,Eastern Mediterranean
United Kingdom,15-04-2020,91030,1111,183,90847,Europe
United Kingdom,15-04-2020,411923,1721,73,411850,Europe
United Kingdom,15-04-2020,20964,2462,1005,19959,Europe
United Kingdom,15-04-2020,290898,2409,65,290833,Europe
United Kingdom,15-04-2020,95137,497,370,94767,Europe
United Kingdom,15-04-2020,123500,1559,1047,122453,Europe
United Kingdom,15-04-2020,192635,1061,30,192605,Europe
Uruguay,15-04-2020,384554,91,1079,383475,Americas
US,15-04-2020,146565,1325,477,146088,Americas
Uzbekistan,15-04-2020,255869,1979,27,255842,Europe
Venezuela,15-04-2020,208798,1479,1047,207751,Americas
Vietnam,15-04-2020,387549,485,261,387288,Western Pacific
Zambia,15-04-2020,82798,1914,1122,81676,Africa
Zimbabwe,15-04-2020,336513,2247,21,336492,Africa
Dominica,15-04-2020,441651,1972,608,441043,Americas
Grenada,15-04-2020,166708,1649,240,166468,Americas
Mozambique,15-04-2020,23773,907,497,23276,Africa
Syria,15-04-2020,168942,1286,1182,167760,Eastern Mediterranean
Timor-Leste,15-04-2020,373035,839,842,372193,South-East Asia
Belize,15-04-2020,237121,100,614,236507,Americas
Laos,15-04-2020,223209,1917,941,222268,Western Pacific
Libya,15-04-2020,364727,1861,977,363750,Eastern Mediterranean
West Bank and Gaza,15-04-2020,8448,2117,740,7708,Eastern Mediterranean
Guinea-Bissau,15-04-2020,337501,333,233,337268,Africa
Mali,15-04-2020,130107,1584,784,129323,Africa
Saint Kitts and Nevis,15-04-2020,89773,1734,375,89398,Americas
Canada,15-04-2020,111244,1821,451,110793,Americas
Canada,15-04-2020,433385,602,352,433033,Americas
Kosovo,15-04-2020,62915,2436,118,62797,Europe
Burma,15-04-2020,634,313,876,-242,South-East Asia
United Kingdom,15-04-2020,212879,2423,67,212812,Europe
United Kingdom,15-04-2020,246160,1859,1087,245073,Europe
United Kingdom,15-04-2020,347118,2397,458,346660,Europe
Botswana,15-04-2020,413409,249,1015,412394,Africa
Burundi,15-04-2020,191460,1046,869,190591,Africa
Sierra Leone,15-04-2020,224379,985,940,223439,Africa
Malawi,15-04-2020,288203,1878,473,287730,Africa
United Kingdom,15-04-2020,27797,1085,175,27622,Europe
France,15-04-2020,192313,1827,151,192162,Europe
South Sudan,15-04-2020,415418,2431,1119,414299,Africa
Western Sahara,15-04-2020,89097,855,470,88627,Africa
Sao Tome and Principe,15-04-2020,356438,1947,968,355470,Africa
Yemen,15-04-2020,79438,919,902,78536,Eastern Mediterranean
Comoros,15-04-2020,339471,1572,877,338594,Africa
Tajikistan,15-04-2020,447547,889,872,446675,Europe
Lesotho,15-04-2020,169837,2109,523,169314,Africa
Afghanistan,16-04-2020,434128,984,1214,432914,Eastern Mediterranean
Albania,16-04-2020,160258,777,1236,159022,Europe
Algeria,16-04-2020,150941,2488,133,150808,Africa
Andorra,16-04-2020,52133,1915,839,51294,Europe
Angola,16-04-2020,405620,1164,480,405140,Africa
Antigua and Barbuda,16-04-2020,199565,1522,558,199007,Americas
Argentina,16-04-2020,119962,1190,1207,118755,Americas
Armenia,16-04-2020,273978,1745,875,273103,Europe
Australia,16-04-2020,84410,182,398,84012,Western Pacific
Australia,16-04-2020,32403,670,754,31649,Western Pacific
Australia,16-04-2020,334820,1160,300,334520,Western Pacific
Australia,16-04-2020,215664,934,398,215266,Western Pacific
Australia,16-04-2020,211713,516,115,211598,Western Pacific
Australia,16-04-2020,126052,1928,292,125760,Western Pacific
Australia,16-04-2020,87469,442,747,86722,Western Pacific
Australia,16-04-2020,94739,1508,113,94626,Western Pacific
Austria,16-04-2020,251469,2431,1250,250219,Europe
Azerbaijan,16-04-2020,13179,1781,87,13092,Europe
Bahamas,16-04-2020,400240,2089,514,399726,Americas
Bahrain,16-04-2020,257514,1932,601,256913,Eastern Mediterranean
Bangladesh,16-04-2020,94212,1274,559,93653,South-East Asia
Barbados,16-04-2020,173868,138,71,173797,Americas
Belarus,16-04-2020,348015,1295,191,347824,Europe
Belgium,16-04-2020,167444,754,338,167106,Europe
Benin,16-04-2020,354566,1911,1201,353365,Africa
Bhutan,16-04-2020,395120,173,608,394512,South-East Asia
Bolivia,16-04-2020,270318,2308,408,269910,Americas
Bosnia and Herzegovina,16-04-2020,40152,19,10,40142,Europe
Brazil,16-04-2020,179204,2050,11,179193,Americas
Brunei,16-04-2020,164784,83,668,164116,Western Pacific
Bulgaria,16-04-2020,146165,1203,784,145381,Europe
Burkina Faso,16-04-2020,388703,290,776,387927,Africa
Cabo Verde,16-04-2020,183880,2362,352,183528,Africa
Cambodia,16-04-2020,54825,1908,1232,53593,Western Pacific
Cameroon,16-04-2020,331997,1818,184,331813,Africa
Canada,16-04-2020,143532,1602,1175,142357,Americas
Canada,16-04-2020,293504,641,700,292804,Americas
Canada,16-04-2020,218397,1045,398,217999,Americas
Canada,16-04-2020,32134,6,405,31729,Americas
Canada,16-04-2020,374861,1320,496,374365,Americas
Canada,16-04-2020,74649,1621,948,73701,Americas
Canada,16-04-2020,174653,632,402,174251,Americas
Canada,16-04-2020,14869,2448,363,14506,Americas
Canada,16-04-2020,113670,62,699,112971,Americas
Canada,16-04-2020,6534,2274,1198,5336,Americas
Central African Republic,16-04-2020,373153,127,37,373116,Africa
Chad,16-04-2020,264406,2324,80,264326,Africa
Chile,16-04-2020,100233,1980,810,99423,Americas
China,16-04-2020,61238,102,382,60856,Western Pacific
China,16-04-2020,289793,626,563,289230,Western Pacific
China,16-04-2020,383174,2286,653,382521,Western Pacific
China,16-04-2020,127941,2101,342,127599,Western Pacific
China,16-04-2020,188035,2200,420,187615,Western Pacific
China,16-04-2020,228996,1648,317,228679,Western Pacific
China,16-04-2020,310354,882,1183,309171,Western Pacific
China,16-04-2020,148792,1764,202,148590,Western Pacific
China,16-04-2020,240048,1018,895,239153,Western Pacific
China,16-04-2020,199120,1776,436,198684,Western Pacific
China,16-04-2020,370482,1463,229,370253,Western Pacific
China,16-04-2020,241506,1406,889,240617,Western Pacific
China,16-04-2020,192029,1720,49,191980,Western Pacific
China,16-04-2020,357586,1556,440,357146,Western Pacific
China,16-04-2020,194892,2190,115,194777,Western Pacific
China,16-04-2020,76175,2271,955,75220,Western Pacific
China,16-04-2020,125992,2245,1187,124805,Western Pacific
China,16-04-2020,230540,1047,326,230214,Western Pacific
China,16-04-2020,405412,51,283,405129,Western Pacific
China,16-04-2020,277623,280,785,276838,Western Pacific
China,16-04-2020,428250,915,846,427404,Western Pacific
China,16-04-2020,20356,1996,372,19984,Western Pacific
China,16-04-2020,64506,702,850,63656,Western Pacific
China,16-04-2020,184668,857,1156,183512,Western Pacific
China,16-04-2020,184391,1654,1146,183245,Western Pacific
China,16-04-2020,281948,21,957,280991,Western Pacific
China,16-04-2020,228828,899,17,228811,Western Pacific
China,16-04-2020,287490,1847,656,286834,Western Pacific
China,16-04-2020,320490,1764,915,319575,Western Pacific
China,16-04-2020,281772,1149,231,281541,Western Pacific
China,16-04-2020,369390,80,78,369312,Western Pacific
China,16-04-2020,189777,1772,1194,188583,Western Pacific
China,16-04-2020,249055,1537,924,248131,Western Pacific
Colombia,16-04-2020,156753,2318,59,156694,Americas
Congo (Brazzaville),16-04-2020,13425,330,761,12664,Africa
Congo (Kinshasa),16-04-2020,51442,1404,80,51362,Africa
Costa Rica,16-04-2020,269661,607,1117,268544,Americas
Cote d'Ivoire,16-04-2020,223872,2329,468,223404,Africa
Croatia,16-04-2020,402720,1994,458,402262,Europe
Cuba,16-04-2020,71726,2290,826,70900,Americas
Cyprus,16-04-2020,13215,2019,316,12899,Europe
Czechia,16-04-2020,297017,832,139,296878,Europe
Denmark,16-04-2020,128700,266,450,128250,Europe
Greenland,16-04-2020,211362,1005,1203,210159,Europe
Denmark,16-04-2020,143422,2021,184,143238,Europe
Djibouti,16-04-2020,385903,1203,57,385846,Eastern Mediterranean
Dominican Republic,16-04-2020,44073,1594,157,43916,Americas
Ecuador,16-04-2020,46369,685,677,45692,Americas
Egypt,16-04-2020,364903,3,581,364322,Eastern Mediterranean
El Salvador,16-04-2020,362617,973,432,362185,Americas
Equatorial Guinea,16-04-2020,191374,2357,925,190449,Africa
Eritrea,16-04-2020,203320,1215,68,203252,Africa
Estonia,16-04-2020,264564,1607,1214,263350,Europe
Eswatini,16-04-2020,174251,827,373,173878,Africa
Ethiopia,16-04-2020,142026,33,1145,140881,Africa
Fiji,16-04-2020,353212,451,1167,352045,Western Pacific
Finland,16-04-2020,64327,731,279,64048,Europe
France,16-04-2020,343448,2285,1058,342390,Europe
France,16-04-2020,55589,1517,324,55265,Europe
France,16-04-2020,213070,139,783,212287,Europe
France,16-04-2020,326634,566,434,326200,Europe
France,16-04-2020,404799,923,340,404459,Europe
France,16-04-2020,100129,832,1189,98940,Europe
France,16-04-2020,353606,2167,324,353282,Europe
France,16-04-2020,341378,2222,231,341147,Europe
France,16-04-2020,117775,739,526,117249,Europe
France,16-04-2020,286687,1448,471,286216,Europe
Gabon,16-04-2020,132255,373,720,131535,Africa
Gambia,16-04-2020,158815,1350,0,158815,Africa
Georgia,16-04-2020,365727,1689,367,365360,Europe
Germany,16-04-2020,97286,1775,677,96609,Europe
Ghana,16-04-2020,218122,1912,89,218033,Africa
Greece,16-04-2020,130127,802,202,129925,Europe
Guatemala,16-04-2020,224581,2451,1143,223438,Americas
Guinea,16-04-2020,249474,2018,1099,248375,Africa
Guyana,16-04-2020,292071,2422,350,291721,Americas
Haiti,16-04-2020,293911,2459,855,293056,Americas
Holy See,16-04-2020,169513,2159,665,168848,Europe
Honduras,16-04-2020,247486,92,174,247312,Americas
Hungary,16-04-2020,178659,1968,95,178564,Europe
Iceland,16-04-2020,438881,1636,1098,437783,Europe
India,16-04-2020,97816,1912,392,97424,South-East Asia
Indonesia,16-04-2020,348186,1030,875,347311,South-East Asia
Iran,16-04-2020,141976,786,837,141139,Eastern Mediterranean
Iraq,16-04-2020,402133,207,683,401450,Eastern Mediterranean
Ireland,16-04-2020,361837,1724,475,361362,Europe
Israel,16-04-2020,57570,2467,342,57228,Europe
Italy,16-04-2020,251659,1508,525,251134,Europe
Jamaica,16-04-2020,434501,1791,186,434315,Americas
Japan,16-04-2020,307480,546,656,306824,Western Pacific
Jordan,16-04-2020,249218,140,485,248733,Eastern Mediterranean
Kazakhstan,16-04-2020,344294,347,1204,343090,Europe
Kenya,16-04-2020,53473,1749,712,52761,Africa
South Korea,16-04-2020,177944,1850,751,177193,Western Pacific
Kuwait,16-04-2020,120311,1044,492,119819,Eastern Mediterranean
Kyrgyzstan,16-04-2020,16731,692,567,16164,Europe
Latvia,16-04-2020,24804,708,691,24113,Europe
Lebanon,16-04-2020,70540,1815,568,69972,Eastern Mediterranean
Liberia,16-04-2020,155343,853,137,155206,Africa
Liechtenstein,16-04-2020,211912,2343,29,211883,Europe
Lithuania,16-04-2020,425921,1142,377,425544,Europe
Luxembourg,16-04-2020,425142,1732,309,424833,Europe
Madagascar,16-04-2020,195857,2338,706,195151,Africa
Malaysia,16-04-2020,128163,683,82,128081,Western Pacific
Maldives,16-04-2020,182152,749,1178,180974,South-East Asia
Malta,16-04-2020,354401,1913,921,353480,Europe
Mauritania,16-04-2020,21644,2054,307,21337,Africa
Mauritius,16-04-2020,102297,521,777,101520,Africa
Mexico,16-04-2020,125035,5,105,124930,Americas
Moldova,16-04-2020,34321,1615,749,33572,Europe
Monaco,16-04-2020,226065,198,829,225236,Europe
Mongolia,16-04-2020,359773,2204,414,359359,Western Pacific
Montenegro,16-04-2020,51077,1885,251,50826,Europe
Morocco,16-04-2020,220227,1853,454,219773,Eastern Mediterranean
Namibia,16-04-2020,403036,2461,581,402455,Africa
Nepal,16-04-2020,270133,2492,1218,268915,South-East Asia
Netherlands,16-04-2020,339830,1892,645,339185,Europe
Netherlands,16-04-2020,126247,894,912,125335,Europe
Netherlands,16-04-2020,280849,2349,2,280847,Europe
Netherlands,16-04-2020,174173,1561,1049,173124,Europe
New Zealand,16-04-2020,95871,1755,909,94962,Western Pacific
Nicaragua,16-04-2020,221637,434,1098,220539,Americas
Niger,16-04-2020,130062,1217,1034,129028,Africa
Nigeria,16-04-2020,277702,60,1106,276596,Africa
North Macedonia,16-04-2020,447273,1585,740,446533,Europe
Norway,16-04-2020,314287,1935,743,313544,Europe
Oman,16-04-2020,405763,7,287,405476,Eastern Mediterranean
Pakistan,16-04-2020,155403,1186,412,154991,Eastern Mediterranean
Panama,16-04-2020,237318,1268,372,236946,Americas
Papua New Guinea,16-04-2020,378610,279,1177,377433,Western Pacific
Paraguay,16-04-2020,204975,1307,1132,203843,Americas
Peru,16-04-2020,165899,1823,994,164905,Americas
Philippines,16-04-2020,322077,1319,704,321373,Western Pacific
Poland,16-04-2020,35508,2229,45,35463,Europe
Portugal,16-04-2020,177569,617,214,177355,Europe
Qatar,16-04-2020,284542,1713,9,284533,Eastern Mediterranean
Romania,16-04-2020,117279,1400,146,117133,Europe
Russia,16-04-2020,90709,1836,864,89845,Europe
Rwanda,16-04-2020,314963,276,764,314199,Africa
Saint Lucia,16-04-2020,273929,1232,577,273352,Americas
Saint Vincent and the Grenadines,16-04-2020,347436,343,414,347022,Americas
San Marino,16-04-2020,441978,1530,58,441920,Europe
Saudi Arabia,16-04-2020,438731,758,1097,437634,Eastern Mediterranean
Senegal,16-04-2020,23917,1689,135,23782,Africa
Serbia,16-04-2020,11106,1196,540,10566,Europe
Seychelles,16-04-2020,209448,351,1118,208330,Africa
Singapore,16-04-2020,233368,2314,455,232913,Western Pacific
Slovakia,16-04-2020,338388,946,874,337514,Europe
Slovenia,16-04-2020,85823,2487,628,85195,Europe
Somalia,16-04-2020,158898,899,416,158482,Eastern Mediterranean
South Africa,16-04-2020,433077,1685,777,432300,Africa
Spain,16-04-2020,10732,2096,1126,9606,Europe
Sri Lanka,16-04-2020,336989,1277,1142,335847,South-East Asia
Sudan,16-04-2020,123530,1410,846,122684,Eastern Mediterranean
Suriname,16-04-2020,39355,1120,454,38901,Americas
Sweden,16-04-2020,713,1817,814,-101,Europe
Switzerland,16-04-2020,225039,1973,173,224866,Europe
Taiwan*,16-04-2020,251796,71,1098,250698,Western Pacific
Tanzania,16-04-2020,88166,811,294,87872,Africa
Thailand,16-04-2020,205278,1442,1014,204264,South-East Asia
Togo,16-04-2020,105739,2298,339,105400,Africa
Trinidad and Tobago,16-04-2020,174683,1224,478,174205,Americas
Tunisia,16-04-2020,411076,131,788,410288,Eastern Mediterranean
Turkey,16-04-2020,240326,326,390,239936,Europe
Uganda,16-04-2020,304689,1615,903,303786,Africa
Ukraine,16-04-2020,179362,1753,449,178913,Europe
United Arab Emirates,16-04-2020,445111,2005,1135,443976,Eastern Mediterranean
United Kingdom,16-04-2020,321591,1348,393,321198,Europe
United Kingdom,16-04-2020,143712,1287,247,143465,Europe
United Kingdom,16-04-2020,216676,773,948,215728,Europe
United Kingdom,16-04-2020,358152,521,810,357342,Europe
United Kingdom,16-04-2020,6093,1703,90,6003,Europe
United Kingdom,16-04-2020,187940,2453,877,187063,Europe
United Kingdom,16-04-2020,217350,1848,277,217073,Europe
Uruguay,16-04-2020,335627,696,577,335050,Americas
US,16-04-2020,11511,1070,625,10886,Americas
Uzbekistan,16-04-2020,283158,80,589,282569,Europe
Venezuela,16-04-2020,227953,64,1233,226720,Americas
Vietnam,16-04-2020,254079,1520,892,253187,Western Pacific
Zambia,16-04-2020,160052,1139,328,159724,Africa
Zimbabwe,16-04-2020,349419,1820,495,348924,Africa
Dominica,16-04-2020,212187,2265,988,211199,Americas
Grenada,16-04-2020,192353,860,992,191361,Americas
Mozambique,16-04-2020,94232,2085,475,93757,Africa
Syria,16-04-2020,169690,1295,713,168977,Eastern Mediterranean
Timor-Leste,16-04-2020,321040,1025,111,320929,South-East Asia
Belize,16-04-2020,196896,573,7,196889,Americas
Laos,16-04-2020,251105,2283,232,250873,Western Pacific
Libya,16-04-2020,7701,1326,1055,6646,Eastern Mediterranean
West Bank and Gaza,16-04-2020,320133,464,38,320095,Eastern Mediterranean
Guinea-Bissau,16-04-2020,67840,1910,181,67659,Africa
Mali,16-04-2020,267267,533,916,266351,Africa
Saint Kitts and Nevis,16-04-2020,377297,1224,720,376577,Americas
Canada,16-04-2020,144213,1885,199,144014,Americas
Canada,16-04-2020,440967,498,62,440905,Americas
Kosovo,16-04-2020,287617,1839,345,287272,Europe
Burma,16-04-2020,219435,1302,449,218986,South-East Asia
United Kingdom,16-04-2020,24211,231,35,24176,Europe
United Kingdom,16-04-2020,77580,2132,1050,76530,Europe
United Kingdom,16-04-2020,166872,1936,1006,165866,Europe
Botswana,16-04-2020,342661,1199,162,342499,Africa
Burundi,16-04-2020,337759,153,467,337292,Africa
Sierra Leone,16-04-2020,302563,1826,780,301783,Africa
Malawi,16-04-2020,125894,77,850,125044,Africa
United Kingdom,16-04-2020,38265,884,1134,37131,Europe
France,16-04-2020,282057,1505,379,281678,Europe
South Sudan,16-04-2020,339064,185,937,338127,Africa
Western Sahara,16-04-2020,286060,337,484,285576,Africa
Sao Tome and Principe,16-04-2020,232894,908,932,231962,Africa
Yemen,16-04-2020,74250,849,676,73574,Eastern Mediterranean
Comoros,16-04-2020,183049,1751,1185,181864,Africa
Tajikistan,16-04-2020,157133,2141,394,156739,Europe
Lesotho,16-04-2020,72718,263,622,72096,Africa
Afghanistan,17-04-2020,87127,2393,188,86939,Eastern Mediterranean
Albania,17-04-2020,444756,2258,658,444098,Europe
Algeria,17-04-2020,412760,146,609,412151,Africa
Andorra,17-04-2020,303946,897,270,303676,Europe
Angola,17-04-2020,17394,290,583,16811,Africa
Antigua and Barbuda,17-04-2020,174887,288,355,174532,Americas
Argentina,17-04-2020,228862,132,1176,227686,Americas
Armenia,17-04-2020,9528,341,157,9371,Europe
Australia,17-04-2020,416254,463,205,416049,Western Pacific
Australia,17-04-2020,35737,415,459,35278,Western Pacific
Australia,17-04-2020,219904,1089,385,219519,Western Pacific
Australia,17-04-2020,48846,1756,1082,47764,Western Pacific
Australia,17-04-2020,171783,326,213,171570,Western Pacific
Australia,17-04-2020,299904,1576,252,299652,Western Pacific
Australia,17-04-2020,396262,2361,852,395410,Western Pacific
Australia,17-04-2020,291047,690,1018,290029,Western Pacific
Austria,17-04-2020,174643,986,1074,173569,Europe
Azerbaijan,17-04-2020,2309,2269,339,1970,Europe
Bahamas,17-04-2020,140895,929,87,140808,Americas
Bahrain,17-04-2020,255988,1340,377,255611,Eastern Mediterranean
Bangladesh,17-04-2020,37823,1053,1229,36594,South-East Asia
Barbados,17-04-2020,314651,1176,203,314448,Americas
Belarus,17-04-2020,88647,1610,93,88554,Europe
Belgium,17-04-2020,139690,1286,442,139248,Europe
Benin,17-04-2020,11053,2307,1056,9997,Africa
Bhutan,17-04-2020,412111,1040,992,411119,South-East Asia
Bolivia,17-04-2020,143135,521,266,142869,Americas
Bosnia and Herzegovina,17-04-2020,20692,2234,711,19981,Europe
Brazil,17-04-2020,96433,584,851,95582,Americas
Brunei,17-04-2020,281381,47,392,280989,Western Pacific
Bulgaria,17-04-2020,164917,2456,119,164798,Europe
Burkina Faso,17-04-2020,228977,480,116,228861,Africa
Cabo Verde,17-04-2020,302550,1696,906,301644,Africa
Cambodia,17-04-2020,63891,1497,772,63119,Western Pacific
Cameroon,17-04-2020,103975,1813,388,103587,Africa
Canada,17-04-2020,62137,1969,619,61518,Americas
Canada,17-04-2020,11341,1273,687,10654,Americas
Canada,17-04-2020,183692,2073,784,182908,Americas
Canada,17-04-2020,271587,371,283,271304,Americas
Canada,17-04-2020,318104,766,221,317883,Americas
Canada,17-04-2020,364846,751,295,364551,Americas
Canada,17-04-2020,142197,1513,1174,141023,Americas
Canada,17-04-2020,401204,2360,1234,399970,Americas
Canada,17-04-2020,372364,34,89,372275,Americas
Canada,17-04-2020,394710,628,1007,393703,Americas
Central African Republic,17-04-2020,56003,727,156,55847,Africa
Chad,17-04-2020,97470,1747,960,96510,Africa
Chile,17-04-2020,447777,1679,1191,446586,Americas
China,17-04-2020,242116,1483,620,241496,Western Pacific
China,17-04-2020,274026,342,624,273402,Western Pacific
China,17-04-2020,395885,686,679,395206,Western Pacific
China,17-04-2020,345615,1092,427,345188,Western Pacific
China,17-04-2020,248726,1176,626,248100,Western Pacific
China,17-04-2020,60970,1,381,60589,Western Pacific
China,17-04-2020,349296,2194,69,349227,Western Pacific
China,17-04-2020,286511,1662,1085,285426,Western Pacific
China,17-04-2020,398036,2015,1208,396828,Western Pacific
China,17-04-2020,254705,297,4,254701,Western Pacific
China,17-04-2020,247417,2398,450,246967,Western Pacific
China,17-04-2020,291342,855,70,291272,Western Pacific
China,17-04-2020,367258,749,678,366580,Western Pacific
China,17-04-2020,93522,1216,648,92874,Western Pacific
China,17-04-2020,176621,1343,1177,175444,Western Pacific
China,17-04-2020,367207,1924,336,366871,Western Pacific
China,17-04-2020,93841,308,1048,92793,Western Pacific
China,17-04-2020,113154,1708,998,112156,Western Pacific
China,17-04-2020,29298,1250,1229,28069,Western Pacific
China,17-04-2020,161667,1917,1232,160435,Western Pacific
China,17-04-2020,142638,394,1163,141475,Western Pacific
China,17-04-2020,439426,1241,364,439062,Western Pacific
China,17-04-2020,447556,1165,949,446607,Western Pacific
China,17-04-2020,115181,206,698,114483,Western Pacific
China,17-04-2020,16018,394,291,15727,Western Pacific
China,17-04-2020,240503,388,147,240356,Western Pacific
China,17-04-2020,233607,2124,310,233297,Western Pacific
China,17-04-2020,440524,1191,602,439922,Western Pacific
China,17-04-2020,80746,1946,675,80071,Western Pacific
China,17-04-2020,246152,695,38,246114,Western Pacific
China,17-04-2020,196235,281,1195,195040,Western Pacific
China,17-04-2020,92488,1099,1084,91404,Western Pacific
China,17-04-2020,98220,1537,924,97296,Western Pacific
Colombia,17-04-2020,305741,919,1176,304565,Americas
Congo (Brazzaville),17-04-2020,393091,1045,549,392542,Africa
Congo (Kinshasa),17-04-2020,166114,905,707,165407,Africa
Costa Rica,17-04-2020,178753,1213,1202,177551,Americas
Cote d'Ivoire,17-04-2020,9688,415,1006,8682,Africa
Croatia,17-04-2020,348327,2152,971,347356,Europe
Cuba,17-04-2020,50098,2155,40,50058,Americas
Cyprus,17-04-2020,436002,2110,1220,434782,Europe
Czechia,17-04-2020,218147,1917,1241,216906,Europe
Denmark,17-04-2020,292655,1394,0,292655,Europe
Greenland,17-04-2020,73088,1302,876,72212,Europe
Denmark,17-04-2020,57989,1409,517,57472,Europe
Djibouti,17-04-2020,407819,345,637,407182,Eastern Mediterranean
Dominican Republic,17-04-2020,287460,550,913,286547,Americas
Ecuador,17-04-2020,253098,2442,823,252275,Americas
Egypt,17-04-2020,103244,2210,764,102480,Eastern Mediterranean
El Salvador,17-04-2020,2111,2114,304,1807,Americas
Equatorial Guinea,17-04-2020,45977,575,724,45253,Africa
Eritrea,17-04-2020,209614,143,1065,208549,Africa
Estonia,17-04-2020,160807,360,31,160776,Europe
Eswatini,17-04-2020,67482,1779,780,66702,Africa
Ethiopia,17-04-2020,292307,2097,1115,291192,Africa
Fiji,17-04-2020,149563,1411,953,148610,Western Pacific
Finland,17-04-2020,21995,1949,907,21088,Europe
France,17-04-2020,41729,1042,120,41609,Europe
France,17-04-2020,213178,2006,118,213060,Europe
France,17-04-2020,53562,1802,442,53120,Europe
France,17-04-2020,176655,1149,1190,175465,Europe
France,17-04-2020,287342,2413,486,286856,Europe
France,17-04-2020,68177,2320,992,67185,Europe
France,17-04-2020,156152,613,428,155724,Europe
France,17-04-2020,345768,1043,478,345290,Europe
France,17-04-2020,362382,1269,903,361479,Europe
France,17-04-2020,97378,168,1033,96345,Europe
Gabon,17-04-2020,311197,893,1127,310070,Africa
Gambia,17-04-2020,120596,1543,811,119785,Africa
Georgia,17-04-2020,215901,533,1095,214806,Europe
Germany,17-04-2020,274732,803,1237,273495,Europe
Ghana,17-04-2020,372634,575,1247,371387,Africa
Greece,17-04-2020,359469,522,416,359053,Europe
Guatemala,17-04-2020,43768,95,199,43569,Americas
Guinea,17-04-2020,371025,748,694,370331,Africa
Guyana,17-04-2020,428398,1744,344,428054,Americas
Haiti,17-04-2020,10530,1774,257,10273,Americas
Holy See,17-04-2020,200325,1666,728,199597,Europe
Honduras,17-04-2020,55561,2097,704,54857,Americas
Hungary,17-04-2020,171732,199,284,171448,Europe
Iceland,17-04-2020,400369,2334,350,400019,Europe
India,17-04-2020,345866,1350,625,345241,South-East Asia
Indonesia,17-04-2020,127268,1038,957,126311,South-East Asia
Iran,17-04-2020,419200,1118,584,418616,Eastern Mediterranean
Iraq,17-04-2020,330598,1596,448,330150,Eastern Mediterranean
Ireland,17-04-2020,119226,424,121,119105,Europe
Israel,17-04-2020,66306,774,367,65939,Europe
Italy,17-04-2020,219761,1051,630,219131,Europe
Jamaica,17-04-2020,327366,2400,723,326643,Americas
Japan,17-04-2020,3276,751,923,2353,Western Pacific
Jordan,17-04-2020,71160,2040,92,71068,Eastern Mediterranean
Kazakhstan,17-04-2020,202612,2442,739,201873,Europe
Kenya,17-04-2020,51140,231,1018,50122,Africa
South Korea,17-04-2020,205539,1685,744,204795,Western Pacific
Kuwait,17-04-2020,181748,54,1250,180498,Eastern Mediterranean
Kyrgyzstan,17-04-2020,168147,662,292,167855,Europe
Latvia,17-04-2020,221596,505,860,220736,Europe
Lebanon,17-04-2020,114781,2156,670,114111,Eastern Mediterranean
Liberia,17-04-2020,50891,2235,856,50035,Africa
Liechtenstein,17-04-2020,135603,2464,914,134689,Europe
Lithuania,17-04-2020,54555,1623,110,54445,Europe
Luxembourg,17-04-2020,325686,2183,906,324780,Europe
Madagascar,17-04-2020,119427,381,628,118799,Africa
Malaysia,17-04-2020,100939,2462,1171,99768,Western Pacific
Maldives,17-04-2020,282451,2440,304,282147,South-East Asia
Malta,17-04-2020,444150,551,797,443353,Europe
Mauritania,17-04-2020,208317,1678,432,207885,Africa
Mauritius,17-04-2020,405983,2000,296,405687,Africa
Mexico,17-04-2020,140827,1048,199,140628,Americas
Moldova,17-04-2020,282912,1478,977,281935,Europe
Monaco,17-04-2020,400832,1509,1041,399791,Europe
Mongolia,17-04-2020,246793,2101,341,246452,Western Pacific
Montenegro,17-04-2020,165571,601,819,164752,Europe
Morocco,17-04-2020,231454,1267,428,231026,Eastern Mediterranean
Namibia,17-04-2020,266418,1230,506,265912,Africa
Nepal,17-04-2020,130812,2093,426,130386,South-East Asia
Netherlands,17-04-2020,80973,1444,653,80320,Europe
Netherlands,17-04-2020,280369,451,821,279548,Europe
Netherlands,17-04-2020,11348,1155,0,11348,Europe
Netherlands,17-04-2020,62673,319,747,61926,Europe
New Zealand,17-04-2020,44886,2136,1172,43714,Western Pacific
Nicaragua,17-04-2020,177300,150,649,176651,Americas
Niger,17-04-2020,191172,2056,784,190388,Africa
Nigeria,17-04-2020,265923,2431,102,265821,Africa
North Macedonia,17-04-2020,110242,284,275,109967,Europe
Norway,17-04-2020,12368,2285,651,11717,Europe
Oman,17-04-2020,339630,546,303,339327,Eastern Mediterranean
Pakistan,17-04-2020,98590,2053,1136,97454,Eastern Mediterranean
Panama,17-04-2020,128153,2439,488,127665,Americas
Papua New Guinea,17-04-2020,49150,1011,722,48428,Western Pacific
Paraguay,17-04-2020,338642,229,102,338540,Americas
Peru,17-04-2020,160498,1387,780,159718,Americas
Philippines,17-04-2020,341610,1971,454,341156,Western Pacific
Poland,17-04-2020,223287,1595,924,222363,Europe
Portugal,17-04-2020,303432,2419,1201,302231,Europe
Qatar,17-04-2020,429746,51,733,429013,Eastern Mediterranean
Romania,17-04-2020,310426,791,324,310102,Europe
Russia,17-04-2020,309154,67,0,309154,Europe
Rwanda,17-04-2020,199551,26,281,199270,Africa
Saint Lucia,17-04-2020,92066,1355,822,91244,Americas
Saint Vincent and the Grenadines,17-04-2020,57822,1173,43,57779,Americas
San Marino,17-04-2020,330726,1286,242,330484,Europe
Saudi Arabia,17-04-2020,396494,926,568,395926,Eastern Mediterranean
Senegal,17-04-2020,314236,2244,1238,312998,Africa
Serbia,17-04-2020,325969,1492,1152,324817,Europe
Seychelles,17-04-2020,202988,888,541,202447,Africa
Singapore,17-04-2020,371926,629,1044,370882,Western Pacific
Slovakia,17-04-2020,335761,855,305,335456,Europe
Slovenia,17-04-2020,138845,748,71,138774,Europe
Somalia,17-04-2020,284740,891,110,284630,Eastern Mediterranean
South Africa,17-04-2020,159377,1631,860,158517,Africa
Spain,17-04-2020,433076,1948,586,432490,Europe
Sri Lanka,17-04-2020,431808,2340,180,431628,South-East Asia
Sudan,17-04-2020,377393,2385,228,377165,Eastern Mediterranean
Suriname,17-04-2020,309045,668,275,308770,Americas
Sweden,17-04-2020,413174,163,777,412397,Europe
Switzerland,17-04-2020,14679,1263,986,13693,Europe
Taiwan*,17-04-2020,387659,588,1082,386577,Western Pacific
Tanzania,17-04-2020,379380,1928,182,379198,Africa
Thailand,17-04-2020,177719,467,178,177541,South-East Asia
Togo,17-04-2020,78144,743,1076,77068,Africa
Trinidad and Tobago,17-04-2020,401401,701,343,401058,Americas
Tunisia,17-04-2020,288390,642,764,287626,Eastern Mediterranean
Turkey,17-04-2020,204638,1009,622,204016,Europe
Uganda,17-04-2020,329341,2182,470,328871,Africa
Ukraine,17-04-2020,443880,163,806,443074,Europe
United Arab Emirates,17-04-2020,339708,1143,909,338799,Eastern Mediterranean
United Kingdom,17-04-2020,190652,922,429,190223,Europe
United Kingdom,17-04-2020,316791,902,433,316358,Europe
United Kingdom,17-04-2020,147809,1516,1185,146624,Europe
United Kingdom,17-04-2020,95740,2433,376,95364,Europe
United Kingdom,17-04-2020,210367,118,940,209427,Europe
United Kingdom,17-04-2020,149060,492,410,148650,Europe
United Kingdom,17-04-2020,415645,1432,563,415082,Europe
Uruguay,17-04-2020,103479,59,1242,102237,Americas
US,17-04-2020,399506,1926,783,398723,Americas
Uzbekistan,17-04-2020,175289,1136,604,174685,Europe
Venezuela,17-04-2020,89804,986,101,89703,Americas
Vietnam,17-04-2020,42360,2010,741,41619,Western Pacific
Zambia,17-04-2020,114951,1034,948,114003,Africa
Zimbabwe,17-04-2020,422287,1802,1147,421140,Africa
Dominica,17-04-2020,328311,1023,1157,327154,Americas
Grenada,17-04-2020,280062,1222,462,279600,Americas
Mozambique,17-04-2020,192904,1824,332,192572,Africa
Syria,17-04-2020,41603,1862,478,41125,Eastern Mediterranean
Timor-Leste,17-04-2020,61106,862,1194,59912,South-East Asia
Belize,17-04-2020,148787,290,452,148335,Americas
Laos,17-04-2020,87970,685,1111,86859,Western Pacific
Libya,17-04-2020,318353,549,971,317382,Eastern Mediterranean
West Bank and Gaza,17-04-2020,239005,130,878,238127,Eastern Mediterranean
Guinea-Bissau,17-04-2020,122464,406,375,122089,Africa
Mali,17-04-2020,14621,335,810,13811,Africa
Saint Kitts and Nevis,17-04-2020,109842,1092,512,109330,Americas
Canada,17-04-2020,28121,2044,45,28076,Americas
Canada,17-04-2020,30700,1602,100,30600,Americas
Kosovo,17-04-2020,270428,556,963,269465,Europe
Burma,17-04-2020,387669,2239,1200,386469,South-East Asia
United Kingdom,17-04-2020,68108,845,834,67274,Europe
United Kingdom,17-04-2020,30998,400,731,30267,Europe
United Kingdom,17-04-2020,257514,126,265,257249,Europe
Botswana,17-04-2020,24322,436,355,23967,Africa
Burundi,17-04-2020,304579,478,1023,303556,Africa
Sierra Leone,17-04-2020,382286,1452,242,382044,Africa
Malawi,17-04-2020,100929,1614,492,100437,Africa
United Kingdom,17-04-2020,329957,2114,1007,328950,Europe
France,17-04-2020,378679,1738,209,378470,Europe
South Sudan,17-04-2020,19213,1189,1060,18153,Africa
Western Sahara,17-04-2020,8167,2089,197,7970,Africa
Sao Tome and Principe,17-04-2020,182288,247,200,182088,Africa
Yemen,17-04-2020,346887,1383,180,346707,Eastern Mediterranean
Comoros,17-04-2020,122877,277,944,121933,Africa
Tajikistan,17-04-2020,396158,658,537,395621,Europe
Lesotho,17-04-2020,44162,1394,546,43616,Africa
Afghanistan,18-04-2020,113807,2179,534,113273,Eastern Mediterranean
Albania,18-04-2020,6224,1341,335,5889,Europe
Algeria,18-04-2020,211570,2031,772,210798,Africa
Andorra,18-04-2020,272274,222,546,271728,Europe
Angola,18-04-2020,260671,1536,1085,259586,Africa
Antigua and Barbuda,18-04-2020,354653,1218,397,354256,Americas
Argentina,18-04-2020,144866,1251,8,144858,Americas
Armenia,18-04-2020,53774,1900,764,53010,Europe
Australia,18-04-2020,352245,416,1089,351156,Western Pacific
Australia,18-04-2020,320114,663,1058,319056,Western Pacific
Australia,18-04-2020,380835,551,1020,379815,Western Pacific
Australia,18-04-2020,342993,899,1172,341821,Western Pacific
Australia,18-04-2020,259028,985,623,258405,Western Pacific
Australia,18-04-2020,445837,2368,747,445090,Western Pacific
Australia,18-04-2020,339982,770,623,339359,Western Pacific
Australia,18-04-2020,157237,1262,732,156505,Western Pacific
Austria,18-04-2020,46304,396,123,46181,Europe
Azerbaijan,18-04-2020,252024,2399,255,251769,Europe
Bahamas,18-04-2020,143012,1683,346,142666,Americas
Bahrain,18-04-2020,217946,2393,957,216989,Eastern Mediterranean
Bangladesh,18-04-2020,51712,830,755,50957,South-East Asia
Barbados,18-04-2020,107055,1534,514,106541,Americas
Belarus,18-04-2020,349360,1154,175,349185,Europe
Belgium,18-04-2020,332968,1546,802,332166,Europe
Benin,18-04-2020,247893,58,45,247848,Africa
Bhutan,18-04-2020,190530,1120,709,189821,South-East Asia
Bolivia,18-04-2020,78255,1862,911,77344,Americas
Bosnia and Herzegovina,18-04-2020,195308,275,2,195306,Europe
Brazil,18-04-2020,315447,1750,808,314639,Americas
Brunei,18-04-2020,69772,2008,1082,68690,Western Pacific
Bulgaria,18-04-2020,141876,2263,24,141852,Europe
Burkina Faso,18-04-2020,341861,2439,427,341434,Africa
Cabo Verde,18-04-2020,449381,2460,47,449334,Africa
Cambodia,18-04-2020,234684,2226,1045,233639,Western Pacific
Cameroon,18-04-2020,317604,1032,205,317399,Africa
Canada,18-04-2020,78310,1049,853,77457,Americas
Canada,18-04-2020,58016,106,109,57907,Americas
Canada,18-04-2020,336428,1270,463,335965,Americas
Canada,18-04-2020,172825,551,79,172746,Americas
Canada,18-04-2020,100898,1213,990,99908,Americas
Canada,18-04-2020,194286,239,1037,193249,Americas
Canada,18-04-2020,79573,1644,616,78957,Americas
Canada,18-04-2020,449009,2370,470,448539,Americas
Canada,18-04-2020,133370,1171,357,133013,Americas
Canada,18-04-2020,333023,247,42,332981,Americas
Central African Republic,18-04-2020,299036,964,1121,297915,Africa
Chad,18-04-2020,150276,1130,70,150206,Africa
Chile,18-04-2020,88708,31,994,87714,Americas
China,18-04-2020,323976,1813,572,323404,Western Pacific
China,18-04-2020,235488,873,170,235318,Western Pacific
China,18-04-2020,411343,345,1180,410163,Western Pacific
China,18-04-2020,123406,868,566,122840,Western Pacific
China,18-04-2020,153708,616,504,153204,Western Pacific
China,18-04-2020,307339,1375,260,307079,Western Pacific
China,18-04-2020,51377,225,1239,50138,Western Pacific
China,18-04-2020,442542,849,146,442396,Western Pacific
China,18-04-2020,389496,66,24,389472,Western Pacific
China,18-04-2020,440925,283,104,440821,Western Pacific
China,18-04-2020,190724,1071,487,190237,Western Pacific
China,18-04-2020,312904,200,424,312480,Western Pacific
China,18-04-2020,201590,798,1203,200387,Western Pacific
China,18-04-2020,88335,2092,167,88168,Western Pacific
China,18-04-2020,366053,1038,985,365068,Western Pacific
China,18-04-2020,224344,1785,463,223881,Western Pacific
China,18-04-2020,181358,1564,345,181013,Western Pacific
China,18-04-2020,159860,185,370,159490,Western Pacific
China,18-04-2020,389929,1928,315,389614,Western Pacific
China,18-04-2020,177730,234,21,177709,Western Pacific
China,18-04-2020,288993,799,884,288109,Western Pacific
China,18-04-2020,99715,235,318,99397,Western Pacific
China,18-04-2020,15918,96,794,15124,Western Pacific
China,18-04-2020,302647,688,611,302036,Western Pacific
China,18-04-2020,394827,959,897,393930,Western Pacific
China,18-04-2020,49047,527,547,48500,Western Pacific
China,18-04-2020,147551,1661,415,147136,Western Pacific
China,18-04-2020,133227,1517,555,132672,Western Pacific
China,18-04-2020,102211,674,666,101545,Western Pacific
China,18-04-2020,280777,1281,1072,279705,Western Pacific
China,18-04-2020,252368,2246,642,251726,Western Pacific
China,18-04-2020,293527,680,261,293266,Western Pacific
China,18-04-2020,38200,1159,240,37960,Western Pacific
Colombia,18-04-2020,136598,1484,419,136179,Americas
Congo (Brazzaville),18-04-2020,199929,2149,409,199520,Africa
Congo (Kinshasa),18-04-2020,229882,1797,700,229182,Africa
Costa Rica,18-04-2020,270287,1125,632,269655,Americas
Cote d'Ivoire,18-04-2020,325750,385,913,324837,Africa
Croatia,18-04-2020,203623,1028,709,202914,Europe
Cuba,18-04-2020,174602,444,99,174503,Americas
Cyprus,18-04-2020,289753,119,752,289001,Europe
Czechia,18-04-2020,42617,1610,683,41934,Europe
Denmark,18-04-2020,162005,2101,482,161523,Europe
Greenland,18-04-2020,139339,285,740,138599,Europe
Denmark,18-04-2020,170025,1980,630,169395,Europe
Djibouti,18-04-2020,68092,2237,348,67744,Eastern Mediterranean
Dominican Republic,18-04-2020,171525,971,90,171435,Americas
Ecuador,18-04-2020,86828,2348,291,86537,Americas
Egypt,18-04-2020,61765,253,799,60966,Eastern Mediterranean
El Salvador,18-04-2020,100512,1915,595,99917,Americas
Equatorial Guinea,18-04-2020,87050,2203,28,87022,Africa
Eritrea,18-04-2020,359329,150,1038,358291,Africa
Estonia,18-04-2020,431194,122,1195,429999,Europe
Eswatini,18-04-2020,184499,2276,1156,183343,Africa
Ethiopia,18-04-2020,40560,1883,648,39912,Africa
Fiji,18-04-2020,247252,2129,1199,246053,Western Pacific
Finland,18-04-2020,63045,2048,267,62778,Europe
France,18-04-2020,148756,2080,1223,147533,Europe
France,18-04-2020,307809,42,904,306905,Europe
France,18-04-2020,169595,85,315,169280,Europe
France,18-04-2020,111238,2156,44,111194,Europe
France,18-04-2020,152799,5,1020,151779,Europe
France,18-04-2020,424738,2450,1137,423601,Europe
France,18-04-2020,170361,1137,1212,169149,Europe
France,18-04-2020,305206,1122,982,304224,Europe
France,18-04-2020,58292,1998,1130,57162,Europe
France,18-04-2020,242178,237,352,241826,Europe
Gabon,18-04-2020,403610,567,1143,402467,Africa
Gambia,18-04-2020,326297,781,609,325688,Africa
Georgia,18-04-2020,269865,2,609,269256,Europe
Germany,18-04-2020,118922,581,198,118724,Europe
Ghana,18-04-2020,436350,993,936,435414,Africa
Greece,18-04-2020,124410,1453,925,123485,Europe
Guatemala,18-04-2020,223570,1668,845,222725,Americas
Guinea,18-04-2020,393366,1383,355,393011,Africa
Guyana,18-04-2020,154405,377,1090,153315,Americas
Haiti,18-04-2020,288229,1173,181,288048,Americas
Holy See,18-04-2020,139665,491,1239,138426,Europe
Honduras,18-04-2020,93609,2242,257,93352,Americas
Hungary,18-04-2020,335451,1525,1106,334345,Europe
Iceland,18-04-2020,140771,1803,643,140128,Europe
India,18-04-2020,132203,145,1038,131165,South-East Asia
Indonesia,18-04-2020,361514,1101,1204,360310,South-East Asia
Iran,18-04-2020,275005,2197,438,274567,Eastern Mediterranean
Iraq,18-04-2020,130970,1025,508,130462,Eastern Mediterranean
Ireland,18-04-2020,94391,2128,228,94163,Europe
Israel,18-04-2020,272517,591,486,272031,Europe
Italy,18-04-2020,314978,2080,826,314152,Europe
Jamaica,18-04-2020,383234,2428,340,382894,Americas
Japan,18-04-2020,275741,720,411,275330,Western Pacific
Jordan,18-04-2020,174348,635,27,174321,Eastern Mediterranean
Kazakhstan,18-04-2020,368689,1016,529,368160,Europe
Kenya,18-04-2020,36852,1816,159,36693,Africa
South Korea,18-04-2020,248581,1503,422,248159,Western Pacific
Kuwait,18-04-2020,284070,173,1169,282901,Eastern Mediterranean
Kyrgyzstan,18-04-2020,339208,684,711,338497,Europe
Latvia,18-04-2020,207475,2363,378,207097,Europe
Lebanon,18-04-2020,312870,14,328,312542,Eastern Mediterranean
Liberia,18-04-2020,183653,1233,880,182773,Africa
Liechtenstein,18-04-2020,203949,1464,913,203036,Europe
Lithuania,18-04-2020,309284,773,286,308998,Europe
Luxembourg,18-04-2020,70777,997,58,70719,Europe
Madagascar,18-04-2020,162796,1399,206,162590,Africa
Malaysia,18-04-2020,271458,308,1190,270268,Western Pacific
Maldives,18-04-2020,359036,1383,1036,358000,South-East Asia
Malta,18-04-2020,441571,636,98,441473,Europe
Mauritania,18-04-2020,395360,1096,461,394899,Africa
Mauritius,18-04-2020,168488,1713,817,167671,Africa
Mexico,18-04-2020,364273,215,133,364140,Americas
Moldova,18-04-2020,362714,2106,1207,361507,Europe
Monaco,18-04-2020,232429,1920,1246,231183,Europe
Mongolia,18-04-2020,373452,974,622,372830,Western Pacific
Montenegro,18-04-2020,181392,282,589,180803,Europe
Morocco,18-04-2020,23518,2398,1058,22460,Eastern Mediterranean
Namibia,18-04-2020,353540,312,723,352817,Africa
Nepal,18-04-2020,131573,2482,592,130981,South-East Asia
Netherlands,18-04-2020,302046,393,776,301270,Europe
Netherlands,18-04-2020,316322,1980,1014,315308,Europe
Netherlands,18-04-2020,422931,2357,448,422483,Europe
Netherlands,18-04-2020,238772,1308,222,238550,Europe
New Zealand,18-04-2020,53083,410,714,52369,Western Pacific
Nicaragua,18-04-2020,414197,1898,171,414026,Americas
Niger,18-04-2020,196339,1603,1015,195324,Africa
Nigeria,18-04-2020,1514,1447,254,1260,Africa
North Macedonia,18-04-2020,85099,1293,1228,83871,Europe
Norway,18-04-2020,86844,1029,1118,85726,Europe
Oman,18-04-2020,170625,761,728,169897,Eastern Mediterranean
Pakistan,18-04-2020,404025,1505,995,403030,Eastern Mediterranean
Panama,18-04-2020,76911,2136,1129,75782,Americas
Papua New Guinea,18-04-2020,337158,1847,502,336656,Western Pacific
Paraguay,18-04-2020,237875,1470,499,237376,Americas
Peru,18-04-2020,269932,1382,1110,268822,Americas
Philippines,18-04-2020,423661,1134,900,422761,Western Pacific
Poland,18-04-2020,446535,1484,1051,445484,Europe
Portugal,18-04-2020,147856,1192,1212,146644,Europe
Qatar,18-04-2020,186672,1447,1226,185446,Eastern Mediterranean
Romania,18-04-2020,86293,501,1180,85113,Europe
Russia,18-04-2020,442005,2189,1216,440789,Europe
Rwanda,18-04-2020,67330,1691,955,66375,Africa
Saint Lucia,18-04-2020,250588,1374,878,249710,Americas
Saint Vincent and the Grenadines,18-04-2020,285340,2054,1224,284116,Americas
San Marino,18-04-2020,249073,994,1223,247850,Europe
Saudi Arabia,18-04-2020,216244,439,500,215744,Eastern Mediterranean
Senegal,18-04-2020,142369,681,73,142296,Africa
Serbia,18-04-2020,113098,1141,182,112916,Europe
Seychelles,18-04-2020,120388,2226,365,120023,Africa
Singapore,18-04-2020,433739,1416,338,433401,Western Pacific
Slovakia,18-04-2020,31188,2288,36,31152,Europe
Slovenia,18-04-2020,115463,641,559,114904,Europe
Somalia,18-04-2020,158828,284,878,157950,Eastern Mediterranean
South Africa,18-04-2020,112996,598,401,112595,Africa
Spain,18-04-2020,27124,1237,294,26830,Europe
Sri Lanka,18-04-2020,62259,698,913,61346,South-East Asia
Sudan,18-04-2020,379015,929,910,378105,Eastern Mediterranean
Suriname,18-04-2020,282483,1980,49,282434,Americas
Sweden,18-04-2020,399165,1373,263,398902,Europe
Switzerland,18-04-2020,254097,503,553,253544,Europe
Taiwan*,18-04-2020,132447,2423,431,132016,Western Pacific
Tanzania,18-04-2020,168071,1596,983,167088,Africa
Thailand,18-04-2020,434238,1412,249,433989,South-East Asia
Togo,18-04-2020,409516,272,576,408940,Africa
Trinidad and Tobago,18-04-2020,64500,1782,434,64066,Americas
Tunisia,18-04-2020,106641,1156,1063,105578,Eastern Mediterranean
Turkey,18-04-2020,191472,651,1085,190387,Europe
Uganda,18-04-2020,270130,822,466,269664,Africa
Ukraine,18-04-2020,56494,1440,252,56242,Europe
United Arab Emirates,18-04-2020,132506,2093,526,131980,Eastern Mediterranean
United Kingdom,18-04-2020,207501,712,387,207114,Europe
United Kingdom,18-04-2020,14087,661,87,14000,Europe
United Kingdom,18-04-2020,284425,1163,781,283644,Europe
United Kingdom,18-04-2020,39789,121,205,39584,Europe
United Kingdom,18-04-2020,113731,1950,782,112949,Europe
United Kingdom,18-04-2020,27828,97,312,27516,Europe
United Kingdom,18-04-2020,36174,1040,979,35195,Europe
Uruguay,18-04-2020,91624,681,1,91623,Americas
US,18-04-2020,436873,2449,1211,435662,Americas
Uzbekistan,18-04-2020,397845,1525,977,396868,Europe
Venezuela,18-04-2020,74990,1099,259,74731,Americas
Vietnam,18-04-2020,401696,1288,235,401461,Western Pacific
Zambia,18-04-2020,317346,1758,693,316653,Africa
Zimbabwe,18-04-2020,181633,65,540,181093,Africa
Dominica,18-04-2020,172857,674,239,172618,Americas
Grenada,18-04-2020,180405,1859,129,180276,Americas
Mozambique,18-04-2020,76103,1102,444,75659,Africa
Syria,18-04-2020,276837,666,127,276710,Eastern Mediterranean
Timor-Leste,18-04-2020,296179,586,475,295704,South-East Asia
Belize,18-04-2020,253611,1425,334,253277,Americas
Laos,18-04-2020,70167,610,149,70018,Western Pacific
Libya,18-04-2020,299720,961,1211,298509,Eastern Mediterranean
West Bank and Gaza,18-04-2020,122753,1362,770,121983,Eastern Mediterranean
Guinea-Bissau,18-04-2020,98119,962,576,97543,Africa
Mali,18-04-2020,160455,2201,402,160053,Africa
Saint Kitts and Nevis,18-04-2020,77954,1309,1239,76715,Americas
Canada,18-04-2020,222149,2474,935,221214,Americas
Canada,18-04-2020,90239,1750,702,89537,Americas
Kosovo,18-04-2020,385510,1599,1003,384507,Europe
Burma,18-04-2020,385539,1913,976,384563,South-East Asia
United Kingdom,18-04-2020,17867,978,941,16926,Europe
United Kingdom,18-04-2020,383556,2230,990,382566,Europe
United Kingdom,18-04-2020,60563,55,761,59802,Europe
Botswana,18-04-2020,123740,1715,1190,122550,Africa
Burundi,18-04-2020,316568,332,712,315856,Africa
Sierra Leone,18-04-2020,160625,1701,15,160610,Africa
Malawi,18-04-2020,442075,839,1181,440894,Africa
United Kingdom,18-04-2020,54782,1576,381,54401,Europe
France,18-04-2020,277673,1188,798,276875,Europe
South Sudan,18-04-2020,14853,225,622,14231,Africa
Western Sahara,18-04-2020,70532,2286,976,69556,Africa
Sao Tome and Principe,18-04-2020,378998,269,605,378393,Africa
Yemen,18-04-2020,382701,1535,312,382389,Eastern Mediterranean
Comoros,18-04-2020,443433,525,543,442890,Africa
Tajikistan,18-04-2020,33286,2349,297,32989,Europe
Lesotho,18-04-2020,106547,2418,901,105646,Africa
Afghanistan,19-04-2020,286509,312,1068,285441,Eastern Mediterranean
Albania,19-04-2020,374868,1600,242,374626,Europe
Algeria,19-04-2020,20186,441,272,19914,Africa
Andorra,19-04-2020,17000,339,270,16730,Europe
Angola,19-04-2020,169540,2171,1245,168295,Africa
Antigua and Barbuda,19-04-2020,190342,2454,718,189624,Americas
Argentina,19-04-2020,205186,1455,1176,204010,Americas
Armenia,19-04-2020,169394,2103,1143,168251,Europe
Australia,19-04-2020,266528,1331,460,266068,Western Pacific
Australia,19-04-2020,423050,556,627,422423,Western Pacific
Australia,19-04-2020,385254,448,703,384551,Western Pacific
Australia,19-04-2020,126807,435,265,126542,Western Pacific
Australia,19-04-2020,199876,363,686,199190,Western Pacific
Australia,19-04-2020,293708,2343,886,292822,Western Pacific
Australia,19-04-2020,206359,1629,682,205677,Western Pacific
Australia,19-04-2020,143788,295,846,142942,Western Pacific
Austria,19-04-2020,182132,1278,898,181234,Europe
Azerbaijan,19-04-2020,374412,1571,273,374139,Europe
Bahamas,19-04-2020,205043,2323,866,204177,Americas
Bahrain,19-04-2020,181454,32,394,181060,Eastern Mediterranean
Bangladesh,19-04-2020,311010,629,292,310718,South-East Asia
Barbados,19-04-2020,269397,2123,169,269228,Americas
Belarus,19-04-2020,122666,2486,287,122379,Europe
Belgium,19-04-2020,131307,2474,29,131278,Europe
Benin,19-04-2020,201683,695,1025,200658,Africa
Bhutan,19-04-2020,98695,2164,791,97904,South-East Asia
Bolivia,19-04-2020,417500,2326,552,416948,Americas
Bosnia and Herzegovina,19-04-2020,68318,1259,1041,67277,Europe
Brazil,19-04-2020,286736,1624,195,286541,Americas
Brunei,19-04-2020,315973,1044,612,315361,Western Pacific
Bulgaria,19-04-2020,352441,164,784,351657,Europe
Burkina Faso,19-04-2020,232017,1702,1077,230940,Africa
Cabo Verde,19-04-2020,109039,775,215,108824,Africa
Cambodia,19-04-2020,311280,1767,1077,310203,Western Pacific
Cameroon,19-04-2020,168625,1785,836,167789,Africa
Canada,19-04-2020,422624,571,920,421704,Americas
Canada,19-04-2020,225575,1455,606,224969,Americas
Canada,19-04-2020,378395,1446,959,377436,Americas
Canada,19-04-2020,268212,226,1136,267076,Americas
Canada,19-04-2020,38364,2050,46,38318,Americas
Canada,19-04-2020,352008,436,723,351285,Americas
Canada,19-04-2020,430964,804,1111,429853,Americas
Canada,19-04-2020,428661,324,333,428328,Americas
Canada,19-04-2020,36609,9,979,35630,Americas
Canada,19-04-2020,213533,1096,630,212903,Americas
Central African Republic,19-04-2020,338381,848,816,337565,Africa
Chad,19-04-2020,138326,155,583,137743,Africa
Chile,19-04-2020,359669,1410,1096,358573,Americas
China,19-04-2020,65831,376,768,65063,Western Pacific
China,19-04-2020,306542,372,230,306312,Western Pacific
China,19-04-2020,185305,581,543,184762,Western Pacific
China,19-04-2020,350639,1121,793,349846,Western Pacific
China,19-04-2020,289685,611,378,289307,Western Pacific
China,19-04-2020,205573,2378,913,204660,Western Pacific
China,19-04-2020,227895,480,73,227822,Western Pacific
China,19-04-2020,211817,646,332,211485,Western Pacific
China,19-04-2020,99179,672,899,98280,Western Pacific
China,19-04-2020,213257,303,480,212777,Western Pacific
China,19-04-2020,161751,1145,1062,160689,Western Pacific
China,19-04-2020,6425,89,644,5781,Western Pacific
China,19-04-2020,22267,1413,83,22184,Western Pacific
China,19-04-2020,243206,421,761,242445,Western Pacific
China,19-04-2020,408010,2321,185,407825,Western Pacific
China,19-04-2020,147856,208,1221,146635,Western Pacific
China,19-04-2020,324373,2389,167,324206,Western Pacific
China,19-04-2020,165233,2438,941,164292,Western Pacific
China,19-04-2020,81716,2265,446,81270,Western Pacific
China,19-04-2020,129826,2328,1158,128668,Western Pacific
China,19-04-2020,301395,1668,1107,300288,Western Pacific
China,19-04-2020,115511,2017,293,115218,Western Pacific
China,19-04-2020,254856,2492,1166,253690,Western Pacific
China,19-04-2020,392288,1305,999,391289,Western Pacific
China,19-04-2020,435547,1460,737,434810,Western Pacific
China,19-04-2020,123783,630,894,122889,Western Pacific
China,19-04-2020,378964,1535,296,378668,Western Pacific
China,19-04-2020,44112,2475,927,43185,Western Pacific
China,19-04-2020,234872,253,946,233926,Western Pacific
China,19-04-2020,372221,1224,98,372123,Western Pacific
China,19-04-2020,32771,208,824,31947,Western Pacific
China,19-04-2020,300044,813,216,299828,Western Pacific
China,19-04-2020,183922,2360,676,183246,Western Pacific
Colombia,19-04-2020,101248,1994,739,100509,Americas
Congo (Brazzaville),19-04-2020,135095,1984,1173,133922,Africa
Congo (Kinshasa),19-04-2020,131607,1750,464,131143,Africa
Costa Rica,19-04-2020,372476,1327,413,372063,Americas
Cote d'Ivoire,19-04-2020,59296,1759,915,58381,Africa
Croatia,19-04-2020,209327,746,16,209311,Europe
Cuba,19-04-2020,333492,257,705,332787,Americas
Cyprus,19-04-2020,6759,1001,717,6042,Europe
Czechia,19-04-2020,46756,1523,809,45947,Europe
Denmark,19-04-2020,43097,1288,1104,41993,Europe
Greenland,19-04-2020,166133,794,318,165815,Europe
Denmark,19-04-2020,114180,717,972,113208,Europe
Djibouti,19-04-2020,328230,586,1231,326999,Eastern Mediterranean
Dominican Republic,19-04-2020,297465,2427,700,296765,Americas
Ecuador,19-04-2020,407945,2412,426,407519,Americas
Egypt,19-04-2020,324970,2338,775,324195,Eastern Mediterranean
El Salvador,19-04-2020,206386,877,663,205723,Americas
Equatorial Guinea,19-04-2020,267495,449,230,267265,Africa
Eritrea,19-04-2020,30940,2415,24,30916,Africa
Estonia,19-04-2020,383676,529,996,382680,Europe
Eswatini,19-04-2020,325127,1698,905,324222,Africa
Ethiopia,19-04-2020,214992,649,63,214929,Africa
Fiji,19-04-2020,425188,640,747,424441,Western Pacific
Finland,19-04-2020,277130,1527,818,276312,Europe
France,19-04-2020,198350,2210,472,197878,Europe
France,19-04-2020,380312,2398,1217,379095,Europe
France,19-04-2020,8645,381,337,8308,Europe
France,19-04-2020,78727,832,350,78377,Europe
France,19-04-2020,142020,99,423,141597,Europe
France,19-04-2020,164693,115,1023,163670,Europe
France,19-04-2020,200080,2183,1181,198899,Europe
France,19-04-2020,394243,232,491,393752,Europe
France,19-04-2020,363494,1306,889,362605,Europe
France,19-04-2020,151518,1033,155,151363,Europe
Gabon,19-04-2020,9187,2132,254,8933,Africa
Gambia,19-04-2020,48771,893,420,48351,Africa
Georgia,19-04-2020,332302,55,1033,331269,Europe
Germany,19-04-2020,194687,1067,893,193794,Europe
Ghana,19-04-2020,290342,1805,831,289511,Africa
Greece,19-04-2020,190876,2020,1219,189657,Europe
Guatemala,19-04-2020,258376,1016,1040,257336,Americas
Guinea,19-04-2020,26841,2405,398,26443,Africa
Guyana,19-04-2020,306071,137,154,305917,Americas
Haiti,19-04-2020,251698,1593,200,251498,Americas
Holy See,19-04-2020,406735,1496,1108,405627,Europe
Honduras,19-04-2020,344709,1681,475,344234,Americas
Hungary,19-04-2020,95973,1021,542,95431,Europe
Iceland,19-04-2020,407218,373,773,406445,Europe
India,19-04-2020,118231,2293,961,117270,South-East Asia
Indonesia,19-04-2020,231802,284,1192,230610,South-East Asia
Iran,19-04-2020,131420,475,689,130731,Eastern Mediterranean
Iraq,19-04-2020,94495,305,228,94267,Eastern Mediterranean
Ireland,19-04-2020,237377,1068,815,236562,Europe
Israel,19-04-2020,348785,523,979,347806,Europe
Italy,19-04-2020,161201,642,45,161156,Europe
Jamaica,19-04-2020,275116,2015,225,274891,Americas
Japan,19-04-2020,84946,2141,430,84516,Western Pacific
Jordan,19-04-2020,421267,740,1153,420114,Eastern Mediterranean
Kazakhstan,19-04-2020,41500,1660,531,40969,Europe
Kenya,19-04-2020,266796,2179,118,266678,Africa
South Korea,19-04-2020,146899,463,1224,145675,Western Pacific
Kuwait,19-04-2020,402178,396,541,401637,Eastern Mediterranean
Kyrgyzstan,19-04-2020,420251,2244,201,420050,Europe
Latvia,19-04-2020,108392,1448,841,107551,Europe
Lebanon,19-04-2020,429308,2027,1008,428300,Eastern Mediterranean
Liberia,19-04-2020,87997,2251,716,87281,Africa
Liechtenstein,19-04-2020,289989,160,157,289832,Europe
Lithuania,19-04-2020,396084,548,167,395917,Europe
Luxembourg,19-04-2020,25204,2168,929,24275,Europe
Madagascar,19-04-2020,95958,591,503,95455,Africa
Malaysia,19-04-2020,192461,1447,1090,191371,Western Pacific
Maldives,19-04-2020,111433,2111,976,110457,South-East Asia
Malta,19-04-2020,377201,449,928,376273,Europe
Mauritania,19-04-2020,435214,726,368,434846,Africa
Mauritius,19-04-2020,398680,837,770,397910,Africa
Mexico,19-04-2020,108144,2020,685,107459,Americas
Moldova,19-04-2020,61729,91,443,61286,Europe
Monaco,19-04-2020,218710,2366,9,218701,Europe
Mongolia,19-04-2020,219805,2344,1106,218699,Western Pacific
Montenegro,19-04-2020,309768,414,880,308888,Europe
Morocco,19-04-2020,326176,2074,1249,324927,Eastern Mediterranean
Namibia,19-04-2020,337477,2263,640,336837,Africa
Nepal,19-04-2020,131309,2467,676,130633,South-East Asia
Netherlands,19-04-2020,381829,1925,1124,380705,Europe
Netherlands,19-04-2020,418678,1901,1209,417469,Europe
Netherlands,19-04-2020,34144,2210,978,33166,Europe
Netherlands,19-04-2020,187177,2473,1054,186123,Europe
New Zealand,19-04-2020,373692,1605,654,373038,Western Pacific
Nicaragua,19-04-2020,307247,685,341,306906,Americas
Niger,19-04-2020,416650,468,768,415882,Africa
Nigeria,19-04-2020,367130,2282,195,366935,Africa
North Macedonia,19-04-2020,53895,870,302,53593,Europe
Norway,19-04-2020,115592,1553,523,115069,Europe
Oman,19-04-2020,279523,1842,196,279327,Eastern Mediterranean
Pakistan,19-04-2020,147618,2321,803,146815,Eastern Mediterranean
Panama,19-04-2020,57933,160,193,57740,Americas
Papua New Guinea,19-04-2020,39815,1410,520,39295,Western Pacific
Paraguay,19-04-2020,365760,1223,442,365318,Americas
Peru,19-04-2020,138391,1523,485,137906,Americas
Philippines,19-04-2020,160450,448,229,160221,Western Pacific
Poland,19-04-2020,446139,1769,1074,445065,Europe
Portugal,19-04-2020,229643,912,129,229514,Europe
Qatar,19-04-2020,25522,489,997,24525,Eastern Mediterranean
Romania,19-04-2020,185592,1170,737,184855,Europe
Russia,19-04-2020,97368,720,579,96789,Europe
Rwanda,19-04-2020,54400,563,929,53471,Africa
Saint Lucia,19-04-2020,436916,1900,1034,435882,Americas
Saint Vincent and the Grenadines,19-04-2020,159820,2454,49,159771,Americas
San Marino,19-04-2020,281,634,791,-510,Europe
Saudi Arabia,19-04-2020,150769,2096,1080,149689,Eastern Mediterranean
Senegal,19-04-2020,349698,1855,1233,348465,Africa
Serbia,19-04-2020,70377,249,572,69805,Europe
Seychelles,19-04-2020,220851,1315,584,220267,Africa
Singapore,19-04-2020,399814,1409,185,399629,Western Pacific
Slovakia,19-04-2020,297173,1798,9,297164,Europe
Slovenia,19-04-2020,9187,2431,644,8543,Europe
Somalia,19-04-2020,302312,951,104,302208,Eastern Mediterranean
South Africa,19-04-2020,129640,99,828,128812,Africa
Spain,19-04-2020,182364,1195,1093,181271,Europe
Sri Lanka,19-04-2020,102091,104,1183,100908,South-East Asia
Sudan,19-04-2020,425689,741,253,425436,Eastern Mediterranean
Suriname,19-04-2020,20627,1485,1000,19627,Americas
Sweden,19-04-2020,337833,2075,411,337422,Europe
Switzerland,19-04-2020,267991,1592,915,267076,Europe
Taiwan*,19-04-2020,232641,597,239,232402,Western Pacific
Tanzania,19-04-2020,226887,2292,115,226772,Africa
Thailand,19-04-2020,353835,869,695,353140,South-East Asia
Togo,19-04-2020,323782,1372,977,322805,Africa
Trinidad and Tobago,19-04-2020,162143,2274,129,162014,Americas
Tunisia,19-04-2020,95119,103,60,95059,Eastern Mediterranean
Turkey,19-04-2020,75726,1562,695,75031,Europe
Uganda,19-04-2020,67595,1388,90,67505,Africa
Ukraine,19-04-2020,312026,834,656,311370,Europe
United Arab Emirates,19-04-2020,25272,656,435,24837,Eastern Mediterranean
United Kingdom,19-04-2020,193417,219,90,193327,Europe
United Kingdom,19-04-2020,97544,563,491,97053,Europe
United Kingdom,19-04-2020,216726,730,239,216487,Europe
United Kingdom,19-04-2020,27355,1236,1204,26151,Europe
United Kingdom,19-04-2020,232079,675,1220,230859,Europe
United Kingdom,19-04-2020,382965,1334,451,382514,Europe
United Kingdom,19-04-2020,192104,83,490,191614,Europe
Uruguay,19-04-2020,42512,1365,882,41630,Americas
US,19-04-2020,96678,331,890,95788,Americas
Uzbekistan,19-04-2020,395882,2237,1047,394835,Europe
Venezuela,19-04-2020,396768,785,314,396454,Americas
Vietnam,19-04-2020,75345,920,70,75275,Western Pacific
Zambia,19-04-2020,309190,799,620,308570,Africa
Zimbabwe,19-04-2020,173412,240,119,173293,Africa
Dominica,19-04-2020,48942,1058,231,48711,Americas
Grenada,19-04-2020,378629,2262,337,378292,Americas
Mozambique,19-04-2020,437409,1967,1175,436234,Africa
Syria,19-04-2020,40128,2147,470,39658,Eastern Mediterranean
Timor-Leste,19-04-2020,328445,873,476,327969,South-East Asia
Belize,19-04-2020,409525,1943,71,409454,Americas
Laos,19-04-2020,379515,1709,888,378627,Western Pacific
Libya,19-04-2020,449087,2324,558,448529,Eastern Mediterranean
West Bank and Gaza,19-04-2020,113211,1147,855,112356,Eastern Mediterranean
Guinea-Bissau,19-04-2020,235941,1069,657,235284,Africa
Mali,19-04-2020,376544,1668,443,376101,Africa
Saint Kitts and Nevis,19-04-2020,337685,1094,52,337633,Americas
Canada,19-04-2020,322007,446,609,321398,Americas
Canada,19-04-2020,345248,713,57,345191,Americas
Kosovo,19-04-2020,98120,1132,1120,97000,Europe
Burma,19-04-2020,88024,477,764,87260,South-East Asia
United Kingdom,19-04-2020,109563,1993,341,109222,Europe
United Kingdom,19-04-2020,84353,2097,17,84336,Europe
United Kingdom,19-04-2020,279043,163,955,278088,Europe
Botswana,19-04-2020,47151,273,980,46171,Africa
Burundi,19-04-2020,6321,628,1056,5265,Africa
Sierra Leone,19-04-2020,334210,1878,916,333294,Africa
Malawi,19-04-2020,149447,473,558,148889,Africa
United Kingdom,19-04-2020,64989,1450,508,64481,Europe
France,19-04-2020,44587,517,50,44537,Europe
South Sudan,19-04-2020,335106,2409,499,334607,Africa
Western Sahara,19-04-2020,83742,306,833,82909,Africa
Sao Tome and Principe,19-04-2020,179724,1213,893,178831,Africa
Yemen,19-04-2020,186496,698,647,185849,Eastern Mediterranean
Comoros,19-04-2020,75915,2121,276,75639,Africa
Tajikistan,19-04-2020,123334,748,120,123214,Europe
Lesotho,19-04-2020,254808,997,1218,253590,Africa
Afghanistan,20-04-2020,32202,1345,790,31412,Eastern Mediterranean
Albania,20-04-2020,372931,1842,727,372204,Europe
Algeria,20-04-2020,386973,2032,970,386003,Africa
Andorra,20-04-2020,318031,1328,568,317463,Europe
Angola,20-04-2020,370659,1723,340,370319,Africa
Antigua and Barbuda,20-04-2020,249973,1115,428,249545,Americas
Argentina,20-04-2020,228506,1885,1141,227365,Americas
Armenia,20-04-2020,40843,539,76,40767,Europe
Australia,20-04-2020,393459,2425,295,393164,Western Pacific
Australia,20-04-2020,52324,1087,400,51924,Western Pacific
Australia,20-04-2020,181671,1275,1124,180547,Western Pacific
Australia,20-04-2020,107207,28,254,106953,Western Pacific
Australia,20-04-2020,161650,2338,883,160767,Western Pacific
Australia,20-04-2020,435144,1965,870,434274,Western Pacific
Australia,20-04-2020,279310,1441,676,278634,Western Pacific
Australia,20-04-2020,202680,1979,597,202083,Western Pacific
Austria,20-04-2020,360346,1154,641,359705,Europe
Azerbaijan,20-04-2020,349333,1263,858,348475,Europe
Bahamas,20-04-2020,202006,399,883,201123,Americas
Bahrain,20-04-2020,242365,2481,43,242322,Eastern Mediterranean
Bangladesh,20-04-2020,438047,1839,1211,436836,South-East Asia
Barbados,20-04-2020,329137,2014,644,328493,Americas
Belarus,20-04-2020,105810,271,899,104911,Europe
Belgium,20-04-2020,91715,473,1016,90699,Europe
Benin,20-04-2020,333834,357,863,332971,Africa
Bhutan,20-04-2020,291008,687,554,290454,South-East Asia
Bolivia,20-04-2020,431825,1243,283,431542,Americas
Bosnia and Herzegovina,20-04-2020,297942,720,339,297603,Europe
Brazil,20-04-2020,2578,71,572,2006,Americas
Brunei,20-04-2020,289420,632,332,289088,Western Pacific
Bulgaria,20-04-2020,415909,2202,854,415055,Europe
Burkina Faso,20-04-2020,331537,1633,251,331286,Africa
Cabo Verde,20-04-2020,396298,1809,336,395962,Africa
Cambodia,20-04-2020,107587,1076,1024,106563,Western Pacific
Cameroon,20-04-2020,42059,773,394,41665,Africa
Canada,20-04-2020,376242,1116,539,375703,Americas
Canada,20-04-2020,297923,2238,99,297824,Americas
Canada,20-04-2020,206964,1893,3,206961,Americas
Canada,20-04-2020,263828,2447,936,262892,Americas
Canada,20-04-2020,396166,991,1020,395146,Americas
Canada,20-04-2020,232673,266,1104,231569,Americas
Canada,20-04-2020,103878,992,722,103156,Americas
Canada,20-04-2020,330048,192,535,329513,Americas
Canada,20-04-2020,278980,855,929,278051,Americas
Canada,20-04-2020,149147,1630,1091,148056,Americas
Central African Republic,20-04-2020,380382,44,1028,379354,Africa
Chad,20-04-2020,89885,1745,707,89178,Africa
Chile,20-04-2020,263674,1422,553,263121,Americas
China,20-04-2020,323818,1515,658,323160,Western Pacific
China,20-04-2020,298580,696,963,297617,Western Pacific
China,20-04-2020,145618,1495,598,145020,Western Pacific
China,20-04-2020,364980,2470,772,364208,Western Pacific
China,20-04-2020,183727,1715,258,183469,Western Pacific
China,20-04-2020,80619,2476,812,79807,Western Pacific
China,20-04-2020,385464,2493,1163,384301,Western Pacific
China,20-04-2020,227582,580,881,226701,Western Pacific
China,20-04-2020,405036,1969,986,404050,Western Pacific
China,20-04-2020,100702,162,939,99763,Western Pacific
China,20-04-2020,333502,1295,722,332780,Western Pacific
China,20-04-2020,182388,1262,390,181998,Western Pacific
China,20-04-2020,14313,485,902,13411,Western Pacific
China,20-04-2020,216125,39,922,215203,Western Pacific
China,20-04-2020,51737,2412,65,51672,Western Pacific
China,20-04-2020,137501,1753,384,137117,Western Pacific
China,20-04-2020,383001,334,149,382852,Western Pacific
China,20-04-2020,10167,233,112,10055,Western Pacific
China,20-04-2020,449685,869,759,448926,Western Pacific
China,20-04-2020,358231,1042,221,358010,Western Pacific
China,20-04-2020,390992,1447,75,390917,Western Pacific
China,20-04-2020,78741,181,1164,77577,Western Pacific
China,20-04-2020,223758,52,798,222960,Western Pacific
China,20-04-2020,372017,782,1200,370817,Western Pacific
China,20-04-2020,230993,508,351,230642,Western Pacific
China,20-04-2020,411637,2119,283,411354,Western Pacific
China,20-04-2020,123791,1033,1118,122673,Western Pacific
China,20-04-2020,321027,173,190,320837,Western Pacific
China,20-04-2020,444343,88,934,443409,Western Pacific
China,20-04-2020,370945,217,981,369964,Western Pacific
China,20-04-2020,349977,1886,16,349961,Western Pacific
China,20-04-2020,278180,223,940,277240,Western Pacific
China,20-04-2020,359003,2212,714,358289,Western Pacific
Colombia,20-04-2020,294609,2420,435,294174,Americas
Congo (Brazzaville),20-04-2020,240018,1321,340,239678,Africa
Congo (Kinshasa),20-04-2020,310156,1072,335,309821,Africa
Costa Rica,20-04-2020,12332,1103,404,11928,Americas
Cote d'Ivoire,20-04-2020,162703,1710,49,162654,Africa
Croatia,20-04-2020,299287,1364,1146,298141,Europe
Cuba,20-04-2020,338670,1965,390,338280,Americas
Cyprus,20-04-2020,108000,1210,950,107050,Europe
Czechia,20-04-2020,188081,1864,100,187981,Europe
Denmark,20-04-2020,400468,598,1228,399240,Europe
Greenland,20-04-2020,97517,2190,50,97467,Europe
Denmark,20-04-2020,151340,1149,873,150467,Europe
Djibouti,20-04-2020,147438,1785,595,146843,Eastern Mediterranean
Dominican Republic,20-04-2020,104487,1384,745,103742,Americas
Ecuador,20-04-2020,370365,185,339,370026,Americas
Egypt,20-04-2020,33509,2195,884,32625,Eastern Mediterranean
El Salvador,20-04-2020,447249,1468,279,446970,Americas
Equatorial Guinea,20-04-2020,294536,237,997,293539,Africa
Eritrea,20-04-2020,149229,833,264,148965,Africa
Estonia,20-04-2020,104561,2483,943,103618,Europe
Eswatini,20-04-2020,245193,2216,150,245043,Africa
Ethiopia,20-04-2020,375024,208,305,374719,Africa
Fiji,20-04-2020,386348,464,112,386236,Western Pacific
Finland,20-04-2020,248520,239,714,247806,Europe
France,20-04-2020,140469,2392,1052,139417,Europe
France,20-04-2020,152680,820,546,152134,Europe
France,20-04-2020,88485,293,87,88398,Europe
France,20-04-2020,201124,973,129,200995,Europe
France,20-04-2020,428081,978,334,427747,Europe
France,20-04-2020,274318,2354,488,273830,Europe
France,20-04-2020,186752,2345,250,186502,Europe
France,20-04-2020,176628,220,353,176275,Europe
France,20-04-2020,8506,515,540,7966,Europe
France,20-04-2020,446644,977,207,446437,Europe
Gabon,20-04-2020,226983,2255,557,226426,Africa
Gambia,20-04-2020,154850,423,224,154626,Africa
Georgia,20-04-2020,20344,881,831,19513,Europe
Germany,20-04-2020,271186,522,631,270555,Europe
Ghana,20-04-2020,375799,1952,420,375379,Africa
Greece,20-04-2020,269666,1527,456,269210,Europe
Guatemala,20-04-2020,286459,693,1094,285365,Americas
Guinea,20-04-2020,205954,462,59,205895,Africa
Guyana,20-04-2020,249689,1803,679,249010,Americas
Haiti,20-04-2020,393669,1793,967,392702,Americas
Holy See,20-04-2020,210666,780,324,210342,Europe
Honduras,20-04-2020,23170,1361,485,22685,Americas
Hungary,20-04-2020,198967,380,379,198588,Europe
Iceland,20-04-2020,376329,1921,1176,375153,Europe
India,20-04-2020,322489,1126,276,322213,South-East Asia
Indonesia,20-04-2020,42135,1726,392,41743,South-East Asia
Iran,20-04-2020,390092,2088,1215,388877,Eastern Mediterranean
Iraq,20-04-2020,95387,2490,618,94769,Eastern Mediterranean
Ireland,20-04-2020,68594,2380,382,68212,Europe
Israel,20-04-2020,130596,1042,640,129956,Europe
Italy,20-04-2020,7949,1258,879,7070,Europe
Jamaica,20-04-2020,142724,1520,1123,141601,Americas
Japan,20-04-2020,338853,1789,181,338672,Western Pacific
Jordan,20-04-2020,200741,2251,1040,199701,Eastern Mediterranean
Kazakhstan,20-04-2020,289565,1648,777,288788,Europe
Kenya,20-04-2020,197507,1144,107,197400,Africa
South Korea,20-04-2020,113047,2155,410,112637,Western Pacific
Kuwait,20-04-2020,327977,1521,734,327243,Eastern Mediterranean
Kyrgyzstan,20-04-2020,433315,1473,499,432816,Europe
Latvia,20-04-2020,60777,1654,422,60355,Europe
Lebanon,20-04-2020,151587,2186,1133,150454,Eastern Mediterranean
Liberia,20-04-2020,432724,4,192,432532,Africa
Liechtenstein,20-04-2020,21964,1209,333,21631,Europe
Lithuania,20-04-2020,405156,1552,1036,404120,Europe
Luxembourg,20-04-2020,380570,565,650,379920,Europe
Madagascar,20-04-2020,168260,2130,784,167476,Africa
Malaysia,20-04-2020,316103,406,89,316014,Western Pacific
Maldives,20-04-2020,311729,2072,669,311060,South-East Asia
Malta,20-04-2020,84443,2257,1187,83256,Europe
Mauritania,20-04-2020,268346,788,1088,267258,Africa
Mauritius,20-04-2020,24202,1649,503,23699,Africa
Mexico,20-04-2020,351411,1412,740,350671,Americas
Moldova,20-04-2020,318243,119,827,317416,Europe
Monaco,20-04-2020,169026,1129,1016,168010,Europe
Mongolia,20-04-2020,15671,1236,302,15369,Western Pacific
Montenegro,20-04-2020,233596,280,107,233489,Europe
Morocco,20-04-2020,154627,1046,1166,153461,Eastern Mediterranean
Namibia,20-04-2020,59672,419,749,58923,Africa
Nepal,20-04-2020,429747,1991,657,429090,South-East Asia
Netherlands,20-04-2020,241393,1555,906,240487,Europe
Netherlands,20-04-2020,109554,1675,1034,108520,Europe
Netherlands,20-04-2020,159909,541,458,159451,Europe
Netherlands,20-04-2020,174235,38,1101,173134,Europe
New Zealand,20-04-2020,157477,377,523,156954,Western Pacific
Nicaragua,20-04-2020,278576,36,64,278512,Americas
Niger,20-04-2020,298872,348,780,298092,Africa
Nigeria,20-04-2020,316705,1199,697,316008,Africa
North Macedonia,20-04-2020,28016,484,206,27810,Europe
Norway,20-04-2020,164594,533,587,164007,Europe
Oman,20-04-2020,99442,699,1215,98227,Eastern Mediterranean
Pakistan,20-04-2020,293322,2114,71,293251,Eastern Mediterranean
Panama,20-04-2020,1243,2429,998,245,Americas
Papua New Guinea,20-04-2020,179697,544,862,178835,Western Pacific
Paraguay,20-04-2020,360791,2441,1237,359554,Americas
Peru,20-04-2020,69206,1631,495,68711,Americas
Philippines,20-04-2020,218573,1679,719,217854,Western Pacific
Poland,20-04-2020,447973,215,792,447181,Europe
Portugal,20-04-2020,63162,2056,639,62523,Europe
Qatar,20-04-2020,86297,900,148,86149,Eastern Mediterranean
Romania,20-04-2020,50950,1141,171,50779,Europe
Russia,20-04-2020,326775,2022,1207,325568,Europe
Rwanda,20-04-2020,140992,405,447,140545,Africa
Saint Lucia,20-04-2020,284503,848,1008,283495,Americas
Saint Vincent and the Grenadines,20-04-2020,298693,658,393,298300,Americas
San Marino,20-04-2020,399582,347,309,399273,Europe
Saudi Arabia,20-04-2020,231198,1320,818,230380,Eastern Mediterranean
Senegal,20-04-2020,87045,2209,517,86528,Africa
Serbia,20-04-2020,156818,477,579,156239,Europe
Seychelles,20-04-2020,106488,481,1227,105261,Africa
Singapore,20-04-2020,96292,2361,788,95504,Western Pacific
Slovakia,20-04-2020,150725,634,958,149767,Europe
Slovenia,20-04-2020,435935,143,97,435838,Europe
Somalia,20-04-2020,431787,79,1173,430614,Eastern Mediterranean
South Africa,20-04-2020,32326,1399,990,31336,Africa
Spain,20-04-2020,359503,289,249,359254,Europe
Sri Lanka,20-04-2020,266617,814,628,265989,South-East Asia
Sudan,20-04-2020,44440,304,211,44229,Eastern Mediterranean
Suriname,20-04-2020,386320,719,568,385752,Americas
Sweden,20-04-2020,383051,1874,83,382968,Europe
Switzerland,20-04-2020,103803,1379,25,103778,Europe
Taiwan*,20-04-2020,233717,1828,721,232996,Western Pacific
Tanzania,20-04-2020,243189,1507,768,242421,Africa
Thailand,20-04-2020,14191,263,1027,13164,South-East Asia
Togo,20-04-2020,187749,2475,646,187103,Africa
Trinidad and Tobago,20-04-2020,247026,1165,1040,245986,Americas
Tunisia,20-04-2020,398688,2141,16,398672,Eastern Mediterranean
Turkey,20-04-2020,348218,1400,1119,347099,Europe
Uganda,20-04-2020,206407,82,13,206394,Africa
Ukraine,20-04-2020,180999,97,470,180529,Europe
United Arab Emirates,20-04-2020,59793,1020,1167,58626,Eastern Mediterranean
United Kingdom,20-04-2020,379888,53,1206,378682,Europe
United Kingdom,20-04-2020,298169,349,477,297692,Europe
United Kingdom,20-04-2020,125323,1760,750,124573,Europe
United Kingdom,20-04-2020,141072,1520,139,140933,Europe
United Kingdom,20-04-2020,134070,925,663,133407,Europe
United Kingdom,20-04-2020,330369,1840,69,330300,Europe
United Kingdom,20-04-2020,248443,1364,668,247775,Europe
Uruguay,20-04-2020,442540,2152,922,441618,Americas
US,20-04-2020,282687,1833,438,282249,Americas
Uzbekistan,20-04-2020,187382,1951,1112,186270,Europe
Venezuela,20-04-2020,242652,469,820,241832,Americas
Vietnam,20-04-2020,326282,843,372,325910,Western Pacific
Zambia,20-04-2020,374171,721,701,373470,Africa
Zimbabwe,20-04-2020,184136,1001,188,183948,Africa
Dominica,20-04-2020,128485,95,287,128198,Americas
Grenada,20-04-2020,244796,170,1044,243752,Americas
Mozambique,20-04-2020,215009,1767,280,214729,Africa
Syria,20-04-2020,101379,2456,843,100536,Eastern Mediterranean
Timor-Leste,20-04-2020,442070,1743,787,441283,South-East Asia
Belize,20-04-2020,37384,1500,1151,36233,Americas
Laos,20-04-2020,58311,1469,96,58215,Western Pacific
Libya,20-04-2020,210073,310,343,209730,Eastern Mediterranean
West Bank and Gaza,20-04-2020,260815,534,916,259899,Eastern Mediterranean
Guinea-Bissau,20-04-2020,334050,79,1108,332942,Africa
Mali,20-04-2020,304415,1501,837,303578,Africa
Saint Kitts and Nevis,20-04-2020,433836,755,1104,432732,Americas
Canada,20-04-2020,402960,1691,995,401965,Americas
Canada,20-04-2020,235266,2000,198,235068,Americas
Kosovo,20-04-2020,102919,877,743,102176,Europe
Burma,20-04-2020,213319,769,534,212785,South-East Asia
United Kingdom,20-04-2020,425209,1630,1016,424193,Europe
United Kingdom,20-04-2020,94943,1149,699,94244,Europe
United Kingdom,20-04-2020,278967,898,661,278306,Europe
Botswana,20-04-2020,160197,1186,269,159928,Africa
Burundi,20-04-2020,112749,1490,266,112483,Africa
Sierra Leone,20-04-2020,278855,641,931,277924,Africa
Malawi,20-04-2020,101438,2203,63,101375,Africa
United Kingdom,20-04-2020,371529,544,139,371390,Europe
France,20-04-2020,267192,2411,35,267157,Europe
South Sudan,20-04-2020,303574,233,335,303239,Africa
Western Sahara,20-04-2020,59190,126,972,58218,Africa
Sao Tome and Principe,20-04-2020,249734,510,276,249458,Africa
Yemen,20-04-2020,95620,2121,296,95324,Eastern Mediterranean
Comoros,20-04-2020,141993,2070,282,141711,Africa
Tajikistan,20-04-2020,296517,859,1156,295361,Europe
Lesotho,20-04-2020,140558,2102,355,140203,Africa
Afghanistan,21-04-2020,203079,1144,73,203006,Eastern Mediterranean
Albania,21-04-2020,366376,121,54,366322,Europe
Algeria,21-04-2020,435595,2118,189,435406,Africa
Andorra,21-04-2020,164501,1941,660,163841,Europe
Angola,21-04-2020,84945,592,148,84797,Africa
Antigua and Barbuda,21-04-2020,273505,1267,1210,272295,Americas
Argentina,21-04-2020,213541,2180,115,213426,Americas
Armenia,21-04-2020,131174,1428,646,130528,Europe
Australia,21-04-2020,387596,1255,560,387036,Western Pacific
Australia,21-04-2020,235191,2333,1036,234155,Western Pacific
Australia,21-04-2020,90778,2461,456,90322,Western Pacific
Australia,21-04-2020,321339,369,405,320934,Western Pacific
Australia,21-04-2020,328285,158,87,328198,Western Pacific
Australia,21-04-2020,13087,134,503,12584,Western Pacific
Australia,21-04-2020,170283,837,264,170019,Western Pacific
Australia,21-04-2020,95318,72,864,94454,Western Pacific
Austria,21-04-2020,322451,1988,436,322015,Europe
Azerbaijan,21-04-2020,228523,1849,611,227912,Europe
Bahamas,21-04-2020,359472,1226,265,359207,Americas
Bahrain,21-04-2020,159080,1076,271,158809,Eastern Mediterranean
Bangladesh,21-04-2020,844,1243,551,293,South-East Asia
Barbados,21-04-2020,354743,2192,549,354194,Americas
Belarus,21-04-2020,68620,879,209,68411,Europe
Belgium,21-04-2020,400134,2323,712,399422,Europe
Benin,21-04-2020,383037,2333,405,382632,Africa
Bhutan,21-04-2020,100813,498,833,99980,South-East Asia
Bolivia,21-04-2020,396826,725,608,396218,Americas
Bosnia and Herzegovina,21-04-2020,50593,2014,354,50239,Europe
Brazil,21-04-2020,295901,2147,878,295023,Americas
Brunei,21-04-2020,247329,1860,680,246649,Western Pacific
Bulgaria,21-04-2020,90820,1457,822,89998,Europe
Burkina Faso,21-04-2020,166314,2222,900,165414,Africa
Cabo Verde,21-04-2020,340959,2010,1107,339852,Africa
Cambodia,21-04-2020,417383,1043,397,416986,Western Pacific
Cameroon,21-04-2020,181526,930,834,180692,Africa
Canada,21-04-2020,45802,1433,1137,44665,Americas
Canada,21-04-2020,13346,1081,776,12570,Americas
Canada,21-04-2020,59208,526,349,58859,Americas
Canada,21-04-2020,210482,1175,673,209809,Americas
Canada,21-04-2020,234516,2275,630,233886,Americas
Canada,21-04-2020,352893,1305,46,352847,Americas
Canada,21-04-2020,44821,2270,752,44069,Americas
Canada,21-04-2020,374611,331,158,374453,Americas
Canada,21-04-2020,152449,1013,295,152154,Americas
Canada,21-04-2020,91655,592,37,91618,Americas
Central African Republic,21-04-2020,312614,801,971,311643,Africa
Chad,21-04-2020,98381,1492,808,97573,Africa
Chile,21-04-2020,188682,1349,221,188461,Americas
China,21-04-2020,69740,1490,920,68820,Western Pacific
China,21-04-2020,410940,5,1105,409835,Western Pacific
China,21-04-2020,71985,827,158,71827,Western Pacific
China,21-04-2020,224100,1193,312,223788,Western Pacific
China,21-04-2020,362841,1971,548,362293,Western Pacific
China,21-04-2020,373541,1532,659,372882,Western Pacific
China,21-04-2020,413925,215,1184,412741,Western Pacific
China,21-04-2020,268794,561,202,268592,Western Pacific
China,21-04-2020,187589,1770,1075,186514,Western Pacific
China,21-04-2020,300807,1775,925,299882,Western Pacific
China,21-04-2020,80671,675,234,80437,Western Pacific
China,21-04-2020,320518,589,317,320201,Western Pacific
China,21-04-2020,93507,54,1231,92276,Western Pacific
China,21-04-2020,186071,551,868,185203,Western Pacific
China,21-04-2020,106892,889,130,106762,Western Pacific
China,21-04-2020,64153,1543,560,63593,Western Pacific
China,21-04-2020,286735,1352,1165,285570,Western Pacific
China,21-04-2020,329551,1161,574,328977,Western Pacific
China,21-04-2020,44950,2171,83,44867,Western Pacific
China,21-04-2020,358353,1730,331,358022,Western Pacific
China,21-04-2020,225408,2439,508,224900,Western Pacific
China,21-04-2020,158778,282,41,158737,Western Pacific
China,21-04-2020,338599,270,758,337841,Western Pacific
China,21-04-2020,84135,77,904,83231,Western Pacific
China,21-04-2020,2400,253,840,1560,Western Pacific
China,21-04-2020,158262,1891,354,157908,Western Pacific
China,21-04-2020,143190,469,133,143057,Western Pacific
China,21-04-2020,120870,792,793,120077,Western Pacific
China,21-04-2020,194705,1185,468,194237,Western Pacific
China,21-04-2020,407341,1097,734,406607,Western Pacific
China,21-04-2020,147371,153,1028,146343,Western Pacific
China,21-04-2020,180109,1512,1198,178911,Western Pacific
China,21-04-2020,45508,321,845,44663,Western Pacific
Colombia,21-04-2020,156821,2278,196,156625,Americas
Congo (Brazzaville),21-04-2020,289934,1839,564,289370,Africa
Congo (Kinshasa),21-04-2020,94150,1525,659,93491,Africa
Costa Rica,21-04-2020,416161,1239,726,415435,Americas
Cote d'Ivoire,21-04-2020,283391,2050,517,282874,Africa
Croatia,21-04-2020,93340,45,161,93179,Europe
Cuba,21-04-2020,271463,178,177,271286,Americas
Cyprus,21-04-2020,357251,2413,875,356376,Europe
Czechia,21-04-2020,14518,1417,957,13561,Europe
Denmark,21-04-2020,111472,1765,729,110743,Europe
Greenland,21-04-2020,190961,88,163,190798,Europe
Denmark,21-04-2020,407122,2016,742,406380,Europe
Djibouti,21-04-2020,82433,286,1233,81200,Eastern Mediterranean
Dominican Republic,21-04-2020,387549,456,344,387205,Americas
Ecuador,21-04-2020,234119,1443,923,233196,Americas
Egypt,21-04-2020,131276,1687,711,130565,Eastern Mediterranean
El Salvador,21-04-2020,148252,1015,1193,147059,Americas
Equatorial Guinea,21-04-2020,361186,398,822,360364,Africa
Eritrea,21-04-2020,314808,547,391,314417,Africa
Estonia,21-04-2020,438680,1878,1235,437445,Europe
Eswatini,21-04-2020,318589,637,600,317989,Africa
Ethiopia,21-04-2020,311892,1626,1016,310876,Africa
Fiji,21-04-2020,116138,1054,630,115508,Western Pacific
Finland,21-04-2020,177321,1392,1241,176080,Europe
France,21-04-2020,147573,1022,626,146947,Europe
France,21-04-2020,153761,972,1019,152742,Europe
France,21-04-2020,422536,1570,630,421906,Europe
France,21-04-2020,312951,1445,1002,311949,Europe
France,21-04-2020,122898,2470,887,122011,Europe
France,21-04-2020,328878,64,192,328686,Europe
France,21-04-2020,155107,605,298,154809,Europe
France,21-04-2020,400896,107,616,400280,Europe
France,21-04-2020,70658,113,368,70290,Europe
France,21-04-2020,68497,50,294,68203,Europe
Gabon,21-04-2020,266879,1394,421,266458,Africa
Gambia,21-04-2020,49926,1135,378,49548,Africa
Georgia,21-04-2020,324392,607,1168,323224,Europe
Germany,21-04-2020,225446,2376,1167,224279,Europe
Ghana,21-04-2020,383863,208,1116,382747,Africa
Greece,21-04-2020,294917,811,778,294139,Europe
Guatemala,21-04-2020,156311,1492,1091,155220,Americas
Guinea,21-04-2020,143382,2303,234,143148,Africa
Guyana,21-04-2020,299730,614,879,298851,Americas
Haiti,21-04-2020,437606,2324,1237,436369,Americas
Holy See,21-04-2020,364179,1727,591,363588,Europe
Honduras,21-04-2020,270102,2492,99,270003,Americas
Hungary,21-04-2020,185788,1112,952,184836,Europe
Iceland,21-04-2020,169224,2276,296,168928,Europe
India,21-04-2020,187683,692,399,187284,South-East Asia
Indonesia,21-04-2020,401409,1886,1155,400254,South-East Asia
Iran,21-04-2020,23681,2441,1145,22536,Eastern Mediterranean
Iraq,21-04-2020,140325,35,812,139513,Eastern Mediterranean
Ireland,21-04-2020,261295,2098,820,260475,Europe
Israel,21-04-2020,343886,1345,350,343536,Europe
Italy,21-04-2020,38863,824,691,38172,Europe
Jamaica,21-04-2020,191007,179,327,190680,Americas
Japan,21-04-2020,105797,238,299,105498,Western Pacific
Jordan,21-04-2020,173781,583,1206,172575,Eastern Mediterranean
Kazakhstan,21-04-2020,353531,1895,594,352937,Europe
Kenya,21-04-2020,11366,1481,1053,10313,Africa
South Korea,21-04-2020,41837,1343,953,40884,Western Pacific
Kuwait,21-04-2020,70375,180,7,70368,Eastern Mediterranean
Kyrgyzstan,21-04-2020,254118,788,523,253595,Europe
Latvia,21-04-2020,329516,1537,13,329503,Europe
Lebanon,21-04-2020,8256,244,142,8114,Eastern Mediterranean
Liberia,21-04-2020,305432,1202,335,305097,Africa
Liechtenstein,21-04-2020,103611,980,1197,102414,Europe
Lithuania,21-04-2020,236843,1048,1190,235653,Europe
Luxembourg,21-04-2020,409887,489,579,409308,Europe
Madagascar,21-04-2020,187332,2440,1000,186332,Africa
Malaysia,21-04-2020,432372,399,1155,431217,Western Pacific
Maldives,21-04-2020,224578,1783,299,224279,South-East Asia
Malta,21-04-2020,325852,515,364,325488,Europe
Mauritania,21-04-2020,277899,107,698,277201,Africa
Mauritius,21-04-2020,257851,1940,361,257490,Africa
Mexico,21-04-2020,366247,2424,123,366124,Americas
Moldova,21-04-2020,78654,844,950,77704,Europe
Monaco,21-04-2020,410176,1046,1138,409038,Europe
Mongolia,21-04-2020,419408,1881,387,419021,Western Pacific
Montenegro,21-04-2020,408788,1513,123,408665,Europe
Morocco,21-04-2020,110522,294,112,110410,Eastern Mediterranean
Namibia,21-04-2020,386553,746,904,385649,Africa
Nepal,21-04-2020,375262,152,347,374915,South-East Asia
Netherlands,21-04-2020,147148,21,856,146292,Europe
Netherlands,21-04-2020,256583,1342,409,256174,Europe
Netherlands,21-04-2020,279565,508,157,279408,Europe
Netherlands,21-04-2020,260480,1598,885,259595,Europe
New Zealand,21-04-2020,440934,625,1095,439839,Western Pacific
Nicaragua,21-04-2020,396378,2189,26,396352,Americas
Niger,21-04-2020,162922,263,1099,161823,Africa
Nigeria,21-04-2020,320533,1203,142,320391,Africa
North Macedonia,21-04-2020,265449,313,896,264553,Europe
Norway,21-04-2020,259522,2049,1245,258277,Europe
Oman,21-04-2020,412248,1939,138,412110,Eastern Mediterranean
Pakistan,21-04-2020,376724,4,673,376051,Eastern Mediterranean
Panama,21-04-2020,279556,1694,57,279499,Americas
Papua New Guinea,21-04-2020,6299,1112,1048,5251,Western Pacific
Paraguay,21-04-2020,247683,645,238,247445,Americas
Peru,21-04-2020,251256,171,568,250688,Americas
Philippines,21-04-2020,184757,582,738,184019,Western Pacific
Poland,21-04-2020,89999,1737,981,89018,Europe
Portugal,21-04-2020,420216,1987,409,419807,Europe
Qatar,21-04-2020,71547,1532,1198,70349,Eastern Mediterranean
Romania,21-04-2020,242079,1675,418,241661,Europe
Russia,21-04-2020,220044,1423,616,219428,Europe
Rwanda,21-04-2020,104242,853,180,104062,Africa
Saint Lucia,21-04-2020,46173,1436,686,45487,Americas
Saint Vincent and the Grenadines,21-04-2020,110477,1263,1220,109257,Americas
San Marino,21-04-2020,82352,704,1106,81246,Europe
Saudi Arabia,21-04-2020,172425,1705,331,172094,Eastern Mediterranean
Senegal,21-04-2020,131612,612,311,131301,Africa
Serbia,21-04-2020,224266,1063,1010,223256,Europe
Seychelles,21-04-2020,50625,2006,1176,49449,Africa
Singapore,21-04-2020,117074,353,58,117016,Western Pacific
Slovakia,21-04-2020,97666,472,812,96854,Europe
Slovenia,21-04-2020,31289,826,1106,30183,Europe
Somalia,21-04-2020,78757,396,308,78449,Eastern Mediterranean
South Africa,21-04-2020,17399,146,656,16743,Africa
Spain,21-04-2020,80865,924,360,80505,Europe
Sri Lanka,21-04-2020,433766,2129,928,432838,South-East Asia
Sudan,21-04-2020,434572,1914,1047,433525,Eastern Mediterranean
Suriname,21-04-2020,316630,1145,988,315642,Americas
Sweden,21-04-2020,362491,2241,887,361604,Europe
Switzerland,21-04-2020,125873,1129,1135,124738,Europe
Taiwan*,21-04-2020,431093,600,800,430293,Western Pacific
Tanzania,21-04-2020,287249,1310,26,287223,Africa
Thailand,21-04-2020,266592,183,777,265815,South-East Asia
Togo,21-04-2020,192134,1379,722,191412,Africa
Trinidad and Tobago,21-04-2020,203029,225,587,202442,Americas
Tunisia,21-04-2020,292417,1373,23,292394,Eastern Mediterranean
Turkey,21-04-2020,231899,112,212,231687,Europe
Uganda,21-04-2020,300972,2413,524,300448,Africa
Ukraine,21-04-2020,340778,831,278,340500,Europe
United Arab Emirates,21-04-2020,50749,1880,831,49918,Eastern Mediterranean
United Kingdom,21-04-2020,130044,1993,106,129938,Europe
United Kingdom,21-04-2020,323853,4,284,323569,Europe
United Kingdom,21-04-2020,301975,2277,736,301239,Europe
United Kingdom,21-04-2020,33512,710,959,32553,Europe
United Kingdom,21-04-2020,105798,1496,1224,104574,Europe
United Kingdom,21-04-2020,147420,635,981,146439,Europe
United Kingdom,21-04-2020,99154,853,454,98700,Europe
Uruguay,21-04-2020,47780,672,1212,46568,Americas
US,21-04-2020,109100,564,1214,107886,Americas
Uzbekistan,21-04-2020,2728,1690,295,2433,Europe
Venezuela,21-04-2020,187123,549,920,186203,Americas
Vietnam,21-04-2020,156077,2430,867,155210,Western Pacific
Zambia,21-04-2020,279899,1970,1205,278694,Africa
Zimbabwe,21-04-2020,14853,1651,915,13938,Africa
Dominica,21-04-2020,135009,466,525,134484,Americas
Grenada,21-04-2020,267527,1338,853,266674,Americas
Mozambique,21-04-2020,182503,1722,85,182418,Africa
Syria,21-04-2020,75224,210,553,74671,Eastern Mediterranean
Timor-Leste,21-04-2020,99775,2205,991,98784,South-East Asia
Belize,21-04-2020,217648,2150,278,217370,Americas
Laos,21-04-2020,53562,1236,508,53054,Western Pacific
Libya,21-04-2020,108350,813,122,108228,Eastern Mediterranean
West Bank and Gaza,21-04-2020,411683,1405,55,411628,Eastern Mediterranean
Guinea-Bissau,21-04-2020,380836,1625,1001,379835,Africa
Mali,21-04-2020,392260,128,736,391524,Africa
Saint Kitts and Nevis,21-04-2020,14423,2353,15,14408,Americas
Canada,21-04-2020,327491,595,948,326543,Americas
Canada,21-04-2020,242664,723,763,241901,Americas
Kosovo,21-04-2020,630,737,683,-53,Europe
Burma,21-04-2020,165593,2133,985,164608,South-East Asia
United Kingdom,21-04-2020,371557,824,807,370750,Europe
United Kingdom,21-04-2020,66609,2272,57,66552,Europe
United Kingdom,21-04-2020,292682,68,498,292184,Europe
Botswana,21-04-2020,54052,1484,45,54007,Africa
Burundi,21-04-2020,190649,455,631,190018,Africa
Sierra Leone,21-04-2020,335183,1777,287,334896,Africa
Malawi,21-04-2020,335854,1157,372,335482,Africa
United Kingdom,21-04-2020,162389,132,711,161678,Europe
France,21-04-2020,381959,584,977,380982,Europe
South Sudan,21-04-2020,290714,1392,365,290349,Africa
Western Sahara,21-04-2020,249449,587,332,249117,Africa
Sao Tome and Principe,21-04-2020,149771,449,770,149001,Africa
Yemen,21-04-2020,60184,205,1106,59078,Eastern Mediterranean
Comoros,21-04-2020,235177,2474,133,235044,Africa
Tajikistan,21-04-2020,319986,944,101,319885,Europe
Lesotho,21-04-2020,140686,91,70,140616,Africa
Afghanistan,22-04-2020,212162,1314,969,211193,Eastern Mediterranean
Albania,22-04-2020,129358,2034,944,128414,Europe
Algeria,22-04-2020,32855,1913,998,31857,Africa
Andorra,22-04-2020,40953,536,897,40056,Europe
Angola,22-04-2020,402999,1616,733,402266,Africa
Antigua and Barbuda,22-04-2020,144421,190,1045,143376,Americas
Argentina,22-04-2020,260133,1624,1058,259075,Americas
Armenia,22-04-2020,421114,2489,1014,420100,Europe
Australia,22-04-2020,51770,2178,913,50857,Western Pacific
Australia,22-04-2020,204675,507,922,203753,Western Pacific
Australia,22-04-2020,53804,555,1100,52704,Western Pacific
Australia,22-04-2020,15553,62,476,15077,Western Pacific
Australia,22-04-2020,302866,1492,394,302472,Western Pacific
Australia,22-04-2020,154266,609,1063,153203,Western Pacific
Australia,22-04-2020,246303,315,892,245411,Western Pacific
Australia,22-04-2020,231501,182,711,230790,Western Pacific
Austria,22-04-2020,367248,1060,325,366923,Europe
Azerbaijan,22-04-2020,375991,1453,687,375304,Europe
Bahamas,22-04-2020,249299,1713,409,248890,Americas
Bahrain,22-04-2020,210063,1192,67,209996,Eastern Mediterranean
Bangladesh,22-04-2020,211933,2254,834,211099,South-East Asia
Barbados,22-04-2020,448187,308,318,447869,Americas
Belarus,22-04-2020,176341,2134,428,175913,Europe
Belgium,22-04-2020,233712,742,750,232962,Europe
Benin,22-04-2020,361964,675,834,361130,Africa
Bhutan,22-04-2020,42487,1054,730,41757,South-East Asia
Bolivia,22-04-2020,411104,1286,195,410909,Americas
Bosnia and Herzegovina,22-04-2020,43178,970,7,43171,Europe
Brazil,22-04-2020,306617,2388,578,306039,Americas
Brunei,22-04-2020,273064,2421,693,272371,Western Pacific
Bulgaria,22-04-2020,243382,538,538,242844,Europe
Burkina Faso,22-04-2020,74121,1287,263,73858,Africa
Cabo Verde,22-04-2020,213359,202,871,212488,Africa
Cambodia,22-04-2020,165796,1354,1126,164670,Western Pacific
Cameroon,22-04-2020,41700,320,762,40938,Africa
Canada,22-04-2020,4948,565,616,4332,Americas
Canada,22-04-2020,44710,333,1182,43528,Americas
Canada,22-04-2020,216287,340,155,216132,Americas
Canada,22-04-2020,363203,503,627,362576,Americas
Canada,22-04-2020,253625,893,859,252766,Americas
Canada,22-04-2020,337997,1718,1197,336800,Americas
Canada,22-04-2020,232861,96,940,231921,Americas
Canada,22-04-2020,272762,1623,902,271860,Americas
Canada,22-04-2020,282884,2252,1247,281637,Americas
Canada,22-04-2020,185126,2393,344,184782,Americas
Central African Republic,22-04-2020,445474,1984,441,445033,Africa
Chad,22-04-2020,39282,1237,1119,38163,Africa
Chile,22-04-2020,346228,886,101,346127,Americas
China,22-04-2020,148540,355,140,148400,Western Pacific
China,22-04-2020,25997,1387,81,25916,Western Pacific
China,22-04-2020,411844,1174,837,411007,Western Pacific
China,22-04-2020,392782,151,80,392702,Western Pacific
China,22-04-2020,170199,70,351,169848,Western Pacific
China,22-04-2020,428694,94,187,428507,Western Pacific
China,22-04-2020,6401,119,920,5481,Western Pacific
China,22-04-2020,68204,222,665,67539,Western Pacific
China,22-04-2020,55097,2029,721,54376,Western Pacific
China,22-04-2020,79666,2380,174,79492,Western Pacific
China,22-04-2020,46380,1904,1162,45218,Western Pacific
China,22-04-2020,138181,1068,1119,137062,Western Pacific
China,22-04-2020,278170,455,790,277380,Western Pacific
China,22-04-2020,374827,1768,235,374592,Western Pacific
China,22-04-2020,244625,1325,1138,243487,Western Pacific
China,22-04-2020,317388,368,1230,316158,Western Pacific
China,22-04-2020,19562,1537,643,18919,Western Pacific
China,22-04-2020,84532,1618,1004,83528,Western Pacific
China,22-04-2020,369560,891,1242,368318,Western Pacific
China,22-04-2020,264861,2452,308,264553,Western Pacific
China,22-04-2020,280222,628,1075,279147,Western Pacific
China,22-04-2020,60730,263,665,60065,Western Pacific
China,22-04-2020,29868,1559,775,29093,Western Pacific
China,22-04-2020,248478,561,1242,247236,Western Pacific
China,22-04-2020,383027,1805,893,382134,Western Pacific
China,22-04-2020,37948,693,44,37904,Western Pacific
China,22-04-2020,208540,517,856,207684,Western Pacific
China,22-04-2020,298015,2416,382,297633,Western Pacific
China,22-04-2020,122893,1594,945,121948,Western Pacific
China,22-04-2020,182859,588,882,181977,Western Pacific
China,22-04-2020,146660,290,570,146090,Western Pacific
China,22-04-2020,313688,2464,453,313235,Western Pacific
China,22-04-2020,313872,2170,141,313731,Western Pacific
Colombia,22-04-2020,222683,976,1186,221497,Americas
Congo (Brazzaville),22-04-2020,164028,430,398,163630,Africa
Congo (Kinshasa),22-04-2020,67737,1483,508,67229,Africa
Costa Rica,22-04-2020,300008,1222,1225,298783,Americas
Cote d'Ivoire,22-04-2020,5695,260,13,5682,Africa
Croatia,22-04-2020,328336,2349,596,327740,Europe
Cuba,22-04-2020,444602,2320,356,444246,Americas
Cyprus,22-04-2020,370931,1956,664,370267,Europe
Czechia,22-04-2020,441395,2000,738,440657,Europe
Denmark,22-04-2020,311685,763,1014,310671,Europe
Greenland,22-04-2020,381630,1498,413,381217,Europe
Denmark,22-04-2020,292949,1205,51,292898,Europe
Djibouti,22-04-2020,154060,2152,422,153638,Eastern Mediterranean
Dominican Republic,22-04-2020,83218,1970,323,82895,Americas
Ecuador,22-04-2020,88556,1226,997,87559,Americas
Egypt,22-04-2020,413466,1479,1065,412401,Eastern Mediterranean
El Salvador,22-04-2020,125081,1183,912,124169,Americas
Equatorial Guinea,22-04-2020,39741,1919,781,38960,Africa
Eritrea,22-04-2020,268437,220,37,268400,Africa
Estonia,22-04-2020,372556,975,37,372519,Europe
Eswatini,22-04-2020,239177,1936,456,238721,Africa
Ethiopia,22-04-2020,434873,733,290,434583,Africa
Fiji,22-04-2020,225697,1613,506,225191,Western Pacific
Finland,22-04-2020,215610,1199,658,214952,Europe
France,22-04-2020,407998,1272,287,407711,Europe
France,22-04-2020,61355,1107,95,61260,Europe
France,22-04-2020,424100,2027,16,424084,Europe
France,22-04-2020,33052,1655,879,32173,Europe
France,22-04-2020,322227,1364,25,322202,Europe
France,22-04-2020,26829,735,199,26630,Europe
France,22-04-2020,35113,965,600,34513,Europe
France,22-04-2020,282415,1538,980,281435,Europe
France,22-04-2020,166336,1867,1237,165099,Europe
France,22-04-2020,58991,2417,399,58592,Europe
Gabon,22-04-2020,31233,2082,298,30935,Africa
Gambia,22-04-2020,150377,711,634,149743,Africa
Georgia,22-04-2020,285229,1789,901,284328,Europe
Germany,22-04-2020,445187,243,484,444703,Europe
Ghana,22-04-2020,323923,2416,455,323468,Africa
Greece,22-04-2020,319966,1910,966,319000,Europe
Guatemala,22-04-2020,362332,6,1225,361107,Americas
Guinea,22-04-2020,91384,1954,206,91178,Africa
Guyana,22-04-2020,233844,2495,499,233345,Americas
Haiti,22-04-2020,84261,1628,793,83468,Americas
Holy See,22-04-2020,209890,2097,642,209248,Europe
Honduras,22-04-2020,48961,1307,836,48125,Americas
Hungary,22-04-2020,62781,1229,550,62231,Europe
Iceland,22-04-2020,316802,201,487,316315,Europe
India,22-04-2020,77286,382,799,76487,South-East Asia
Indonesia,22-04-2020,137051,226,683,136368,South-East Asia
Iran,22-04-2020,138258,746,757,137501,Eastern Mediterranean
Iraq,22-04-2020,209276,1868,390,208886,Eastern Mediterranean
Ireland,22-04-2020,330982,83,699,330283,Europe
Israel,22-04-2020,274129,1610,463,273666,Europe
Italy,22-04-2020,53179,2093,248,52931,Europe
Jamaica,22-04-2020,400592,1118,1078,399514,Americas
Japan,22-04-2020,390275,1562,297,389978,Western Pacific
Jordan,22-04-2020,401927,673,398,401529,Eastern Mediterranean
Kazakhstan,22-04-2020,53753,305,361,53392,Europe
Kenya,22-04-2020,314133,1481,938,313195,Africa
South Korea,22-04-2020,224577,163,669,223908,Western Pacific
Kuwait,22-04-2020,383449,935,274,383175,Eastern Mediterranean
Kyrgyzstan,22-04-2020,369375,944,566,368809,Europe
Latvia,22-04-2020,288211,1687,251,287960,Europe
Lebanon,22-04-2020,8495,1585,1209,7286,Eastern Mediterranean
Liberia,22-04-2020,276254,1455,1116,275138,Africa
Liechtenstein,22-04-2020,395610,783,289,395321,Europe
Lithuania,22-04-2020,48830,1196,352,48478,Europe
Luxembourg,22-04-2020,34607,20,871,33736,Europe
Madagascar,22-04-2020,421040,2361,755,420285,Africa
Malaysia,22-04-2020,6433,1557,382,6051,Western Pacific
Maldives,22-04-2020,206070,301,74,205996,South-East Asia
Malta,22-04-2020,349387,2318,1035,348352,Europe
Mauritania,22-04-2020,126781,565,1144,125637,Africa
Mauritius,22-04-2020,303616,2393,298,303318,Africa
Mexico,22-04-2020,59913,2142,984,58929,Americas
Moldova,22-04-2020,341548,1317,958,340590,Europe
Monaco,22-04-2020,408713,1634,974,407739,Europe
Mongolia,22-04-2020,102095,2143,364,101731,Western Pacific
Montenegro,22-04-2020,221968,780,86,221882,Europe
Morocco,22-04-2020,327045,1996,181,326864,Eastern Mediterranean
Namibia,22-04-2020,307591,970,30,307561,Africa
Nepal,22-04-2020,43406,1177,999,42407,South-East Asia
Netherlands,22-04-2020,108507,992,167,108340,Europe
Netherlands,22-04-2020,246124,148,899,245225,Europe
Netherlands,22-04-2020,304862,1495,946,303916,Europe
Netherlands,22-04-2020,265296,1230,260,265036,Europe
New Zealand,22-04-2020,232551,2421,22,232529,Western Pacific
Nicaragua,22-04-2020,338384,1591,901,337483,Americas
Niger,22-04-2020,188218,1058,93,188125,Africa
Nigeria,22-04-2020,362062,365,287,361775,Africa
North Macedonia,22-04-2020,336963,833,274,336689,Europe
Norway,22-04-2020,237239,2413,469,236770,Europe
Oman,22-04-2020,448145,248,415,447730,Eastern Mediterranean
Pakistan,22-04-2020,319111,2285,164,318947,Eastern Mediterranean
Panama,22-04-2020,13614,1638,640,12974,Americas
Papua New Guinea,22-04-2020,295536,767,818,294718,Western Pacific
Paraguay,22-04-2020,337535,1547,1222,336313,Americas
Peru,22-04-2020,227577,1147,1149,226428,Americas
Philippines,22-04-2020,90816,564,186,90630,Western Pacific
Poland,22-04-2020,435130,224,227,434903,Europe
Portugal,22-04-2020,158811,2273,1242,157569,Europe
Qatar,22-04-2020,20074,1716,395,19679,Eastern Mediterranean
Romania,22-04-2020,308437,1548,1053,307384,Europe
Russia,22-04-2020,16487,295,1081,15406,Europe
Rwanda,22-04-2020,448010,1593,371,447639,Africa
Saint Lucia,22-04-2020,390350,802,537,389813,Americas
Saint Vincent and the Grenadines,22-04-2020,230434,462,465,229969,Americas
San Marino,22-04-2020,321003,236,550,320453,Europe
Saudi Arabia,22-04-2020,121600,1516,722,120878,Eastern Mediterranean
Senegal,22-04-2020,346714,2273,625,346089,Africa
Serbia,22-04-2020,227875,1301,640,227235,Europe
Seychelles,22-04-2020,61333,1339,862,60471,Africa
Singapore,22-04-2020,138486,332,578,137908,Western Pacific
Slovakia,22-04-2020,427408,1935,102,427306,Europe
Slovenia,22-04-2020,33686,1411,1085,32601,Europe
Somalia,22-04-2020,207791,583,1203,206588,Eastern Mediterranean
South Africa,22-04-2020,44176,2208,421,43755,Africa
Spain,22-04-2020,292827,1941,916,291911,Europe
Sri Lanka,22-04-2020,194357,2158,685,193672,South-East Asia
Sudan,22-04-2020,202703,68,1067,201636,Eastern Mediterranean
Suriname,22-04-2020,233264,440,852,232412,Americas
Sweden,22-04-2020,55522,1287,293,55229,Europe
Switzerland,22-04-2020,347106,2458,728,346378,Europe
Taiwan*,22-04-2020,319497,1310,933,318564,Western Pacific
Tanzania,22-04-2020,428706,713,627,428079,Africa
Thailand,22-04-2020,226512,453,17,226495,South-East Asia
Togo,22-04-2020,407074,210,163,406911,Africa
Trinidad and Tobago,22-04-2020,429524,1845,611,428913,Americas
Tunisia,22-04-2020,289508,1873,713,288795,Eastern Mediterranean
Turkey,22-04-2020,371022,1029,949,370073,Europe
Uganda,22-04-2020,52097,982,1129,50968,Africa
Ukraine,22-04-2020,154042,145,257,153785,Europe
United Arab Emirates,22-04-2020,353850,826,1144,352706,Eastern Mediterranean
United Kingdom,22-04-2020,121274,1755,82,121192,Europe
United Kingdom,22-04-2020,216706,1600,51,216655,Europe
United Kingdom,22-04-2020,130795,227,600,130195,Europe
United Kingdom,22-04-2020,105405,2098,668,104737,Europe
United Kingdom,22-04-2020,225778,1803,582,225196,Europe
United Kingdom,22-04-2020,11388,257,773,10615,Europe
United Kingdom,22-04-2020,234499,519,1091,233408,Europe
Uruguay,22-04-2020,37842,2148,780,37062,Americas
US,22-04-2020,149081,406,774,148307,Americas
Uzbekistan,22-04-2020,71745,2480,376,71369,Europe
Venezuela,22-04-2020,126288,2417,1190,125098,Americas
Vietnam,22-04-2020,83038,1328,1223,81815,Western Pacific
Zambia,22-04-2020,328601,593,1230,327371,Africa
Zimbabwe,22-04-2020,229194,1490,697,228497,Africa
Dominica,22-04-2020,367791,1757,1166,366625,Americas
Grenada,22-04-2020,143794,568,1154,142640,Americas
Mozambique,22-04-2020,143906,1532,1226,142680,Africa
Syria,22-04-2020,243223,175,459,242764,Eastern Mediterranean
Timor-Leste,22-04-2020,268170,1893,918,267252,South-East Asia
Belize,22-04-2020,206158,715,968,205190,Americas
Laos,22-04-2020,351117,998,1059,350058,Western Pacific
Libya,22-04-2020,404929,1343,714,404215,Eastern Mediterranean
West Bank and Gaza,22-04-2020,45233,1906,618,44615,Eastern Mediterranean
Guinea-Bissau,22-04-2020,312004,1757,49,311955,Africa
Mali,22-04-2020,360422,1330,381,360041,Africa
Saint Kitts and Nevis,22-04-2020,186514,1212,255,186259,Americas
Canada,22-04-2020,210471,827,520,209951,Americas
Canada,22-04-2020,427172,1981,29,427143,Americas
Kosovo,22-04-2020,204863,1973,738,204125,Europe
Burma,22-04-2020,310026,2006,179,309847,South-East Asia
United Kingdom,22-04-2020,202344,588,424,201920,Europe
United Kingdom,22-04-2020,225268,712,926,224342,Europe
United Kingdom,22-04-2020,30364,872,393,29971,Europe
Botswana,22-04-2020,123616,130,409,123207,Africa
Burundi,22-04-2020,322155,1965,704,321451,Africa
Sierra Leone,22-04-2020,233930,1986,774,233156,Africa
Malawi,22-04-2020,425889,550,1066,424823,Africa
United Kingdom,22-04-2020,14188,1269,1142,13046,Europe
France,22-04-2020,294545,2410,373,294172,Europe
South Sudan,22-04-2020,3239,1962,792,2447,Africa
Western Sahara,22-04-2020,140101,1130,786,139315,Africa
Sao Tome and Principe,22-04-2020,64511,1621,656,63855,Africa
Yemen,22-04-2020,154433,1266,672,153761,Eastern Mediterranean
Comoros,22-04-2020,330245,107,956,329289,Africa
Tajikistan,22-04-2020,360943,754,411,360532,Europe
Lesotho,22-04-2020,258742,2294,15,258727,Africa
Afghanistan,23-04-2020,190341,1543,571,189770,Eastern Mediterranean
Albania,23-04-2020,401806,2252,209,401597,Europe
Algeria,23-04-2020,25950,1880,574,25376,Africa
Andorra,23-04-2020,184685,757,449,184236,Europe
Angola,23-04-2020,282095,2167,818,281277,Africa
Antigua and Barbuda,23-04-2020,58367,70,311,58056,Americas
Argentina,23-04-2020,4086,843,165,3921,Americas
Armenia,23-04-2020,308080,2178,24,308056,Europe
Australia,23-04-2020,191381,2064,248,191133,Western Pacific
Australia,23-04-2020,31960,1520,1008,30952,Western Pacific
Australia,23-04-2020,428195,1297,292,427903,Western Pacific
Australia,23-04-2020,304905,80,485,304420,Western Pacific
Australia,23-04-2020,171996,2414,242,171754,Western Pacific
Australia,23-04-2020,20962,2307,546,20416,Western Pacific
Australia,23-04-2020,215826,2339,174,215652,Western Pacific
Australia,23-04-2020,112118,1948,60,112058,Western Pacific
Austria,23-04-2020,47396,752,880,46516,Europe
Azerbaijan,23-04-2020,331507,1084,1097,330410,Europe
Bahamas,23-04-2020,368028,2441,112,367916,Americas
Bahrain,23-04-2020,303989,24,676,303313,Eastern Mediterranean
Bangladesh,23-04-2020,273565,39,864,272701,South-East Asia
Barbados,23-04-2020,99309,206,45,99264,Americas
Belarus,23-04-2020,290764,2209,824,289940,Europe
Belgium,23-04-2020,367047,456,723,366324,Europe
Benin,23-04-2020,323120,1532,102,323018,Africa
Bhutan,23-04-2020,96853,1534,1174,95679,South-East Asia
Bolivia,23-04-2020,276471,1679,719,275752,Americas
Bosnia and Herzegovina,23-04-2020,67745,579,391,67354,Europe
Brazil,23-04-2020,130665,660,280,130385,Americas
Brunei,23-04-2020,89682,2452,847,88835,Western Pacific
Bulgaria,23-04-2020,133204,816,820,132384,Europe
Burkina Faso,23-04-2020,5011,339,934,4077,Africa
Cabo Verde,23-04-2020,343680,1568,897,342783,Africa
Cambodia,23-04-2020,342531,975,247,342284,Western Pacific
Cameroon,23-04-2020,31252,405,603,30649,Africa
Canada,23-04-2020,374890,2441,950,373940,Americas
Canada,23-04-2020,322262,2324,963,321299,Americas
Canada,23-04-2020,196053,2226,970,195083,Americas
Canada,23-04-2020,406091,1793,1133,404958,Americas
Canada,23-04-2020,262449,778,372,262077,Americas
Canada,23-04-2020,140744,1684,634,140110,Americas
Canada,23-04-2020,40589,2072,151,40438,Americas
Canada,23-04-2020,55456,682,728,54728,Americas
Canada,23-04-2020,102210,1484,174,102036,Americas
Canada,23-04-2020,325475,2275,410,325065,Americas
Central African Republic,23-04-2020,289611,1743,759,288852,Africa
Chad,23-04-2020,182095,98,678,181417,Africa
Chile,23-04-2020,179889,1332,1137,178752,Americas
China,23-04-2020,366681,1126,915,365766,Western Pacific
China,23-04-2020,350944,1453,369,350575,Western Pacific
China,23-04-2020,5068,495,972,4096,Western Pacific
China,23-04-2020,23524,1803,551,22973,Western Pacific
China,23-04-2020,394148,1215,778,393370,Western Pacific
China,23-04-2020,64827,381,109,64718,Western Pacific
China,23-04-2020,330585,2018,1246,329339,Western Pacific
China,23-04-2020,345778,183,822,344956,Western Pacific
China,23-04-2020,400517,1537,947,399570,Western Pacific
China,23-04-2020,402066,1309,380,401686,Western Pacific
China,23-04-2020,149488,1449,818,148670,Western Pacific
China,23-04-2020,212122,828,938,211184,Western Pacific
China,23-04-2020,211269,649,215,211054,Western Pacific
China,23-04-2020,398437,955,703,397734,Western Pacific
China,23-04-2020,372908,1714,455,372453,Western Pacific
China,23-04-2020,231483,1373,922,230561,Western Pacific
China,23-04-2020,290833,1574,236,290597,Western Pacific
China,23-04-2020,7506,2327,354,7152,Western Pacific
China,23-04-2020,115871,792,1074,114797,Western Pacific
China,23-04-2020,431477,1764,463,431014,Western Pacific
China,23-04-2020,409967,980,822,409145,Western Pacific
China,23-04-2020,447484,2206,118,447366,Western Pacific
China,23-04-2020,247083,1544,564,246519,Western Pacific
China,23-04-2020,242317,1090,363,241954,Western Pacific
China,23-04-2020,140746,2057,975,139771,Western Pacific
China,23-04-2020,430052,683,294,429758,Western Pacific
China,23-04-2020,150128,2061,992,149136,Western Pacific
China,23-04-2020,408223,2007,700,407523,Western Pacific
China,23-04-2020,316462,1667,666,315796,Western Pacific
China,23-04-2020,418626,1439,686,417940,Western Pacific
China,23-04-2020,297259,572,1040,296219,Western Pacific
China,23-04-2020,347955,1731,107,347848,Western Pacific
China,23-04-2020,140008,2267,1161,138847,Western Pacific
Colombia,23-04-2020,267402,546,699,266703,Americas
Congo (Brazzaville),23-04-2020,80661,2018,567,80094,Africa
Congo (Kinshasa),23-04-2020,356101,1171,807,355294,Africa
Costa Rica,23-04-2020,96565,350,496,96069,Americas
Cote d'Ivoire,23-04-2020,130061,1481,718,129343,Africa
Croatia,23-04-2020,223922,780,323,223599,Europe
Cuba,23-04-2020,153527,1513,1063,152464,Americas
Cyprus,23-04-2020,449823,2474,142,449681,Europe
Czechia,23-04-2020,120829,701,1057,119772,Europe
Denmark,23-04-2020,16307,1749,1068,15239,Europe
Greenland,23-04-2020,75140,384,108,75032,Europe
Denmark,23-04-2020,37333,2119,1133,36200,Europe
Djibouti,23-04-2020,126451,269,29,126422,Eastern Mediterranean
Dominican Republic,23-04-2020,23650,1535,1172,22478,Americas
Ecuador,23-04-2020,11644,541,926,10718,Americas
Egypt,23-04-2020,131669,410,44,131625,Eastern Mediterranean
El Salvador,23-04-2020,192145,2465,551,191594,Americas
Equatorial Guinea,23-04-2020,414032,2403,195,413837,Africa
Eritrea,23-04-2020,176527,2230,965,175562,Africa
Estonia,23-04-2020,134358,1747,1232,133126,Europe
Eswatini,23-04-2020,168150,1568,355,167795,Africa
Ethiopia,23-04-2020,202336,717,66,202270,Africa
Fiji,23-04-2020,346797,1107,179,346618,Western Pacific
Finland,23-04-2020,47294,2212,1039,46255,Europe
France,23-04-2020,257532,893,477,257055,Europe
France,23-04-2020,298441,2196,335,298106,Europe
France,23-04-2020,343527,1794,363,343164,Europe
France,23-04-2020,280385,805,543,279842,Europe
France,23-04-2020,366089,2098,639,365450,Europe
France,23-04-2020,433956,863,679,433277,Europe
France,23-04-2020,144779,1359,362,144417,Europe
France,23-04-2020,307340,2126,112,307228,Europe
France,23-04-2020,330412,1683,105,330307,Europe
France,23-04-2020,3399,339,753,2646,Europe
Gabon,23-04-2020,172349,287,1104,171245,Africa
Gambia,23-04-2020,209415,1732,1186,208229,Africa
Georgia,23-04-2020,29995,627,569,29426,Europe
Germany,23-04-2020,7089,830,628,6461,Europe
Ghana,23-04-2020,435048,984,120,434928,Africa
Greece,23-04-2020,394289,270,1072,393217,Europe
Guatemala,23-04-2020,195363,140,705,194658,Americas
Guinea,23-04-2020,148476,356,846,147630,Africa
Guyana,23-04-2020,372203,1565,302,371901,Americas
Haiti,23-04-2020,289984,728,227,289757,Americas
Holy See,23-04-2020,56138,2040,492,55646,Europe
Honduras,23-04-2020,10250,967,417,9833,Americas
Hungary,23-04-2020,382152,1179,381,381771,Europe
Iceland,23-04-2020,35368,566,21,35347,Europe
India,23-04-2020,189767,58,137,189630,South-East Asia
Indonesia,23-04-2020,347017,2275,162,346855,South-East Asia
Iran,23-04-2020,382106,264,1178,380928,Eastern Mediterranean
Iraq,23-04-2020,269580,2049,1197,268383,Eastern Mediterranean
Ireland,23-04-2020,141580,914,493,141087,Europe
Israel,23-04-2020,81736,1352,518,81218,Europe
Italy,23-04-2020,422450,313,1214,421236,Europe
Jamaica,23-04-2020,177363,1735,14,177349,Americas
Japan,23-04-2020,355543,1773,812,354731,Western Pacific
Jordan,23-04-2020,337934,285,192,337742,Eastern Mediterranean
Kazakhstan,23-04-2020,44949,266,103,44846,Europe
Kenya,23-04-2020,111308,239,63,111245,Africa
South Korea,23-04-2020,152237,2356,583,151654,Western Pacific
Kuwait,23-04-2020,201895,1958,557,201338,Eastern Mediterranean
Kyrgyzstan,23-04-2020,250320,1374,1041,249279,Europe
Latvia,23-04-2020,43753,813,514,43239,Europe
Lebanon,23-04-2020,24837,791,955,23882,Eastern Mediterranean
Liberia,23-04-2020,41797,932,318,41479,Africa
Liechtenstein,23-04-2020,354378,279,998,353380,Europe
Lithuania,23-04-2020,169955,178,1102,168853,Europe
Luxembourg,23-04-2020,223901,558,89,223812,Europe
Madagascar,23-04-2020,247958,2190,70,247888,Africa
Malaysia,23-04-2020,437782,2386,796,436986,Western Pacific
Maldives,23-04-2020,121827,577,62,121765,South-East Asia
Malta,23-04-2020,371392,301,594,370798,Europe
Mauritania,23-04-2020,386160,866,417,385743,Africa
Mauritius,23-04-2020,84674,1330,68,84606,Africa
Mexico,23-04-2020,296424,780,209,296215,Americas
Moldova,23-04-2020,30018,304,1125,28893,Europe
Monaco,23-04-2020,275859,378,541,275318,Europe
Mongolia,23-04-2020,270893,2254,203,270690,Western Pacific
Montenegro,23-04-2020,17836,956,1050,16786,Europe
Morocco,23-04-2020,175440,1259,827,174613,Eastern Mediterranean
Namibia,23-04-2020,449652,547,119,449533,Africa
Nepal,23-04-2020,322220,383,1023,321197,South-East Asia
Netherlands,23-04-2020,345202,299,1189,344013,Europe
Netherlands,23-04-2020,75573,77,708,74865,Europe
Netherlands,23-04-2020,308892,954,1232,307660,Europe
Netherlands,23-04-2020,14136,201,938,13198,Europe
New Zealand,23-04-2020,284281,1021,203,284078,Western Pacific
Nicaragua,23-04-2020,207706,1951,1122,206584,Americas
Niger,23-04-2020,212198,1687,1041,211157,Africa
Nigeria,23-04-2020,18737,116,725,18012,Africa
North Macedonia,23-04-2020,336162,1732,698,335464,Europe
Norway,23-04-2020,384599,1612,601,383998,Europe
Oman,23-04-2020,317175,88,503,316672,Eastern Mediterranean
Pakistan,23-04-2020,322462,434,796,321666,Eastern Mediterranean
Panama,23-04-2020,163231,364,1050,162181,Americas
Papua New Guinea,23-04-2020,86412,2253,783,85629,Western Pacific
Paraguay,23-04-2020,252966,953,1076,251890,Americas
Peru,23-04-2020,236315,692,435,235880,Americas
Philippines,23-04-2020,329730,1604,232,329498,Western Pacific
Poland,23-04-2020,256236,2118,392,255844,Europe
Portugal,23-04-2020,295988,218,1187,294801,Europe
Qatar,23-04-2020,354499,758,679,353820,Eastern Mediterranean
Romania,23-04-2020,250339,609,1027,249312,Europe
Russia,23-04-2020,430358,2298,1228,429130,Europe
Rwanda,23-04-2020,303231,1856,171,303060,Africa
Saint Lucia,23-04-2020,420321,31,4,420317,Americas
Saint Vincent and the Grenadines,23-04-2020,101924,2489,546,101378,Americas
San Marino,23-04-2020,180628,561,475,180153,Europe
Saudi Arabia,23-04-2020,50120,1854,859,49261,Eastern Mediterranean
Senegal,23-04-2020,305131,1834,739,304392,Africa
Serbia,23-04-2020,112748,547,566,112182,Europe
Seychelles,23-04-2020,86699,1534,857,85842,Africa
Singapore,23-04-2020,393624,399,136,393488,Western Pacific
Slovakia,23-04-2020,200502,1971,1215,199287,Europe
Slovenia,23-04-2020,55165,553,721,54444,Europe
Somalia,23-04-2020,113352,228,436,112916,Eastern Mediterranean
South Africa,23-04-2020,292767,1339,316,292451,Africa
Spain,23-04-2020,144711,123,403,144308,Europe
Sri Lanka,23-04-2020,73894,777,672,73222,South-East Asia
Sudan,23-04-2020,368286,323,507,367779,Eastern Mediterranean
Suriname,23-04-2020,134192,2446,779,133413,Americas
Sweden,23-04-2020,427056,2406,1014,426042,Europe
Switzerland,23-04-2020,134145,268,904,133241,Europe
Taiwan*,23-04-2020,47473,1258,175,47298,Western Pacific
Tanzania,23-04-2020,385367,919,505,384862,Africa
Thailand,23-04-2020,437367,536,327,437040,South-East Asia
Togo,23-04-2020,345764,555,172,345592,Africa
Trinidad and Tobago,23-04-2020,64869,1053,20,64849,Americas
Tunisia,23-04-2020,168115,1212,923,167192,Eastern Mediterranean
Turkey,23-04-2020,57820,2419,1051,56769,Europe
Uganda,23-04-2020,394437,1861,741,393696,Africa
Ukraine,23-04-2020,179263,543,1126,178137,Europe
United Arab Emirates,23-04-2020,246267,2500,1005,245262,Eastern Mediterranean
United Kingdom,23-04-2020,330161,183,1052,329109,Europe
United Kingdom,23-04-2020,382616,2203,784,381832,Europe
United Kingdom,23-04-2020,241611,944,936,240675,Europe
United Kingdom,23-04-2020,16820,1106,648,16172,Europe
United Kingdom,23-04-2020,183256,292,123,183133,Europe
United Kingdom,23-04-2020,27300,2378,1024,26276,Europe
United Kingdom,23-04-2020,112033,1269,291,111742,Europe
Uruguay,23-04-2020,388243,686,783,387460,Americas
US,23-04-2020,312944,583,578,312366,Americas
Uzbekistan,23-04-2020,148691,1147,797,147894,Europe
Venezuela,23-04-2020,42413,2293,1189,41224,Americas
Vietnam,23-04-2020,38552,1937,949,37603,Western Pacific
Zambia,23-04-2020,83327,1144,838,82489,Africa
Zimbabwe,23-04-2020,347092,2442,418,346674,Africa
Dominica,23-04-2020,407219,502,300,406919,Americas
Grenada,23-04-2020,207030,1761,964,206066,Americas
Mozambique,23-04-2020,301640,714,735,300905,Africa
Syria,23-04-2020,47748,2415,414,47334,Eastern Mediterranean
Timor-Leste,23-04-2020,37614,2015,1029,36585,South-East Asia
Belize,23-04-2020,131956,1945,487,131469,Americas
Laos,23-04-2020,29097,370,314,28783,Western Pacific
Libya,23-04-2020,163227,1086,960,162267,Eastern Mediterranean
West Bank and Gaza,23-04-2020,282548,2344,607,281941,Eastern Mediterranean
Guinea-Bissau,23-04-2020,172619,2494,267,172352,Africa
Mali,23-04-2020,434380,172,1074,433306,Africa
Saint Kitts and Nevis,23-04-2020,181776,1173,53,181723,Americas
Canada,23-04-2020,447228,482,724,446504,Americas
Canada,23-04-2020,201402,1737,452,200950,Americas
Kosovo,23-04-2020,161734,1967,875,160859,Europe
Burma,23-04-2020,408686,2280,907,407779,South-East Asia
United Kingdom,23-04-2020,10613,2225,200,10413,Europe
United Kingdom,23-04-2020,19352,2092,1207,18145,Europe
United Kingdom,23-04-2020,153242,1473,263,152979,Europe
Botswana,23-04-2020,384541,715,921,383620,Africa
Burundi,23-04-2020,136603,1546,2,136601,Africa
Sierra Leone,23-04-2020,422118,744,740,421378,Africa
Malawi,23-04-2020,401755,756,276,401479,Africa
United Kingdom,23-04-2020,360128,651,961,359167,Europe
France,23-04-2020,91360,2234,475,90885,Europe
South Sudan,23-04-2020,397607,562,858,396749,Africa
Western Sahara,23-04-2020,378860,234,981,377879,Africa
Sao Tome and Principe,23-04-2020,103958,1106,759,103199,Africa
Yemen,23-04-2020,298230,1060,97,298133,Eastern Mediterranean
Comoros,23-04-2020,130379,1483,575,129804,Africa
Tajikistan,23-04-2020,142051,2324,422,141629,Europe
Lesotho,23-04-2020,178745,215,161,178584,Africa
Afghanistan,24-04-2020,343841,336,925,342916,Eastern Mediterranean
Albania,24-04-2020,187883,1143,374,187509,Europe
Algeria,24-04-2020,205074,494,717,204357,Africa
Andorra,24-04-2020,355777,1551,1016,354761,Europe
Angola,24-04-2020,12016,1965,25,11991,Africa
Antigua and Barbuda,24-04-2020,163057,223,306,162751,Americas
Argentina,24-04-2020,295594,1768,93,295501,Americas
Armenia,24-04-2020,423808,1467,1033,422775,Europe
Australia,24-04-2020,43447,1870,726,42721,Western Pacific
Australia,24-04-2020,224046,218,21,224025,Western Pacific
Australia,24-04-2020,126087,1388,708,125379,Western Pacific
Australia,24-04-2020,340489,2107,436,340053,Western Pacific
Australia,24-04-2020,29515,420,688,28827,Western Pacific
Australia,24-04-2020,126544,1194,531,126013,Western Pacific
Australia,24-04-2020,82496,1923,691,81805,Western Pacific
Australia,24-04-2020,214832,276,1190,213642,Western Pacific
Austria,24-04-2020,392729,521,1086,391643,Europe
Azerbaijan,24-04-2020,266741,1078,961,265780,Europe
Bahamas,24-04-2020,256235,2444,580,255655,Americas
Bahrain,24-04-2020,155786,2332,360,155426,Eastern Mediterranean
Bangladesh,24-04-2020,9242,77,185,9057,South-East Asia
Barbados,24-04-2020,211289,2055,295,210994,Americas
Belarus,24-04-2020,148739,2343,616,148123,Europe
Belgium,24-04-2020,361793,1405,332,361461,Europe
Benin,24-04-2020,54956,1751,772,54184,Africa
Bhutan,24-04-2020,247878,2432,647,247231,South-East Asia
Bolivia,24-04-2020,320273,1240,161,320112,Americas
Bosnia and Herzegovina,24-04-2020,37451,2331,927,36524,Europe
Brazil,24-04-2020,354340,395,858,353482,Americas
Brunei,24-04-2020,23544,1032,433,23111,Western Pacific
Bulgaria,24-04-2020,400338,231,77,400261,Europe
Burkina Faso,24-04-2020,146590,875,1045,145545,Africa
Cabo Verde,24-04-2020,445382,246,25,445357,Africa
Cambodia,24-04-2020,321173,2309,166,321007,Western Pacific
Cameroon,24-04-2020,220711,736,356,220355,Africa
Canada,24-04-2020,267139,632,968,266171,Americas
Canada,24-04-2020,153951,1302,305,153646,Americas
Canada,24-04-2020,242653,1090,383,242270,Americas
Canada,24-04-2020,6240,146,250,5990,Americas
Canada,24-04-2020,192788,664,598,192190,Americas
Canada,24-04-2020,1234,1507,777,457,Americas
Canada,24-04-2020,198707,2014,821,197886,Americas
Canada,24-04-2020,80208,347,368,79840,Americas
Canada,24-04-2020,241445,1190,423,241022,Americas
Canada,24-04-2020,227607,2066,941,226666,Americas
Central African Republic,24-04-2020,400404,1435,1245,399159,Africa
Chad,24-04-2020,202360,2294,372,201988,Africa
Chile,24-04-2020,128499,1306,392,128107,Americas
China,24-04-2020,110505,1570,931,109574,Western Pacific
China,24-04-2020,231877,1666,529,231348,Western Pacific
China,24-04-2020,55456,1392,21,55435,Western Pacific
China,24-04-2020,369351,495,305,369046,Western Pacific
China,24-04-2020,307620,569,713,306907,Western Pacific
China,24-04-2020,145696,1675,32,145664,Western Pacific
China,24-04-2020,274617,454,1139,273478,Western Pacific
China,24-04-2020,292472,550,942,291530,Western Pacific
China,24-04-2020,100238,107,560,99678,Western Pacific
China,24-04-2020,62741,730,803,61938,Western Pacific
China,24-04-2020,333939,295,564,333375,Western Pacific
China,24-04-2020,194187,2450,945,193242,Western Pacific
China,24-04-2020,239639,1228,382,239257,Western Pacific
China,24-04-2020,103704,842,380,103324,Western Pacific
China,24-04-2020,314749,579,1245,313504,Western Pacific
China,24-04-2020,148194,711,138,148056,Western Pacific
China,24-04-2020,16027,74,224,15803,Western Pacific
China,24-04-2020,387769,1987,1067,386702,Western Pacific
China,24-04-2020,275774,1754,315,275459,Western Pacific
China,24-04-2020,446090,1944,372,445718,Western Pacific
China,24-04-2020,403951,2105,552,403399,Western Pacific
China,24-04-2020,125159,587,756,124403,Western Pacific
China,24-04-2020,302556,1197,843,301713,Western Pacific
China,24-04-2020,170674,1376,1244,169430,Western Pacific
China,24-04-2020,243089,1223,480,242609,Western Pacific
China,24-04-2020,238139,994,457,237682,Western Pacific
China,24-04-2020,143440,1788,943,142497,Western Pacific
China,24-04-2020,401025,1387,472,400553,Western Pacific
China,24-04-2020,161418,570,176,161242,Western Pacific
China,24-04-2020,239782,753,477,239305,Western Pacific
China,24-04-2020,107805,882,944,106861,Western Pacific
China,24-04-2020,279547,1447,755,278792,Western Pacific
China,24-04-2020,167896,715,148,167748,Western Pacific
Colombia,24-04-2020,118674,1689,415,118259,Americas
Congo (Brazzaville),24-04-2020,358178,613,17,358161,Africa
Congo (Kinshasa),24-04-2020,284485,1234,914,283571,Africa
Costa Rica,24-04-2020,420955,2122,550,420405,Americas
Cote d'Ivoire,24-04-2020,313787,772,960,312827,Africa
Croatia,24-04-2020,334196,2272,550,333646,Europe
Cuba,24-04-2020,292752,590,995,291757,Americas
Cyprus,24-04-2020,95393,1578,1140,94253,Europe
Czechia,24-04-2020,390699,73,674,390025,Europe
Denmark,24-04-2020,51533,1497,328,51205,Europe
Greenland,24-04-2020,199793,1077,166,199627,Europe
Denmark,24-04-2020,183547,1442,1228,182319,Europe
Djibouti,24-04-2020,401792,1291,198,401594,Eastern Mediterranean
Dominican Republic,24-04-2020,376850,1063,295,376555,Americas
Ecuador,24-04-2020,106446,1686,418,106028,Americas
Egypt,24-04-2020,402338,2106,323,402015,Eastern Mediterranean
El Salvador,24-04-2020,82785,1122,347,82438,Americas
Equatorial Guinea,24-04-2020,410512,1198,144,410368,Africa
Eritrea,24-04-2020,197710,407,41,197669,Africa
Estonia,24-04-2020,66775,2152,1000,65775,Europe
Eswatini,24-04-2020,51471,2123,600,50871,Africa
Ethiopia,24-04-2020,388183,71,618,387565,Africa
Fiji,24-04-2020,385717,1546,820,384897,Western Pacific
Finland,24-04-2020,246460,1789,1179,245281,Europe
France,24-04-2020,86100,2166,125,85975,Europe
France,24-04-2020,161608,2337,310,161298,Europe
France,24-04-2020,210342,286,422,209920,Europe
France,24-04-2020,65787,282,318,65469,Europe
France,24-04-2020,216084,524,862,215222,Europe
France,24-04-2020,436529,616,430,436099,Europe
France,24-04-2020,250342,2141,604,249738,Europe
France,24-04-2020,383851,676,926,382925,Europe
France,24-04-2020,136218,393,927,135291,Europe
France,24-04-2020,87593,640,1064,86529,Europe
Gabon,24-04-2020,315637,1532,852,314785,Africa
Gambia,24-04-2020,179735,2030,778,178957,Africa
Georgia,24-04-2020,426694,332,218,426476,Europe
Germany,24-04-2020,314284,317,800,313484,Europe
Ghana,24-04-2020,382061,2451,351,381710,Africa
Greece,24-04-2020,31261,1765,575,30686,Europe
Guatemala,24-04-2020,394341,2070,1219,393122,Americas
Guinea,24-04-2020,43564,703,613,42951,Africa
Guyana,24-04-2020,348419,941,334,348085,Americas
Haiti,24-04-2020,274685,1925,497,274188,Americas
Holy See,24-04-2020,445357,2231,1090,444267,Europe
Honduras,24-04-2020,107251,343,85,107166,Americas
Hungary,24-04-2020,138377,1311,50,138327,Europe
Iceland,24-04-2020,250502,914,767,249735,Europe
India,24-04-2020,418540,393,343,418197,South-East Asia
Indonesia,24-04-2020,332102,1230,288,331814,South-East Asia
Iran,24-04-2020,76594,2042,256,76338,Eastern Mediterranean
Iraq,24-04-2020,252704,791,766,251938,Eastern Mediterranean
Ireland,24-04-2020,27187,1180,367,26820,Europe
Israel,24-04-2020,363861,2325,26,363835,Europe
Italy,24-04-2020,430128,1605,418,429710,Europe
Jamaica,24-04-2020,31325,2137,1239,30086,Americas
Japan,24-04-2020,320305,2155,185,320120,Western Pacific
Jordan,24-04-2020,382654,230,875,381779,Eastern Mediterranean
Kazakhstan,24-04-2020,446602,991,901,445701,Europe
Kenya,24-04-2020,73538,770,905,72633,Africa
South Korea,24-04-2020,293075,1819,1177,291898,Western Pacific
Kuwait,24-04-2020,90977,1933,559,90418,Eastern Mediterranean
Kyrgyzstan,24-04-2020,411143,767,1126,410017,Europe
Latvia,24-04-2020,414607,1875,164,414443,Europe
Lebanon,24-04-2020,431668,419,1046,430622,Eastern Mediterranean
Liberia,24-04-2020,255743,1496,1154,254589,Africa
Liechtenstein,24-04-2020,99293,8,1174,98119,Europe
Lithuania,24-04-2020,381972,2066,765,381207,Europe
Luxembourg,24-04-2020,436394,1748,841,435553,Europe
Madagascar,24-04-2020,228721,387,1002,227719,Africa
Malaysia,24-04-2020,164043,1903,264,163779,Western Pacific
Maldives,24-04-2020,18137,1808,322,17815,South-East Asia
Malta,24-04-2020,18819,2048,331,18488,Europe
Mauritania,24-04-2020,237477,399,134,237343,Africa
Mauritius,24-04-2020,350781,2238,1003,349778,Africa
Mexico,24-04-2020,444519,1522,392,444127,Americas
Moldova,24-04-2020,169091,1373,158,168933,Europe
Monaco,24-04-2020,386889,968,1154,385735,Europe
Mongolia,24-04-2020,311835,2263,365,311470,Western Pacific
Montenegro,24-04-2020,23291,633,309,22982,Europe
Morocco,24-04-2020,134235,100,1178,133057,Eastern Mediterranean
Namibia,24-04-2020,19214,454,847,18367,Africa
Nepal,24-04-2020,239010,1390,27,238983,South-East Asia
Netherlands,24-04-2020,436370,447,121,436249,Europe
Netherlands,24-04-2020,94117,670,465,93652,Europe
Netherlands,24-04-2020,335595,2202,71,335524,Europe
Netherlands,24-04-2020,90390,482,801,89589,Europe
New Zealand,24-04-2020,315052,673,667,314385,Western Pacific
Nicaragua,24-04-2020,54795,2143,205,54590,Americas
Niger,24-04-2020,341512,1772,1053,340459,Africa
Nigeria,24-04-2020,297958,1394,617,297341,Africa
North Macedonia,24-04-2020,208598,2123,841,207757,Europe
Norway,24-04-2020,388697,522,1172,387525,Europe
Oman,24-04-2020,74490,1916,673,73817,Eastern Mediterranean
Pakistan,24-04-2020,284963,2197,1209,283754,Eastern Mediterranean
Panama,24-04-2020,364324,972,348,363976,Americas
Papua New Guinea,24-04-2020,198920,1554,602,198318,Western Pacific
Paraguay,24-04-2020,394681,1269,320,394361,Americas
Peru,24-04-2020,326241,1728,1210,325031,Americas
Philippines,24-04-2020,184803,2017,408,184395,Western Pacific
Poland,24-04-2020,59758,964,1096,58662,Europe
Portugal,24-04-2020,410878,2384,271,410607,Europe
Qatar,24-04-2020,73383,894,1165,72218,Eastern Mediterranean
Romania,24-04-2020,420411,1801,5,420406,Europe
Russia,24-04-2020,231681,859,633,231048,Europe
Rwanda,24-04-2020,93249,405,614,92635,Africa
Saint Lucia,24-04-2020,306074,1041,1109,304965,Americas
Saint Vincent and the Grenadines,24-04-2020,276552,189,782,275770,Americas
San Marino,24-04-2020,69526,650,1150,68376,Europe
Saudi Arabia,24-04-2020,395462,2384,61,395401,Eastern Mediterranean
Senegal,24-04-2020,246800,1390,474,246326,Africa
Serbia,24-04-2020,186019,861,516,185503,Europe
Seychelles,24-04-2020,361911,1785,558,361353,Africa
Singapore,24-04-2020,159090,1582,421,158669,Western Pacific
Slovakia,24-04-2020,210990,2354,1190,209800,Europe
Slovenia,24-04-2020,299425,761,38,299387,Europe
Somalia,24-04-2020,406920,916,1190,405730,Eastern Mediterranean
South Africa,24-04-2020,98488,1067,1222,97266,Africa
Spain,24-04-2020,12997,1736,462,12535,Europe
Sri Lanka,24-04-2020,109103,1308,762,108341,South-East Asia
Sudan,24-04-2020,119408,1381,13,119395,Eastern Mediterranean
Suriname,24-04-2020,381460,1862,854,380606,Americas
Sweden,24-04-2020,264482,1473,1247,263235,Europe
Switzerland,24-04-2020,92294,2060,1148,91146,Europe
Taiwan*,24-04-2020,425894,598,1180,424714,Western Pacific
Tanzania,24-04-2020,36457,980,435,36022,Africa
Thailand,24-04-2020,223401,398,1211,222190,South-East Asia
Togo,24-04-2020,127887,1154,1151,126736,Africa
Trinidad and Tobago,24-04-2020,206867,1751,723,206144,Americas
Tunisia,24-04-2020,180191,964,777,179414,Eastern Mediterranean
Turkey,24-04-2020,240215,1047,41,240174,Europe
Uganda,24-04-2020,193032,2216,384,192648,Africa
Ukraine,24-04-2020,3671,1046,584,3087,Europe
United Arab Emirates,24-04-2020,59823,1277,681,59142,Eastern Mediterranean
United Kingdom,24-04-2020,430664,1569,407,430257,Europe
United Kingdom,24-04-2020,274607,1625,698,273909,Europe
United Kingdom,24-04-2020,153397,1695,832,152565,Europe
United Kingdom,24-04-2020,26510,1555,1110,25400,Europe
United Kingdom,24-04-2020,175051,1144,809,174242,Europe
United Kingdom,24-04-2020,282602,883,118,282484,Europe
United Kingdom,24-04-2020,142473,1573,223,142250,Europe
Uruguay,24-04-2020,295529,1789,1021,294508,Americas
US,24-04-2020,296455,665,102,296353,Americas
Uzbekistan,24-04-2020,15544,1828,1241,14303,Europe
Venezuela,24-04-2020,56197,1665,979,55218,Americas
Vietnam,24-04-2020,142765,857,933,141832,Western Pacific
Zambia,24-04-2020,234994,921,1100,233894,Africa
Zimbabwe,24-04-2020,49463,1350,187,49276,Africa
Dominica,24-04-2020,366962,1018,35,366927,Americas
Grenada,24-04-2020,258369,2470,232,258137,Americas
Mozambique,24-04-2020,11812,1246,827,10985,Africa
Syria,24-04-2020,37774,1617,217,37557,Eastern Mediterranean
Timor-Leste,24-04-2020,252598,902,91,252507,South-East Asia
Belize,24-04-2020,191839,1890,565,191274,Americas
Laos,24-04-2020,3967,1152,1171,2796,Western Pacific
Libya,24-04-2020,84176,826,303,83873,Eastern Mediterranean
West Bank and Gaza,24-04-2020,292541,435,730,291811,Eastern Mediterranean
Guinea-Bissau,24-04-2020,106404,621,751,105653,Africa
Mali,24-04-2020,173980,1715,450,173530,Africa
Saint Kitts and Nevis,24-04-2020,215414,195,28,215386,Americas
Canada,24-04-2020,357122,548,1038,356084,Americas
Canada,24-04-2020,16800,1839,579,16221,Americas
Kosovo,24-04-2020,266089,2360,634,265455,Europe
Burma,24-04-2020,64460,1813,360,64100,South-East Asia
United Kingdom,24-04-2020,119198,1682,215,118983,Europe
United Kingdom,24-04-2020,51526,1597,302,51224,Europe
United Kingdom,24-04-2020,432097,1596,895,431202,Europe
Botswana,24-04-2020,275811,384,144,275667,Africa
Burundi,24-04-2020,410861,610,679,410182,Africa
Sierra Leone,24-04-2020,158007,1531,899,157108,Africa
Malawi,24-04-2020,241538,1993,501,241037,Africa
United Kingdom,24-04-2020,201842,325,459,201383,Europe
France,24-04-2020,319298,1343,374,318924,Europe
South Sudan,24-04-2020,383139,148,841,382298,Africa
Western Sahara,24-04-2020,152895,427,951,151944,Africa
Sao Tome and Principe,24-04-2020,264613,918,642,263971,Africa
Yemen,24-04-2020,189036,1707,1007,188029,Eastern Mediterranean
Comoros,24-04-2020,64152,223,44,64108,Africa
Tajikistan,24-04-2020,213596,1716,172,213424,Europe
Lesotho,24-04-2020,385023,1605,435,384588,Africa
Afghanistan,25-04-2020,340399,733,1222,339177,Eastern Mediterranean
Albania,25-04-2020,235223,1660,414,234809,Europe
Algeria,25-04-2020,45278,92,950,44328,Africa
Andorra,25-04-2020,200730,1120,808,199922,Europe
Angola,25-04-2020,377972,2296,893,377079,Africa
Antigua and Barbuda,25-04-2020,57022,869,450,56572,Americas
Argentina,25-04-2020,272217,1238,1160,271057,Americas
Armenia,25-04-2020,260307,864,910,259397,Europe
Australia,25-04-2020,143474,1539,1074,142400,Western Pacific
Australia,25-04-2020,121953,1779,1021,120932,Western Pacific
Australia,25-04-2020,150808,661,101,150707,Western Pacific
Australia,25-04-2020,29216,993,966,28250,Western Pacific
Australia,25-04-2020,95711,717,1174,94537,Western Pacific
Australia,25-04-2020,428928,1138,596,428332,Western Pacific
Australia,25-04-2020,324464,476,920,323544,Western Pacific
Australia,25-04-2020,426996,2351,1120,425876,Western Pacific
Austria,25-04-2020,372564,862,986,371578,Europe
Azerbaijan,25-04-2020,336530,247,480,336050,Europe
Bahamas,25-04-2020,390582,1716,852,389730,Americas
Bahrain,25-04-2020,102805,422,222,102583,Eastern Mediterranean
Bangladesh,25-04-2020,260995,1835,762,260233,South-East Asia
Barbados,25-04-2020,316136,1319,379,315757,Americas
Belarus,25-04-2020,197389,2336,107,197282,Europe
Belgium,25-04-2020,292090,2267,232,291858,Europe
Benin,25-04-2020,371489,69,550,370939,Africa
Bhutan,25-04-2020,80245,11,1025,79220,South-East Asia
Bolivia,25-04-2020,264720,1138,1124,263596,Americas
Bosnia and Herzegovina,25-04-2020,399061,1479,1091,397970,Europe
Brazil,25-04-2020,11178,249,782,10396,Americas
Brunei,25-04-2020,36853,1360,347,36506,Western Pacific
Bulgaria,25-04-2020,135199,719,782,134417,Europe
Burkina Faso,25-04-2020,417780,696,1128,416652,Africa
Cabo Verde,25-04-2020,425824,2396,452,425372,Africa
Cambodia,25-04-2020,8161,2167,747,7414,Western Pacific
Cameroon,25-04-2020,243560,1511,871,242689,Africa
Canada,25-04-2020,127094,1662,369,126725,Americas
Canada,25-04-2020,273157,1509,798,272359,Americas
Canada,25-04-2020,318842,785,1146,317696,Americas
Canada,25-04-2020,347049,56,567,346482,Americas
Canada,25-04-2020,94673,1895,1118,93555,Americas
Canada,25-04-2020,272729,1338,76,272653,Americas
Canada,25-04-2020,22745,1949,557,22188,Americas
Canada,25-04-2020,274667,2406,457,274210,Americas
Canada,25-04-2020,71964,586,565,71399,Americas
Canada,25-04-2020,192270,134,165,192105,Americas
Central African Republic,25-04-2020,176029,756,410,175619,Africa
Chad,25-04-2020,345982,1818,1057,344925,Africa
Chile,25-04-2020,214132,248,623,213509,Americas
China,25-04-2020,163369,2407,259,163110,Western Pacific
China,25-04-2020,255924,1114,1205,254719,Western Pacific
China,25-04-2020,114598,1598,415,114183,Western Pacific
China,25-04-2020,219433,2433,609,218824,Western Pacific
China,25-04-2020,396635,1247,284,396351,Western Pacific
China,25-04-2020,338585,1042,227,338358,Western Pacific
China,25-04-2020,17975,1022,584,17391,Western Pacific
China,25-04-2020,218956,2047,176,218780,Western Pacific
China,25-04-2020,306764,1870,352,306412,Western Pacific
China,25-04-2020,333465,199,35,333430,Western Pacific
China,25-04-2020,230139,2095,345,229794,Western Pacific
China,25-04-2020,292586,405,475,292111,Western Pacific
China,25-04-2020,245211,1444,185,245026,Western Pacific
China,25-04-2020,304927,2295,635,304292,Western Pacific
China,25-04-2020,399335,1491,278,399057,Western Pacific
China,25-04-2020,102787,2366,933,101854,Western Pacific
China,25-04-2020,411853,1445,887,410966,Western Pacific
China,25-04-2020,306543,317,1176,305367,Western Pacific
China,25-04-2020,147602,1564,158,147444,Western Pacific
China,25-04-2020,226683,1661,1083,225600,Western Pacific
China,25-04-2020,436698,2134,943,435755,Western Pacific
China,25-04-2020,285133,859,200,284933,Western Pacific
China,25-04-2020,168028,2069,1003,167025,Western Pacific
China,25-04-2020,373036,90,1063,371973,Western Pacific
China,25-04-2020,373064,1550,667,372397,Western Pacific
China,25-04-2020,31042,2140,1237,29805,Western Pacific
China,25-04-2020,210301,1736,655,209646,Western Pacific
China,25-04-2020,104176,393,575,103601,Western Pacific
China,25-04-2020,208779,1787,289,208490,Western Pacific
China,25-04-2020,36510,845,119,36391,Western Pacific
China,25-04-2020,113744,63,19,113725,Western Pacific
China,25-04-2020,59298,808,1212,58086,Western Pacific
China,25-04-2020,419074,1789,53,419021,Western Pacific
Colombia,25-04-2020,436691,1998,1201,435490,Americas
Congo (Brazzaville),25-04-2020,93052,649,227,92825,Africa
Congo (Kinshasa),25-04-2020,221268,2199,1149,220119,Africa
Costa Rica,25-04-2020,65651,984,1168,64483,Americas
Cote d'Ivoire,25-04-2020,254890,1148,949,253941,Africa
Croatia,25-04-2020,74641,509,685,73956,Europe
Cuba,25-04-2020,213742,4,839,212903,Americas
Cyprus,25-04-2020,33392,1339,851,32541,Europe
Czechia,25-04-2020,106447,2215,714,105733,Europe
Denmark,25-04-2020,176364,1220,888,175476,Europe
Greenland,25-04-2020,291835,1641,581,291254,Europe
Denmark,25-04-2020,101559,420,470,101089,Europe
Djibouti,25-04-2020,282551,1436,192,282359,Eastern Mediterranean
Dominican Republic,25-04-2020,196600,589,1010,195590,Americas
Ecuador,25-04-2020,394745,34,190,394555,Americas
Egypt,25-04-2020,317926,1169,913,317013,Eastern Mediterranean
El Salvador,25-04-2020,295376,211,1165,294211,Americas
Equatorial Guinea,25-04-2020,410468,1768,139,410329,Africa
Eritrea,25-04-2020,172004,1853,974,171030,Africa
Estonia,25-04-2020,291840,565,224,291616,Europe
Eswatini,25-04-2020,131728,315,66,131662,Africa
Ethiopia,25-04-2020,135189,1426,332,134857,Africa
Fiji,25-04-2020,171217,1662,701,170516,Western Pacific
Finland,25-04-2020,360586,2349,484,360102,Europe
France,25-04-2020,232470,1442,1081,231389,Europe
France,25-04-2020,55779,680,137,55642,Europe
France,25-04-2020,422177,1479,297,421880,Europe
France,25-04-2020,184551,1034,58,184493,Europe
France,25-04-2020,21446,1870,253,21193,Europe
France,25-04-2020,320398,1109,1150,319248,Europe
France,25-04-2020,355355,22,86,355269,Europe
France,25-04-2020,317433,2137,139,317294,Europe
France,25-04-2020,143171,704,280,142891,Europe
France,25-04-2020,258681,492,17,258664,Europe
Gabon,25-04-2020,253195,1089,81,253114,Africa
Gambia,25-04-2020,446965,983,1009,445956,Africa
Georgia,25-04-2020,393226,506,231,392995,Europe
Germany,25-04-2020,318845,338,367,318478,Europe
Ghana,25-04-2020,253569,1141,721,252848,Africa
Greece,25-04-2020,374034,702,1071,372963,Europe
Guatemala,25-04-2020,368,1968,907,-539,Americas
Guinea,25-04-2020,258751,1534,450,258301,Africa
Guyana,25-04-2020,258848,506,682,258166,Americas
Haiti,25-04-2020,265948,303,70,265878,Americas
Holy See,25-04-2020,334659,1844,477,334182,Europe
Honduras,25-04-2020,272178,1379,691,271487,Americas
Hungary,25-04-2020,18316,366,286,18030,Europe
Iceland,25-04-2020,246146,2298,254,245892,Europe
India,25-04-2020,411282,1678,479,410803,South-East Asia
Indonesia,25-04-2020,149254,832,695,148559,South-East Asia
Iran,25-04-2020,267464,310,360,267104,Eastern Mediterranean
Iraq,25-04-2020,182822,892,731,182091,Eastern Mediterranean
Ireland,25-04-2020,249275,811,418,248857,Europe
Israel,25-04-2020,265795,1257,947,264848,Europe
Italy,25-04-2020,413452,1663,697,412755,Europe
Jamaica,25-04-2020,404253,525,584,403669,Americas
Japan,25-04-2020,251812,1231,548,251264,Western Pacific
Jordan,25-04-2020,17445,1295,1155,16290,Eastern Mediterranean
Kazakhstan,25-04-2020,407788,564,135,407653,Europe
Kenya,25-04-2020,92128,262,410,91718,Africa
South Korea,25-04-2020,396400,2242,1228,395172,Western Pacific
Kuwait,25-04-2020,24083,2168,1178,22905,Eastern Mediterranean
Kyrgyzstan,25-04-2020,143555,1012,700,142855,Europe
Latvia,25-04-2020,160481,440,533,159948,Europe
Lebanon,25-04-2020,117688,254,1115,116573,Eastern Mediterranean
Liberia,25-04-2020,19196,1943,108,19088,Africa
Liechtenstein,25-04-2020,70771,361,348,70423,Europe
Lithuania,25-04-2020,284734,1343,789,283945,Europe
Luxembourg,25-04-2020,34237,1881,1140,33097,Europe
Madagascar,25-04-2020,186486,668,990,185496,Africa
Malaysia,25-04-2020,264420,1392,753,263667,Western Pacific
Maldives,25-04-2020,102764,1545,750,102014,South-East Asia
Malta,25-04-2020,48934,1114,1075,47859,Europe
Mauritania,25-04-2020,194852,1803,736,194116,Africa
Mauritius,25-04-2020,227985,1507,684,227301,Africa
Mexico,25-04-2020,431636,2494,143,431493,Americas
Moldova,25-04-2020,3815,249,335,3480,Europe
Monaco,25-04-2020,160587,461,358,160229,Europe
Mongolia,25-04-2020,63215,1610,334,62881,Western Pacific
Montenegro,25-04-2020,15726,1646,434,15292,Europe
Morocco,25-04-2020,31553,1476,870,30683,Eastern Mediterranean
Namibia,25-04-2020,323921,1775,794,323127,Africa
Nepal,25-04-2020,23794,2495,1069,22725,South-East Asia
Netherlands,25-04-2020,186051,151,159,185892,Europe
Netherlands,25-04-2020,270525,641,133,270392,Europe
Netherlands,25-04-2020,13213,312,1120,12093,Europe
Netherlands,25-04-2020,146095,1157,47,146048,Europe
New Zealand,25-04-2020,13437,522,393,13044,Western Pacific
Nicaragua,25-04-2020,85490,1725,1129,84361,Americas
Niger,25-04-2020,157949,2373,591,157358,Africa
Nigeria,25-04-2020,26383,590,108,26275,Africa
North Macedonia,25-04-2020,373035,2033,330,372705,Europe
Norway,25-04-2020,319208,2489,555,318653,Europe
Oman,25-04-2020,15167,1778,796,14371,Eastern Mediterranean
Pakistan,25-04-2020,140017,1334,240,139777,Eastern Mediterranean
Panama,25-04-2020,85613,721,523,85090,Americas
Papua New Guinea,25-04-2020,182946,1277,558,182388,Western Pacific
Paraguay,25-04-2020,154490,107,345,154145,Americas
Peru,25-04-2020,383129,211,1214,381915,Americas
Philippines,25-04-2020,388750,2171,1067,387683,Western Pacific
Poland,25-04-2020,360607,418,159,360448,Europe
Portugal,25-04-2020,370263,2496,397,369866,Europe
Qatar,25-04-2020,114787,566,1219,113568,Eastern Mediterranean
Romania,25-04-2020,70430,1329,150,70280,Europe
Russia,25-04-2020,394205,2106,571,393634,Europe
Rwanda,25-04-2020,206821,402,467,206354,Africa
Saint Lucia,25-04-2020,283327,248,1114,282213,Americas
Saint Vincent and the Grenadines,25-04-2020,228545,1197,879,227666,Americas
San Marino,25-04-2020,413529,1230,1132,412397,Europe
Saudi Arabia,25-04-2020,70326,656,300,70026,Eastern Mediterranean
Senegal,25-04-2020,352640,2304,1214,351426,Africa
Serbia,25-04-2020,28475,2117,1130,27345,Europe
Seychelles,25-04-2020,68313,563,1147,67166,Africa
Singapore,25-04-2020,33048,1995,255,32793,Western Pacific
Slovakia,25-04-2020,224197,1602,1156,223041,Europe
Slovenia,25-04-2020,187373,1103,164,187209,Europe
Somalia,25-04-2020,180655,532,714,179941,Eastern Mediterranean
South Africa,25-04-2020,27928,71,436,27492,Africa
Spain,25-04-2020,405576,484,803,404773,Europe
Sri Lanka,25-04-2020,335951,817,614,335337,South-East Asia
Sudan,25-04-2020,59382,126,740,58642,Eastern Mediterranean
Suriname,25-04-2020,438291,1061,1223,437068,Americas
Sweden,25-04-2020,212878,323,52,212826,Europe
Switzerland,25-04-2020,314107,592,993,313114,Europe
Taiwan*,25-04-2020,2561,900,863,1698,Western Pacific
Tanzania,25-04-2020,426476,650,885,425591,Africa
Thailand,25-04-2020,436890,38,578,436312,South-East Asia
Togo,25-04-2020,229183,595,118,229065,Africa
Trinidad and Tobago,25-04-2020,399168,2389,1055,398113,Americas
Tunisia,25-04-2020,378495,1326,377,378118,Eastern Mediterranean
Turkey,25-04-2020,380954,317,1151,379803,Europe
Uganda,25-04-2020,242923,1518,690,242233,Africa
Ukraine,25-04-2020,230818,1835,404,230414,Europe
United Arab Emirates,25-04-2020,395062,1446,641,394421,Eastern Mediterranean
United Kingdom,25-04-2020,209868,211,947,208921,Europe
United Kingdom,25-04-2020,64174,209,884,63290,Europe
United Kingdom,25-04-2020,341027,1843,716,340311,Europe
United Kingdom,25-04-2020,356372,290,565,355807,Europe
United Kingdom,25-04-2020,377740,570,188,377552,Europe
United Kingdom,25-04-2020,406845,1237,1005,405840,Europe
United Kingdom,25-04-2020,26452,2440,756,25696,Europe
Uruguay,25-04-2020,107419,75,812,106607,Americas
US,25-04-2020,420052,1624,1032,419020,Americas
Uzbekistan,25-04-2020,249224,1302,46,249178,Europe
Venezuela,25-04-2020,434857,333,1001,433856,Americas
Vietnam,25-04-2020,213294,1332,119,213175,Western Pacific
Zambia,25-04-2020,148918,2349,336,148582,Africa
Zimbabwe,25-04-2020,438632,512,380,438252,Africa
Dominica,25-04-2020,56935,664,1225,55710,Americas
Grenada,25-04-2020,428468,1216,1199,427269,Americas
Mozambique,25-04-2020,348567,702,1135,347432,Africa
Syria,25-04-2020,425288,1702,348,424940,Eastern Mediterranean
Timor-Leste,25-04-2020,208351,60,899,207452,South-East Asia
Belize,25-04-2020,201724,2118,1015,200709,Americas
Laos,25-04-2020,12664,1155,69,12595,Western Pacific
Libya,25-04-2020,165192,309,1197,163995,Eastern Mediterranean
West Bank and Gaza,25-04-2020,238831,1912,58,238773,Eastern Mediterranean
Guinea-Bissau,25-04-2020,306716,2485,462,306254,Africa
Mali,25-04-2020,51777,1162,879,50898,Africa
Saint Kitts and Nevis,25-04-2020,439762,1398,356,439406,Americas
Canada,25-04-2020,119541,1193,859,118682,Americas
Canada,25-04-2020,71489,569,346,71143,Americas
Kosovo,25-04-2020,332454,1301,732,331722,Europe
Burma,25-04-2020,414985,154,519,414466,South-East Asia
United Kingdom,25-04-2020,144396,2156,536,143860,Europe
United Kingdom,25-04-2020,92904,2210,1081,91823,Europe
United Kingdom,25-04-2020,186332,1804,597,185735,Europe
Botswana,25-04-2020,244319,1761,819,243500,Africa
Burundi,25-04-2020,321482,2055,89,321393,Africa
Sierra Leone,25-04-2020,7852,2206,1074,6778,Africa
Malawi,25-04-2020,371006,1764,1096,369910,Africa
United Kingdom,25-04-2020,117317,1675,1242,116075,Europe
France,25-04-2020,132717,1730,853,131864,Europe
South Sudan,25-04-2020,73330,1426,97,73233,Africa
Western Sahara,25-04-2020,280031,1684,693,279338,Africa
Sao Tome and Principe,25-04-2020,405705,2104,1188,404517,Africa
Yemen,25-04-2020,253791,2409,753,253038,Eastern Mediterranean
Comoros,25-04-2020,365654,1744,1223,364431,Africa
Tajikistan,25-04-2020,143321,172,109,143212,Europe
Lesotho,25-04-2020,254744,2491,1049,253695,Africa
Afghanistan,26-04-2020,258323,616,938,257385,Eastern Mediterranean
Albania,26-04-2020,21246,2484,475,20771,Europe
Algeria,26-04-2020,398568,1098,1131,397437,Africa
Andorra,26-04-2020,342024,1630,1215,340809,Europe
Angola,26-04-2020,96031,2212,930,95101,Africa
Antigua and Barbuda,26-04-2020,125218,60,1129,124089,Americas
Argentina,26-04-2020,58421,1644,206,58215,Americas
Armenia,26-04-2020,386609,1153,397,386212,Europe
Australia,26-04-2020,353843,2087,1070,352773,Western Pacific
Australia,26-04-2020,397437,50,664,396773,Western Pacific
Australia,26-04-2020,65134,1040,31,65103,Western Pacific
Australia,26-04-2020,150889,868,281,150608,Western Pacific
Australia,26-04-2020,257162,1058,177,256985,Western Pacific
Australia,26-04-2020,341713,1405,861,340852,Western Pacific
Australia,26-04-2020,90546,1699,643,89903,Western Pacific
Australia,26-04-2020,210979,1026,958,210021,Western Pacific
Austria,26-04-2020,354961,297,842,354119,Europe
Azerbaijan,26-04-2020,413293,1073,1092,412201,Europe
Bahamas,26-04-2020,269095,2216,1023,268072,Americas
Bahrain,26-04-2020,43716,1825,414,43302,Eastern Mediterranean
Bangladesh,26-04-2020,337051,2316,963,336088,South-East Asia
Barbados,26-04-2020,145082,1706,131,144951,Americas
Belarus,26-04-2020,406013,1587,799,405214,Europe
Belgium,26-04-2020,151436,1462,818,150618,Europe
Benin,26-04-2020,168492,998,765,167727,Africa
Bhutan,26-04-2020,364686,2383,1054,363632,South-East Asia
Bolivia,26-04-2020,272693,2360,1104,271589,Americas
Bosnia and Herzegovina,26-04-2020,319986,417,1175,318811,Europe
Brazil,26-04-2020,44412,2129,834,43578,Americas
Brunei,26-04-2020,295444,1283,769,294675,Western Pacific
Bulgaria,26-04-2020,6553,950,896,5657,Europe
Burkina Faso,26-04-2020,14640,979,435,14205,Africa
Cabo Verde,26-04-2020,18874,1765,540,18334,Africa
Cambodia,26-04-2020,337727,363,1082,336645,Western Pacific
Cameroon,26-04-2020,3342,704,752,2590,Africa
Canada,26-04-2020,13664,413,269,13395,Americas
Canada,26-04-2020,310846,744,412,310434,Americas
Canada,26-04-2020,382528,1024,82,382446,Americas
Canada,26-04-2020,333353,544,453,332900,Americas
Canada,26-04-2020,213474,88,63,213411,Americas
Canada,26-04-2020,46772,2334,213,46559,Americas
Canada,26-04-2020,238369,2461,710,237659,Americas
Canada,26-04-2020,28155,28,1130,27025,Americas
Canada,26-04-2020,12796,80,561,12235,Americas
Canada,26-04-2020,43036,370,889,42147,Americas
Central African Republic,26-04-2020,226031,156,380,225651,Africa
Chad,26-04-2020,362783,2475,994,361789,Africa
Chile,26-04-2020,383557,1077,1110,382447,Americas
China,26-04-2020,357805,9,1038,356767,Western Pacific
China,26-04-2020,974,1707,930,44,Western Pacific
China,26-04-2020,342168,1805,399,341769,Western Pacific
China,26-04-2020,85331,2047,913,84418,Western Pacific
China,26-04-2020,150031,1672,1247,148784,Western Pacific
China,26-04-2020,421540,230,1119,420421,Western Pacific
China,26-04-2020,129165,1014,326,128839,Western Pacific
China,26-04-2020,131525,566,1218,130307,Western Pacific
China,26-04-2020,376931,1202,730,376201,Western Pacific
China,26-04-2020,203685,37,771,202914,Western Pacific
China,26-04-2020,164170,2145,714,163456,Western Pacific
China,26-04-2020,128380,806,743,127637,Western Pacific
China,26-04-2020,263094,821,419,262675,Western Pacific
China,26-04-2020,384664,1251,441,384223,Western Pacific
China,26-04-2020,121230,324,1247,119983,Western Pacific
China,26-04-2020,49870,902,508,49362,Western Pacific
China,26-04-2020,374023,1108,678,373345,Western Pacific
China,26-04-2020,351054,1241,722,350332,Western Pacific
China,26-04-2020,274634,1879,1127,273507,Western Pacific
China,26-04-2020,170109,2484,447,169662,Western Pacific
China,26-04-2020,16233,1657,863,15370,Western Pacific
China,26-04-2020,143790,122,106,143684,Western Pacific
China,26-04-2020,46918,1208,389,46529,Western Pacific
China,26-04-2020,419106,1550,29,419077,Western Pacific
China,26-04-2020,307684,1859,293,307391,Western Pacific
China,26-04-2020,15310,459,81,15229,Western Pacific
China,26-04-2020,409414,515,1091,408323,Western Pacific
China,26-04-2020,373648,549,1161,372487,Western Pacific
China,26-04-2020,269081,61,1154,267927,Western Pacific
China,26-04-2020,327647,2262,647,327000,Western Pacific
China,26-04-2020,143445,2159,768,142677,Western Pacific
China,26-04-2020,355041,1088,297,354744,Western Pacific
China,26-04-2020,399705,11,81,399624,Western Pacific
Colombia,26-04-2020,308006,1691,86,307920,Americas
Congo (Brazzaville),26-04-2020,183467,1945,147,183320,Africa
Congo (Kinshasa),26-04-2020,360416,1586,172,360244,Africa
Costa Rica,26-04-2020,402244,882,570,401674,Americas
Cote d'Ivoire,26-04-2020,331966,872,312,331654,Africa
Croatia,26-04-2020,438721,2378,901,437820,Europe
Cuba,26-04-2020,314336,554,874,313462,Americas
Cyprus,26-04-2020,247356,85,591,246765,Europe
Czechia,26-04-2020,162665,984,289,162376,Europe
Denmark,26-04-2020,286473,2425,804,285669,Europe
Greenland,26-04-2020,20145,1607,405,19740,Europe
Denmark,26-04-2020,203438,1990,1045,202393,Europe
Djibouti,26-04-2020,417284,1344,203,417081,Eastern Mediterranean
Dominican Republic,26-04-2020,107869,1941,1038,106831,Americas
Ecuador,26-04-2020,418993,1634,484,418509,Americas
Egypt,26-04-2020,176869,89,1149,175720,Eastern Mediterranean
El Salvador,26-04-2020,326286,1959,437,325849,Americas
Equatorial Guinea,26-04-2020,164611,869,172,164439,Africa
Eritrea,26-04-2020,229943,2044,1101,228842,Africa
Estonia,26-04-2020,323672,124,418,323254,Europe
Eswatini,26-04-2020,308274,1897,564,307710,Africa
Ethiopia,26-04-2020,371855,628,75,371780,Africa
Fiji,26-04-2020,167878,235,700,167178,Western Pacific
Finland,26-04-2020,277831,1497,1061,276770,Europe
France,26-04-2020,178675,2433,323,178352,Europe
France,26-04-2020,351291,1397,292,350999,Europe
France,26-04-2020,163930,2383,350,163580,Europe
France,26-04-2020,415749,916,650,415099,Europe
France,26-04-2020,240447,2373,1032,239415,Europe
France,26-04-2020,66650,33,1050,65600,Europe
France,26-04-2020,39491,1428,1087,38404,Europe
France,26-04-2020,191136,1444,1072,190064,Europe
France,26-04-2020,64269,20,765,63504,Europe
France,26-04-2020,64436,87,885,63551,Europe
Gabon,26-04-2020,249406,1343,641,248765,Africa
Gambia,26-04-2020,89185,1418,1059,88126,Africa
Georgia,26-04-2020,205711,929,907,204804,Europe
Germany,26-04-2020,393390,1497,956,392434,Europe
Ghana,26-04-2020,440392,1822,1049,439343,Africa
Greece,26-04-2020,198724,1071,558,198166,Europe
Guatemala,26-04-2020,301621,1206,389,301232,Americas
Guinea,26-04-2020,304689,418,50,304639,Africa
Guyana,26-04-2020,319770,35,129,319641,Americas
Haiti,26-04-2020,43713,1989,104,43609,Americas
Holy See,26-04-2020,183104,1964,306,182798,Europe
Honduras,26-04-2020,278764,497,898,277866,Americas
Hungary,26-04-2020,198021,507,949,197072,Europe
Iceland,26-04-2020,85349,158,987,84362,Europe
India,26-04-2020,50097,992,994,49103,South-East Asia
Indonesia,26-04-2020,32768,1243,554,32214,South-East Asia
Iran,26-04-2020,237716,572,1221,236495,Eastern Mediterranean
Iraq,26-04-2020,310669,1302,927,309742,Eastern Mediterranean
Ireland,26-04-2020,43182,1749,925,42257,Europe
Israel,26-04-2020,427996,1559,700,427296,Europe
Italy,26-04-2020,176564,2085,535,176029,Europe
Jamaica,26-04-2020,67099,169,970,66129,Americas
Japan,26-04-2020,114623,1718,1137,113486,Western Pacific
Jordan,26-04-2020,442290,2500,1044,441246,Eastern Mediterranean
Kazakhstan,26-04-2020,34762,2415,1056,33706,Europe
Kenya,26-04-2020,353839,319,1191,352648,Africa
South Korea,26-04-2020,158407,96,823,157584,Western Pacific
Kuwait,26-04-2020,274061,2410,1044,273017,Eastern Mediterranean
Kyrgyzstan,26-04-2020,318548,1623,614,317934,Europe
Latvia,26-04-2020,64862,136,818,64044,Europe
Lebanon,26-04-2020,50895,1786,390,50505,Eastern Mediterranean
Liberia,26-04-2020,8915,2333,478,8437,Africa
Liechtenstein,26-04-2020,334162,2255,735,333427,Europe
Lithuania,26-04-2020,250484,585,874,249610,Europe
Luxembourg,26-04-2020,191885,1213,1017,190868,Europe
Madagascar,26-04-2020,350564,2486,912,349652,Africa
Malaysia,26-04-2020,396468,412,786,395682,Western Pacific
Maldives,26-04-2020,429787,1320,550,429237,South-East Asia
Malta,26-04-2020,107236,1377,318,106918,Europe
Mauritania,26-04-2020,172042,502,704,171338,Africa
Mauritius,26-04-2020,349318,506,1020,348298,Africa
Mexico,26-04-2020,339776,2033,806,338970,Americas
Moldova,26-04-2020,326561,2098,792,325769,Europe
Monaco,26-04-2020,125556,98,157,125399,Europe
Mongolia,26-04-2020,51268,765,1197,50071,Western Pacific
Montenegro,26-04-2020,341759,531,189,341570,Europe
Morocco,26-04-2020,307591,997,317,307274,Eastern Mediterranean
Namibia,26-04-2020,231294,2054,703,230591,Africa
Nepal,26-04-2020,120157,2266,901,119256,South-East Asia
Netherlands,26-04-2020,350468,2036,192,350276,Europe
Netherlands,26-04-2020,18261,2185,635,17626,Europe
Netherlands,26-04-2020,82192,2143,577,81615,Europe
Netherlands,26-04-2020,143561,1443,795,142766,Europe
New Zealand,26-04-2020,186206,1836,759,185447,Western Pacific
Nicaragua,26-04-2020,361674,1411,524,361150,Americas
Niger,26-04-2020,239936,81,844,239092,Africa
Nigeria,26-04-2020,101616,1693,1234,100382,Africa
North Macedonia,26-04-2020,128967,2304,1112,127855,Europe
Norway,26-04-2020,360956,1600,813,360143,Europe
Oman,26-04-2020,97738,1171,665,97073,Eastern Mediterranean
Pakistan,26-04-2020,224481,1882,1213,223268,Eastern Mediterranean
Panama,26-04-2020,374065,1245,142,373923,Americas
Papua New Guinea,26-04-2020,372917,1853,813,372104,Western Pacific
Paraguay,26-04-2020,240645,621,530,240115,Americas
Peru,26-04-2020,311572,887,510,311062,Americas
Philippines,26-04-2020,436218,1471,497,435721,Western Pacific
Poland,26-04-2020,313254,282,618,312636,Europe
Portugal,26-04-2020,428368,2441,1198,427170,Europe
Qatar,26-04-2020,374018,2140,65,373953,Eastern Mediterranean
Romania,26-04-2020,199173,1334,905,198268,Europe
Russia,26-04-2020,345709,1818,860,344849,Europe
Rwanda,26-04-2020,215442,182,781,214661,Africa
Saint Lucia,26-04-2020,378360,201,919,377441,Americas
Saint Vincent and the Grenadines,26-04-2020,212934,385,311,212623,Americas
San Marino,26-04-2020,230062,1090,390,229672,Europe
Saudi Arabia,26-04-2020,261243,1979,740,260503,Eastern Mediterranean
Senegal,26-04-2020,89619,1615,781,88838,Africa
Serbia,26-04-2020,201498,2335,300,201198,Europe
Seychelles,26-04-2020,431224,2121,722,430502,Africa
Singapore,26-04-2020,286431,2091,21,286410,Western Pacific
Slovakia,26-04-2020,71826,2354,147,71679,Europe
Slovenia,26-04-2020,19709,2476,70,19639,Europe
Somalia,26-04-2020,144446,911,515,143931,Eastern Mediterranean
South Africa,26-04-2020,24983,580,721,24262,Africa
Spain,26-04-2020,232826,1491,1091,231735,Europe
Sri Lanka,26-04-2020,444128,353,601,443527,South-East Asia
Sudan,26-04-2020,431545,2085,166,431379,Eastern Mediterranean
Suriname,26-04-2020,437514,43,593,436921,Americas
Sweden,26-04-2020,271403,1275,1134,270269,Europe
Switzerland,26-04-2020,34339,1925,22,34317,Europe
Taiwan*,26-04-2020,339237,1195,738,338499,Western Pacific
Tanzania,26-04-2020,208092,1044,136,207956,Africa
Thailand,26-04-2020,427878,927,467,427411,South-East Asia
Togo,26-04-2020,286909,2371,1014,285895,Africa
Trinidad and Tobago,26-04-2020,241833,850,324,241509,Americas
Tunisia,26-04-2020,69690,2140,887,68803,Eastern Mediterranean
Turkey,26-04-2020,183054,252,258,182796,Europe
Uganda,26-04-2020,188739,726,922,187817,Africa
Ukraine,26-04-2020,83678,1607,283,83395,Europe
United Arab Emirates,26-04-2020,363423,2314,1237,362186,Eastern Mediterranean
United Kingdom,26-04-2020,306590,1422,317,306273,Europe
United Kingdom,26-04-2020,293929,2414,126,293803,Europe
United Kingdom,26-04-2020,156104,1790,1167,154937,Europe
United Kingdom,26-04-2020,410060,902,252,409808,Europe
United Kingdom,26-04-2020,410608,1799,725,409883,Europe
United Kingdom,26-04-2020,313755,1323,132,313623,Europe
United Kingdom,26-04-2020,407108,1217,867,406241,Europe
Uruguay,26-04-2020,146524,514,76,146448,Americas
US,26-04-2020,377610,1748,237,377373,Americas
Uzbekistan,26-04-2020,192925,1284,300,192625,Europe
Venezuela,26-04-2020,193596,1464,765,192831,Americas
Vietnam,26-04-2020,279356,1002,99,279257,Western Pacific
Zambia,26-04-2020,175802,1217,655,175147,Africa
Zimbabwe,26-04-2020,47528,1454,1028,46500,Africa
Dominica,26-04-2020,333131,233,198,332933,Americas
Grenada,26-04-2020,172067,1275,465,171602,Americas
Mozambique,26-04-2020,299931,1820,1162,298769,Africa
Syria,26-04-2020,113568,1349,994,112574,Eastern Mediterranean
Timor-Leste,26-04-2020,77789,1264,263,77526,South-East Asia
Belize,26-04-2020,29315,1842,587,28728,Americas
Laos,26-04-2020,421975,1855,756,421219,Western Pacific
Libya,26-04-2020,173035,247,982,172053,Eastern Mediterranean
West Bank and Gaza,26-04-2020,59461,1895,218,59243,Eastern Mediterranean
Guinea-Bissau,26-04-2020,299509,1345,970,298539,Africa
Mali,26-04-2020,166776,979,10,166766,Africa
Saint Kitts and Nevis,26-04-2020,182303,411,272,182031,Americas
Canada,26-04-2020,128472,1450,975,127497,Americas
Canada,26-04-2020,328501,417,1140,327361,Americas
Kosovo,26-04-2020,53629,1102,545,53084,Europe
Burma,26-04-2020,116192,1792,561,115631,South-East Asia
United Kingdom,26-04-2020,105667,1447,411,105256,Europe
United Kingdom,26-04-2020,25150,866,284,24866,Europe
United Kingdom,26-04-2020,406032,982,750,405282,Europe
Botswana,26-04-2020,430417,1178,265,430152,Africa
Burundi,26-04-2020,316592,115,545,316047,Africa
Sierra Leone,26-04-2020,306344,881,1020,305324,Africa
Malawi,26-04-2020,223484,988,262,223222,Africa
United Kingdom,26-04-2020,117029,2079,1035,115994,Europe
France,26-04-2020,287623,1287,500,287123,Europe
South Sudan,26-04-2020,361246,1851,829,360417,Africa
Western Sahara,26-04-2020,76576,1605,329,76247,Africa
Sao Tome and Principe,26-04-2020,104515,503,614,103901,Africa
Yemen,26-04-2020,364905,1904,1022,363883,Eastern Mediterranean
Comoros,26-04-2020,200640,804,125,200515,Africa
Tajikistan,26-04-2020,24339,948,854,23485,Europe
Lesotho,26-04-2020,424293,2107,1184,423109,Africa
Afghanistan,27-04-2020,348540,2181,396,348144,Eastern Mediterranean
Albania,27-04-2020,8763,1532,67,8696,Europe
Algeria,27-04-2020,189246,1520,688,188558,Africa
Andorra,27-04-2020,445369,287,602,444767,Europe
Angola,27-04-2020,336303,1604,1000,335303,Africa
Antigua and Barbuda,27-04-2020,81711,891,938,80773,Americas
Argentina,27-04-2020,129051,1909,246,128805,Americas
Armenia,27-04-2020,82824,423,997,81827,Europe
Australia,27-04-2020,130689,1998,1112,129577,Western Pacific
Australia,27-04-2020,286661,2229,1076,285585,Western Pacific
Australia,27-04-2020,243976,1630,299,243677,Western Pacific
Australia,27-04-2020,262456,2216,260,262196,Western Pacific
Australia,27-04-2020,235771,522,389,235382,Western Pacific
Australia,27-04-2020,244252,1142,544,243708,Western Pacific
Australia,27-04-2020,245887,1244,1124,244763,Western Pacific
Australia,27-04-2020,367622,630,524,367098,Western Pacific
Austria,27-04-2020,352374,720,1093,351281,Europe
Azerbaijan,27-04-2020,12701,2255,1201,11500,Europe
Bahamas,27-04-2020,294591,2215,300,294291,Americas
Bahrain,27-04-2020,347996,1728,1210,346786,Eastern Mediterranean
Bangladesh,27-04-2020,59955,141,682,59273,South-East Asia
Barbados,27-04-2020,174835,1688,973,173862,Americas
Belarus,27-04-2020,421511,2364,48,421463,Europe
Belgium,27-04-2020,37865,2297,571,37294,Europe
Benin,27-04-2020,349084,2206,67,349017,Africa
Bhutan,27-04-2020,59104,421,129,58975,South-East Asia
Bolivia,27-04-2020,90699,1688,538,90161,Americas
Bosnia and Herzegovina,27-04-2020,417752,1790,1149,416603,Europe
Brazil,27-04-2020,233414,2032,779,232635,Americas
Brunei,27-04-2020,399306,1279,890,398416,Western Pacific
Bulgaria,27-04-2020,353015,2379,737,352278,Europe
Burkina Faso,27-04-2020,118826,603,357,118469,Africa
Cabo Verde,27-04-2020,67516,2218,464,67052,Africa
Cambodia,27-04-2020,142887,1591,278,142609,Western Pacific
Cameroon,27-04-2020,412526,853,1095,411431,Africa
Canada,27-04-2020,77169,2402,892,76277,Americas
Canada,27-04-2020,92624,569,895,91729,Americas
Canada,27-04-2020,317853,2427,194,317659,Americas
Canada,27-04-2020,121906,1825,95,121811,Americas
Canada,27-04-2020,402591,1001,648,401943,Americas
Canada,27-04-2020,275951,1025,492,275459,Americas
Canada,27-04-2020,137812,2401,124,137688,Americas
Canada,27-04-2020,261490,1491,610,260880,Americas
Canada,27-04-2020,1132,584,257,875,Americas
Canada,27-04-2020,303630,675,473,303157,Americas
Central African Republic,27-04-2020,100292,253,280,100012,Africa
Chad,27-04-2020,183584,422,238,183346,Africa
Chile,27-04-2020,12270,1653,1127,11143,Americas
China,27-04-2020,304220,636,712,303508,Western Pacific
China,27-04-2020,389995,585,566,389429,Western Pacific
China,27-04-2020,400141,821,234,399907,Western Pacific
China,27-04-2020,50446,1577,72,50374,Western Pacific
China,27-04-2020,68769,971,620,68149,Western Pacific
China,27-04-2020,82541,1784,265,82276,Western Pacific
China,27-04-2020,445694,1150,15,445679,Western Pacific
China,27-04-2020,79463,248,477,78986,Western Pacific
China,27-04-2020,444993,4,910,444083,Western Pacific
China,27-04-2020,195553,700,215,195338,Western Pacific
China,27-04-2020,253757,555,156,253601,Western Pacific
China,27-04-2020,48797,1888,430,48367,Western Pacific
China,27-04-2020,305949,598,599,305350,Western Pacific
China,27-04-2020,148102,885,150,147952,Western Pacific
China,27-04-2020,27324,1835,499,26825,Western Pacific
China,27-04-2020,156627,3,997,155630,Western Pacific
China,27-04-2020,170026,1855,235,169791,Western Pacific
China,27-04-2020,215972,2236,480,215492,Western Pacific
China,27-04-2020,131897,2426,931,130966,Western Pacific
China,27-04-2020,309162,232,1070,308092,Western Pacific
China,27-04-2020,277479,1092,943,276536,Western Pacific
China,27-04-2020,251074,1473,390,250684,Western Pacific
China,27-04-2020,224978,1671,722,224256,Western Pacific
China,27-04-2020,426156,651,651,425505,Western Pacific
China,27-04-2020,380277,706,407,379870,Western Pacific
China,27-04-2020,41534,2346,920,40614,Western Pacific
China,27-04-2020,396634,419,984,395650,Western Pacific
China,27-04-2020,34201,2074,855,33346,Western Pacific
China,27-04-2020,181064,2384,522,180542,Western Pacific
China,27-04-2020,279019,1208,1170,277849,Western Pacific
China,27-04-2020,211402,1382,32,211370,Western Pacific
China,27-04-2020,27898,405,1149,26749,Western Pacific
China,27-04-2020,435681,2178,308,435373,Western Pacific
Colombia,27-04-2020,414458,561,624,413834,Americas
Congo (Brazzaville),27-04-2020,302587,1586,91,302496,Africa
Congo (Kinshasa),27-04-2020,105308,100,771,104537,Africa
Costa Rica,27-04-2020,316295,409,619,315676,Americas
Cote d'Ivoire,27-04-2020,219643,109,273,219370,Africa
Croatia,27-04-2020,220793,546,625,220168,Europe
Cuba,27-04-2020,224639,10,178,224461,Americas
Cyprus,27-04-2020,344300,437,950,343350,Europe
Czechia,27-04-2020,299086,594,679,298407,Europe
Denmark,27-04-2020,339852,1559,330,339522,Europe
Greenland,27-04-2020,342185,1033,346,341839,Europe
Denmark,27-04-2020,410737,831,583,410154,Europe
Djibouti,27-04-2020,148569,2207,1097,147472,Eastern Mediterranean
Dominican Republic,27-04-2020,236767,497,281,236486,Americas
Ecuador,27-04-2020,109290,1799,780,108510,Americas
Egypt,27-04-2020,297187,74,415,296772,Eastern Mediterranean
El Salvador,27-04-2020,195358,1140,1125,194233,Americas
Equatorial Guinea,27-04-2020,441799,24,1243,440556,Africa
Eritrea,27-04-2020,275611,1718,1040,274571,Africa
Estonia,27-04-2020,324211,553,43,324168,Europe
Eswatini,27-04-2020,84730,945,387,84343,Africa
Ethiopia,27-04-2020,158615,2090,536,158079,Africa
Fiji,27-04-2020,354219,397,374,353845,Western Pacific
Finland,27-04-2020,259428,1903,289,259139,Europe
France,27-04-2020,335832,1033,29,335803,Europe
France,27-04-2020,226534,137,1098,225436,Europe
France,27-04-2020,186232,1863,1011,185221,Europe
France,27-04-2020,237078,1726,257,236821,Europe
France,27-04-2020,208019,1276,3,208016,Europe
France,27-04-2020,422134,109,933,421201,Europe
France,27-04-2020,325424,2466,405,325019,Europe
France,27-04-2020,36067,1204,387,35680,Europe
France,27-04-2020,133842,546,1206,132636,Europe
France,27-04-2020,338225,395,507,337718,Europe
Gabon,27-04-2020,259478,1917,195,259283,Africa
Gambia,27-04-2020,127500,2480,908,126592,Africa
Georgia,27-04-2020,165818,4,212,165606,Europe
Germany,27-04-2020,20230,556,1074,19156,Europe
Ghana,27-04-2020,199489,470,600,198889,Africa
Greece,27-04-2020,233693,328,812,232881,Europe
Guatemala,27-04-2020,94731,1921,937,93794,Americas
Guinea,27-04-2020,415144,684,839,414305,Africa
Guyana,27-04-2020,20868,1133,420,20448,Americas
Haiti,27-04-2020,92480,1455,1184,91296,Americas
Holy See,27-04-2020,142890,2369,816,142074,Europe
Honduras,27-04-2020,249617,1995,284,249333,Americas
Hungary,27-04-2020,435949,2334,554,435395,Europe
Iceland,27-04-2020,100677,1538,239,100438,Europe
India,27-04-2020,328496,281,996,327500,South-East Asia
Indonesia,27-04-2020,306051,583,87,305964,South-East Asia
Iran,27-04-2020,338574,2047,89,338485,Eastern Mediterranean
Iraq,27-04-2020,391625,1920,71,391554,Eastern Mediterranean
Ireland,27-04-2020,311239,557,747,310492,Europe
Israel,27-04-2020,388589,529,266,388323,Europe
Italy,27-04-2020,378856,1078,974,377882,Europe
Jamaica,27-04-2020,278963,1374,441,278522,Americas
Japan,27-04-2020,295948,436,357,295591,Western Pacific
Jordan,27-04-2020,114872,2020,250,114622,Eastern Mediterranean
Kazakhstan,27-04-2020,276039,1722,532,275507,Europe
Kenya,27-04-2020,267722,446,1194,266528,Africa
South Korea,27-04-2020,92956,977,211,92745,Western Pacific
Kuwait,27-04-2020,88678,2231,443,88235,Eastern Mediterranean
Kyrgyzstan,27-04-2020,77480,277,147,77333,Europe
Latvia,27-04-2020,91102,1041,1227,89875,Europe
Lebanon,27-04-2020,397401,501,1013,396388,Eastern Mediterranean
Liberia,27-04-2020,111686,1710,1146,110540,Africa
Liechtenstein,27-04-2020,12338,432,355,11983,Europe
Lithuania,27-04-2020,19919,1273,938,18981,Europe
Luxembourg,27-04-2020,135832,946,468,135364,Europe
Madagascar,27-04-2020,128224,2256,746,127478,Africa
Malaysia,27-04-2020,89802,849,246,89556,Western Pacific
Maldives,27-04-2020,18761,897,361,18400,South-East Asia
Malta,27-04-2020,424682,2344,731,423951,Europe
Mauritania,27-04-2020,348701,1262,644,348057,Africa
Mauritius,27-04-2020,216927,11,144,216783,Africa
Mexico,27-04-2020,13589,1043,281,13308,Americas
Moldova,27-04-2020,88711,1963,458,88253,Europe
Monaco,27-04-2020,23561,968,276,23285,Europe
Mongolia,27-04-2020,385873,1773,289,385584,Western Pacific
Montenegro,27-04-2020,54718,58,291,54427,Europe
Morocco,27-04-2020,160713,2415,1174,159539,Eastern Mediterranean
Namibia,27-04-2020,1843,1929,467,1376,Africa
Nepal,27-04-2020,144796,452,112,144684,South-East Asia
Netherlands,27-04-2020,79677,1198,61,79616,Europe
Netherlands,27-04-2020,227037,241,635,226402,Europe
Netherlands,27-04-2020,85821,389,808,85013,Europe
Netherlands,27-04-2020,397679,98,93,397586,Europe
New Zealand,27-04-2020,107194,1285,590,106604,Western Pacific
Nicaragua,27-04-2020,295731,2495,236,295495,Americas
Niger,27-04-2020,298653,484,1059,297594,Africa
Nigeria,27-04-2020,366752,298,82,366670,Africa
North Macedonia,27-04-2020,444732,594,600,444132,Europe
Norway,27-04-2020,247423,146,37,247386,Europe
Oman,27-04-2020,228183,231,909,227274,Eastern Mediterranean
Pakistan,27-04-2020,402881,1028,1055,401826,Eastern Mediterranean
Panama,27-04-2020,409772,1676,865,408907,Americas
Papua New Guinea,27-04-2020,223764,1930,305,223459,Western Pacific
Paraguay,27-04-2020,153696,693,280,153416,Americas
Peru,27-04-2020,145434,1381,418,145016,Americas
Philippines,27-04-2020,176107,786,874,175233,Western Pacific
Poland,27-04-2020,354155,621,793,353362,Europe
Portugal,27-04-2020,45528,715,164,45364,Europe
Qatar,27-04-2020,421246,2219,468,420778,Eastern Mediterranean
Romania,27-04-2020,235139,1772,183,234956,Europe
Russia,27-04-2020,379269,881,758,378511,Europe
Rwanda,27-04-2020,355391,2432,303,355088,Africa
Saint Lucia,27-04-2020,30764,562,1081,29683,Americas
Saint Vincent and the Grenadines,27-04-2020,94639,1845,339,94300,Americas
San Marino,27-04-2020,283386,2342,642,282744,Europe
Saudi Arabia,27-04-2020,212436,1,524,211912,Eastern Mediterranean
Senegal,27-04-2020,221217,2236,793,220424,Africa
Serbia,27-04-2020,383661,66,1230,382431,Europe
Seychelles,27-04-2020,75168,601,239,74929,Africa
Singapore,27-04-2020,52115,1890,60,52055,Western Pacific
Slovakia,27-04-2020,180756,1855,541,180215,Europe
Slovenia,27-04-2020,89930,697,483,89447,Europe
Somalia,27-04-2020,260275,1055,969,259306,Eastern Mediterranean
South Africa,27-04-2020,424317,2108,1134,423183,Africa
Spain,27-04-2020,153713,472,178,153535,Europe
Sri Lanka,27-04-2020,315851,1629,213,315638,South-East Asia
Sudan,27-04-2020,338838,436,652,338186,Eastern Mediterranean
Suriname,27-04-2020,411945,1928,1064,410881,Americas
Sweden,27-04-2020,133549,802,682,132867,Europe
Switzerland,27-04-2020,343989,2444,403,343586,Europe
Taiwan*,27-04-2020,161503,757,802,160701,Western Pacific
Tanzania,27-04-2020,36631,1649,46,36585,Africa
Thailand,27-04-2020,157323,1098,352,156971,South-East Asia
Togo,27-04-2020,241080,867,90,240990,Africa
Trinidad and Tobago,27-04-2020,428692,120,1032,427660,Americas
Tunisia,27-04-2020,433258,1138,646,432612,Eastern Mediterranean
Turkey,27-04-2020,439966,976,562,439404,Europe
Uganda,27-04-2020,362221,638,982,361239,Africa
Ukraine,27-04-2020,334720,657,1024,333696,Europe
United Arab Emirates,27-04-2020,275909,1224,527,275382,Eastern Mediterranean
United Kingdom,27-04-2020,200793,1293,810,199983,Europe
United Kingdom,27-04-2020,203188,2302,47,203141,Europe
United Kingdom,27-04-2020,364091,1536,244,363847,Europe
United Kingdom,27-04-2020,283676,2289,449,283227,Europe
United Kingdom,27-04-2020,214717,2482,1024,213693,Europe
United Kingdom,27-04-2020,356818,1562,801,356017,Europe
United Kingdom,27-04-2020,351199,1352,330,350869,Europe
Uruguay,27-04-2020,278937,2121,1184,277753,Americas
US,27-04-2020,32558,1593,60,32498,Americas
Uzbekistan,27-04-2020,294466,322,187,294279,Europe
Venezuela,27-04-2020,22633,1166,1189,21444,Americas
Vietnam,27-04-2020,207828,2030,736,207092,Western Pacific
Zambia,27-04-2020,276239,1801,902,275337,Africa
Zimbabwe,27-04-2020,14734,1013,1041,13693,Africa
Dominica,27-04-2020,234237,1889,1050,233187,Americas
Grenada,27-04-2020,235667,2340,456,235211,Americas
Mozambique,27-04-2020,5659,1715,532,5127,Africa
Syria,27-04-2020,97032,1256,814,96218,Eastern Mediterranean
Timor-Leste,27-04-2020,303436,1476,1004,302432,South-East Asia
Belize,27-04-2020,368821,2406,769,368052,Americas
Laos,27-04-2020,342553,2147,271,342282,Western Pacific
Libya,27-04-2020,414394,297,514,413880,Eastern Mediterranean
West Bank and Gaza,27-04-2020,295943,2231,831,295112,Eastern Mediterranean
Guinea-Bissau,27-04-2020,390033,1795,567,389466,Africa
Mali,27-04-2020,179940,2034,606,179334,Africa
Saint Kitts and Nevis,27-04-2020,246488,1726,1003,245485,Americas
Canada,27-04-2020,74088,574,1157,72931,Americas
Canada,27-04-2020,439973,1833,1100,438873,Americas
Kosovo,27-04-2020,20947,1329,120,20827,Europe
Burma,27-04-2020,342491,142,1141,341350,South-East Asia
United Kingdom,27-04-2020,154707,198,447,154260,Europe
United Kingdom,27-04-2020,244191,1838,422,243769,Europe
United Kingdom,27-04-2020,165934,2100,519,165415,Europe
Botswana,27-04-2020,307558,2356,6,307552,Africa
Burundi,27-04-2020,278543,2080,759,277784,Africa
Sierra Leone,27-04-2020,371682,346,908,370774,Africa
Malawi,27-04-2020,191499,373,539,190960,Africa
United Kingdom,27-04-2020,135148,714,415,134733,Europe
France,27-04-2020,43636,2149,604,43032,Europe
South Sudan,27-04-2020,319849,1289,512,319337,Africa
Western Sahara,27-04-2020,258747,1096,261,258486,Africa
Sao Tome and Principe,27-04-2020,338872,2258,992,337880,Africa
Yemen,27-04-2020,17539,81,515,17024,Eastern Mediterranean
Comoros,27-04-2020,158558,881,1236,157322,Africa
Tajikistan,27-04-2020,404208,1520,371,403837,Europe
Lesotho,27-04-2020,201264,222,456,200808,Africa
Afghanistan,28-04-2020,120681,1882,460,120221,Eastern Mediterranean
Albania,28-04-2020,344600,1839,114,344486,Europe
Algeria,28-04-2020,292113,1946,1236,290877,Africa
Andorra,28-04-2020,131571,761,1100,130471,Europe
Angola,28-04-2020,40239,2118,396,39843,Africa
Antigua and Barbuda,28-04-2020,297398,969,93,297305,Americas
Argentina,28-04-2020,355508,1310,1119,354389,Americas
Armenia,28-04-2020,315341,1911,625,314716,Europe
Australia,28-04-2020,446083,2189,453,445630,Western Pacific
Australia,28-04-2020,251761,789,721,251040,Western Pacific
Australia,28-04-2020,173277,914,1133,172144,Western Pacific
Australia,28-04-2020,255155,820,573,254582,Western Pacific
Australia,28-04-2020,77540,805,736,76804,Western Pacific
Australia,28-04-2020,195203,1488,102,195101,Western Pacific
Australia,28-04-2020,165489,1019,647,164842,Western Pacific
Australia,28-04-2020,281750,827,80,281670,Western Pacific
Austria,28-04-2020,306276,780,498,305778,Europe
Azerbaijan,28-04-2020,242733,2413,54,242679,Europe
Bahamas,28-04-2020,112530,595,251,112279,Americas
Bahrain,28-04-2020,419595,1923,478,419117,Eastern Mediterranean
Bangladesh,28-04-2020,183619,1698,896,182723,South-East Asia
Barbados,28-04-2020,448705,657,286,448419,Americas
Belarus,28-04-2020,241258,1207,1204,240054,Europe
Belgium,28-04-2020,172267,2425,4,172263,Europe
Benin,28-04-2020,71402,2176,901,70501,Africa
Bhutan,28-04-2020,243260,51,540,242720,South-East Asia
Bolivia,28-04-2020,307169,1045,785,306384,Americas
Bosnia and Herzegovina,28-04-2020,364618,370,592,364026,Europe
Brazil,28-04-2020,69773,2231,549,69224,Americas
Brunei,28-04-2020,333914,2300,530,333384,Western Pacific
Bulgaria,28-04-2020,304283,1272,662,303621,Europe
Burkina Faso,28-04-2020,121737,180,1034,120703,Africa
Cabo Verde,28-04-2020,53127,1357,359,52768,Africa
Cambodia,28-04-2020,86101,1150,122,85979,Western Pacific
Cameroon,28-04-2020,10657,394,105,10552,Africa
Canada,28-04-2020,161527,532,577,160950,Americas
Canada,28-04-2020,54422,58,730,53692,Americas
Canada,28-04-2020,261554,1124,1104,260450,Americas
Canada,28-04-2020,383177,419,599,382578,Americas
Canada,28-04-2020,378782,237,6,378776,Americas
Canada,28-04-2020,270903,714,288,270615,Americas
Canada,28-04-2020,161666,1363,264,161402,Americas
Canada,28-04-2020,16086,1321,742,15344,Americas
Canada,28-04-2020,400390,1578,1088,399302,Americas
Canada,28-04-2020,246060,797,413,245647,Americas
Central African Republic,28-04-2020,378896,1562,877,378019,Africa
Chad,28-04-2020,176093,1040,762,175331,Africa
Chile,28-04-2020,317371,292,301,317070,Americas
China,28-04-2020,365254,2108,767,364487,Western Pacific
China,28-04-2020,167892,434,662,167230,Western Pacific
China,28-04-2020,327188,521,1008,326180,Western Pacific
China,28-04-2020,14229,259,951,13278,Western Pacific
China,28-04-2020,113696,2477,356,113340,Western Pacific
China,28-04-2020,48610,2487,968,47642,Western Pacific
China,28-04-2020,62191,1578,672,61519,Western Pacific
China,28-04-2020,60348,1274,307,60041,Western Pacific
China,28-04-2020,317413,710,479,316934,Western Pacific
China,28-04-2020,403633,1438,403,403230,Western Pacific
China,28-04-2020,262991,1124,48,262943,Western Pacific
China,28-04-2020,110097,60,137,109960,Western Pacific
China,28-04-2020,23719,1368,1207,22512,Western Pacific
China,28-04-2020,401427,912,28,401399,Western Pacific
China,28-04-2020,33204,324,1211,31993,Western Pacific
China,28-04-2020,108234,1551,363,107871,Western Pacific
China,28-04-2020,375048,601,357,374691,Western Pacific
China,28-04-2020,387646,2479,395,387251,Western Pacific
China,28-04-2020,133988,687,830,133158,Western Pacific
China,28-04-2020,409077,139,588,408489,Western Pacific
China,28-04-2020,171787,106,330,171457,Western Pacific
China,28-04-2020,15552,523,943,14609,Western Pacific
China,28-04-2020,356000,864,334,355666,Western Pacific
China,28-04-2020,79779,1154,551,79228,Western Pacific
China,28-04-2020,330544,2402,110,330434,Western Pacific
China,28-04-2020,225938,113,1208,224730,Western Pacific
China,28-04-2020,270667,2463,104,270563,Western Pacific
China,28-04-2020,62974,848,927,62047,Western Pacific
China,28-04-2020,93426,1455,51,93375,Western Pacific
China,28-04-2020,352230,2210,1097,351133,Western Pacific
China,28-04-2020,229156,1938,481,228675,Western Pacific
China,28-04-2020,205003,373,1151,203852,Western Pacific
China,28-04-2020,144721,1169,250,144471,Western Pacific
Colombia,28-04-2020,141181,1204,246,140935,Americas
Congo (Brazzaville),28-04-2020,445853,539,1014,444839,Africa
Congo (Kinshasa),28-04-2020,222443,698,1213,221230,Africa
Costa Rica,28-04-2020,90063,791,582,89481,Americas
Cote d'Ivoire,28-04-2020,359612,739,558,359054,Africa
Croatia,28-04-2020,303252,685,755,302497,Europe
Cuba,28-04-2020,319948,1336,1202,318746,Americas
Cyprus,28-04-2020,385192,501,322,384870,Europe
Czechia,28-04-2020,134710,491,912,133798,Europe
Denmark,28-04-2020,111049,1415,1,111048,Europe
Greenland,28-04-2020,304053,1657,396,303657,Europe
Denmark,28-04-2020,354019,1936,319,353700,Europe
Djibouti,28-04-2020,412592,1712,430,412162,Eastern Mediterranean
Dominican Republic,28-04-2020,20468,184,713,19755,Americas
Ecuador,28-04-2020,434186,1191,8,434178,Americas
Egypt,28-04-2020,428128,1478,69,428059,Eastern Mediterranean
El Salvador,28-04-2020,364564,938,704,363860,Americas
Equatorial Guinea,28-04-2020,72149,683,393,71756,Africa
Eritrea,28-04-2020,428082,595,621,427461,Africa
Estonia,28-04-2020,64755,1983,61,64694,Europe
Eswatini,28-04-2020,175278,2042,655,174623,Africa
Ethiopia,28-04-2020,239620,1566,1049,238571,Africa
Fiji,28-04-2020,16395,666,912,15483,Western Pacific
Finland,28-04-2020,84497,2427,217,84280,Europe
France,28-04-2020,121234,2386,1248,119986,Europe
France,28-04-2020,375057,646,1122,373935,Europe
France,28-04-2020,249898,1697,548,249350,Europe
France,28-04-2020,184792,1439,505,184287,Europe
France,28-04-2020,26249,156,986,25263,Europe
France,28-04-2020,386863,505,1093,385770,Europe
France,28-04-2020,222325,489,1003,221322,Europe
France,28-04-2020,64373,1216,313,64060,Europe
France,28-04-2020,265309,1737,827,264482,Europe
France,28-04-2020,344855,2351,998,343857,Europe
Gabon,28-04-2020,342619,1844,1081,341538,Africa
Gambia,28-04-2020,15970,546,790,15180,Africa
Georgia,28-04-2020,197007,2247,1110,195897,Europe
Germany,28-04-2020,125623,584,438,125185,Europe
Ghana,28-04-2020,235180,1555,1206,233974,Africa
Greece,28-04-2020,44463,235,510,43953,Europe
Guatemala,28-04-2020,157819,1864,854,156965,Americas
Guinea,28-04-2020,228982,2127,122,228860,Africa
Guyana,28-04-2020,102447,1510,1180,101267,Americas
Haiti,28-04-2020,255948,99,751,255197,Americas
Holy See,28-04-2020,122800,2487,680,122120,Europe
Honduras,28-04-2020,418985,1125,236,418749,Americas
Hungary,28-04-2020,439492,1938,663,438829,Europe
Iceland,28-04-2020,126160,2025,1057,125103,Europe
India,28-04-2020,73641,2291,850,72791,South-East Asia
Indonesia,28-04-2020,269638,804,805,268833,South-East Asia
Iran,28-04-2020,217122,1313,159,216963,Eastern Mediterranean
Iraq,28-04-2020,68221,2294,753,67468,Eastern Mediterranean
Ireland,28-04-2020,117864,632,1,117863,Europe
Israel,28-04-2020,153491,981,558,152933,Europe
Italy,28-04-2020,40615,779,446,40169,Europe
Jamaica,28-04-2020,164647,2358,157,164490,Americas
Japan,28-04-2020,402273,138,296,401977,Western Pacific
Jordan,28-04-2020,224149,2431,1220,222929,Eastern Mediterranean
Kazakhstan,28-04-2020,433431,1695,532,432899,Europe
Kenya,28-04-2020,310321,485,138,310183,Africa
South Korea,28-04-2020,234710,775,890,233820,Western Pacific
Kuwait,28-04-2020,120748,1738,239,120509,Eastern Mediterranean
Kyrgyzstan,28-04-2020,262708,1065,244,262464,Europe
Latvia,28-04-2020,357444,2116,1166,356278,Europe
Lebanon,28-04-2020,49638,1877,1100,48538,Eastern Mediterranean
Liberia,28-04-2020,280593,1609,1159,279434,Africa
Liechtenstein,28-04-2020,382589,1422,896,381693,Europe
Lithuania,28-04-2020,49285,1169,337,48948,Europe
Luxembourg,28-04-2020,417976,1244,1215,416761,Europe
Madagascar,28-04-2020,76890,1401,438,76452,Africa
Malaysia,28-04-2020,324007,426,959,323048,Western Pacific
Maldives,28-04-2020,402482,1885,1185,401297,South-East Asia
Malta,28-04-2020,84994,1490,65,84929,Europe
Mauritania,28-04-2020,395991,410,566,395425,Africa
Mauritius,28-04-2020,151195,298,122,151073,Africa
Mexico,28-04-2020,212040,21,890,211150,Americas
Moldova,28-04-2020,167553,984,664,166889,Europe
Monaco,28-04-2020,166672,1993,915,165757,Europe
Mongolia,28-04-2020,371655,1079,106,371549,Western Pacific
Montenegro,28-04-2020,68496,17,1141,67355,Europe
Morocco,28-04-2020,350940,480,1058,349882,Eastern Mediterranean
Namibia,28-04-2020,79820,2168,775,79045,Africa
Nepal,28-04-2020,228450,2046,562,227888,South-East Asia
Netherlands,28-04-2020,203882,196,685,203197,Europe
Netherlands,28-04-2020,181135,2123,892,180243,Europe
Netherlands,28-04-2020,156371,1339,758,155613,Europe
Netherlands,28-04-2020,238063,1095,48,238015,Europe
New Zealand,28-04-2020,24624,1723,958,23666,Western Pacific
Nicaragua,28-04-2020,404526,2420,352,404174,Americas
Niger,28-04-2020,124050,1270,776,123274,Africa
Nigeria,28-04-2020,314243,1114,584,313659,Africa
North Macedonia,28-04-2020,45292,1586,350,44942,Europe
Norway,28-04-2020,48812,1276,1215,47597,Europe
Oman,28-04-2020,263566,341,445,263121,Eastern Mediterranean
Pakistan,28-04-2020,269954,797,67,269887,Eastern Mediterranean
Panama,28-04-2020,260271,135,135,260136,Americas
Papua New Guinea,28-04-2020,330940,644,759,330181,Western Pacific
Paraguay,28-04-2020,30739,2260,1226,29513,Americas
Peru,28-04-2020,358443,2249,264,358179,Americas
Philippines,28-04-2020,271133,1988,909,270224,Western Pacific
Poland,28-04-2020,376266,311,458,375808,Europe
Portugal,28-04-2020,381625,1859,108,381517,Europe
Qatar,28-04-2020,12221,1483,43,12178,Eastern Mediterranean
Romania,28-04-2020,64711,1777,738,63973,Europe
Russia,28-04-2020,228530,1786,1142,227388,Europe
Rwanda,28-04-2020,275,1757,1090,-815,Africa
Saint Lucia,28-04-2020,70473,1757,180,70293,Americas
Saint Vincent and the Grenadines,28-04-2020,199273,1642,99,199174,Americas
San Marino,28-04-2020,223710,798,115,223595,Europe
Saudi Arabia,28-04-2020,25746,974,1041,24705,Eastern Mediterranean
Senegal,28-04-2020,363053,259,1007,362046,Africa
Serbia,28-04-2020,387302,112,987,386315,Europe
Seychelles,28-04-2020,280416,1240,137,280279,Africa
Singapore,28-04-2020,230193,2177,130,230063,Western Pacific
Slovakia,28-04-2020,96473,1286,163,96310,Europe
Slovenia,28-04-2020,215974,151,747,215227,Europe
Somalia,28-04-2020,398924,763,988,397936,Eastern Mediterranean
South Africa,28-04-2020,232207,1899,1098,231109,Africa
Spain,28-04-2020,96621,62,1051,95570,Europe
Sri Lanka,28-04-2020,170496,371,1068,169428,South-East Asia
Sudan,28-04-2020,153583,2437,925,152658,Eastern Mediterranean
Suriname,28-04-2020,146230,1477,1013,145217,Americas
Sweden,28-04-2020,254448,16,1093,253355,Europe
Switzerland,28-04-2020,99882,451,605,99277,Europe
Taiwan*,28-04-2020,183075,2374,302,182773,Western Pacific
Tanzania,28-04-2020,31125,1042,712,30413,Africa
Thailand,28-04-2020,153296,1363,349,152947,South-East Asia
Togo,28-04-2020,193380,493,818,192562,Africa
Trinidad and Tobago,28-04-2020,307349,248,1230,306119,Americas
Tunisia,28-04-2020,357046,2312,981,356065,Eastern Mediterranean
Turkey,28-04-2020,285601,177,1036,284565,Europe
Uganda,28-04-2020,344871,2279,58,344813,Africa
Ukraine,28-04-2020,20150,1460,1204,18946,Europe
United Arab Emirates,28-04-2020,179122,2003,768,178354,Eastern Mediterranean
United Kingdom,28-04-2020,337813,246,973,336840,Europe
United Kingdom,28-04-2020,82451,132,190,82261,Europe
United Kingdom,28-04-2020,114531,1006,577,113954,Europe
United Kingdom,28-04-2020,64894,1247,957,63937,Europe
United Kingdom,28-04-2020,39086,477,1064,38022,Europe
United Kingdom,28-04-2020,407975,753,1042,406933,Europe
United Kingdom,28-04-2020,162473,148,464,162009,Europe
Uruguay,28-04-2020,268605,46,335,268270,Americas
US,28-04-2020,393771,1416,485,393286,Americas
Uzbekistan,28-04-2020,358692,232,1080,357612,Europe
Venezuela,28-04-2020,106234,1841,42,106192,Americas
Vietnam,28-04-2020,256597,1279,705,255892,Western Pacific
Zambia,28-04-2020,305008,2470,954,304054,Africa
Zimbabwe,28-04-2020,194462,2131,9,194453,Africa
Dominica,28-04-2020,235213,2124,1099,234114,Americas
Grenada,28-04-2020,389490,1738,135,389355,Americas
Mozambique,28-04-2020,32551,1439,1005,31546,Africa
Syria,28-04-2020,390002,2021,634,389368,Eastern Mediterranean
Timor-Leste,28-04-2020,323306,2281,355,322951,South-East Asia
Belize,28-04-2020,181460,483,55,181405,Americas
Laos,28-04-2020,356262,1986,881,355381,Western Pacific
Libya,28-04-2020,399576,1935,604,398972,Eastern Mediterranean
West Bank and Gaza,28-04-2020,365860,440,257,365603,Eastern Mediterranean
Guinea-Bissau,28-04-2020,227676,1781,312,227364,Africa
Mali,28-04-2020,61954,767,95,61859,Africa
Saint Kitts and Nevis,28-04-2020,285980,1915,512,285468,Americas
Canada,28-04-2020,295700,1758,7,295693,Americas
Canada,28-04-2020,48794,1474,355,48439,Americas
Kosovo,28-04-2020,386444,815,133,386311,Europe
Burma,28-04-2020,13322,2208,69,13253,South-East Asia
United Kingdom,28-04-2020,103359,1867,887,102472,Europe
United Kingdom,28-04-2020,199182,1257,94,199088,Europe
United Kingdom,28-04-2020,380209,64,462,379747,Europe
Botswana,28-04-2020,158161,1483,293,157868,Africa
Burundi,28-04-2020,130523,2391,38,130485,Africa
Sierra Leone,28-04-2020,344180,646,745,343435,Africa
Malawi,28-04-2020,223530,1697,1018,222512,Africa
United Kingdom,28-04-2020,368052,1933,120,367932,Europe
France,28-04-2020,171314,1847,1215,170099,Europe
South Sudan,28-04-2020,213462,2333,1192,212270,Africa
Western Sahara,28-04-2020,257036,175,953,256083,Africa
Sao Tome and Principe,28-04-2020,151591,1631,1234,150357,Africa
Yemen,28-04-2020,211092,1124,918,210174,Eastern Mediterranean
Comoros,28-04-2020,329590,1463,472,329118,Africa
Tajikistan,28-04-2020,94795,2278,129,94666,Europe
Lesotho,28-04-2020,218043,502,153,217890,Africa
Afghanistan,29-04-2020,37158,2315,246,36912,Eastern Mediterranean
Albania,29-04-2020,121363,663,566,120797,Europe
Algeria,29-04-2020,64039,2269,1177,62862,Africa
Andorra,29-04-2020,321426,501,890,320536,Europe
Angola,29-04-2020,279715,862,832,278883,Africa
Antigua and Barbuda,29-04-2020,398261,2248,268,397993,Americas
Argentina,29-04-2020,57714,694,256,57458,Americas
Armenia,29-04-2020,164510,942,331,164179,Europe
Australia,29-04-2020,168577,1062,353,168224,Western Pacific
Australia,29-04-2020,144461,1508,216,144245,Western Pacific
Australia,29-04-2020,327982,655,159,327823,Western Pacific
Australia,29-04-2020,415406,588,1024,414382,Western Pacific
Australia,29-04-2020,212870,2251,974,211896,Western Pacific
Australia,29-04-2020,13580,917,1119,12461,Western Pacific
Australia,29-04-2020,32127,2325,284,31843,Western Pacific
Australia,29-04-2020,332881,2396,75,332806,Western Pacific
Austria,29-04-2020,207774,1449,419,207355,Europe
Azerbaijan,29-04-2020,164502,2231,152,164350,Europe
Bahamas,29-04-2020,288271,987,747,287524,Americas
Bahrain,29-04-2020,206659,863,768,205891,Eastern Mediterranean
Bangladesh,29-04-2020,418370,1495,956,417414,South-East Asia
Barbados,29-04-2020,231520,441,557,230963,Americas
Belarus,29-04-2020,382341,920,673,381668,Europe
Belgium,29-04-2020,427104,385,836,426268,Europe
Benin,29-04-2020,13996,2153,1201,12795,Africa
Bhutan,29-04-2020,41350,1555,817,40533,South-East Asia
Bolivia,29-04-2020,28349,2088,25,28324,Americas
Bosnia and Herzegovina,29-04-2020,387432,1634,221,387211,Europe
Brazil,29-04-2020,216783,2371,982,215801,Americas
Brunei,29-04-2020,55391,1427,1046,54345,Western Pacific
Bulgaria,29-04-2020,299481,1416,963,298518,Europe
Burkina Faso,29-04-2020,279050,545,489,278561,Africa
Cabo Verde,29-04-2020,418389,1164,318,418071,Africa
Cambodia,29-04-2020,252556,128,323,252233,Western Pacific
Cameroon,29-04-2020,227641,1299,631,227010,Africa
Canada,29-04-2020,250146,1153,450,249696,Americas
Canada,29-04-2020,124247,636,1198,123049,Americas
Canada,29-04-2020,274109,106,178,273931,Americas
Canada,29-04-2020,413,2087,645,-232,Americas
Canada,29-04-2020,305878,1965,1242,304636,Americas
Canada,29-04-2020,247704,1938,1019,246685,Americas
Canada,29-04-2020,334529,993,346,334183,Americas
Canada,29-04-2020,115483,1374,604,114879,Americas
Canada,29-04-2020,65870,209,1096,64774,Americas
Canada,29-04-2020,418978,51,1215,417763,Americas
Central African Republic,29-04-2020,124697,2395,400,124297,Africa
Chad,29-04-2020,387470,626,1123,386347,Africa
Chile,29-04-2020,2415,2464,64,2351,Americas
China,29-04-2020,415638,709,101,415537,Western Pacific
China,29-04-2020,267018,1832,705,266313,Western Pacific
China,29-04-2020,69842,671,565,69277,Western Pacific
China,29-04-2020,50001,1092,1147,48854,Western Pacific
China,29-04-2020,319898,2481,951,318947,Western Pacific
China,29-04-2020,309205,262,864,308341,Western Pacific
China,29-04-2020,353577,1759,371,353206,Western Pacific
China,29-04-2020,278731,1508,370,278361,Western Pacific
China,29-04-2020,420535,1449,509,420026,Western Pacific
China,29-04-2020,219187,686,702,218485,Western Pacific
China,29-04-2020,184873,2274,318,184555,Western Pacific
China,29-04-2020,250448,414,358,250090,Western Pacific
China,29-04-2020,79253,106,132,79121,Western Pacific
China,29-04-2020,183641,2236,818,182823,Western Pacific
China,29-04-2020,323676,792,1138,322538,Western Pacific
China,29-04-2020,34717,1592,198,34519,Western Pacific
China,29-04-2020,124539,1636,330,124209,Western Pacific
China,29-04-2020,329321,2030,130,329191,Western Pacific
China,29-04-2020,39988,746,781,39207,Western Pacific
China,29-04-2020,150548,1873,839,149709,Western Pacific
China,29-04-2020,404016,2316,950,403066,Western Pacific
China,29-04-2020,335764,1583,68,335696,Western Pacific
China,29-04-2020,48691,126,719,47972,Western Pacific
China,29-04-2020,35681,1716,1082,34599,Western Pacific
China,29-04-2020,98096,741,30,98066,Western Pacific
China,29-04-2020,167499,1590,422,167077,Western Pacific
China,29-04-2020,321770,310,555,321215,Western Pacific
China,29-04-2020,351561,378,522,351039,Western Pacific
China,29-04-2020,231364,204,901,230463,Western Pacific
China,29-04-2020,148849,2024,289,148560,Western Pacific
China,29-04-2020,236635,2329,637,235998,Western Pacific
China,29-04-2020,201042,137,833,200209,Western Pacific
China,29-04-2020,126522,1920,1164,125358,Western Pacific
Colombia,29-04-2020,168131,1544,752,167379,Americas
Congo (Brazzaville),29-04-2020,429061,678,720,428341,Africa
Congo (Kinshasa),29-04-2020,115632,734,572,115060,Africa
Costa Rica,29-04-2020,277785,2186,828,276957,Americas
Cote d'Ivoire,29-04-2020,408897,2441,998,407899,Africa
Croatia,29-04-2020,251024,67,912,250112,Europe
Cuba,29-04-2020,178994,1363,199,178795,Americas
Cyprus,29-04-2020,120748,1801,632,120116,Europe
Czechia,29-04-2020,427114,844,124,426990,Europe
Denmark,29-04-2020,121320,2484,189,121131,Europe
Greenland,29-04-2020,110167,2182,680,109487,Europe
Denmark,29-04-2020,324588,389,624,323964,Europe
Djibouti,29-04-2020,153773,2070,942,152831,Eastern Mediterranean
Dominican Republic,29-04-2020,244923,533,846,244077,Americas
Ecuador,29-04-2020,262243,2387,400,261843,Americas
Egypt,29-04-2020,32534,2440,405,32129,Eastern Mediterranean
El Salvador,29-04-2020,358202,774,565,357637,Americas
Equatorial Guinea,29-04-2020,232277,517,57,232220,Africa
Eritrea,29-04-2020,84502,178,713,83789,Africa
Estonia,29-04-2020,172048,2122,1204,170844,Europe
Eswatini,29-04-2020,4269,325,744,3525,Africa
Ethiopia,29-04-2020,371474,1398,895,370579,Africa
Fiji,29-04-2020,49451,762,162,49289,Western Pacific
Finland,29-04-2020,194095,1882,576,193519,Europe
France,29-04-2020,28722,1489,871,27851,Europe
France,29-04-2020,258588,2199,793,257795,Europe
France,29-04-2020,241088,1559,765,240323,Europe
France,29-04-2020,203259,886,250,203009,Europe
France,29-04-2020,205679,2334,834,204845,Europe
France,29-04-2020,240119,1596,923,239196,Europe
France,29-04-2020,207648,1516,1037,206611,Europe
France,29-04-2020,29169,1359,649,28520,Europe
France,29-04-2020,72184,2358,307,71877,Europe
France,29-04-2020,446546,1756,616,445930,Europe
Gabon,29-04-2020,178011,35,145,177866,Africa
Gambia,29-04-2020,367341,1946,746,366595,Africa
Georgia,29-04-2020,337296,71,791,336505,Europe
Germany,29-04-2020,10041,1062,168,9873,Europe
Ghana,29-04-2020,322550,360,501,322049,Africa
Greece,29-04-2020,295595,406,1149,294446,Europe
Guatemala,29-04-2020,191544,147,1066,190478,Americas
Guinea,29-04-2020,69452,1421,206,69246,Africa
Guyana,29-04-2020,442833,1554,727,442106,Americas
Haiti,29-04-2020,340630,821,976,339654,Americas
Holy See,29-04-2020,403383,1967,54,403329,Europe
Honduras,29-04-2020,295522,1891,919,294603,Americas
Hungary,29-04-2020,224376,2459,376,224000,Europe
Iceland,29-04-2020,357705,866,852,356853,Europe
India,29-04-2020,167330,290,761,166569,South-East Asia
Indonesia,29-04-2020,398895,226,1043,397852,South-East Asia
Iran,29-04-2020,316223,765,479,315744,Eastern Mediterranean
Iraq,29-04-2020,651,744,706,-55,Eastern Mediterranean
Ireland,29-04-2020,398488,862,197,398291,Europe
Israel,29-04-2020,264462,1562,52,264410,Europe
Italy,29-04-2020,442338,500,933,441405,Europe
Jamaica,29-04-2020,290434,538,51,290383,Americas
Japan,29-04-2020,28971,1721,1032,27939,Western Pacific
Jordan,29-04-2020,101655,717,529,101126,Eastern Mediterranean
Kazakhstan,29-04-2020,109356,98,1011,108345,Europe
Kenya,29-04-2020,119839,776,1071,118768,Africa
South Korea,29-04-2020,283310,1572,697,282613,Western Pacific
Kuwait,29-04-2020,38929,429,1115,37814,Eastern Mediterranean
Kyrgyzstan,29-04-2020,105052,1857,588,104464,Europe
Latvia,29-04-2020,201912,565,907,201005,Europe
Lebanon,29-04-2020,145095,2003,1145,143950,Eastern Mediterranean
Liberia,29-04-2020,220601,70,943,219658,Africa
Liechtenstein,29-04-2020,143460,1692,1013,142447,Europe
Lithuania,29-04-2020,157115,1024,902,156213,Europe
Luxembourg,29-04-2020,362420,1334,421,361999,Europe
Madagascar,29-04-2020,137696,2018,156,137540,Africa
Malaysia,29-04-2020,428054,1592,841,427213,Western Pacific
Maldives,29-04-2020,381776,666,547,381229,South-East Asia
Malta,29-04-2020,169822,416,770,169052,Europe
Mauritania,29-04-2020,201274,1470,103,201171,Africa
Mauritius,29-04-2020,303343,1308,61,303282,Africa
Mexico,29-04-2020,111089,383,611,110478,Americas
Moldova,29-04-2020,86402,479,400,86002,Europe
Monaco,29-04-2020,310823,1711,467,310356,Europe
Mongolia,29-04-2020,423663,2350,800,422863,Western Pacific
Montenegro,29-04-2020,126225,1530,675,125550,Europe
Morocco,29-04-2020,308234,920,996,307238,Eastern Mediterranean
Namibia,29-04-2020,418927,2187,950,417977,Africa
Nepal,29-04-2020,221370,2177,507,220863,South-East Asia
Netherlands,29-04-2020,428284,1689,488,427796,Europe
Netherlands,29-04-2020,440826,406,825,440001,Europe
Netherlands,29-04-2020,154618,1607,7,154611,Europe
Netherlands,29-04-2020,252939,195,175,252764,Europe
New Zealand,29-04-2020,284505,1809,1193,283312,Western Pacific
Nicaragua,29-04-2020,289158,1561,840,288318,Americas
Niger,29-04-2020,365080,1310,6,365074,Africa
Nigeria,29-04-2020,87854,292,1017,86837,Africa
North Macedonia,29-04-2020,259173,1209,43,259130,Europe
Norway,29-04-2020,121149,525,703,120446,Europe
Oman,29-04-2020,80554,1824,972,79582,Eastern Mediterranean
Pakistan,29-04-2020,357666,1892,274,357392,Eastern Mediterranean
Panama,29-04-2020,160017,2346,1118,158899,Americas
Papua New Guinea,29-04-2020,256553,690,1233,255320,Western Pacific
Paraguay,29-04-2020,369783,851,1166,368617,Americas
Peru,29-04-2020,197643,1082,1115,196528,Americas
Philippines,29-04-2020,56536,749,860,55676,Western Pacific
Poland,29-04-2020,116111,607,962,115149,Europe
Portugal,29-04-2020,227251,2078,377,226874,Europe
Qatar,29-04-2020,247899,878,493,247406,Eastern Mediterranean
Romania,29-04-2020,256198,2081,331,255867,Europe
Russia,29-04-2020,146314,622,552,145762,Europe
Rwanda,29-04-2020,283951,268,494,283457,Africa
Saint Lucia,29-04-2020,185237,560,175,185062,Americas
Saint Vincent and the Grenadines,29-04-2020,280280,1490,1024,279256,Americas
San Marino,29-04-2020,254427,538,170,254257,Europe
Saudi Arabia,29-04-2020,19219,593,613,18606,Eastern Mediterranean
Senegal,29-04-2020,238683,379,434,238249,Africa
Serbia,29-04-2020,270319,971,298,270021,Europe
Seychelles,29-04-2020,201334,2050,655,200679,Africa
Singapore,29-04-2020,295694,994,1150,294544,Western Pacific
Slovakia,29-04-2020,51317,249,340,50977,Europe
Slovenia,29-04-2020,273393,2176,463,272930,Europe
Somalia,29-04-2020,415019,886,1014,414005,Eastern Mediterranean
South Africa,29-04-2020,448036,2357,981,447055,Africa
Spain,29-04-2020,232640,2384,1086,231554,Europe
Sri Lanka,29-04-2020,303912,1593,738,303174,South-East Asia
Sudan,29-04-2020,1806,1970,386,1420,Eastern Mediterranean
Suriname,29-04-2020,420379,1400,1002,419377,Americas
Sweden,29-04-2020,2691,1446,829,1862,Europe
Switzerland,29-04-2020,324247,1896,283,323964,Europe
Taiwan*,29-04-2020,52874,882,538,52336,Western Pacific
Tanzania,29-04-2020,25406,1529,747,24659,Africa
Thailand,29-04-2020,195863,1769,453,195410,South-East Asia
Togo,29-04-2020,442876,1658,730,442146,Africa
Trinidad and Tobago,29-04-2020,46648,2287,65,46583,Americas
Tunisia,29-04-2020,283414,1951,373,283041,Eastern Mediterranean
Turkey,29-04-2020,350497,1735,688,349809,Europe
Uganda,29-04-2020,335852,623,637,335215,Africa
Ukraine,29-04-2020,321934,1557,997,320937,Europe
United Arab Emirates,29-04-2020,145793,1414,92,145701,Eastern Mediterranean
United Kingdom,29-04-2020,221651,73,99,221552,Europe
United Kingdom,29-04-2020,274382,920,56,274326,Europe
United Kingdom,29-04-2020,289330,501,444,288886,Europe
United Kingdom,29-04-2020,215153,1526,937,214216,Europe
United Kingdom,29-04-2020,424484,1699,1248,423236,Europe
United Kingdom,29-04-2020,342058,2174,108,341950,Europe
United Kingdom,29-04-2020,393325,1285,991,392334,Europe
Uruguay,29-04-2020,415063,916,444,414619,Americas
US,29-04-2020,416895,2474,892,416003,Americas
Uzbekistan,29-04-2020,395503,1027,712,394791,Europe
Venezuela,29-04-2020,447926,1017,935,446991,Americas
Vietnam,29-04-2020,2281,1090,280,2001,Western Pacific
Zambia,29-04-2020,223073,2321,196,222877,Africa
Zimbabwe,29-04-2020,87689,1844,440,87249,Africa
Dominica,29-04-2020,365324,264,236,365088,Americas
Grenada,29-04-2020,178951,1805,582,178369,Americas
Mozambique,29-04-2020,250792,2059,748,250044,Africa
Syria,29-04-2020,234247,2421,1167,233080,Eastern Mediterranean
Timor-Leste,29-04-2020,428754,2276,183,428571,South-East Asia
Belize,29-04-2020,169916,827,405,169511,Americas
Laos,29-04-2020,227344,1625,1214,226130,Western Pacific
Libya,29-04-2020,422472,1045,953,421519,Eastern Mediterranean
West Bank and Gaza,29-04-2020,160664,1797,676,159988,Eastern Mediterranean
Guinea-Bissau,29-04-2020,37620,1686,146,37474,Africa
Mali,29-04-2020,131642,1298,315,131327,Africa
Saint Kitts and Nevis,29-04-2020,144097,49,1044,143053,Americas
Canada,29-04-2020,75056,1969,1202,73854,Americas
Canada,29-04-2020,443026,1254,435,442591,Americas
Kosovo,29-04-2020,234459,723,764,233695,Europe
Burma,29-04-2020,135779,1984,262,135517,South-East Asia
United Kingdom,29-04-2020,117367,889,793,116574,Europe
United Kingdom,29-04-2020,41323,1342,716,40607,Europe
United Kingdom,29-04-2020,369807,391,1060,368747,Europe
Botswana,29-04-2020,303507,2340,1152,302355,Africa
Burundi,29-04-2020,413156,1072,854,412302,Africa
Sierra Leone,29-04-2020,423917,1401,539,423378,Africa
Malawi,29-04-2020,202526,560,498,202028,Africa
United Kingdom,29-04-2020,323547,2465,92,323455,Europe
France,29-04-2020,275008,1616,189,274819,Europe
South Sudan,29-04-2020,1618,1057,710,908,Africa
Western Sahara,29-04-2020,448619,2067,838,447781,Africa
Sao Tome and Principe,29-04-2020,181967,653,607,181360,Africa
Yemen,29-04-2020,289918,1492,1250,288668,Eastern Mediterranean
Comoros,29-04-2020,249921,1326,363,249558,Africa
Tajikistan,29-04-2020,383891,564,476,383415,Europe
Lesotho,29-04-2020,414445,2494,813,413632,Africa
Afghanistan,30-04-2020,32680,1173,309,32371,Eastern Mediterranean
Albania,30-04-2020,442056,209,332,441724,Europe
Algeria,30-04-2020,356266,1411,868,355398,Africa
Andorra,30-04-2020,446903,2024,1218,445685,Europe
Angola,30-04-2020,229798,2478,195,229603,Africa
Antigua and Barbuda,30-04-2020,293624,1731,133,293491,Americas
Argentina,30-04-2020,409226,1663,358,408868,Americas
Armenia,30-04-2020,203843,1009,384,203459,Europe
Australia,30-04-2020,215265,1472,38,215227,Western Pacific
Australia,30-04-2020,92354,2188,21,92333,Western Pacific
Australia,30-04-2020,288225,1403,1145,287080,Western Pacific
Australia,30-04-2020,347177,377,204,346973,Western Pacific
Australia,30-04-2020,101724,537,843,100881,Western Pacific
Australia,30-04-2020,199760,117,214,199546,Western Pacific
Australia,30-04-2020,142584,1751,1235,141349,Western Pacific
Australia,30-04-2020,187909,181,645,187264,Western Pacific
Austria,30-04-2020,37694,1525,988,36706,Europe
Azerbaijan,30-04-2020,411659,1666,911,410748,Europe
Bahamas,30-04-2020,49322,786,432,48890,Americas
Bahrain,30-04-2020,173147,1446,270,172877,Eastern Mediterranean
Bangladesh,30-04-2020,139555,977,808,138747,South-East Asia
Barbados,30-04-2020,79161,1550,383,78778,Americas
Belarus,30-04-2020,163793,420,13,163780,Europe
Belgium,30-04-2020,122191,1517,1144,121047,Europe
Benin,30-04-2020,275880,1443,888,274992,Africa
Bhutan,30-04-2020,2078,2123,580,1498,South-East Asia
Bolivia,30-04-2020,88113,767,713,87400,Americas
Bosnia and Herzegovina,30-04-2020,233164,1323,716,232448,Europe
Brazil,30-04-2020,32825,2043,784,32041,Americas
Brunei,30-04-2020,50018,664,505,49513,Western Pacific
Bulgaria,30-04-2020,303930,967,2,303928,Europe
Burkina Faso,30-04-2020,219396,1848,427,218969,Africa
Cabo Verde,30-04-2020,159646,1407,347,159299,Africa
Cambodia,30-04-2020,91909,391,1148,90761,Western Pacific
Cameroon,30-04-2020,21824,942,479,21345,Africa
Canada,30-04-2020,431588,2072,696,430892,Americas
Canada,30-04-2020,297831,2039,417,297414,Americas
Canada,30-04-2020,345165,717,1135,344030,Americas
Canada,30-04-2020,373980,1204,569,373411,Americas
Canada,30-04-2020,133425,1131,33,133392,Americas
Canada,30-04-2020,198219,1332,740,197479,Americas
Canada,30-04-2020,167042,2192,248,166794,Americas
Canada,30-04-2020,4205,808,831,3374,Americas
Canada,30-04-2020,295994,282,442,295552,Americas
Canada,30-04-2020,162314,2218,872,161442,Americas
Central African Republic,30-04-2020,17395,1750,962,16433,Africa
Chad,30-04-2020,304746,2188,394,304352,Africa
Chile,30-04-2020,422364,217,626,421738,Americas
China,30-04-2020,363633,1717,668,362965,Western Pacific
China,30-04-2020,358330,1669,854,357476,Western Pacific
China,30-04-2020,364680,1808,28,364652,Western Pacific
China,30-04-2020,398924,1425,315,398609,Western Pacific
China,30-04-2020,437195,2247,911,436284,Western Pacific
China,30-04-2020,213127,1016,1083,212044,Western Pacific
China,30-04-2020,390106,2042,528,389578,Western Pacific
China,30-04-2020,348066,1431,382,347684,Western Pacific
China,30-04-2020,216720,1168,929,215791,Western Pacific
China,30-04-2020,141163,1167,120,141043,Western Pacific
China,30-04-2020,104699,1439,74,104625,Western Pacific
China,30-04-2020,39879,1436,391,39488,Western Pacific
China,30-04-2020,144778,130,732,144046,Western Pacific
China,30-04-2020,332881,1949,721,332160,Western Pacific
China,30-04-2020,149209,133,264,148945,Western Pacific
China,30-04-2020,180133,2461,1033,179100,Western Pacific
China,30-04-2020,210536,1518,81,210455,Western Pacific
China,30-04-2020,302991,898,655,302336,Western Pacific
China,30-04-2020,226110,753,1133,224977,Western Pacific
China,30-04-2020,433038,1012,1158,431880,Western Pacific
China,30-04-2020,137840,978,204,137636,Western Pacific
China,30-04-2020,177116,1340,100,177016,Western Pacific
China,30-04-2020,186148,612,1018,185130,Western Pacific
China,30-04-2020,144235,2063,719,143516,Western Pacific
China,30-04-2020,110105,2364,704,109401,Western Pacific
China,30-04-2020,137443,525,825,136618,Western Pacific
China,30-04-2020,86408,2114,1079,85329,Western Pacific
China,30-04-2020,174807,1357,1077,173730,Western Pacific
China,30-04-2020,178734,2353,1095,177639,Western Pacific
China,30-04-2020,189758,2495,355,189403,Western Pacific
China,30-04-2020,83473,650,391,83082,Western Pacific
China,30-04-2020,249017,1378,80,248937,Western Pacific
China,30-04-2020,157531,1818,956,156575,Western Pacific
Colombia,30-04-2020,87096,1115,287,86809,Americas
Congo (Brazzaville),30-04-2020,339168,2065,702,338466,Africa
Congo (Kinshasa),30-04-2020,340836,1230,658,340178,Africa
Costa Rica,30-04-2020,58624,1318,1066,57558,Americas
Cote d'Ivoire,30-04-2020,270105,107,754,269351,Africa
Croatia,30-04-2020,79976,1836,722,79254,Europe
Cuba,30-04-2020,422063,663,212,421851,Americas
Cyprus,30-04-2020,196717,201,1085,195632,Europe
Czechia,30-04-2020,380679,337,1219,379460,Europe
Denmark,30-04-2020,63509,563,791,62718,Europe
Greenland,30-04-2020,166523,324,451,166072,Europe
Denmark,30-04-2020,443756,1034,1037,442719,Europe
Djibouti,30-04-2020,214274,1555,460,213814,Eastern Mediterranean
Dominican Republic,30-04-2020,172219,1193,1188,171031,Americas
Ecuador,30-04-2020,191095,1991,495,190600,Americas
Egypt,30-04-2020,343067,1714,205,342862,Eastern Mediterranean
El Salvador,30-04-2020,5449,719,358,5091,Americas
Equatorial Guinea,30-04-2020,159663,264,589,159074,Africa
Eritrea,30-04-2020,186360,2032,78,186282,Africa
Estonia,30-04-2020,145555,56,915,144640,Europe
Eswatini,30-04-2020,130229,2446,972,129257,Africa
Ethiopia,30-04-2020,335092,940,883,334209,Africa
Fiji,30-04-2020,388383,2422,1053,387330,Western Pacific
Finland,30-04-2020,76225,501,270,75955,Europe
France,30-04-2020,433811,2421,597,433214,Europe
France,30-04-2020,371906,43,1067,370839,Europe
France,30-04-2020,279340,2088,515,278825,Europe
France,30-04-2020,83199,180,618,82581,Europe
France,30-04-2020,154815,2014,844,153971,Europe
France,30-04-2020,431994,2038,144,431850,Europe
France,30-04-2020,80876,2078,84,80792,Europe
France,30-04-2020,400846,1155,282,400564,Europe
France,30-04-2020,60108,656,430,59678,Europe
France,30-04-2020,442818,850,1235,441583,Europe
Gabon,30-04-2020,140428,1501,461,139967,Africa
Gambia,30-04-2020,228803,1724,304,228499,Africa
Georgia,30-04-2020,283103,83,515,282588,Europe
Germany,30-04-2020,82583,1649,821,81762,Europe
Ghana,30-04-2020,190356,859,992,189364,Africa
Greece,30-04-2020,201717,942,755,200962,Europe
Guatemala,30-04-2020,137288,1856,1005,136283,Americas
Guinea,30-04-2020,261872,733,640,261232,Africa
Guyana,30-04-2020,86013,868,733,85280,Americas
Haiti,30-04-2020,142391,2029,1088,141303,Americas
Holy See,30-04-2020,85443,621,177,85266,Europe
Honduras,30-04-2020,270891,413,104,270787,Americas
Hungary,30-04-2020,180940,2423,412,180528,Europe
Iceland,30-04-2020,184788,2416,718,184070,Europe
India,30-04-2020,16361,464,648,15713,South-East Asia
Indonesia,30-04-2020,149990,539,964,149026,South-East Asia
Iran,30-04-2020,23544,1687,395,23149,Eastern Mediterranean
Iraq,30-04-2020,215881,1507,341,215540,Eastern Mediterranean
Ireland,30-04-2020,221097,564,862,220235,Europe
Israel,30-04-2020,60852,191,693,60159,Europe
Italy,30-04-2020,149050,1213,112,148938,Europe
Jamaica,30-04-2020,55841,517,256,55585,Americas
Japan,30-04-2020,146083,2170,668,145415,Western Pacific
Jordan,30-04-2020,130312,281,545,129767,Eastern Mediterranean
Kazakhstan,30-04-2020,417859,2040,556,417303,Europe
Kenya,30-04-2020,92582,2365,541,92041,Africa
South Korea,30-04-2020,126536,1000,1150,125386,Western Pacific
Kuwait,30-04-2020,412611,2178,241,412370,Eastern Mediterranean
Kyrgyzstan,30-04-2020,58433,683,794,57639,Europe
Latvia,30-04-2020,82930,1828,9,82921,Europe
Lebanon,30-04-2020,205678,976,83,205595,Eastern Mediterranean
Liberia,30-04-2020,204331,2296,465,203866,Africa
Liechtenstein,30-04-2020,308737,1106,866,307871,Europe
Lithuania,30-04-2020,104955,1534,966,103989,Europe
Luxembourg,30-04-2020,205841,1488,932,204909,Europe
Madagascar,30-04-2020,271845,1328,162,271683,Africa
Malaysia,30-04-2020,318351,1537,1048,317303,Western Pacific
Maldives,30-04-2020,347783,416,804,346979,South-East Asia
Malta,30-04-2020,315813,2176,993,314820,Europe
Mauritania,30-04-2020,324569,197,556,324013,Africa
Mauritius,30-04-2020,193828,1045,301,193527,Africa
Mexico,30-04-2020,214478,1442,1047,213431,Americas
Moldova,30-04-2020,222453,896,1095,221358,Europe
Monaco,30-04-2020,178380,1221,1197,177183,Europe
Mongolia,30-04-2020,544,2143,333,211,Western Pacific
Montenegro,30-04-2020,379084,2131,906,378178,Europe
Morocco,30-04-2020,386638,1819,121,386517,Eastern Mediterranean
Namibia,30-04-2020,359513,1415,422,359091,Africa
Nepal,30-04-2020,218232,9,123,218109,South-East Asia
Netherlands,30-04-2020,157947,2043,124,157823,Europe
Netherlands,30-04-2020,78580,582,1132,77448,Europe
Netherlands,30-04-2020,365366,625,59,365307,Europe
Netherlands,30-04-2020,161854,316,248,161606,Europe
New Zealand,30-04-2020,286102,962,709,285393,Western Pacific
Nicaragua,30-04-2020,428718,223,3,428715,Americas
Niger,30-04-2020,364694,194,322,364372,Africa
Nigeria,30-04-2020,380302,735,929,379373,Africa
North Macedonia,30-04-2020,156718,624,874,155844,Europe
Norway,30-04-2020,185883,2215,1031,184852,Europe
Oman,30-04-2020,388834,189,1009,387825,Eastern Mediterranean
Pakistan,30-04-2020,215888,1017,817,215071,Eastern Mediterranean
Panama,30-04-2020,226888,1602,233,226655,Americas
Papua New Guinea,30-04-2020,238486,1990,324,238162,Western Pacific
Paraguay,30-04-2020,333432,1472,940,332492,Americas
Peru,30-04-2020,342078,244,998,341080,Americas
Philippines,30-04-2020,258089,1866,1070,257019,Western Pacific
Poland,30-04-2020,306742,560,94,306648,Europe
Portugal,30-04-2020,365656,855,738,364918,Europe
Qatar,30-04-2020,8144,216,131,8013,Eastern Mediterranean
Romania,30-04-2020,236510,867,322,236188,Europe
Russia,30-04-2020,122061,61,190,121871,Europe
Rwanda,30-04-2020,94848,1118,775,94073,Africa
Saint Lucia,30-04-2020,247250,2183,30,247220,Americas
Saint Vincent and the Grenadines,30-04-2020,58385,2321,323,58062,Americas
San Marino,30-04-2020,317349,404,334,317015,Europe
Saudi Arabia,30-04-2020,269993,2286,1073,268920,Eastern Mediterranean
Senegal,30-04-2020,46756,1191,768,45988,Africa
Serbia,30-04-2020,330756,537,378,330378,Europe
Seychelles,30-04-2020,314408,2454,816,313592,Africa
Singapore,30-04-2020,333788,214,155,333633,Western Pacific
Slovakia,30-04-2020,435690,1258,702,434988,Europe
Slovenia,30-04-2020,380663,1284,206,380457,Europe
Somalia,30-04-2020,74962,1586,487,74475,Eastern Mediterranean
South Africa,30-04-2020,203014,40,13,203001,Africa
Spain,30-04-2020,300905,138,13,300892,Europe
Sri Lanka,30-04-2020,105851,89,889,104962,South-East Asia
Sudan,30-04-2020,348623,1415,76,348547,Eastern Mediterranean
Suriname,30-04-2020,174289,15,463,173826,Americas
Sweden,30-04-2020,317373,16,1049,316324,Europe
Switzerland,30-04-2020,358927,1876,1108,357819,Europe
Taiwan*,30-04-2020,427994,2463,360,427634,Western Pacific
Tanzania,30-04-2020,374136,398,1091,373045,Africa
Thailand,30-04-2020,411214,2466,587,410627,South-East Asia
Togo,30-04-2020,31873,130,68,31805,Africa
Trinidad and Tobago,30-04-2020,397793,820,161,397632,Americas
Tunisia,30-04-2020,10464,2088,99,10365,Eastern Mediterranean
Turkey,30-04-2020,22013,1890,1115,20898,Europe
Uganda,30-04-2020,190354,446,964,189390,Africa
Ukraine,30-04-2020,6847,1635,145,6702,Europe
United Arab Emirates,30-04-2020,334484,27,197,334287,Eastern Mediterranean
United Kingdom,30-04-2020,405361,1914,202,405159,Europe
United Kingdom,30-04-2020,4032,2351,993,3039,Europe
United Kingdom,30-04-2020,333202,481,192,333010,Europe
United Kingdom,30-04-2020,231443,1011,575,230868,Europe
United Kingdom,30-04-2020,428667,1576,1014,427653,Europe
United Kingdom,30-04-2020,334139,427,389,333750,Europe
United Kingdom,30-04-2020,391720,600,780,390940,Europe
Uruguay,30-04-2020,330001,2046,22,329979,Americas
US,30-04-2020,401835,328,392,401443,Americas
Uzbekistan,30-04-2020,248859,87,82,248777,Europe
Venezuela,30-04-2020,279598,1089,226,279372,Americas
Vietnam,30-04-2020,177268,2389,870,176398,Western Pacific
Zambia,30-04-2020,88100,1333,317,87783,Africa
Zimbabwe,30-04-2020,415099,1588,1091,414008,Africa
Dominica,30-04-2020,206577,6,675,205902,Americas
Grenada,30-04-2020,445129,2159,445,444684,Americas
Mozambique,30-04-2020,395208,1212,766,394442,Africa
Syria,30-04-2020,311977,1754,1176,310801,Eastern Mediterranean
Timor-Leste,30-04-2020,374803,282,1199,373604,South-East Asia
Belize,30-04-2020,412909,1497,407,412502,Americas
Laos,30-04-2020,259688,2471,873,258815,Western Pacific
Libya,30-04-2020,11425,604,439,10986,Eastern Mediterranean
West Bank and Gaza,30-04-2020,350077,1240,511,349566,Eastern Mediterranean
Guinea-Bissau,30-04-2020,603,1241,1159,-556,Africa
Mali,30-04-2020,377226,1885,978,376248,Africa
Saint Kitts and Nevis,30-04-2020,163369,455,1021,162348,Americas
Canada,30-04-2020,166753,2343,1074,165679,Americas
Canada,30-04-2020,185865,845,1078,184787,Americas
Kosovo,30-04-2020,301289,98,911,300378,Europe
Burma,30-04-2020,64586,150,539,64047,South-East Asia
United Kingdom,30-04-2020,405226,1698,688,404538,Europe
United Kingdom,30-04-2020,152587,2119,414,152173,Europe
United Kingdom,30-04-2020,263015,2318,658,262357,Europe
Botswana,30-04-2020,424430,1570,425,424005,Africa
Burundi,30-04-2020,142238,1462,655,141583,Africa
Sierra Leone,30-04-2020,440285,27,338,439947,Africa
Malawi,30-04-2020,351626,1816,81,351545,Africa
United Kingdom,30-04-2020,217608,1230,761,216847,Europe
France,30-04-2020,77797,720,462,77335,Europe
South Sudan,30-04-2020,446231,1805,826,445405,Africa
Western Sahara,30-04-2020,52009,828,941,51068,Africa
Sao Tome and Principe,30-04-2020,195621,1304,506,195115,Africa
Yemen,30-04-2020,287710,687,103,287607,Eastern Mediterranean
Comoros,30-04-2020,285056,908,1163,283893,Africa
Tajikistan,30-04-2020,377153,1537,5,377148,Europe
Lesotho,30-04-2020,80634,1660,1183,79451,Africa
Afghanistan,01-05-2020,219985,535,872,219113,Eastern Mediterranean
Albania,01-05-2020,389452,1172,1027,388425,Europe
Algeria,01-05-2020,73248,1431,108,73140,Africa
Andorra,01-05-2020,444412,204,1124,443288,Europe
Angola,01-05-2020,350371,2118,234,350137,Africa
Antigua and Barbuda,01-05-2020,364143,1035,125,364018,Americas
Argentina,01-05-2020,332131,1461,370,331761,Americas
Armenia,01-05-2020,424322,1187,153,424169,Europe
Australia,01-05-2020,98317,745,767,97550,Western Pacific
Australia,01-05-2020,380431,1938,966,379465,Western Pacific
Australia,01-05-2020,294196,706,421,293775,Western Pacific
Australia,01-05-2020,9811,2030,179,9632,Western Pacific
Australia,01-05-2020,360595,549,1154,359441,Western Pacific
Australia,01-05-2020,129767,1910,1194,128573,Western Pacific
Australia,01-05-2020,86518,1399,874,85644,Western Pacific
Australia,01-05-2020,394136,434,79,394057,Western Pacific
Austria,01-05-2020,199425,2326,982,198443,Europe
Azerbaijan,01-05-2020,158466,623,1058,157408,Europe
Bahamas,01-05-2020,202627,1019,718,201909,Americas
Bahrain,01-05-2020,252213,196,1126,251087,Eastern Mediterranean
Bangladesh,01-05-2020,95092,827,1137,93955,South-East Asia
Barbados,01-05-2020,173650,1987,89,173561,Americas
Belarus,01-05-2020,134000,949,361,133639,Europe
Belgium,01-05-2020,119492,1131,869,118623,Europe
Benin,01-05-2020,439413,2429,1051,438362,Africa
Bhutan,01-05-2020,112454,1991,105,112349,South-East Asia
Bolivia,01-05-2020,416246,1553,917,415329,Americas
Bosnia and Herzegovina,01-05-2020,44367,1769,240,44127,Europe
Brazil,01-05-2020,195167,1617,438,194729,Americas
Brunei,01-05-2020,172134,1430,551,171583,Western Pacific
Bulgaria,01-05-2020,405242,2219,1191,404051,Europe
Burkina Faso,01-05-2020,63957,1214,463,63494,Africa
Cabo Verde,01-05-2020,60460,1232,190,60270,Africa
Cambodia,01-05-2020,28646,98,236,28410,Western Pacific
Cameroon,01-05-2020,399633,1396,69,399564,Africa
Canada,01-05-2020,264714,1642,894,263820,Americas
Canada,01-05-2020,223808,2450,795,223013,Americas
Canada,01-05-2020,216870,719,1093,215777,Americas
Canada,01-05-2020,115385,115,1202,114183,Americas
Canada,01-05-2020,27226,433,1006,26220,Americas
Canada,01-05-2020,84457,1728,138,84319,Americas
Canada,01-05-2020,350362,1950,494,349868,Americas
Canada,01-05-2020,301863,1849,1014,300849,Americas
Canada,01-05-2020,294412,1631,224,294188,Americas
Canada,01-05-2020,406730,1794,776,405954,Americas
Central African Republic,01-05-2020,407901,651,1059,406842,Africa
Chad,01-05-2020,278357,1058,587,277770,Africa
Chile,01-05-2020,390825,118,187,390638,Americas
China,01-05-2020,223529,504,922,222607,Western Pacific
China,01-05-2020,368439,1178,588,367851,Western Pacific
China,01-05-2020,54446,1331,66,54380,Western Pacific
China,01-05-2020,396334,2319,613,395721,Western Pacific
China,01-05-2020,271788,1238,97,271691,Western Pacific
China,01-05-2020,211284,2489,778,210506,Western Pacific
China,01-05-2020,211971,544,665,211306,Western Pacific
China,01-05-2020,395847,1675,476,395371,Western Pacific
China,01-05-2020,349276,1090,735,348541,Western Pacific
China,01-05-2020,147798,2003,915,146883,Western Pacific
China,01-05-2020,224159,310,1005,223154,Western Pacific
China,01-05-2020,333944,952,694,333250,Western Pacific
China,01-05-2020,241036,1992,986,240050,Western Pacific
China,01-05-2020,61115,196,547,60568,Western Pacific
China,01-05-2020,251902,1827,745,251157,Western Pacific
China,01-05-2020,96489,66,600,95889,Western Pacific
China,01-05-2020,209853,1631,944,208909,Western Pacific
China,01-05-2020,290439,1332,109,290330,Western Pacific
China,01-05-2020,47566,1821,148,47418,Western Pacific
China,01-05-2020,356688,2128,559,356129,Western Pacific
China,01-05-2020,206643,814,208,206435,Western Pacific
China,01-05-2020,82129,1883,411,81718,Western Pacific
China,01-05-2020,199216,1664,553,198663,Western Pacific
China,01-05-2020,166775,127,1141,165634,Western Pacific
China,01-05-2020,52685,1407,49,52636,Western Pacific
China,01-05-2020,445379,1222,42,445337,Western Pacific
China,01-05-2020,106166,79,866,105300,Western Pacific
China,01-05-2020,203438,1264,481,202957,Western Pacific
China,01-05-2020,362942,311,1157,361785,Western Pacific
China,01-05-2020,260861,1608,981,259880,Western Pacific
China,01-05-2020,214558,117,540,214018,Western Pacific
China,01-05-2020,321974,1634,64,321910,Western Pacific
China,01-05-2020,322732,1207,738,321994,Western Pacific
Colombia,01-05-2020,12700,128,977,11723,Americas
Congo (Brazzaville),01-05-2020,399473,1180,557,398916,Africa
Congo (Kinshasa),01-05-2020,246441,1484,741,245700,Africa
Costa Rica,01-05-2020,280485,849,1218,279267,Americas
Cote d'Ivoire,01-05-2020,148205,2307,59,148146,Africa
Croatia,01-05-2020,7265,165,858,6407,Europe
Cuba,01-05-2020,101612,388,265,101347,Americas
Cyprus,01-05-2020,102648,1170,684,101964,Europe
Czechia,01-05-2020,409298,198,757,408541,Europe
Denmark,01-05-2020,57006,5,196,56810,Europe
Greenland,01-05-2020,159460,1604,216,159244,Europe
Denmark,01-05-2020,441080,1025,481,440599,Europe
Djibouti,01-05-2020,272777,1723,20,272757,Eastern Mediterranean
Dominican Republic,01-05-2020,101111,2401,756,100355,Americas
Ecuador,01-05-2020,43504,1701,967,42537,Americas
Egypt,01-05-2020,220153,2001,636,219517,Eastern Mediterranean
El Salvador,01-05-2020,354469,1747,240,354229,Americas
Equatorial Guinea,01-05-2020,362119,246,1037,361082,Africa
Eritrea,01-05-2020,342733,1704,505,342228,Africa
Estonia,01-05-2020,311403,1766,592,310811,Europe
Eswatini,01-05-2020,182785,659,481,182304,Africa
Ethiopia,01-05-2020,297299,113,197,297102,Africa
Fiji,01-05-2020,143055,1491,639,142416,Western Pacific
Finland,01-05-2020,170533,1922,1207,169326,Europe
France,01-05-2020,414296,2403,317,413979,Europe
France,01-05-2020,19487,230,43,19444,Europe
France,01-05-2020,74264,408,153,74111,Europe
France,01-05-2020,120849,230,931,119918,Europe
France,01-05-2020,9887,38,59,9828,Europe
France,01-05-2020,449721,587,170,449551,Europe
France,01-05-2020,68231,1449,791,67440,Europe
France,01-05-2020,233525,501,232,233293,Europe
France,01-05-2020,81734,841,455,81279,Europe
France,01-05-2020,2480,91,317,2163,Europe
Gabon,01-05-2020,166255,430,1127,165128,Africa
Gambia,01-05-2020,138504,424,543,137961,Africa
Georgia,01-05-2020,174422,2231,652,173770,Europe
Germany,01-05-2020,236254,1775,1078,235176,Europe
Ghana,01-05-2020,82343,2444,34,82309,Africa
Greece,01-05-2020,361038,1706,1174,359864,Europe
Guatemala,01-05-2020,66250,1966,556,65694,Americas
Guinea,01-05-2020,23096,1585,766,22330,Africa
Guyana,01-05-2020,320831,42,973,319858,Americas
Haiti,01-05-2020,152951,2235,571,152380,Americas
Holy See,01-05-2020,308427,1381,1247,307180,Europe
Honduras,01-05-2020,47075,2113,25,47050,Americas
Hungary,01-05-2020,190445,2101,1225,189220,Europe
Iceland,01-05-2020,22417,89,396,22021,Europe
India,01-05-2020,167613,50,924,166689,South-East Asia
Indonesia,01-05-2020,290179,370,16,290163,South-East Asia
Iran,01-05-2020,123187,416,877,122310,Eastern Mediterranean
Iraq,01-05-2020,374406,2227,883,373523,Eastern Mediterranean
Ireland,01-05-2020,183263,2416,828,182435,Europe
Israel,01-05-2020,145448,642,105,145343,Europe
Italy,01-05-2020,426370,603,719,425651,Europe
Jamaica,01-05-2020,436356,2200,426,435930,Americas
Japan,01-05-2020,309693,2047,1089,308604,Western Pacific
Jordan,01-05-2020,245078,1932,1081,243997,Eastern Mediterranean
Kazakhstan,01-05-2020,107000,1457,1210,105790,Europe
Kenya,01-05-2020,375317,911,705,374612,Africa
South Korea,01-05-2020,379162,851,824,378338,Western Pacific
Kuwait,01-05-2020,88861,178,507,88354,Eastern Mediterranean
Kyrgyzstan,01-05-2020,22122,901,1175,20947,Europe
Latvia,01-05-2020,304787,981,901,303886,Europe
Lebanon,01-05-2020,297521,884,45,297476,Eastern Mediterranean
Liberia,01-05-2020,335072,1187,799,334273,Africa
Liechtenstein,01-05-2020,247007,1628,503,246504,Europe
Lithuania,01-05-2020,32121,489,1115,31006,Europe
Luxembourg,01-05-2020,53468,2403,942,52526,Europe
Madagascar,01-05-2020,303654,964,647,303007,Africa
Malaysia,01-05-2020,310489,1399,632,309857,Western Pacific
Maldives,01-05-2020,442387,1613,830,441557,South-East Asia
Malta,01-05-2020,374109,407,200,373909,Europe
Mauritania,01-05-2020,89215,1519,1206,88009,Africa
Mauritius,01-05-2020,365087,1244,1159,363928,Africa
Mexico,01-05-2020,77553,1856,41,77512,Americas
Moldova,01-05-2020,328308,633,487,327821,Europe
Monaco,01-05-2020,176446,581,758,175688,Europe
Mongolia,01-05-2020,110670,1258,507,110163,Western Pacific
Montenegro,01-05-2020,390303,996,31,390272,Europe
Morocco,01-05-2020,171478,556,363,171115,Eastern Mediterranean
Namibia,01-05-2020,38503,1280,502,38001,Africa
Nepal,01-05-2020,139135,398,565,138570,South-East Asia
Netherlands,01-05-2020,169311,210,1133,168178,Europe
Netherlands,01-05-2020,26147,1655,395,25752,Europe
Netherlands,01-05-2020,94709,974,1041,93668,Europe
Netherlands,01-05-2020,111518,765,489,111029,Europe
New Zealand,01-05-2020,268310,1006,540,267770,Western Pacific
Nicaragua,01-05-2020,294446,1961,50,294396,Americas
Niger,01-05-2020,30785,1284,771,30014,Africa
Nigeria,01-05-2020,189596,1215,533,189063,Africa
North Macedonia,01-05-2020,420587,1424,261,420326,Europe
Norway,01-05-2020,114628,1262,584,114044,Europe
Oman,01-05-2020,444590,1817,720,443870,Eastern Mediterranean
Pakistan,01-05-2020,240867,1122,367,240500,Eastern Mediterranean
Panama,01-05-2020,155205,552,817,154388,Americas
Papua New Guinea,01-05-2020,18243,621,467,17776,Western Pacific
Paraguay,01-05-2020,210284,248,110,210174,Americas
Peru,01-05-2020,45619,2461,1221,44398,Americas
Philippines,01-05-2020,431863,587,585,431278,Western Pacific
Poland,01-05-2020,152766,987,770,151996,Europe
Portugal,01-05-2020,292585,2047,1195,291390,Europe
Qatar,01-05-2020,368950,82,670,368280,Eastern Mediterranean
Romania,01-05-2020,301915,1590,1000,300915,Europe
Russia,01-05-2020,86880,188,754,86126,Europe
Rwanda,01-05-2020,238124,1605,823,237301,Africa
Saint Lucia,01-05-2020,322758,459,679,322079,Americas
Saint Vincent and the Grenadines,01-05-2020,222295,1288,1108,221187,Americas
San Marino,01-05-2020,243666,7,1049,242617,Europe
Saudi Arabia,01-05-2020,340832,242,171,340661,Eastern Mediterranean
Senegal,01-05-2020,360890,1625,112,360778,Africa
Serbia,01-05-2020,32537,743,380,32157,Europe
Seychelles,01-05-2020,279115,1009,974,278141,Africa
Singapore,01-05-2020,77390,1543,373,77017,Western Pacific
Slovakia,01-05-2020,296988,1446,645,296343,Europe
Slovenia,01-05-2020,354945,957,342,354603,Europe
Somalia,01-05-2020,50598,1342,367,50231,Eastern Mediterranean
South Africa,01-05-2020,295601,1159,90,295511,Africa
Spain,01-05-2020,357529,575,646,356883,Europe
Sri Lanka,01-05-2020,30705,1182,549,30156,South-East Asia
Sudan,01-05-2020,250986,2342,1082,249904,Eastern Mediterranean
Suriname,01-05-2020,53066,2382,1018,52048,Americas
Sweden,01-05-2020,422387,163,720,421667,Europe
Switzerland,01-05-2020,419407,1805,520,418887,Europe
Taiwan*,01-05-2020,249908,1204,622,249286,Western Pacific
Tanzania,01-05-2020,415112,1184,154,414958,Africa
Thailand,01-05-2020,333859,2486,646,333213,South-East Asia
Togo,01-05-2020,412716,329,1207,411509,Africa
Trinidad and Tobago,01-05-2020,380450,2223,546,379904,Americas
Tunisia,01-05-2020,384192,250,234,383958,Eastern Mediterranean
Turkey,01-05-2020,21557,2274,745,20812,Europe
Uganda,01-05-2020,391979,886,608,391371,Africa
Ukraine,01-05-2020,95415,582,655,94760,Europe
United Arab Emirates,01-05-2020,391873,2146,473,391400,Eastern Mediterranean
United Kingdom,01-05-2020,217244,320,640,216604,Europe
United Kingdom,01-05-2020,130169,344,63,130106,Europe
United Kingdom,01-05-2020,108967,5,898,108069,Europe
United Kingdom,01-05-2020,256734,1032,929,255805,Europe
United Kingdom,01-05-2020,241905,629,1183,240722,Europe
United Kingdom,01-05-2020,424863,899,40,424823,Europe
United Kingdom,01-05-2020,154543,298,879,153664,Europe
Uruguay,01-05-2020,353112,1434,599,352513,Americas
US,01-05-2020,99563,718,182,99381,Americas
Uzbekistan,01-05-2020,223833,2363,227,223606,Europe
Venezuela,01-05-2020,276779,2347,500,276279,Americas
Vietnam,01-05-2020,142080,2396,189,141891,Western Pacific
Zambia,01-05-2020,244371,311,149,244222,Africa
Zimbabwe,01-05-2020,433110,1160,539,432571,Africa
Dominica,01-05-2020,388425,1500,476,387949,Americas
Grenada,01-05-2020,115997,2337,1167,114830,Americas
Mozambique,01-05-2020,387682,1091,747,386935,Africa
Syria,01-05-2020,132642,1497,175,132467,Eastern Mediterranean
Timor-Leste,01-05-2020,287892,691,528,287364,South-East Asia
Belize,01-05-2020,33424,1876,65,33359,Americas
Laos,01-05-2020,197884,2300,851,197033,Western Pacific
Libya,01-05-2020,49897,1325,784,49113,Eastern Mediterranean
West Bank and Gaza,01-05-2020,156170,2045,881,155289,Eastern Mediterranean
Guinea-Bissau,01-05-2020,319500,1619,425,319075,Africa
Mali,01-05-2020,274845,2355,610,274235,Africa
Saint Kitts and Nevis,01-05-2020,348481,1661,44,348437,Americas
Canada,01-05-2020,210914,2253,794,210120,Americas
Canada,01-05-2020,279481,517,18,279463,Americas
Kosovo,01-05-2020,211658,1265,1179,210479,Europe
Burma,01-05-2020,378893,1717,343,378550,South-East Asia
United Kingdom,01-05-2020,150590,1961,1032,149558,Europe
United Kingdom,01-05-2020,290286,2255,316,289970,Europe
United Kingdom,01-05-2020,68794,2322,712,68082,Europe
Botswana,01-05-2020,352955,814,1145,351810,Africa
Burundi,01-05-2020,227844,1534,345,227499,Africa
Sierra Leone,01-05-2020,105614,1050,110,105504,Africa
Malawi,01-05-2020,356140,1621,435,355705,Africa
United Kingdom,01-05-2020,123442,2109,1156,122286,Europe
France,01-05-2020,428098,1850,251,427847,Europe
South Sudan,01-05-2020,416502,161,830,415672,Africa
Western Sahara,01-05-2020,366182,1126,530,365652,Africa
Sao Tome and Principe,01-05-2020,280382,1679,1161,279221,Africa
Yemen,01-05-2020,15013,1742,264,14749,Eastern Mediterranean
Comoros,01-05-2020,240452,2350,860,239592,Africa
Tajikistan,01-05-2020,159869,426,703,159166,Europe
Lesotho,01-05-2020,344886,1767,409,344477,Africa
Afghanistan,02-05-2020,171906,1716,1096,170810,Eastern Mediterranean
Albania,02-05-2020,250567,342,166,250401,Europe
Algeria,02-05-2020,346447,1226,363,346084,Africa
Andorra,02-05-2020,64921,80,888,64033,Europe
Angola,02-05-2020,187837,691,1012,186825,Africa
Antigua and Barbuda,02-05-2020,388648,1993,994,387654,Americas
Argentina,02-05-2020,371683,2000,1002,370681,Americas
Armenia,02-05-2020,423974,731,311,423663,Europe
Australia,02-05-2020,73405,1854,952,72453,Western Pacific
Australia,02-05-2020,159540,1368,687,158853,Western Pacific
Australia,02-05-2020,44806,1521,340,44466,Western Pacific
Australia,02-05-2020,415615,2465,1069,414546,Western Pacific
Australia,02-05-2020,316930,714,1076,315854,Western Pacific
Australia,02-05-2020,405581,2356,317,405264,Western Pacific
Australia,02-05-2020,334545,557,1078,333467,Western Pacific
Australia,02-05-2020,422380,1821,1038,421342,Western Pacific
Austria,02-05-2020,594,1312,674,-80,Europe
Azerbaijan,02-05-2020,154115,1406,401,153714,Europe
Bahamas,02-05-2020,91568,1657,1074,90494,Americas
Bahrain,02-05-2020,333983,689,930,333053,Eastern Mediterranean
Bangladesh,02-05-2020,223109,1036,921,222188,South-East Asia
Barbados,02-05-2020,319953,1155,1023,318930,Americas
Belarus,02-05-2020,360477,186,293,360184,Europe
Belgium,02-05-2020,384101,364,847,383254,Europe
Benin,02-05-2020,82803,1499,688,82115,Africa
Bhutan,02-05-2020,103872,2215,878,102994,South-East Asia
Bolivia,02-05-2020,252451,987,1082,251369,Americas
Bosnia and Herzegovina,02-05-2020,45608,1196,58,45550,Europe
Brazil,02-05-2020,101441,1579,998,100443,Americas
Brunei,02-05-2020,280353,1867,689,279664,Western Pacific
Bulgaria,02-05-2020,364219,338,781,363438,Europe
Burkina Faso,02-05-2020,176497,1721,1072,175425,Africa
Cabo Verde,02-05-2020,144269,1421,485,143784,Africa
Cambodia,02-05-2020,233070,1412,572,232498,Western Pacific
Cameroon,02-05-2020,41016,2118,535,40481,Africa
Canada,02-05-2020,297677,1467,733,296944,Americas
Canada,02-05-2020,114058,2000,746,113312,Americas
Canada,02-05-2020,359692,1656,59,359633,Americas
Canada,02-05-2020,302181,1950,955,301226,Americas
Canada,02-05-2020,44671,1570,721,43950,Americas
Canada,02-05-2020,329201,1921,328,328873,Americas
Canada,02-05-2020,372193,1029,463,371730,Americas
Canada,02-05-2020,72282,2141,607,71675,Americas
Canada,02-05-2020,293952,723,977,292975,Americas
Canada,02-05-2020,8008,1675,1205,6803,Americas
Central African Republic,02-05-2020,387165,2489,538,386627,Africa
Chad,02-05-2020,302488,1429,522,301966,Africa
Chile,02-05-2020,368198,827,1238,366960,Americas
China,02-05-2020,159090,684,102,158988,Western Pacific
China,02-05-2020,284253,2477,23,284230,Western Pacific
China,02-05-2020,289870,1948,775,289095,Western Pacific
China,02-05-2020,448908,1666,746,448162,Western Pacific
China,02-05-2020,377760,163,1069,376691,Western Pacific
China,02-05-2020,98651,49,484,98167,Western Pacific
China,02-05-2020,21401,2023,726,20675,Western Pacific
China,02-05-2020,331001,94,871,330130,Western Pacific
China,02-05-2020,374133,1236,1145,372988,Western Pacific
China,02-05-2020,316384,2074,898,315486,Western Pacific
China,02-05-2020,270461,318,998,269463,Western Pacific
China,02-05-2020,69177,1728,683,68494,Western Pacific
China,02-05-2020,294282,1466,819,293463,Western Pacific
China,02-05-2020,51306,977,158,51148,Western Pacific
China,02-05-2020,343937,41,1225,342712,Western Pacific
China,02-05-2020,144253,293,786,143467,Western Pacific
China,02-05-2020,239322,2410,682,238640,Western Pacific
China,02-05-2020,221859,2165,1186,220673,Western Pacific
China,02-05-2020,153949,1979,1016,152933,Western Pacific
China,02-05-2020,72597,2278,1049,71548,Western Pacific
China,02-05-2020,272993,2009,306,272687,Western Pacific
China,02-05-2020,407685,1180,1177,406508,Western Pacific
China,02-05-2020,32649,347,174,32475,Western Pacific
China,02-05-2020,366757,1933,1040,365717,Western Pacific
China,02-05-2020,291647,1530,427,291220,Western Pacific
China,02-05-2020,115732,1263,1112,114620,Western Pacific
China,02-05-2020,64454,2270,669,63785,Western Pacific
China,02-05-2020,196546,739,14,196532,Western Pacific
China,02-05-2020,372082,152,556,371526,Western Pacific
China,02-05-2020,281120,1069,909,280211,Western Pacific
China,02-05-2020,363973,2217,473,363500,Western Pacific
China,02-05-2020,135787,2018,20,135767,Western Pacific
China,02-05-2020,341711,65,131,341580,Western Pacific
Colombia,02-05-2020,56915,1341,775,56140,Americas
Congo (Brazzaville),02-05-2020,100385,326,638,99747,Africa
Congo (Kinshasa),02-05-2020,6902,2049,593,6309,Africa
Costa Rica,02-05-2020,399642,2492,956,398686,Americas
Cote d'Ivoire,02-05-2020,238058,918,857,237201,Africa
Croatia,02-05-2020,143798,50,626,143172,Europe
Cuba,02-05-2020,419890,119,687,419203,Americas
Cyprus,02-05-2020,409767,1114,811,408956,Europe
Czechia,02-05-2020,230884,2126,1082,229802,Europe
Denmark,02-05-2020,55738,1388,1161,54577,Europe
Greenland,02-05-2020,317617,2217,907,316710,Europe
Denmark,02-05-2020,63691,668,935,62756,Europe
Djibouti,02-05-2020,322786,661,898,321888,Eastern Mediterranean
Dominican Republic,02-05-2020,29087,1030,985,28102,Americas
Ecuador,02-05-2020,249602,1098,718,248884,Americas
Egypt,02-05-2020,198372,1428,372,198000,Eastern Mediterranean
El Salvador,02-05-2020,426472,2260,392,426080,Americas
Equatorial Guinea,02-05-2020,370132,1650,1168,368964,Africa
Eritrea,02-05-2020,125554,1581,820,124734,Africa
Estonia,02-05-2020,78102,557,419,77683,Europe
Eswatini,02-05-2020,335220,1660,584,334636,Africa
Ethiopia,02-05-2020,326580,1036,58,326522,Africa
Fiji,02-05-2020,259958,488,679,259279,Western Pacific
Finland,02-05-2020,252279,110,1193,251086,Europe
France,02-05-2020,384168,2428,778,383390,Europe
France,02-05-2020,72888,2055,619,72269,Europe
France,02-05-2020,334026,1958,332,333694,Europe
France,02-05-2020,440406,848,149,440257,Europe
France,02-05-2020,47294,2014,611,46683,Europe
France,02-05-2020,291377,1404,1197,290180,Europe
France,02-05-2020,385151,1131,494,384657,Europe
France,02-05-2020,39884,1815,677,39207,Europe
France,02-05-2020,80880,1505,134,80746,Europe
France,02-05-2020,169296,1972,608,168688,Europe
Gabon,02-05-2020,103806,1103,1090,102716,Africa
Gambia,02-05-2020,192595,1089,465,192130,Africa
Georgia,02-05-2020,13347,1885,541,12806,Europe
Germany,02-05-2020,73057,904,656,72401,Europe
Ghana,02-05-2020,355148,1990,229,354919,Africa
Greece,02-05-2020,207833,1956,254,207579,Europe
Guatemala,02-05-2020,57746,1154,1118,56628,Americas
Guinea,02-05-2020,133882,1662,414,133468,Africa
Guyana,02-05-2020,88071,2176,291,87780,Americas
Haiti,02-05-2020,204004,1052,977,203027,Americas
Holy See,02-05-2020,351855,220,786,351069,Europe
Honduras,02-05-2020,43960,2117,546,43414,Americas
Hungary,02-05-2020,19571,1579,1196,18375,Europe
Iceland,02-05-2020,318101,1225,417,317684,Europe
India,02-05-2020,172669,2343,1060,171609,South-East Asia
Indonesia,02-05-2020,30893,255,1125,29768,South-East Asia
Iran,02-05-2020,292666,788,419,292247,Eastern Mediterranean
Iraq,02-05-2020,39985,2452,1181,38804,Eastern Mediterranean
Ireland,02-05-2020,188202,511,1018,187184,Europe
Israel,02-05-2020,444828,1862,673,444155,Europe
Italy,02-05-2020,244107,1940,719,243388,Europe
Jamaica,02-05-2020,436317,135,708,435609,Americas
Japan,02-05-2020,175443,1080,212,175231,Western Pacific
Jordan,02-05-2020,55650,2432,870,54780,Eastern Mediterranean
Kazakhstan,02-05-2020,117193,572,288,116905,Europe
Kenya,02-05-2020,299478,86,851,298627,Africa
South Korea,02-05-2020,125538,1860,1203,124335,Western Pacific
Kuwait,02-05-2020,352074,570,199,351875,Eastern Mediterranean
Kyrgyzstan,02-05-2020,372059,1375,579,371480,Europe
Latvia,02-05-2020,353802,57,97,353705,Europe
Lebanon,02-05-2020,314803,2310,466,314337,Eastern Mediterranean
Liberia,02-05-2020,386431,1128,1161,385270,Africa
Liechtenstein,02-05-2020,5277,383,1075,4202,Europe
Lithuania,02-05-2020,350245,2224,96,350149,Europe
Luxembourg,02-05-2020,107696,142,330,107366,Europe
Madagascar,02-05-2020,122002,2250,829,121173,Africa
Malaysia,02-05-2020,323520,1764,986,322534,Western Pacific
Maldives,02-05-2020,185213,171,600,184613,South-East Asia
Malta,02-05-2020,155292,146,328,154964,Europe
Mauritania,02-05-2020,40473,1343,844,39629,Africa
Mauritius,02-05-2020,353333,1829,748,352585,Africa
Mexico,02-05-2020,259313,1587,593,258720,Americas
Moldova,02-05-2020,82999,1610,1062,81937,Europe
Monaco,02-05-2020,312547,581,365,312182,Europe
Mongolia,02-05-2020,97237,2493,140,97097,Western Pacific
Montenegro,02-05-2020,67752,1303,319,67433,Europe
Morocco,02-05-2020,69832,2093,62,69770,Eastern Mediterranean
Namibia,02-05-2020,406967,423,718,406249,Africa
Nepal,02-05-2020,139075,634,433,138642,South-East Asia
Netherlands,02-05-2020,130245,844,863,129382,Europe
Netherlands,02-05-2020,436044,1023,1169,434875,Europe
Netherlands,02-05-2020,139364,1461,1138,138226,Europe
Netherlands,02-05-2020,426032,1953,821,425211,Europe
New Zealand,02-05-2020,370722,1012,225,370497,Western Pacific
Nicaragua,02-05-2020,403164,1012,582,402582,Americas
Niger,02-05-2020,285643,1976,970,284673,Africa
Nigeria,02-05-2020,332052,597,1203,330849,Africa
North Macedonia,02-05-2020,246818,338,843,245975,Europe
Norway,02-05-2020,415366,321,314,415052,Europe
Oman,02-05-2020,82801,283,858,81943,Eastern Mediterranean
Pakistan,02-05-2020,321548,1112,471,321077,Eastern Mediterranean
Panama,02-05-2020,269334,15,34,269300,Americas
Papua New Guinea,02-05-2020,226916,2019,924,225992,Western Pacific
Paraguay,02-05-2020,38441,718,1242,37199,Americas
Peru,02-05-2020,332852,864,638,332214,Americas
Philippines,02-05-2020,276595,1718,1051,275544,Western Pacific
Poland,02-05-2020,15648,2266,472,15176,Europe
Portugal,02-05-2020,133380,188,934,132446,Europe
Qatar,02-05-2020,252382,2115,516,251866,Eastern Mediterranean
Romania,02-05-2020,210185,870,668,209517,Europe
Russia,02-05-2020,272797,1561,996,271801,Europe
Rwanda,02-05-2020,39144,390,450,38694,Africa
Saint Lucia,02-05-2020,433612,1074,1198,432414,Americas
Saint Vincent and the Grenadines,02-05-2020,412080,1957,718,411362,Americas
San Marino,02-05-2020,206172,1005,738,205434,Europe
Saudi Arabia,02-05-2020,376293,597,653,375640,Eastern Mediterranean
Senegal,02-05-2020,248887,2376,907,247980,Africa
Serbia,02-05-2020,59206,1101,969,58237,Europe
Seychelles,02-05-2020,33646,2401,619,33027,Africa
Singapore,02-05-2020,91476,1121,876,90600,Western Pacific
Slovakia,02-05-2020,311808,1773,765,311043,Europe
Slovenia,02-05-2020,44531,715,588,43943,Europe
Somalia,02-05-2020,121491,1558,139,121352,Eastern Mediterranean
South Africa,02-05-2020,302657,1826,1037,301620,Africa
Spain,02-05-2020,233357,675,1195,232162,Europe
Sri Lanka,02-05-2020,349148,418,437,348711,South-East Asia
Sudan,02-05-2020,341687,757,1013,340674,Eastern Mediterranean
Suriname,02-05-2020,265893,1097,612,265281,Americas
Sweden,02-05-2020,166966,2129,651,166315,Europe
Switzerland,02-05-2020,76627,973,900,75727,Europe
Taiwan*,02-05-2020,350655,2173,719,349936,Western Pacific
Tanzania,02-05-2020,30279,2321,194,30085,Africa
Thailand,02-05-2020,203538,639,1091,202447,South-East Asia
Togo,02-05-2020,24343,812,306,24037,Africa
Trinidad and Tobago,02-05-2020,446981,271,507,446474,Americas
Tunisia,02-05-2020,153990,949,226,153764,Eastern Mediterranean
Turkey,02-05-2020,265266,81,123,265143,Europe
Uganda,02-05-2020,32848,1944,1034,31814,Africa
Ukraine,02-05-2020,355519,2404,536,354983,Europe
United Arab Emirates,02-05-2020,395299,2074,180,395119,Eastern Mediterranean
United Kingdom,02-05-2020,147062,1961,1162,145900,Europe
United Kingdom,02-05-2020,319132,1502,204,318928,Europe
United Kingdom,02-05-2020,275490,2090,1054,274436,Europe
United Kingdom,02-05-2020,128750,687,1216,127534,Europe
United Kingdom,02-05-2020,390312,1930,1127,389185,Europe
United Kingdom,02-05-2020,174964,1650,1227,173737,Europe
United Kingdom,02-05-2020,383943,1242,163,383780,Europe
Uruguay,02-05-2020,313940,138,592,313348,Americas
US,02-05-2020,264877,847,570,264307,Americas
Uzbekistan,02-05-2020,172163,2498,707,171456,Europe
Venezuela,02-05-2020,69524,1467,747,68777,Americas
Vietnam,02-05-2020,151337,611,367,150970,Western Pacific
Zambia,02-05-2020,294212,613,685,293527,Africa
Zimbabwe,02-05-2020,289664,814,836,288828,Africa
Dominica,02-05-2020,2549,138,68,2481,Americas
Grenada,02-05-2020,5222,948,1008,4214,Americas
Mozambique,02-05-2020,105280,2497,918,104362,Africa
Syria,02-05-2020,428227,1857,214,428013,Eastern Mediterranean
Timor-Leste,02-05-2020,152607,1714,199,152408,South-East Asia
Belize,02-05-2020,178192,1996,275,177917,Americas
Laos,02-05-2020,302085,1341,740,301345,Western Pacific
Libya,02-05-2020,195780,539,732,195048,Eastern Mediterranean
West Bank and Gaza,02-05-2020,116914,1195,743,116171,Eastern Mediterranean
Guinea-Bissau,02-05-2020,437391,954,13,437378,Africa
Mali,02-05-2020,298190,1813,837,297353,Africa
Saint Kitts and Nevis,02-05-2020,337637,567,416,337221,Americas
Canada,02-05-2020,58270,298,509,57761,Americas
Canada,02-05-2020,287056,2334,1014,286042,Americas
Kosovo,02-05-2020,317667,1929,1022,316645,Europe
Burma,02-05-2020,108755,619,1190,107565,South-East Asia
United Kingdom,02-05-2020,310515,2151,856,309659,Europe
United Kingdom,02-05-2020,175186,1868,1246,173940,Europe
United Kingdom,02-05-2020,35537,1449,232,35305,Europe
Botswana,02-05-2020,137710,1060,301,137409,Africa
Burundi,02-05-2020,45695,863,218,45477,Africa
Sierra Leone,02-05-2020,99815,1157,1249,98566,Africa
Malawi,02-05-2020,127204,1501,116,127088,Africa
United Kingdom,02-05-2020,102429,1299,664,101765,Europe
France,02-05-2020,54252,111,155,54097,Europe
South Sudan,02-05-2020,356175,710,662,355513,Africa
Western Sahara,02-05-2020,270328,892,125,270203,Africa
Sao Tome and Principe,02-05-2020,120427,111,283,120144,Africa
Yemen,02-05-2020,33929,318,1102,32827,Eastern Mediterranean
Comoros,02-05-2020,193754,2038,1098,192656,Africa
Tajikistan,02-05-2020,69008,1729,1210,67798,Europe
Lesotho,02-05-2020,177136,308,1180,175956,Africa
Afghanistan,03-05-2020,193398,101,302,193096,Eastern Mediterranean
Albania,03-05-2020,77964,1502,1123,76841,Europe
Algeria,03-05-2020,240802,415,642,240160,Africa
Andorra,03-05-2020,69865,365,881,68984,Europe
Angola,03-05-2020,303945,2440,421,303524,Africa
Antigua and Barbuda,03-05-2020,426755,1507,864,425891,Americas
Argentina,03-05-2020,175459,565,83,175376,Americas
Armenia,03-05-2020,63930,863,752,63178,Europe
Australia,03-05-2020,354813,1626,621,354192,Western Pacific
Australia,03-05-2020,177346,1440,1092,176254,Western Pacific
Australia,03-05-2020,377135,1906,426,376709,Western Pacific
Australia,03-05-2020,34918,1780,434,34484,Western Pacific
Australia,03-05-2020,154140,474,669,153471,Western Pacific
Australia,03-05-2020,111167,1245,1217,109950,Western Pacific
Australia,03-05-2020,128129,866,848,127281,Western Pacific
Australia,03-05-2020,419424,1160,1214,418210,Western Pacific
Austria,03-05-2020,365073,559,184,364889,Europe
Azerbaijan,03-05-2020,153404,2170,250,153154,Europe
Bahamas,03-05-2020,422966,1146,204,422762,Americas
Bahrain,03-05-2020,446207,856,1071,445136,Eastern Mediterranean
Bangladesh,03-05-2020,446279,2162,357,445922,South-East Asia
Barbados,03-05-2020,379355,1409,139,379216,Americas
Belarus,03-05-2020,14519,1763,978,13541,Europe
Belgium,03-05-2020,82373,2202,75,82298,Europe
Benin,03-05-2020,377686,1611,200,377486,Africa
Bhutan,03-05-2020,372775,1162,134,372641,South-East Asia
Bolivia,03-05-2020,253985,458,847,253138,Americas
Bosnia and Herzegovina,03-05-2020,19516,2135,779,18737,Europe
Brazil,03-05-2020,296329,469,405,295924,Americas
Brunei,03-05-2020,85043,968,316,84727,Western Pacific
Bulgaria,03-05-2020,279092,2057,642,278450,Europe
Burkina Faso,03-05-2020,365418,1582,121,365297,Africa
Cabo Verde,03-05-2020,434033,1860,151,433882,Africa
Cambodia,03-05-2020,120912,2184,335,120577,Western Pacific
Cameroon,03-05-2020,196611,2404,854,195757,Africa
Canada,03-05-2020,155445,1039,772,154673,Americas
Canada,03-05-2020,223531,681,733,222798,Americas
Canada,03-05-2020,162427,266,326,162101,Americas
Canada,03-05-2020,110533,432,635,109898,Americas
Canada,03-05-2020,285391,283,271,285120,Americas
Canada,03-05-2020,207516,589,887,206629,Americas
Canada,03-05-2020,116959,413,109,116850,Americas
Canada,03-05-2020,122469,1911,519,121950,Americas
Canada,03-05-2020,245155,1961,85,245070,Americas
Canada,03-05-2020,238159,2407,971,237188,Americas
Central African Republic,03-05-2020,222027,575,1054,220973,Africa
Chad,03-05-2020,63078,39,268,62810,Africa
Chile,03-05-2020,195261,781,1000,194261,Americas
China,03-05-2020,141667,2379,854,140813,Western Pacific
China,03-05-2020,76339,1853,1242,75097,Western Pacific
China,03-05-2020,314830,901,180,314650,Western Pacific
China,03-05-2020,8610,2186,237,8373,Western Pacific
China,03-05-2020,213023,720,1028,211995,Western Pacific
China,03-05-2020,70450,2099,511,69939,Western Pacific
China,03-05-2020,271437,2171,823,270614,Western Pacific
China,03-05-2020,212306,1812,1238,211068,Western Pacific
China,03-05-2020,20655,467,159,20496,Western Pacific
China,03-05-2020,201064,2013,213,200851,Western Pacific
China,03-05-2020,16292,272,916,15376,Western Pacific
China,03-05-2020,328581,1492,717,327864,Western Pacific
China,03-05-2020,107,1602,1064,-957,Western Pacific
China,03-05-2020,99484,1830,1019,98465,Western Pacific
China,03-05-2020,389051,150,1231,387820,Western Pacific
China,03-05-2020,414639,1412,426,414213,Western Pacific
China,03-05-2020,401516,2035,968,400548,Western Pacific
China,03-05-2020,256637,132,1009,255628,Western Pacific
China,03-05-2020,281567,1940,382,281185,Western Pacific
China,03-05-2020,421183,967,26,421157,Western Pacific
China,03-05-2020,95029,1398,129,94900,Western Pacific
China,03-05-2020,51883,562,605,51278,Western Pacific
China,03-05-2020,428723,2310,1124,427599,Western Pacific
China,03-05-2020,210505,392,1077,209428,Western Pacific
China,03-05-2020,418988,2430,438,418550,Western Pacific
China,03-05-2020,245947,1365,707,245240,Western Pacific
China,03-05-2020,426150,1551,716,425434,Western Pacific
China,03-05-2020,249625,2486,146,249479,Western Pacific
China,03-05-2020,140855,1074,1200,139655,Western Pacific
China,03-05-2020,93337,267,837,92500,Western Pacific
China,03-05-2020,349411,19,1182,348229,Western Pacific
China,03-05-2020,177157,739,328,176829,Western Pacific
China,03-05-2020,388684,840,763,387921,Western Pacific
Colombia,03-05-2020,6566,2438,1014,5552,Americas
Congo (Brazzaville),03-05-2020,266199,802,1055,265144,Africa
Congo (Kinshasa),03-05-2020,361097,1312,424,360673,Africa
Costa Rica,03-05-2020,201934,737,1120,200814,Americas
Cote d'Ivoire,03-05-2020,54140,635,586,53554,Africa
Croatia,03-05-2020,238997,2101,339,238658,Europe
Cuba,03-05-2020,400199,218,390,399809,Americas
Cyprus,03-05-2020,244250,1209,999,243251,Europe
Czechia,03-05-2020,364532,1996,629,363903,Europe
Denmark,03-05-2020,449517,508,1112,448405,Europe
Greenland,03-05-2020,191550,1331,63,191487,Europe
Denmark,03-05-2020,34935,1478,906,34029,Europe
Djibouti,03-05-2020,341935,1153,149,341786,Eastern Mediterranean
Dominican Republic,03-05-2020,297927,263,385,297542,Americas
Ecuador,03-05-2020,327741,1165,250,327491,Americas
Egypt,03-05-2020,10876,617,378,10498,Eastern Mediterranean
El Salvador,03-05-2020,365,172,854,-489,Americas
Equatorial Guinea,03-05-2020,201947,1110,962,200985,Africa
Eritrea,03-05-2020,98124,1311,798,97326,Africa
Estonia,03-05-2020,21834,1671,820,21014,Europe
Eswatini,03-05-2020,168903,407,786,168117,Africa
Ethiopia,03-05-2020,121770,1267,709,121061,Africa
Fiji,03-05-2020,54528,2127,258,54270,Western Pacific
Finland,03-05-2020,113910,783,426,113484,Europe
France,03-05-2020,203802,2255,787,203015,Europe
France,03-05-2020,348284,614,392,347892,Europe
France,03-05-2020,371567,2141,177,371390,Europe
France,03-05-2020,21087,1729,446,20641,Europe
France,03-05-2020,285325,403,894,284431,Europe
France,03-05-2020,370254,1436,1208,369046,Europe
France,03-05-2020,152214,742,959,151255,Europe
France,03-05-2020,176278,1350,12,176266,Europe
France,03-05-2020,115525,1392,508,115017,Europe
France,03-05-2020,352124,287,755,351369,Europe
Gabon,03-05-2020,44580,241,866,43714,Africa
Gambia,03-05-2020,74839,399,1086,73753,Africa
Georgia,03-05-2020,155705,2305,730,154975,Europe
Germany,03-05-2020,252281,1952,191,252090,Europe
Ghana,03-05-2020,101753,58,580,101173,Africa
Greece,03-05-2020,386365,118,1244,385121,Europe
Guatemala,03-05-2020,405654,1613,52,405602,Americas
Guinea,03-05-2020,164581,710,369,164212,Africa
Guyana,03-05-2020,442074,2342,907,441167,Americas
Haiti,03-05-2020,192041,1199,378,191663,Americas
Holy See,03-05-2020,40987,1869,671,40316,Europe
Honduras,03-05-2020,53979,960,570,53409,Americas
Hungary,03-05-2020,103080,1151,1023,102057,Europe
Iceland,03-05-2020,375216,1691,1130,374086,Europe
India,03-05-2020,154480,617,363,154117,South-East Asia
Indonesia,03-05-2020,66738,2131,1043,65695,South-East Asia
Iran,03-05-2020,77878,1826,780,77098,Eastern Mediterranean
Iraq,03-05-2020,79372,2483,17,79355,Eastern Mediterranean
Ireland,03-05-2020,373462,236,1230,372232,Europe
Israel,03-05-2020,159645,763,472,159173,Europe
Italy,03-05-2020,282550,1722,615,281935,Europe
Jamaica,03-05-2020,62652,623,262,62390,Americas
Japan,03-05-2020,358319,1181,455,357864,Western Pacific
Jordan,03-05-2020,147609,224,609,147000,Eastern Mediterranean
Kazakhstan,03-05-2020,266474,1355,1237,265237,Europe
Kenya,03-05-2020,213444,2495,1186,212258,Africa
South Korea,03-05-2020,260998,2408,1141,259857,Western Pacific
Kuwait,03-05-2020,167594,36,663,166931,Eastern Mediterranean
Kyrgyzstan,03-05-2020,60683,610,613,60070,Europe
Latvia,03-05-2020,285914,717,549,285365,Europe
Lebanon,03-05-2020,86144,1537,710,85434,Eastern Mediterranean
Liberia,03-05-2020,55613,1969,671,54942,Africa
Liechtenstein,03-05-2020,140992,166,722,140270,Europe
Lithuania,03-05-2020,358936,800,782,358154,Europe
Luxembourg,03-05-2020,243701,565,1197,242504,Europe
Madagascar,03-05-2020,400499,1097,277,400222,Africa
Malaysia,03-05-2020,79058,1814,96,78962,Western Pacific
Maldives,03-05-2020,233386,424,312,233074,South-East Asia
Malta,03-05-2020,103730,1754,898,102832,Europe
Mauritania,03-05-2020,325321,2010,446,324875,Africa
Mauritius,03-05-2020,143061,786,73,142988,Africa
Mexico,03-05-2020,381934,1430,1101,380833,Americas
Moldova,03-05-2020,289669,1525,1037,288632,Europe
Monaco,03-05-2020,214521,1786,1024,213497,Europe
Mongolia,03-05-2020,250513,1931,1100,249413,Western Pacific
Montenegro,03-05-2020,191571,1758,246,191325,Europe
Morocco,03-05-2020,287536,1932,787,286749,Eastern Mediterranean
Namibia,03-05-2020,251338,1464,797,250541,Africa
Nepal,03-05-2020,50858,368,275,50583,South-East Asia
Netherlands,03-05-2020,432026,1382,1089,430937,Europe
Netherlands,03-05-2020,196827,526,42,196785,Europe
Netherlands,03-05-2020,310231,1651,623,309608,Europe
Netherlands,03-05-2020,87460,2247,1058,86402,Europe
New Zealand,03-05-2020,91142,2343,513,90629,Western Pacific
Nicaragua,03-05-2020,352665,2482,412,352253,Americas
Niger,03-05-2020,291627,671,400,291227,Africa
Nigeria,03-05-2020,344500,376,864,343636,Africa
North Macedonia,03-05-2020,141855,1860,1096,140759,Europe
Norway,03-05-2020,418092,488,521,417571,Europe
Oman,03-05-2020,325331,971,400,324931,Eastern Mediterranean
Pakistan,03-05-2020,438343,1402,351,437992,Eastern Mediterranean
Panama,03-05-2020,355235,558,185,355050,Americas
Papua New Guinea,03-05-2020,52242,2399,410,51832,Western Pacific
Paraguay,03-05-2020,277306,1517,397,276909,Americas
Peru,03-05-2020,356306,750,1213,355093,Americas
Philippines,03-05-2020,64087,2193,1152,62935,Western Pacific
Poland,03-05-2020,201846,1291,733,201113,Europe
Portugal,03-05-2020,208239,1100,1007,207232,Europe
Qatar,03-05-2020,438096,1054,704,437392,Eastern Mediterranean
Romania,03-05-2020,32,1843,1127,-1095,Europe
Russia,03-05-2020,117308,1167,567,116741,Europe
Rwanda,03-05-2020,73604,2018,576,73028,Africa
Saint Lucia,03-05-2020,178494,1142,1230,177264,Americas
Saint Vincent and the Grenadines,03-05-2020,103020,2209,33,102987,Americas
San Marino,03-05-2020,222897,1053,1101,221796,Europe
Saudi Arabia,03-05-2020,128771,1901,1204,127567,Eastern Mediterranean
Senegal,03-05-2020,279439,2425,267,279172,Africa
Serbia,03-05-2020,32764,830,1110,31654,Europe
Seychelles,03-05-2020,294822,779,1130,293692,Africa
Singapore,03-05-2020,24963,2439,131,24832,Western Pacific
Slovakia,03-05-2020,10815,1920,224,10591,Europe
Slovenia,03-05-2020,202427,1650,841,201586,Europe
Somalia,03-05-2020,94362,1112,431,93931,Eastern Mediterranean
South Africa,03-05-2020,254539,758,1014,253525,Africa
Spain,03-05-2020,312106,1083,879,311227,Europe
Sri Lanka,03-05-2020,137841,1754,1087,136754,South-East Asia
Sudan,03-05-2020,148516,814,1077,147439,Eastern Mediterranean
Suriname,03-05-2020,362235,381,399,361836,Americas
Sweden,03-05-2020,441117,1657,551,440566,Europe
Switzerland,03-05-2020,317022,2016,1140,315882,Europe
Taiwan*,03-05-2020,382229,1131,695,381534,Western Pacific
Tanzania,03-05-2020,105713,2360,1186,104527,Africa
Thailand,03-05-2020,306620,1098,341,306279,South-East Asia
Togo,03-05-2020,191817,1940,1140,190677,Africa
Trinidad and Tobago,03-05-2020,232604,1456,314,232290,Americas
Tunisia,03-05-2020,401235,1969,386,400849,Eastern Mediterranean
Turkey,03-05-2020,14381,594,927,13454,Europe
Uganda,03-05-2020,386936,2310,639,386297,Africa
Ukraine,03-05-2020,348497,2351,448,348049,Europe
United Arab Emirates,03-05-2020,41396,834,793,40603,Eastern Mediterranean
United Kingdom,03-05-2020,426778,1029,521,426257,Europe
United Kingdom,03-05-2020,235807,837,57,235750,Europe
United Kingdom,03-05-2020,15981,1699,1082,14899,Europe
United Kingdom,03-05-2020,120192,1375,505,119687,Europe
United Kingdom,03-05-2020,233475,1368,338,233137,Europe
United Kingdom,03-05-2020,161028,1324,726,160302,Europe
United Kingdom,03-05-2020,253295,1217,1214,252081,Europe
Uruguay,03-05-2020,242746,1302,147,242599,Americas
US,03-05-2020,145284,1060,380,144904,Americas
Uzbekistan,03-05-2020,333750,638,808,332942,Europe
Venezuela,03-05-2020,353494,930,1209,352285,Americas
Vietnam,03-05-2020,411917,940,900,411017,Western Pacific
Zambia,03-05-2020,420464,1651,903,419561,Africa
Zimbabwe,03-05-2020,1667,2203,649,1018,Africa
Dominica,03-05-2020,32677,49,260,32417,Americas
Grenada,03-05-2020,150654,1037,777,149877,Americas
Mozambique,03-05-2020,401154,2153,1145,400009,Africa
Syria,03-05-2020,392658,439,379,392279,Eastern Mediterranean
Timor-Leste,03-05-2020,268240,283,891,267349,South-East Asia
Belize,03-05-2020,449364,239,1045,448319,Americas
Laos,03-05-2020,292881,2481,52,292829,Western Pacific
Libya,03-05-2020,178845,874,947,177898,Eastern Mediterranean
West Bank and Gaza,03-05-2020,60078,1745,10,60068,Eastern Mediterranean
Guinea-Bissau,03-05-2020,380095,1474,1102,378993,Africa
Mali,03-05-2020,226411,1561,38,226373,Africa
Saint Kitts and Nevis,03-05-2020,113807,946,1102,112705,Americas
Canada,03-05-2020,175897,12,9,175888,Americas
Canada,03-05-2020,121385,1677,179,121206,Americas
Kosovo,03-05-2020,253181,833,1006,252175,Europe
Burma,03-05-2020,124215,1443,502,123713,South-East Asia
United Kingdom,03-05-2020,378427,85,729,377698,Europe
United Kingdom,03-05-2020,217302,1396,143,217159,Europe
United Kingdom,03-05-2020,147619,7,952,146667,Europe
Botswana,03-05-2020,214537,1030,616,213921,Africa
Burundi,03-05-2020,65138,1686,993,64145,Africa
Sierra Leone,03-05-2020,393453,980,1182,392271,Africa
Malawi,03-05-2020,358596,749,621,357975,Africa
United Kingdom,03-05-2020,306252,1366,1155,305097,Europe
France,03-05-2020,340228,1049,377,339851,Europe
South Sudan,03-05-2020,355523,607,47,355476,Africa
Western Sahara,03-05-2020,66578,1228,457,66121,Africa
Sao Tome and Principe,03-05-2020,447747,1212,901,446846,Africa
Yemen,03-05-2020,424526,1239,988,423538,Eastern Mediterranean
Comoros,03-05-2020,449256,662,1010,448246,Africa
Tajikistan,03-05-2020,422810,1503,485,422325,Europe
Lesotho,03-05-2020,272409,2368,397,272012,Africa
Afghanistan,04-05-2020,132812,1432,1150,131662,Eastern Mediterranean
Albania,04-05-2020,149018,2034,587,148431,Europe
Algeria,04-05-2020,422853,624,837,422016,Africa
Andorra,04-05-2020,133248,1681,292,132956,Europe
Angola,04-05-2020,350667,2213,1086,349581,Africa
Antigua and Barbuda,04-05-2020,321191,1671,707,320484,Americas
Argentina,04-05-2020,65912,825,1213,64699,Americas
Armenia,04-05-2020,311948,1814,706,311242,Europe
Australia,04-05-2020,294214,1950,809,293405,Western Pacific
Australia,04-05-2020,297982,2038,56,297926,Western Pacific
Australia,04-05-2020,370885,648,1128,369757,Western Pacific
Australia,04-05-2020,423396,2148,673,422723,Western Pacific
Australia,04-05-2020,162848,1168,829,162019,Western Pacific
Australia,04-05-2020,57591,1843,143,57448,Western Pacific
Australia,04-05-2020,144917,1251,711,144206,Western Pacific
Australia,04-05-2020,213605,31,130,213475,Western Pacific
Austria,04-05-2020,370362,1506,15,370347,Europe
Azerbaijan,04-05-2020,132465,814,283,132182,Europe
Bahamas,04-05-2020,431941,788,173,431768,Americas
Bahrain,04-05-2020,165226,297,864,164362,Eastern Mediterranean
Bangladesh,04-05-2020,171243,1283,528,170715,South-East Asia
Barbados,04-05-2020,90828,1106,287,90541,Americas
Belarus,04-05-2020,175031,354,179,174852,Europe
Belgium,04-05-2020,190879,1498,426,190453,Europe
Benin,04-05-2020,237780,1154,547,237233,Africa
Bhutan,04-05-2020,10636,2174,863,9773,South-East Asia
Bolivia,04-05-2020,48530,867,165,48365,Americas
Bosnia and Herzegovina,04-05-2020,441746,1679,792,440954,Europe
Brazil,04-05-2020,115582,2104,97,115485,Americas
Brunei,04-05-2020,122259,2229,1103,121156,Western Pacific
Bulgaria,04-05-2020,379149,2187,692,378457,Europe
Burkina Faso,04-05-2020,352250,589,1044,351206,Africa
Cabo Verde,04-05-2020,213079,2181,292,212787,Africa
Cambodia,04-05-2020,262931,2426,1065,261866,Western Pacific
Cameroon,04-05-2020,305376,60,114,305262,Africa
Canada,04-05-2020,373442,1653,489,372953,Americas
Canada,04-05-2020,1530,2379,1124,406,Americas
Canada,04-05-2020,269849,724,289,269560,Americas
Canada,04-05-2020,61827,1188,532,61295,Americas
Canada,04-05-2020,173868,1604,194,173674,Americas
Canada,04-05-2020,71030,1076,655,70375,Americas
Canada,04-05-2020,297919,1233,170,297749,Americas
Canada,04-05-2020,67659,1200,1063,66596,Americas
Canada,04-05-2020,237325,2277,437,236888,Americas
Canada,04-05-2020,81954,977,517,81437,Americas
Central African Republic,04-05-2020,61282,2005,439,60843,Africa
Chad,04-05-2020,253847,1654,951,252896,Africa
Chile,04-05-2020,223070,2461,1095,221975,Americas
China,04-05-2020,99708,125,1001,98707,Western Pacific
China,04-05-2020,83264,964,878,82386,Western Pacific
China,04-05-2020,419518,1926,1040,418478,Western Pacific
China,04-05-2020,74536,1480,595,73941,Western Pacific
China,04-05-2020,8279,989,67,8212,Western Pacific
China,04-05-2020,198445,1085,132,198313,Western Pacific
China,04-05-2020,383749,992,67,383682,Western Pacific
China,04-05-2020,133352,2022,236,133116,Western Pacific
China,04-05-2020,403229,1478,1005,402224,Western Pacific
China,04-05-2020,396628,347,1225,395403,Western Pacific
China,04-05-2020,309364,1629,79,309285,Western Pacific
China,04-05-2020,164019,1651,398,163621,Western Pacific
China,04-05-2020,124036,499,521,123515,Western Pacific
China,04-05-2020,213798,66,1018,212780,Western Pacific
China,04-05-2020,428469,164,56,428413,Western Pacific
China,04-05-2020,396759,1906,194,396565,Western Pacific
China,04-05-2020,142005,521,976,141029,Western Pacific
China,04-05-2020,75546,1065,359,75187,Western Pacific
China,04-05-2020,16492,458,769,15723,Western Pacific
China,04-05-2020,229813,2034,549,229264,Western Pacific
China,04-05-2020,380174,26,1244,378930,Western Pacific
China,04-05-2020,276605,1726,673,275932,Western Pacific
China,04-05-2020,73852,272,221,73631,Western Pacific
China,04-05-2020,227941,884,6,227935,Western Pacific
China,04-05-2020,101709,326,348,101361,Western Pacific
China,04-05-2020,213054,607,685,212369,Western Pacific
China,04-05-2020,3525,1169,468,3057,Western Pacific
China,04-05-2020,133497,1237,701,132796,Western Pacific
China,04-05-2020,345862,203,512,345350,Western Pacific
China,04-05-2020,5325,2135,860,4465,Western Pacific
China,04-05-2020,387807,1614,795,387012,Western Pacific
China,04-05-2020,28816,134,1215,27601,Western Pacific
China,04-05-2020,146198,2071,750,145448,Western Pacific
Colombia,04-05-2020,357413,3,51,357362,Americas
Congo (Brazzaville),04-05-2020,369110,1655,1206,367904,Africa
Congo (Kinshasa),04-05-2020,252869,1850,403,252466,Africa
Costa Rica,04-05-2020,449400,1083,304,449096,Americas
Cote d'Ivoire,04-05-2020,137166,1477,1070,136096,Africa
Croatia,04-05-2020,368687,2316,638,368049,Europe
Cuba,04-05-2020,291455,820,711,290744,Americas
Cyprus,04-05-2020,333960,1529,787,333173,Europe
Czechia,04-05-2020,78661,1292,842,77819,Europe
Denmark,04-05-2020,135059,1713,566,134493,Europe
Greenland,04-05-2020,148881,1202,1103,147778,Europe
Denmark,04-05-2020,180800,911,612,180188,Europe
Djibouti,04-05-2020,94400,1076,550,93850,Eastern Mediterranean
Dominican Republic,04-05-2020,369333,150,436,368897,Americas
Ecuador,04-05-2020,232202,1353,228,231974,Americas
Egypt,04-05-2020,132182,384,116,132066,Eastern Mediterranean
El Salvador,04-05-2020,400461,429,94,400367,Americas
Equatorial Guinea,04-05-2020,16445,480,895,15550,Africa
Eritrea,04-05-2020,268380,766,504,267876,Africa
Estonia,04-05-2020,6621,1163,68,6553,Europe
Eswatini,04-05-2020,75426,1272,655,74771,Africa
Ethiopia,04-05-2020,430665,2330,333,430332,Africa
Fiji,04-05-2020,59355,2250,461,58894,Western Pacific
Finland,04-05-2020,349081,512,738,348343,Europe
France,04-05-2020,33986,196,41,33945,Europe
France,04-05-2020,8699,1328,418,8281,Europe
France,04-05-2020,92691,563,267,92424,Europe
France,04-05-2020,211296,1765,370,210926,Europe
France,04-05-2020,369847,2340,742,369105,Europe
France,04-05-2020,339870,731,260,339610,Europe
France,04-05-2020,414017,1455,620,413397,Europe
France,04-05-2020,322913,600,1130,321783,Europe
France,04-05-2020,237432,152,701,236731,Europe
France,04-05-2020,406768,2259,109,406659,Europe
Gabon,04-05-2020,367924,570,694,367230,Africa
Gambia,04-05-2020,394110,932,679,393431,Africa
Georgia,04-05-2020,158355,806,942,157413,Europe
Germany,04-05-2020,417999,1446,386,417613,Europe
Ghana,04-05-2020,46629,1002,446,46183,Africa
Greece,04-05-2020,112749,998,173,112576,Europe
Guatemala,04-05-2020,209091,456,593,208498,Americas
Guinea,04-05-2020,154932,532,433,154499,Africa
Guyana,04-05-2020,109365,907,16,109349,Americas
Haiti,04-05-2020,323309,1252,844,322465,Americas
Holy See,04-05-2020,448204,2348,216,447988,Europe
Honduras,04-05-2020,346585,945,616,345969,Americas
Hungary,04-05-2020,341017,1189,8,341009,Europe
Iceland,04-05-2020,191844,1875,190,191654,Europe
India,04-05-2020,307582,1596,572,307010,South-East Asia
Indonesia,04-05-2020,414548,2198,772,413776,South-East Asia
Iran,04-05-2020,120591,1454,380,120211,Eastern Mediterranean
Iraq,04-05-2020,262851,1477,1248,261603,Eastern Mediterranean
Ireland,04-05-2020,362450,2149,475,361975,Europe
Israel,04-05-2020,91158,1651,1145,90013,Europe
Italy,04-05-2020,353626,1421,1099,352527,Europe
Jamaica,04-05-2020,266312,119,1244,265068,Americas
Japan,04-05-2020,95133,2067,301,94832,Western Pacific
Jordan,04-05-2020,152773,1628,942,151831,Eastern Mediterranean
Kazakhstan,04-05-2020,18821,395,701,18120,Europe
Kenya,04-05-2020,365383,286,1158,364225,Africa
South Korea,04-05-2020,87884,589,810,87074,Western Pacific
Kuwait,04-05-2020,425252,1656,789,424463,Eastern Mediterranean
Kyrgyzstan,04-05-2020,62605,5,1108,61497,Europe
Latvia,04-05-2020,153253,1931,93,153160,Europe
Lebanon,04-05-2020,249031,1618,489,248542,Eastern Mediterranean
Liberia,04-05-2020,45440,2463,133,45307,Africa
Liechtenstein,04-05-2020,319177,1871,950,318227,Europe
Lithuania,04-05-2020,286031,199,327,285704,Europe
Luxembourg,04-05-2020,226578,1994,375,226203,Europe
Madagascar,04-05-2020,167252,35,889,166363,Africa
Malaysia,04-05-2020,186371,1556,235,186136,Western Pacific
Maldives,04-05-2020,394602,1973,468,394134,South-East Asia
Malta,04-05-2020,382239,2070,355,381884,Europe
Mauritania,04-05-2020,262236,2477,884,261352,Africa
Mauritius,04-05-2020,442225,227,789,441436,Africa
Mexico,04-05-2020,225023,1903,156,224867,Americas
Moldova,04-05-2020,214281,1578,113,214168,Europe
Monaco,04-05-2020,111378,1971,966,110412,Europe
Mongolia,04-05-2020,307497,1355,1245,306252,Western Pacific
Montenegro,04-05-2020,347787,401,547,347240,Europe
Morocco,04-05-2020,196647,1781,1249,195398,Eastern Mediterranean
Namibia,04-05-2020,255845,586,254,255591,Africa
Nepal,04-05-2020,59345,1656,1035,58310,South-East Asia
Netherlands,04-05-2020,439052,746,1157,437895,Europe
Netherlands,04-05-2020,330025,727,168,329857,Europe
Netherlands,04-05-2020,419982,940,184,419798,Europe
Netherlands,04-05-2020,315885,1522,651,315234,Europe
New Zealand,04-05-2020,408034,964,228,407806,Western Pacific
Nicaragua,04-05-2020,172649,684,246,172403,Americas
Niger,04-05-2020,374158,281,404,373754,Africa
Nigeria,04-05-2020,197457,235,531,196926,Africa
North Macedonia,04-05-2020,208917,1655,127,208790,Europe
Norway,04-05-2020,354047,1571,592,353455,Europe
Oman,04-05-2020,6777,125,493,6284,Eastern Mediterranean
Pakistan,04-05-2020,252321,830,521,251800,Eastern Mediterranean
Panama,04-05-2020,336421,2132,453,335968,Americas
Papua New Guinea,04-05-2020,381172,2233,1034,380138,Western Pacific
Paraguay,04-05-2020,80324,1165,861,79463,Americas
Peru,04-05-2020,312138,2285,65,312073,Americas
Philippines,04-05-2020,60710,1354,783,59927,Western Pacific
Poland,04-05-2020,284280,1722,877,283403,Europe
Portugal,04-05-2020,417487,2255,568,416919,Europe
Qatar,04-05-2020,169769,19,225,169544,Eastern Mediterranean
Romania,04-05-2020,180049,1079,34,180015,Europe
Russia,04-05-2020,403755,1732,145,403610,Europe
Rwanda,04-05-2020,293757,420,21,293736,Africa
Saint Lucia,04-05-2020,282097,1505,922,281175,Americas
Saint Vincent and the Grenadines,04-05-2020,116695,176,1025,115670,Americas
San Marino,04-05-2020,133043,2492,937,132106,Europe
Saudi Arabia,04-05-2020,43241,697,805,42436,Eastern Mediterranean
Senegal,04-05-2020,20783,1467,7,20776,Africa
Serbia,04-05-2020,409693,279,1113,408580,Europe
Seychelles,04-05-2020,114667,1649,994,113673,Africa
Singapore,04-05-2020,365230,1771,377,364853,Western Pacific
Slovakia,04-05-2020,215936,1451,1104,214832,Europe
Slovenia,04-05-2020,96351,2222,518,95833,Europe
Somalia,04-05-2020,94379,1406,197,94182,Eastern Mediterranean
South Africa,04-05-2020,251724,618,988,250736,Africa
Spain,04-05-2020,309632,1523,217,309415,Europe
Sri Lanka,04-05-2020,141024,1961,1106,139918,South-East Asia
Sudan,04-05-2020,154180,2097,1246,152934,Eastern Mediterranean
Suriname,04-05-2020,413383,2210,678,412705,Americas
Sweden,04-05-2020,50634,2469,432,50202,Europe
Switzerland,04-05-2020,56294,863,466,55828,Europe
Taiwan*,04-05-2020,105706,150,944,104762,Western Pacific
Tanzania,04-05-2020,144113,83,1032,143081,Africa
Thailand,04-05-2020,71073,749,1161,69912,South-East Asia
Togo,04-05-2020,34429,1922,642,33787,Africa
Trinidad and Tobago,04-05-2020,144906,1680,1072,143834,Americas
Tunisia,04-05-2020,299804,1694,109,299695,Eastern Mediterranean
Turkey,04-05-2020,177901,888,877,177024,Europe
Uganda,04-05-2020,310584,2081,713,309871,Africa
Ukraine,04-05-2020,393508,1933,971,392537,Europe
United Arab Emirates,04-05-2020,154036,2040,496,153540,Eastern Mediterranean
United Kingdom,04-05-2020,282310,588,378,281932,Europe
United Kingdom,04-05-2020,378824,2415,534,378290,Europe
United Kingdom,04-05-2020,243263,2237,697,242566,Europe
United Kingdom,04-05-2020,369146,2039,1119,368027,Europe
United Kingdom,04-05-2020,368341,956,109,368232,Europe
United Kingdom,04-05-2020,348072,481,1181,346891,Europe
United Kingdom,04-05-2020,139217,2160,852,138365,Europe
Uruguay,04-05-2020,61239,1971,936,60303,Americas
US,04-05-2020,123446,1061,619,122827,Americas
Uzbekistan,04-05-2020,332624,1718,1188,331436,Europe
Venezuela,04-05-2020,81524,1762,1008,80516,Americas
Vietnam,04-05-2020,222390,1321,157,222233,Western Pacific
Zambia,04-05-2020,150781,1031,14,150767,Africa
Zimbabwe,04-05-2020,217126,2092,692,216434,Africa
Dominica,04-05-2020,223263,363,180,223083,Americas
Grenada,04-05-2020,433815,1886,32,433783,Americas
Mozambique,04-05-2020,401464,561,1018,400446,Africa
Syria,04-05-2020,230826,1335,893,229933,Eastern Mediterranean
Timor-Leste,04-05-2020,322223,1169,750,321473,South-East Asia
Belize,04-05-2020,182979,1897,735,182244,Americas
Laos,04-05-2020,448121,624,954,447167,Western Pacific
Libya,04-05-2020,262424,759,1239,261185,Eastern Mediterranean
West Bank and Gaza,04-05-2020,385034,152,474,384560,Eastern Mediterranean
Guinea-Bissau,04-05-2020,124318,1609,289,124029,Africa
Mali,04-05-2020,69848,592,274,69574,Africa
Saint Kitts and Nevis,04-05-2020,171275,2017,887,170388,Americas
Canada,04-05-2020,382850,2475,483,382367,Americas
Canada,04-05-2020,256666,2471,350,256316,Americas
Kosovo,04-05-2020,446739,2476,1228,445511,Europe
Burma,04-05-2020,401319,978,713,400606,South-East Asia
United Kingdom,04-05-2020,256804,1365,287,256517,Europe
United Kingdom,04-05-2020,81356,357,88,81268,Europe
United Kingdom,04-05-2020,131448,303,463,130985,Europe
Botswana,04-05-2020,18491,1640,804,17687,Africa
Burundi,04-05-2020,247713,1335,245,247468,Africa
Sierra Leone,04-05-2020,262898,271,839,262059,Africa
Malawi,04-05-2020,339365,718,1199,338166,Africa
United Kingdom,04-05-2020,235060,1301,431,234629,Europe
France,04-05-2020,341646,162,286,341360,Europe
South Sudan,04-05-2020,15043,1219,492,14551,Africa
Western Sahara,04-05-2020,139180,1120,207,138973,Africa
Sao Tome and Principe,04-05-2020,47209,1765,360,46849,Africa
Yemen,04-05-2020,88170,1940,909,87261,Eastern Mediterranean
Comoros,04-05-2020,221539,1915,646,220893,Africa
Tajikistan,04-05-2020,338783,588,1122,337661,Europe
Lesotho,04-05-2020,216075,586,1192,214883,Africa
Afghanistan,05-05-2020,231402,300,645,230757,Eastern Mediterranean
Albania,05-05-2020,434226,1082,162,434064,Europe
Algeria,05-05-2020,233489,2085,858,232631,Africa
Andorra,05-05-2020,205766,1093,540,205226,Europe
Angola,05-05-2020,274670,671,1006,273664,Africa
Antigua and Barbuda,05-05-2020,379094,1893,1157,377937,Americas
Argentina,05-05-2020,390477,316,1196,389281,Americas
Armenia,05-05-2020,110890,848,225,110665,Europe
Australia,05-05-2020,289547,953,61,289486,Western Pacific
Australia,05-05-2020,150729,1021,76,150653,Western Pacific
Australia,05-05-2020,313509,654,361,313148,Western Pacific
Australia,05-05-2020,386233,143,483,385750,Western Pacific
Australia,05-05-2020,194848,2193,1149,193699,Western Pacific
Australia,05-05-2020,322446,1841,135,322311,Western Pacific
Australia,05-05-2020,199352,2069,11,199341,Western Pacific
Australia,05-05-2020,72018,2412,50,71968,Western Pacific
Austria,05-05-2020,244404,750,1064,243340,Europe
Azerbaijan,05-05-2020,386848,873,299,386549,Europe
Bahamas,05-05-2020,46948,2049,1103,45845,Americas
Bahrain,05-05-2020,386799,1011,833,385966,Eastern Mediterranean
Bangladesh,05-05-2020,277029,1885,1150,275879,South-East Asia
Barbados,05-05-2020,378388,2141,488,377900,Americas
Belarus,05-05-2020,311833,2380,820,311013,Europe
Belgium,05-05-2020,556,1000,688,-132,Europe
Benin,05-05-2020,91214,1422,578,90636,Africa
Bhutan,05-05-2020,13893,1923,85,13808,South-East Asia
Bolivia,05-05-2020,93616,983,70,93546,Americas
Bosnia and Herzegovina,05-05-2020,208433,1019,1212,207221,Europe
Brazil,05-05-2020,423372,835,0,423372,Americas
Brunei,05-05-2020,409368,390,1177,408191,Western Pacific
Bulgaria,05-05-2020,339335,1427,767,338568,Europe
Burkina Faso,05-05-2020,93089,2457,1218,91871,Africa
Cabo Verde,05-05-2020,355163,1927,1138,354025,Africa
Cambodia,05-05-2020,87596,852,511,87085,Western Pacific
Cameroon,05-05-2020,286448,1508,897,285551,Africa
Canada,05-05-2020,194505,398,646,193859,Americas
Canada,05-05-2020,252692,1509,65,252627,Americas
Canada,05-05-2020,184266,1377,546,183720,Americas
Canada,05-05-2020,119373,427,70,119303,Americas
Canada,05-05-2020,403292,972,470,402822,Americas
Canada,05-05-2020,247714,33,395,247319,Americas
Canada,05-05-2020,28751,1451,161,28590,Americas
Canada,05-05-2020,414520,1880,168,414352,Americas
Canada,05-05-2020,112323,1606,223,112100,Americas
Canada,05-05-2020,420361,491,1017,419344,Americas
Central African Republic,05-05-2020,187512,1908,858,186654,Africa
Chad,05-05-2020,147013,1451,786,146227,Africa
Chile,05-05-2020,292177,214,1167,291010,Americas
China,05-05-2020,59175,1374,358,58817,Western Pacific
China,05-05-2020,72243,2033,402,71841,Western Pacific
China,05-05-2020,108296,346,426,107870,Western Pacific
China,05-05-2020,332993,2387,211,332782,Western Pacific
China,05-05-2020,311487,870,310,311177,Western Pacific
China,05-05-2020,17539,79,642,16897,Western Pacific
China,05-05-2020,173997,1405,1108,172889,Western Pacific
China,05-05-2020,399666,613,1090,398576,Western Pacific
China,05-05-2020,334420,520,917,333503,Western Pacific
China,05-05-2020,201446,1795,673,200773,Western Pacific
China,05-05-2020,77652,2360,1212,76440,Western Pacific
China,05-05-2020,282422,1460,651,281771,Western Pacific
China,05-05-2020,172837,1662,871,171966,Western Pacific
China,05-05-2020,238910,1798,26,238884,Western Pacific
China,05-05-2020,290064,425,313,289751,Western Pacific
China,05-05-2020,327844,423,918,326926,Western Pacific
China,05-05-2020,30960,1225,40,30920,Western Pacific
China,05-05-2020,1172,514,1089,83,Western Pacific
China,05-05-2020,179529,1761,420,179109,Western Pacific
China,05-05-2020,273434,187,324,273110,Western Pacific
China,05-05-2020,342519,558,274,342245,Western Pacific
China,05-05-2020,240812,916,693,240119,Western Pacific
China,05-05-2020,88020,1895,947,87073,Western Pacific
China,05-05-2020,159710,1261,539,159171,Western Pacific
China,05-05-2020,165614,1083,618,164996,Western Pacific
China,05-05-2020,372156,1788,1127,371029,Western Pacific
China,05-05-2020,283611,1370,345,283266,Western Pacific
China,05-05-2020,15001,270,1052,13949,Western Pacific
China,05-05-2020,2921,1302,186,2735,Western Pacific
China,05-05-2020,252974,1348,42,252932,Western Pacific
China,05-05-2020,308854,2138,620,308234,Western Pacific
China,05-05-2020,10119,1147,208,9911,Western Pacific
China,05-05-2020,313314,823,384,312930,Western Pacific
Colombia,05-05-2020,167745,2198,1207,166538,Americas
Congo (Brazzaville),05-05-2020,134858,452,847,134011,Africa
Congo (Kinshasa),05-05-2020,354428,2094,253,354175,Africa
Costa Rica,05-05-2020,162140,219,883,161257,Americas
Cote d'Ivoire,05-05-2020,332849,1890,148,332701,Africa
Croatia,05-05-2020,99399,2079,714,98685,Europe
Cuba,05-05-2020,64905,889,391,64514,Americas
Cyprus,05-05-2020,392886,654,791,392095,Europe
Czechia,05-05-2020,167527,2295,882,166645,Europe
Denmark,05-05-2020,356340,1666,1126,355214,Europe
Greenland,05-05-2020,236241,949,527,235714,Europe
Denmark,05-05-2020,276784,464,343,276441,Europe
Djibouti,05-05-2020,8434,1256,1127,7307,Eastern Mediterranean
Dominican Republic,05-05-2020,293141,2059,952,292189,Americas
Ecuador,05-05-2020,26223,970,375,25848,Americas
Egypt,05-05-2020,288547,2314,377,288170,Eastern Mediterranean
El Salvador,05-05-2020,126036,2296,1246,124790,Americas
Equatorial Guinea,05-05-2020,267545,86,542,267003,Africa
Eritrea,05-05-2020,324940,2375,946,323994,Africa
Estonia,05-05-2020,288232,1563,520,287712,Europe
Eswatini,05-05-2020,376814,193,696,376118,Africa
Ethiopia,05-05-2020,11202,951,505,10697,Africa
Fiji,05-05-2020,407191,1177,337,406854,Western Pacific
Finland,05-05-2020,388088,129,1249,386839,Europe
France,05-05-2020,21965,1359,656,21309,Europe
France,05-05-2020,157148,417,371,156777,Europe
France,05-05-2020,433110,846,737,432373,Europe
France,05-05-2020,409306,2118,87,409219,Europe
France,05-05-2020,67518,29,243,67275,Europe
France,05-05-2020,352835,1226,455,352380,Europe
France,05-05-2020,432062,2375,1241,430821,Europe
France,05-05-2020,401167,1870,155,401012,Europe
France,05-05-2020,222572,2407,492,222080,Europe
France,05-05-2020,264609,693,1233,263376,Europe
Gabon,05-05-2020,439067,2213,545,438522,Africa
Gambia,05-05-2020,441800,1113,818,440982,Africa
Georgia,05-05-2020,430431,56,994,429437,Europe
Germany,05-05-2020,221441,1979,239,221202,Europe
Ghana,05-05-2020,143026,897,298,142728,Africa
Greece,05-05-2020,130216,2432,865,129351,Europe
Guatemala,05-05-2020,402377,2123,228,402149,Americas
Guinea,05-05-2020,271034,2012,104,270930,Africa
Guyana,05-05-2020,427360,1691,1193,426167,Americas
Haiti,05-05-2020,293251,1660,152,293099,Americas
Holy See,05-05-2020,186314,2380,944,185370,Europe
Honduras,05-05-2020,151591,234,466,151125,Americas
Hungary,05-05-2020,444803,1108,477,444326,Europe
Iceland,05-05-2020,337820,548,145,337675,Europe
India,05-05-2020,132916,726,748,132168,South-East Asia
Indonesia,05-05-2020,25549,305,132,25417,South-East Asia
Iran,05-05-2020,49870,1715,240,49630,Eastern Mediterranean
Iraq,05-05-2020,65339,27,914,64425,Eastern Mediterranean
Ireland,05-05-2020,287982,724,645,287337,Europe
Israel,05-05-2020,16300,1019,798,15502,Europe
Italy,05-05-2020,155447,1938,867,154580,Europe
Jamaica,05-05-2020,195484,1674,674,194810,Americas
Japan,05-05-2020,21522,934,482,21040,Western Pacific
Jordan,05-05-2020,287344,1510,1180,286164,Eastern Mediterranean
Kazakhstan,05-05-2020,305654,1719,1067,304587,Europe
Kenya,05-05-2020,211745,456,82,211663,Africa
South Korea,05-05-2020,159000,450,362,158638,Western Pacific
Kuwait,05-05-2020,228857,2175,367,228490,Eastern Mediterranean
Kyrgyzstan,05-05-2020,64166,259,1233,62933,Europe
Latvia,05-05-2020,341861,1807,771,341090,Europe
Lebanon,05-05-2020,95941,1137,686,95255,Eastern Mediterranean
Liberia,05-05-2020,275118,2394,728,274390,Africa
Liechtenstein,05-05-2020,301877,94,501,301376,Europe
Lithuania,05-05-2020,210871,848,110,210761,Europe
Luxembourg,05-05-2020,429642,650,149,429493,Europe
Madagascar,05-05-2020,192386,2292,82,192304,Africa
Malaysia,05-05-2020,432409,819,957,431452,Western Pacific
Maldives,05-05-2020,232346,377,540,231806,South-East Asia
Malta,05-05-2020,42269,586,276,41993,Europe
Mauritania,05-05-2020,126677,961,761,125916,Africa
Mauritius,05-05-2020,41100,366,913,40187,Africa
Mexico,05-05-2020,32549,2168,518,32031,Americas
Moldova,05-05-2020,206018,2032,103,205915,Europe
Monaco,05-05-2020,164547,1741,975,163572,Europe
Mongolia,05-05-2020,414382,1454,1219,413163,Western Pacific
Montenegro,05-05-2020,55568,2307,933,54635,Europe
Morocco,05-05-2020,316736,638,681,316055,Eastern Mediterranean
Namibia,05-05-2020,177346,2374,231,177115,Africa
Nepal,05-05-2020,305216,2307,118,305098,South-East Asia
Netherlands,05-05-2020,344361,211,946,343415,Europe
Netherlands,05-05-2020,376979,915,347,376632,Europe
Netherlands,05-05-2020,2089,1143,504,1585,Europe
Netherlands,05-05-2020,417135,2093,45,417090,Europe
New Zealand,05-05-2020,412344,118,282,412062,Western Pacific
Nicaragua,05-05-2020,89984,404,20,89964,Americas
Niger,05-05-2020,427601,365,794,426807,Africa
Nigeria,05-05-2020,217572,222,215,217357,Africa
North Macedonia,05-05-2020,58818,2236,1240,57578,Europe
Norway,05-05-2020,172715,386,1136,171579,Europe
Oman,05-05-2020,288480,294,262,288218,Eastern Mediterranean
Pakistan,05-05-2020,234020,1337,1223,232797,Eastern Mediterranean
Panama,05-05-2020,120969,875,144,120825,Americas
Papua New Guinea,05-05-2020,53234,2210,253,52981,Western Pacific
Paraguay,05-05-2020,212698,679,506,212192,Americas
Peru,05-05-2020,409293,990,1057,408236,Americas
Philippines,05-05-2020,252662,528,8,252654,Western Pacific
Poland,05-05-2020,281604,684,291,281313,Europe
Portugal,05-05-2020,442662,389,447,442215,Europe
Qatar,05-05-2020,328242,523,869,327373,Eastern Mediterranean
Romania,05-05-2020,373956,1885,24,373932,Europe
Russia,05-05-2020,266796,767,161,266635,Europe
Rwanda,05-05-2020,254165,923,1052,253113,Africa
Saint Lucia,05-05-2020,253249,1329,256,252993,Americas
Saint Vincent and the Grenadines,05-05-2020,344034,1948,757,343277,Americas
San Marino,05-05-2020,267399,218,509,266890,Europe
Saudi Arabia,05-05-2020,209656,2497,179,209477,Eastern Mediterranean
Senegal,05-05-2020,116439,242,294,116145,Africa
Serbia,05-05-2020,121626,2029,81,121545,Europe
Seychelles,05-05-2020,448910,1921,412,448498,Africa
Singapore,05-05-2020,76244,1938,161,76083,Western Pacific
Slovakia,05-05-2020,195415,350,746,194669,Europe
Slovenia,05-05-2020,226331,98,151,226180,Europe
Somalia,05-05-2020,380919,1459,318,380601,Eastern Mediterranean
South Africa,05-05-2020,336106,389,15,336091,Africa
Spain,05-05-2020,288053,51,794,287259,Europe
Sri Lanka,05-05-2020,44230,572,455,43775,South-East Asia
Sudan,05-05-2020,255291,928,1156,254135,Eastern Mediterranean
Suriname,05-05-2020,331536,1312,775,330761,Americas
Sweden,05-05-2020,141457,2450,1099,140358,Europe
Switzerland,05-05-2020,90443,582,1132,89311,Europe
Taiwan*,05-05-2020,48920,2202,809,48111,Western Pacific
Tanzania,05-05-2020,141743,421,700,141043,Africa
Thailand,05-05-2020,148634,2140,353,148281,South-East Asia
Togo,05-05-2020,302194,2166,674,301520,Africa
Trinidad and Tobago,05-05-2020,265403,1375,1145,264258,Americas
Tunisia,05-05-2020,408515,1838,94,408421,Eastern Mediterranean
Turkey,05-05-2020,295115,379,758,294357,Europe
Uganda,05-05-2020,144106,721,424,143682,Africa
Ukraine,05-05-2020,348863,1711,112,348751,Europe
United Arab Emirates,05-05-2020,245270,1215,1060,244210,Eastern Mediterranean
United Kingdom,05-05-2020,125513,2376,1114,124399,Europe
United Kingdom,05-05-2020,290379,2323,1017,289362,Europe
United Kingdom,05-05-2020,70552,226,818,69734,Europe
United Kingdom,05-05-2020,69253,2141,1182,68071,Europe
United Kingdom,05-05-2020,444120,247,1027,443093,Europe
United Kingdom,05-05-2020,222081,890,1002,221079,Europe
United Kingdom,05-05-2020,376878,805,779,376099,Europe
Uruguay,05-05-2020,380275,1532,1136,379139,Americas
US,05-05-2020,223428,350,78,223350,Americas
Uzbekistan,05-05-2020,404135,2186,1092,403043,Europe
Venezuela,05-05-2020,116931,2122,260,116671,Americas
Vietnam,05-05-2020,380175,54,1008,379167,Western Pacific
Zambia,05-05-2020,178563,967,890,177673,Africa
Zimbabwe,05-05-2020,272385,1089,1000,271385,Africa
Dominica,05-05-2020,273849,2151,608,273241,Americas
Grenada,05-05-2020,291465,2497,1159,290306,Americas
Mozambique,05-05-2020,202878,1868,1107,201771,Africa
Syria,05-05-2020,87612,419,839,86773,Eastern Mediterranean
Timor-Leste,05-05-2020,70541,1473,114,70427,South-East Asia
Belize,05-05-2020,390573,2216,758,389815,Americas
Laos,05-05-2020,238084,1096,1172,236912,Western Pacific
Libya,05-05-2020,271227,1622,829,270398,Eastern Mediterranean
West Bank and Gaza,05-05-2020,431120,1542,428,430692,Eastern Mediterranean
Guinea-Bissau,05-05-2020,74916,1299,1077,73839,Africa
Mali,05-05-2020,66197,1710,487,65710,Africa
Saint Kitts and Nevis,05-05-2020,421713,840,591,421122,Americas
Canada,05-05-2020,404365,2298,1046,403319,Americas
Canada,05-05-2020,46198,1383,653,45545,Americas
Kosovo,05-05-2020,388146,1671,648,387498,Europe
Burma,05-05-2020,326205,1339,941,325264,South-East Asia
United Kingdom,05-05-2020,52859,2213,290,52569,Europe
United Kingdom,05-05-2020,132450,1462,866,131584,Europe
United Kingdom,05-05-2020,63591,574,116,63475,Europe
Botswana,05-05-2020,242478,614,90,242388,Africa
Burundi,05-05-2020,378896,1549,541,378355,Africa
Sierra Leone,05-05-2020,422361,1203,816,421545,Africa
Malawi,05-05-2020,173149,811,982,172167,Africa
United Kingdom,05-05-2020,14375,1859,806,13569,Europe
France,05-05-2020,441450,2035,66,441384,Europe
South Sudan,05-05-2020,382192,841,1154,381038,Africa
Western Sahara,05-05-2020,259591,1090,327,259264,Africa
Sao Tome and Principe,05-05-2020,106083,2357,213,105870,Africa
Yemen,05-05-2020,176413,308,41,176372,Eastern Mediterranean
Comoros,05-05-2020,317124,94,345,316779,Africa
Tajikistan,05-05-2020,385457,307,382,385075,Europe
Lesotho,05-05-2020,172652,180,429,172223,Africa
Afghanistan,06-05-2020,431775,1275,790,430985,Eastern Mediterranean
Albania,06-05-2020,159347,1242,237,159110,Europe
Algeria,06-05-2020,258974,2115,121,258853,Africa
Andorra,06-05-2020,24555,241,604,23951,Europe
Angola,06-05-2020,142693,1981,954,141739,Africa
Antigua and Barbuda,06-05-2020,200395,749,913,199482,Americas
Argentina,06-05-2020,261819,2298,454,261365,Americas
Armenia,06-05-2020,263649,1588,701,262948,Europe
Australia,06-05-2020,63459,2114,311,63148,Western Pacific
Australia,06-05-2020,86669,1710,845,85824,Western Pacific
Australia,06-05-2020,10262,747,1013,9249,Western Pacific
Australia,06-05-2020,38026,780,844,37182,Western Pacific
Australia,06-05-2020,193885,980,742,193143,Western Pacific
Australia,06-05-2020,256875,254,1088,255787,Western Pacific
Australia,06-05-2020,198404,2010,1057,197347,Western Pacific
Australia,06-05-2020,435332,766,717,434615,Western Pacific
Austria,06-05-2020,290553,1056,569,289984,Europe
Azerbaijan,06-05-2020,351319,1445,601,350718,Europe
Bahamas,06-05-2020,408976,629,1053,407923,Americas
Bahrain,06-05-2020,279125,70,829,278296,Eastern Mediterranean
Bangladesh,06-05-2020,4200,854,42,4158,South-East Asia
Barbados,06-05-2020,338238,909,446,337792,Americas
Belarus,06-05-2020,90470,470,187,90283,Europe
Belgium,06-05-2020,284930,2167,1121,283809,Europe
Benin,06-05-2020,25008,853,205,24803,Africa
Bhutan,06-05-2020,262572,1537,889,261683,South-East Asia
Bolivia,06-05-2020,347786,1803,490,347296,Americas
Bosnia and Herzegovina,06-05-2020,203279,1636,1189,202090,Europe
Brazil,06-05-2020,447881,643,442,447439,Americas
Brunei,06-05-2020,414556,612,1169,413387,Western Pacific
Bulgaria,06-05-2020,82590,506,560,82030,Europe
Burkina Faso,06-05-2020,282970,1574,1032,281938,Africa
Cabo Verde,06-05-2020,296884,438,5,296879,Africa
Cambodia,06-05-2020,261099,301,946,260153,Western Pacific
Cameroon,06-05-2020,442513,385,944,441569,Africa
Canada,06-05-2020,123497,1524,963,122534,Americas
Canada,06-05-2020,263310,459,565,262745,Americas
Canada,06-05-2020,425279,703,396,424883,Americas
Canada,06-05-2020,190493,1397,175,190318,Americas
Canada,06-05-2020,236601,1332,677,235924,Americas
Canada,06-05-2020,324193,660,909,323284,Americas
Canada,06-05-2020,37738,2128,1037,36701,Americas
Canada,06-05-2020,190171,937,906,189265,Americas
Canada,06-05-2020,61684,2261,808,60876,Americas
Canada,06-05-2020,184286,1671,208,184078,Americas
Central African Republic,06-05-2020,39644,51,7,39637,Africa
Chad,06-05-2020,197232,2460,1086,196146,Africa
Chile,06-05-2020,44990,2279,671,44319,Americas
China,06-05-2020,179094,2243,147,178947,Western Pacific
China,06-05-2020,52251,833,151,52100,Western Pacific
China,06-05-2020,3096,2169,1076,2020,Western Pacific
China,06-05-2020,238582,874,681,237901,Western Pacific
China,06-05-2020,233648,413,1009,232639,Western Pacific
China,06-05-2020,146609,2065,949,145660,Western Pacific
China,06-05-2020,244307,849,395,243912,Western Pacific
China,06-05-2020,147353,1371,41,147312,Western Pacific
China,06-05-2020,218772,1039,1216,217556,Western Pacific
China,06-05-2020,327610,1756,99,327511,Western Pacific
China,06-05-2020,202684,732,203,202481,Western Pacific
China,06-05-2020,285646,569,721,284925,Western Pacific
China,06-05-2020,69057,817,975,68082,Western Pacific
China,06-05-2020,224580,1478,1104,223476,Western Pacific
China,06-05-2020,27947,628,350,27597,Western Pacific
China,06-05-2020,133993,471,521,133472,Western Pacific
China,06-05-2020,172657,779,580,172077,Western Pacific
China,06-05-2020,197087,587,860,196227,Western Pacific
China,06-05-2020,223379,1730,1133,222246,Western Pacific
China,06-05-2020,366157,735,692,365465,Western Pacific
China,06-05-2020,368420,995,510,367910,Western Pacific
China,06-05-2020,45311,1443,275,45036,Western Pacific
China,06-05-2020,150602,1149,707,149895,Western Pacific
China,06-05-2020,169718,587,281,169437,Western Pacific
China,06-05-2020,320700,2391,129,320571,Western Pacific
China,06-05-2020,294452,465,660,293792,Western Pacific
China,06-05-2020,28689,1444,823,27866,Western Pacific
China,06-05-2020,207541,410,239,207302,Western Pacific
China,06-05-2020,121542,166,1066,120476,Western Pacific
China,06-05-2020,167705,225,194,167511,Western Pacific
China,06-05-2020,423969,640,951,423018,Western Pacific
China,06-05-2020,224141,2426,485,223656,Western Pacific
China,06-05-2020,121824,1899,269,121555,Western Pacific
Colombia,06-05-2020,23022,1499,316,22706,Americas
Congo (Brazzaville),06-05-2020,287114,245,333,286781,Africa
Congo (Kinshasa),06-05-2020,342910,2227,222,342688,Africa
Costa Rica,06-05-2020,182961,1624,1154,181807,Americas
Cote d'Ivoire,06-05-2020,69103,1663,1007,68096,Africa
Croatia,06-05-2020,51457,1279,173,51284,Europe
Cuba,06-05-2020,284273,336,610,283663,Americas
Cyprus,06-05-2020,246026,1378,1058,244968,Europe
Czechia,06-05-2020,213419,474,200,213219,Europe
Denmark,06-05-2020,16099,2325,701,15398,Europe
Greenland,06-05-2020,207615,1681,1232,206383,Europe
Denmark,06-05-2020,324546,2,385,324161,Europe
Djibouti,06-05-2020,100416,759,131,100285,Eastern Mediterranean
Dominican Republic,06-05-2020,353912,1067,448,353464,Americas
Ecuador,06-05-2020,272725,1110,705,272020,Americas
Egypt,06-05-2020,63256,2036,63,63193,Eastern Mediterranean
El Salvador,06-05-2020,330502,241,749,329753,Americas
Equatorial Guinea,06-05-2020,86689,1050,491,86198,Africa
Eritrea,06-05-2020,334172,1488,421,333751,Africa
Estonia,06-05-2020,358675,2114,801,357874,Europe
Eswatini,06-05-2020,103083,1605,533,102550,Africa
Ethiopia,06-05-2020,144445,2379,1076,143369,Africa
Fiji,06-05-2020,259219,2385,1093,258126,Western Pacific
Finland,06-05-2020,287655,613,1026,286629,Europe
France,06-05-2020,218835,750,1165,217670,Europe
France,06-05-2020,436776,1578,355,436421,Europe
France,06-05-2020,211089,1298,820,210269,Europe
France,06-05-2020,286862,1343,8,286854,Europe
France,06-05-2020,413794,1799,564,413230,Europe
France,06-05-2020,20088,739,883,19205,Europe
France,06-05-2020,419347,2268,539,418808,Europe
France,06-05-2020,26475,767,334,26141,Europe
France,06-05-2020,206293,1758,287,206006,Europe
France,06-05-2020,103105,1753,549,102556,Europe
Gabon,06-05-2020,178491,245,34,178457,Africa
Gambia,06-05-2020,55472,1002,720,54752,Africa
Georgia,06-05-2020,275476,139,19,275457,Europe
Germany,06-05-2020,277888,1385,639,277249,Europe
Ghana,06-05-2020,189111,1035,564,188547,Africa
Greece,06-05-2020,397899,2106,281,397618,Europe
Guatemala,06-05-2020,387637,1206,891,386746,Americas
Guinea,06-05-2020,10962,1820,1194,9768,Africa
Guyana,06-05-2020,432268,463,580,431688,Americas
Haiti,06-05-2020,279121,335,260,278861,Americas
Holy See,06-05-2020,260877,884,45,260832,Europe
Honduras,06-05-2020,85446,1907,985,84461,Americas
Hungary,06-05-2020,334862,1860,286,334576,Europe
Iceland,06-05-2020,290618,1174,1158,289460,Europe
India,06-05-2020,282176,1974,1145,281031,South-East Asia
Indonesia,06-05-2020,25926,57,249,25677,South-East Asia
Iran,06-05-2020,127691,445,1004,126687,Eastern Mediterranean
Iraq,06-05-2020,144090,1561,607,143483,Eastern Mediterranean
Ireland,06-05-2020,432279,1724,425,431854,Europe
Israel,06-05-2020,210697,1890,12,210685,Europe
Italy,06-05-2020,252955,473,683,252272,Europe
Jamaica,06-05-2020,233060,1552,938,232122,Americas
Japan,06-05-2020,415219,1702,485,414734,Western Pacific
Jordan,06-05-2020,236511,1390,18,236493,Eastern Mediterranean
Kazakhstan,06-05-2020,226932,1106,316,226616,Europe
Kenya,06-05-2020,189424,2014,1065,188359,Africa
South Korea,06-05-2020,124505,1434,775,123730,Western Pacific
Kuwait,06-05-2020,251781,786,557,251224,Eastern Mediterranean
Kyrgyzstan,06-05-2020,221404,1141,1066,220338,Europe
Latvia,06-05-2020,11072,2105,845,10227,Europe
Lebanon,06-05-2020,213419,319,889,212530,Eastern Mediterranean
Liberia,06-05-2020,111210,1164,124,111086,Africa
Liechtenstein,06-05-2020,64279,1339,865,63414,Europe
Lithuania,06-05-2020,159033,687,919,158114,Europe
Luxembourg,06-05-2020,381731,859,599,381132,Europe
Madagascar,06-05-2020,391549,355,1185,390364,Africa
Malaysia,06-05-2020,76312,340,81,76231,Western Pacific
Maldives,06-05-2020,402135,2491,754,401381,South-East Asia
Malta,06-05-2020,195780,1415,827,194953,Europe
Mauritania,06-05-2020,239826,1860,692,239134,Africa
Mauritius,06-05-2020,96831,808,933,95898,Africa
Mexico,06-05-2020,434179,1885,766,433413,Americas
Moldova,06-05-2020,357390,2058,512,356878,Europe
Monaco,06-05-2020,89804,834,1126,88678,Europe
Mongolia,06-05-2020,334543,1848,354,334189,Western Pacific
Montenegro,06-05-2020,392159,71,788,391371,Europe
Morocco,06-05-2020,375023,1502,423,374600,Eastern Mediterranean
Namibia,06-05-2020,135852,1276,199,135653,Africa
Nepal,06-05-2020,339454,1896,692,338762,South-East Asia
Netherlands,06-05-2020,384708,1344,1066,383642,Europe
Netherlands,06-05-2020,87276,267,143,87133,Europe
Netherlands,06-05-2020,265488,1709,1036,264452,Europe
Netherlands,06-05-2020,41998,548,615,41383,Europe
New Zealand,06-05-2020,323119,31,357,322762,Western Pacific
Nicaragua,06-05-2020,275906,2443,1180,274726,Americas
Niger,06-05-2020,65281,1285,991,64290,Africa
Nigeria,06-05-2020,429390,1364,853,428537,Africa
North Macedonia,06-05-2020,1727,1219,14,1713,Europe
Norway,06-05-2020,277321,253,204,277117,Europe
Oman,06-05-2020,244686,588,115,244571,Eastern Mediterranean
Pakistan,06-05-2020,266082,961,404,265678,Eastern Mediterranean
Panama,06-05-2020,282552,2251,828,281724,Americas
Papua New Guinea,06-05-2020,359729,2265,741,358988,Western Pacific
Paraguay,06-05-2020,129670,33,862,128808,Americas
Peru,06-05-2020,244278,747,102,244176,Americas
Philippines,06-05-2020,72090,2379,324,71766,Western Pacific
Poland,06-05-2020,394077,2138,851,393226,Europe
Portugal,06-05-2020,24877,2347,997,23880,Europe
Qatar,06-05-2020,103687,1893,323,103364,Eastern Mediterranean
Romania,06-05-2020,305652,1859,997,304655,Europe
Russia,06-05-2020,386229,1914,884,385345,Europe
Rwanda,06-05-2020,181445,1725,589,180856,Africa
Saint Lucia,06-05-2020,275884,2318,1248,274636,Americas
Saint Vincent and the Grenadines,06-05-2020,53169,1230,141,53028,Americas
San Marino,06-05-2020,148899,1890,783,148116,Europe
Saudi Arabia,06-05-2020,36560,1705,859,35701,Eastern Mediterranean
Senegal,06-05-2020,195385,2112,1024,194361,Africa
Serbia,06-05-2020,21267,1114,638,20629,Europe
Seychelles,06-05-2020,351254,253,901,350353,Africa
Singapore,06-05-2020,301541,1976,1133,300408,Western Pacific
Slovakia,06-05-2020,183610,1482,432,183178,Europe
Slovenia,06-05-2020,58051,703,188,57863,Europe
Somalia,06-05-2020,102723,1034,113,102610,Eastern Mediterranean
South Africa,06-05-2020,446362,2282,224,446138,Africa
Spain,06-05-2020,214357,2333,39,214318,Europe
Sri Lanka,06-05-2020,266995,900,787,266208,South-East Asia
Sudan,06-05-2020,26331,184,1212,25119,Eastern Mediterranean
Suriname,06-05-2020,195841,2018,13,195828,Americas
Sweden,06-05-2020,324688,725,1068,323620,Europe
Switzerland,06-05-2020,124655,2311,739,123916,Europe
Taiwan*,06-05-2020,155657,1001,24,155633,Western Pacific
Tanzania,06-05-2020,412420,804,1061,411359,Africa
Thailand,06-05-2020,264672,257,82,264590,South-East Asia
Togo,06-05-2020,107242,1942,236,107006,Africa
Trinidad and Tobago,06-05-2020,398559,1761,585,397974,Americas
Tunisia,06-05-2020,117991,1099,764,117227,Eastern Mediterranean
Turkey,06-05-2020,411325,1840,803,410522,Europe
Uganda,06-05-2020,422683,305,31,422652,Africa
Ukraine,06-05-2020,110942,142,865,110077,Europe
United Arab Emirates,06-05-2020,367476,1767,867,366609,Eastern Mediterranean
United Kingdom,06-05-2020,148500,691,8,148492,Europe
United Kingdom,06-05-2020,227329,842,884,226445,Europe
United Kingdom,06-05-2020,43468,41,22,43446,Europe
United Kingdom,06-05-2020,321708,549,333,321375,Europe
United Kingdom,06-05-2020,145251,403,471,144780,Europe
United Kingdom,06-05-2020,336200,2119,308,335892,Europe
United Kingdom,06-05-2020,354357,634,545,353812,Europe
Uruguay,06-05-2020,151170,1941,456,150714,Americas
US,06-05-2020,19794,458,129,19665,Americas
Uzbekistan,06-05-2020,26727,636,902,25825,Europe
Venezuela,06-05-2020,200061,701,319,199742,Americas
Vietnam,06-05-2020,435543,108,1056,434487,Western Pacific
Zambia,06-05-2020,159922,1585,923,158999,Africa
Zimbabwe,06-05-2020,160700,2016,687,160013,Africa
Dominica,06-05-2020,271414,849,1245,270169,Americas
Grenada,06-05-2020,215288,623,733,214555,Americas
Mozambique,06-05-2020,66825,2057,393,66432,Africa
Syria,06-05-2020,209821,1822,1082,208739,Eastern Mediterranean
Timor-Leste,06-05-2020,340870,2415,314,340556,South-East Asia
Belize,06-05-2020,82764,525,977,81787,Americas
Laos,06-05-2020,234251,1019,289,233962,Western Pacific
Libya,06-05-2020,302030,588,1076,300954,Eastern Mediterranean
West Bank and Gaza,06-05-2020,14705,1133,490,14215,Eastern Mediterranean
Guinea-Bissau,06-05-2020,71164,227,231,70933,Africa
Mali,06-05-2020,254087,1520,1238,252849,Africa
Saint Kitts and Nevis,06-05-2020,299924,125,1007,298917,Americas
Canada,06-05-2020,46822,1797,36,46786,Americas
Canada,06-05-2020,15907,850,551,15356,Americas
Kosovo,06-05-2020,317154,1889,1127,316027,Europe
Burma,06-05-2020,201858,2085,1058,200800,South-East Asia
United Kingdom,06-05-2020,405776,1019,1209,404567,Europe
United Kingdom,06-05-2020,6008,1770,277,5731,Europe
United Kingdom,06-05-2020,424996,1987,930,424066,Europe
Botswana,06-05-2020,320949,446,1075,319874,Africa
Burundi,06-05-2020,162816,800,507,162309,Africa
Sierra Leone,06-05-2020,62693,1163,379,62314,Africa
Malawi,06-05-2020,77768,620,1189,76579,Africa
United Kingdom,06-05-2020,362115,57,827,361288,Europe
France,06-05-2020,444357,2147,866,443491,Europe
South Sudan,06-05-2020,9619,866,798,8821,Africa
Western Sahara,06-05-2020,169479,2433,921,168558,Africa
Sao Tome and Principe,06-05-2020,272067,1855,1219,270848,Africa
Yemen,06-05-2020,80729,1496,691,80038,Eastern Mediterranean
Comoros,06-05-2020,353484,855,189,353295,Africa
Tajikistan,06-05-2020,205368,772,944,204424,Europe
Lesotho,06-05-2020,302051,863,1245,300806,Africa
Afghanistan,07-05-2020,274219,1460,852,273367,Eastern Mediterranean
Albania,07-05-2020,406258,371,1224,405034,Europe
Algeria,07-05-2020,415011,1908,548,414463,Africa
Andorra,07-05-2020,71500,1193,578,70922,Europe
Angola,07-05-2020,233544,1352,470,233074,Africa
Antigua and Barbuda,07-05-2020,137023,835,1087,135936,Americas
Argentina,07-05-2020,79650,968,840,78810,Americas
Armenia,07-05-2020,299774,1905,895,298879,Europe
Australia,07-05-2020,9276,252,849,8427,Western Pacific
Australia,07-05-2020,24385,1465,172,24213,Western Pacific
Australia,07-05-2020,221206,1930,825,220381,Western Pacific
Australia,07-05-2020,213574,2437,915,212659,Western Pacific
Australia,07-05-2020,299099,2362,896,298203,Western Pacific
Australia,07-05-2020,336981,942,1115,335866,Western Pacific
Australia,07-05-2020,11862,2124,755,11107,Western Pacific
Australia,07-05-2020,271339,839,911,270428,Western Pacific
Austria,07-05-2020,128605,2246,942,127663,Europe
Azerbaijan,07-05-2020,78278,898,916,77362,Europe
Bahamas,07-05-2020,363247,2304,794,362453,Americas
Bahrain,07-05-2020,323798,376,3,323795,Eastern Mediterranean
Bangladesh,07-05-2020,438378,2211,57,438321,South-East Asia
Barbados,07-05-2020,135326,1542,1141,134185,Americas
Belarus,07-05-2020,405329,673,942,404387,Europe
Belgium,07-05-2020,343399,1456,1134,342265,Europe
Benin,07-05-2020,141571,774,42,141529,Africa
Bhutan,07-05-2020,24716,1928,304,24412,South-East Asia
Bolivia,07-05-2020,348130,739,314,347816,Americas
Bosnia and Herzegovina,07-05-2020,443502,1888,362,443140,Europe
Brazil,07-05-2020,187870,509,1009,186861,Americas
Brunei,07-05-2020,24265,2407,465,23800,Western Pacific
Bulgaria,07-05-2020,242414,375,212,242202,Europe
Burkina Faso,07-05-2020,154365,1808,824,153541,Africa
Cabo Verde,07-05-2020,245446,1720,1147,244299,Africa
Cambodia,07-05-2020,105129,1524,1006,104123,Western Pacific
Cameroon,07-05-2020,425591,691,1023,424568,Africa
Canada,07-05-2020,77176,544,779,76397,Americas
Canada,07-05-2020,33226,1676,453,32773,Americas
Canada,07-05-2020,224981,171,1033,223948,Americas
Canada,07-05-2020,263046,1617,929,262117,Americas
Canada,07-05-2020,398957,267,105,398852,Americas
Canada,07-05-2020,47571,173,823,46748,Americas
Canada,07-05-2020,279930,1144,976,278954,Americas
Canada,07-05-2020,387347,2086,500,386847,Americas
Canada,07-05-2020,179029,1207,57,178972,Americas
Canada,07-05-2020,373733,1860,350,373383,Americas
Central African Republic,07-05-2020,317433,2383,344,317089,Africa
Chad,07-05-2020,48858,1289,935,47923,Africa
Chile,07-05-2020,359604,2161,905,358699,Americas
China,07-05-2020,335492,177,514,334978,Western Pacific
China,07-05-2020,23019,2099,1088,21931,Western Pacific
China,07-05-2020,45383,1183,1092,44291,Western Pacific
China,07-05-2020,370620,306,5,370615,Western Pacific
China,07-05-2020,348344,1440,672,347672,Western Pacific
China,07-05-2020,58428,1964,727,57701,Western Pacific
China,07-05-2020,295069,1353,500,294569,Western Pacific
China,07-05-2020,223150,1446,43,223107,Western Pacific
China,07-05-2020,211780,784,73,211707,Western Pacific
China,07-05-2020,26517,2215,1051,25466,Western Pacific
China,07-05-2020,37600,1471,165,37435,Western Pacific
China,07-05-2020,13448,635,304,13144,Western Pacific
China,07-05-2020,325285,2368,479,324806,Western Pacific
China,07-05-2020,150358,1710,307,150051,Western Pacific
China,07-05-2020,42186,168,816,41370,Western Pacific
China,07-05-2020,260589,1257,555,260034,Western Pacific
China,07-05-2020,29354,967,845,28509,Western Pacific
China,07-05-2020,234188,1625,194,233994,Western Pacific
China,07-05-2020,142449,1916,205,142244,Western Pacific
China,07-05-2020,211103,1850,1059,210044,Western Pacific
China,07-05-2020,262748,109,463,262285,Western Pacific
China,07-05-2020,279761,2288,757,279004,Western Pacific
China,07-05-2020,24999,2071,543,24456,Western Pacific
China,07-05-2020,46665,1049,607,46058,Western Pacific
China,07-05-2020,147225,1819,846,146379,Western Pacific
China,07-05-2020,381224,1471,125,381099,Western Pacific
China,07-05-2020,121315,2485,671,120644,Western Pacific
China,07-05-2020,257051,1376,128,256923,Western Pacific
China,07-05-2020,431490,2433,1085,430405,Western Pacific
China,07-05-2020,142902,1221,107,142795,Western Pacific
China,07-05-2020,25661,1194,188,25473,Western Pacific
China,07-05-2020,387966,1791,995,386971,Western Pacific
China,07-05-2020,358583,1331,939,357644,Western Pacific
Colombia,07-05-2020,89198,2274,575,88623,Americas
Congo (Brazzaville),07-05-2020,401646,73,805,400841,Africa
Congo (Kinshasa),07-05-2020,436137,504,75,436062,Africa
Costa Rica,07-05-2020,311749,955,130,311619,Americas
Cote d'Ivoire,07-05-2020,282492,1859,687,281805,Africa
Croatia,07-05-2020,267448,33,1175,266273,Europe
Cuba,07-05-2020,37915,1568,160,37755,Americas
Cyprus,07-05-2020,339052,886,708,338344,Europe
Czechia,07-05-2020,122922,689,502,122420,Europe
Denmark,07-05-2020,188161,917,427,187734,Europe
Greenland,07-05-2020,8591,2308,123,8468,Europe
Denmark,07-05-2020,138440,1587,147,138293,Europe
Djibouti,07-05-2020,302292,1999,918,301374,Eastern Mediterranean
Dominican Republic,07-05-2020,224593,1197,1141,223452,Americas
Ecuador,07-05-2020,24993,1052,990,24003,Americas
Egypt,07-05-2020,112117,603,19,112098,Eastern Mediterranean
El Salvador,07-05-2020,343459,693,116,343343,Americas
Equatorial Guinea,07-05-2020,369227,1256,582,368645,Africa
Eritrea,07-05-2020,173326,1741,35,173291,Africa
Estonia,07-05-2020,241922,2461,729,241193,Europe
Eswatini,07-05-2020,86568,927,439,86129,Africa
Ethiopia,07-05-2020,194964,1343,810,194154,Africa
Fiji,07-05-2020,252879,848,151,252728,Western Pacific
Finland,07-05-2020,246098,267,1236,244862,Europe
France,07-05-2020,290922,1055,1097,289825,Europe
France,07-05-2020,342107,1237,987,341120,Europe
France,07-05-2020,256794,1105,1044,255750,Europe
France,07-05-2020,203804,2020,110,203694,Europe
France,07-05-2020,324701,1464,715,323986,Europe
France,07-05-2020,153635,3,559,153076,Europe
France,07-05-2020,12442,226,729,11713,Europe
France,07-05-2020,70793,175,382,70411,Europe
France,07-05-2020,228473,906,1151,227322,Europe
France,07-05-2020,437420,788,376,437044,Europe
Gabon,07-05-2020,258518,221,771,257747,Africa
Gambia,07-05-2020,109943,426,881,109062,Africa
Georgia,07-05-2020,205371,1465,326,205045,Europe
Germany,07-05-2020,52216,1941,1140,51076,Europe
Ghana,07-05-2020,96117,459,113,96004,Africa
Greece,07-05-2020,354597,608,1246,353351,Europe
Guatemala,07-05-2020,96719,259,655,96064,Americas
Guinea,07-05-2020,362666,2134,885,361781,Africa
Guyana,07-05-2020,134590,1220,1056,133534,Americas
Haiti,07-05-2020,286873,1107,1165,285708,Americas
Holy See,07-05-2020,203953,2137,1248,202705,Europe
Honduras,07-05-2020,170599,423,1005,169594,Americas
Hungary,07-05-2020,83440,598,647,82793,Europe
Iceland,07-05-2020,275918,376,182,275736,Europe
India,07-05-2020,356415,25,561,355854,South-East Asia
Indonesia,07-05-2020,212599,1818,886,211713,South-East Asia
Iran,07-05-2020,339768,1473,180,339588,Eastern Mediterranean
Iraq,07-05-2020,133008,987,225,132783,Eastern Mediterranean
Ireland,07-05-2020,211611,1627,129,211482,Europe
Israel,07-05-2020,292596,2495,557,292039,Europe
Italy,07-05-2020,303846,451,568,303278,Europe
Jamaica,07-05-2020,282070,191,1003,281067,Americas
Japan,07-05-2020,164085,2385,589,163496,Western Pacific
Jordan,07-05-2020,204613,1939,351,204262,Eastern Mediterranean
Kazakhstan,07-05-2020,266996,218,699,266297,Europe
Kenya,07-05-2020,188755,61,165,188590,Africa
South Korea,07-05-2020,234677,1594,781,233896,Western Pacific
Kuwait,07-05-2020,172314,308,1066,171248,Eastern Mediterranean
Kyrgyzstan,07-05-2020,381307,1355,1000,380307,Europe
Latvia,07-05-2020,100663,618,197,100466,Europe
Lebanon,07-05-2020,75924,388,896,75028,Eastern Mediterranean
Liberia,07-05-2020,157010,1353,895,156115,Africa
Liechtenstein,07-05-2020,74084,226,726,73358,Europe
Lithuania,07-05-2020,400348,1203,997,399351,Europe
Luxembourg,07-05-2020,145930,2404,1049,144881,Europe
Madagascar,07-05-2020,275492,1752,1046,274446,Africa
Malaysia,07-05-2020,425129,440,835,424294,Western Pacific
Maldives,07-05-2020,361647,1765,1102,360545,South-East Asia
Malta,07-05-2020,270805,376,391,270414,Europe
Mauritania,07-05-2020,65277,1434,208,65069,Africa
Mauritius,07-05-2020,320568,21,11,320557,Africa
Mexico,07-05-2020,2843,1627,583,2260,Americas
Moldova,07-05-2020,336753,465,866,335887,Europe
Monaco,07-05-2020,127284,1848,244,127040,Europe
Mongolia,07-05-2020,417890,658,270,417620,Western Pacific
Montenegro,07-05-2020,25748,1469,921,24827,Europe
Morocco,07-05-2020,107998,363,581,107417,Eastern Mediterranean
Namibia,07-05-2020,330037,1370,219,329818,Africa
Nepal,07-05-2020,232100,1618,1049,231051,South-East Asia
Netherlands,07-05-2020,31402,1710,938,30464,Europe
Netherlands,07-05-2020,284076,2341,1039,283037,Europe
Netherlands,07-05-2020,201516,609,1023,200493,Europe
Netherlands,07-05-2020,371012,2463,713,370299,Europe
New Zealand,07-05-2020,4051,382,1064,2987,Western Pacific
Nicaragua,07-05-2020,60993,1778,676,60317,Americas
Niger,07-05-2020,162047,2230,1142,160905,Africa
Nigeria,07-05-2020,299080,511,60,299020,Africa
North Macedonia,07-05-2020,1093,2123,940,153,Europe
Norway,07-05-2020,373564,1639,1018,372546,Europe
Oman,07-05-2020,420994,2500,1202,419792,Eastern Mediterranean
Pakistan,07-05-2020,414539,1253,1013,413526,Eastern Mediterranean
Panama,07-05-2020,266230,845,470,265760,Americas
Papua New Guinea,07-05-2020,254183,2279,940,253243,Western Pacific
Paraguay,07-05-2020,85520,1035,315,85205,Americas
Peru,07-05-2020,442231,1692,1248,440983,Americas
Philippines,07-05-2020,341880,254,884,340996,Western Pacific
Poland,07-05-2020,332436,326,403,332033,Europe
Portugal,07-05-2020,348589,1825,1133,347456,Europe
Qatar,07-05-2020,162681,1403,604,162077,Eastern Mediterranean
Romania,07-05-2020,352446,1680,755,351691,Europe
Russia,07-05-2020,250115,2297,1134,248981,Europe
Rwanda,07-05-2020,21103,1944,500,20603,Africa
Saint Lucia,07-05-2020,135595,2378,257,135338,Americas
Saint Vincent and the Grenadines,07-05-2020,449679,711,807,448872,Americas
San Marino,07-05-2020,267991,887,282,267709,Europe
Saudi Arabia,07-05-2020,337078,1416,120,336958,Eastern Mediterranean
Senegal,07-05-2020,261878,1343,1048,260830,Africa
Serbia,07-05-2020,321346,1113,593,320753,Europe
Seychelles,07-05-2020,389645,1187,602,389043,Africa
Singapore,07-05-2020,298711,197,388,298323,Western Pacific
Slovakia,07-05-2020,373386,1401,1225,372161,Europe
Slovenia,07-05-2020,256231,491,477,255754,Europe
Somalia,07-05-2020,212689,1084,371,212318,Eastern Mediterranean
South Africa,07-05-2020,340743,1345,649,340094,Africa
Spain,07-05-2020,162702,500,641,162061,Europe
Sri Lanka,07-05-2020,413566,1850,1089,412477,South-East Asia
Sudan,07-05-2020,344106,632,384,343722,Eastern Mediterranean
Suriname,07-05-2020,111606,2098,717,110889,Americas
Sweden,07-05-2020,276391,1519,632,275759,Europe
Switzerland,07-05-2020,140425,1993,18,140407,Europe
Taiwan*,07-05-2020,94896,1533,396,94500,Western Pacific
Tanzania,07-05-2020,116976,1203,664,116312,Africa
Thailand,07-05-2020,181043,1025,652,180391,South-East Asia
Togo,07-05-2020,249919,1387,1119,248800,Africa
Trinidad and Tobago,07-05-2020,9687,467,180,9507,Americas
Tunisia,07-05-2020,377054,671,140,376914,Eastern Mediterranean
Turkey,07-05-2020,24261,1662,1155,23106,Europe
Uganda,07-05-2020,265637,2077,1216,264421,Africa
Ukraine,07-05-2020,284145,208,331,283814,Europe
United Arab Emirates,07-05-2020,257165,1221,17,257148,Eastern Mediterranean
United Kingdom,07-05-2020,198258,1867,198,198060,Europe
United Kingdom,07-05-2020,49663,1251,551,49112,Europe
United Kingdom,07-05-2020,226221,471,963,225258,Europe
United Kingdom,07-05-2020,111644,565,336,111308,Europe
United Kingdom,07-05-2020,424957,827,637,424320,Europe
United Kingdom,07-05-2020,248756,256,55,248701,Europe
United Kingdom,07-05-2020,408103,2206,605,407498,Europe
Uruguay,07-05-2020,238485,1749,382,238103,Americas
US,07-05-2020,24147,786,825,23322,Americas
Uzbekistan,07-05-2020,29495,1366,1143,28352,Europe
Venezuela,07-05-2020,41931,1249,944,40987,Americas
Vietnam,07-05-2020,272414,1064,170,272244,Western Pacific
Zambia,07-05-2020,60163,2056,273,59890,Africa
Zimbabwe,07-05-2020,344322,821,786,343536,Africa
Dominica,07-05-2020,381497,241,924,380573,Americas
Grenada,07-05-2020,253930,1669,62,253868,Americas
Mozambique,07-05-2020,140128,1160,737,139391,Africa
Syria,07-05-2020,338890,704,1137,337753,Eastern Mediterranean
Timor-Leste,07-05-2020,329792,1822,465,329327,South-East Asia
Belize,07-05-2020,153075,1917,279,152796,Americas
Laos,07-05-2020,111464,403,408,111056,Western Pacific
Libya,07-05-2020,407155,2324,105,407050,Eastern Mediterranean
West Bank and Gaza,07-05-2020,297694,2091,328,297366,Eastern Mediterranean
Guinea-Bissau,07-05-2020,249757,1828,408,249349,Africa
Mali,07-05-2020,343199,161,431,342768,Africa
Saint Kitts and Nevis,07-05-2020,112615,443,1126,111489,Americas
Canada,07-05-2020,195660,2303,539,195121,Americas
Canada,07-05-2020,198018,719,873,197145,Americas
Kosovo,07-05-2020,389974,266,708,389266,Europe
Burma,07-05-2020,433407,1924,693,432714,South-East Asia
United Kingdom,07-05-2020,1855,1710,842,1013,Europe
United Kingdom,07-05-2020,46965,1764,568,46397,Europe
United Kingdom,07-05-2020,401316,763,61,401255,Europe
Botswana,07-05-2020,269445,523,1225,268220,Africa
Burundi,07-05-2020,430224,1723,1126,429098,Africa
Sierra Leone,07-05-2020,269483,2446,810,268673,Africa
Malawi,07-05-2020,22298,982,1153,21145,Africa
United Kingdom,07-05-2020,346051,547,128,345923,Europe
France,07-05-2020,275078,1653,740,274338,Europe
South Sudan,07-05-2020,341948,1669,442,341506,Africa
Western Sahara,07-05-2020,129437,1324,336,129101,Africa
Sao Tome and Principe,07-05-2020,70560,1821,1064,69496,Africa
Yemen,07-05-2020,356316,2428,1139,355177,Eastern Mediterranean
Comoros,07-05-2020,168691,1229,1212,167479,Africa
Tajikistan,07-05-2020,307743,1696,1129,306614,Europe
Lesotho,07-05-2020,330300,769,370,329930,Africa
Afghanistan,08-05-2020,226585,2428,746,225839,Eastern Mediterranean
Albania,08-05-2020,415798,1581,1218,414580,Europe
Algeria,08-05-2020,420354,542,617,419737,Africa
Andorra,08-05-2020,57485,1351,1231,56254,Europe
Angola,08-05-2020,92299,1750,827,91472,Africa
Antigua and Barbuda,08-05-2020,22038,923,333,21705,Americas
Argentina,08-05-2020,334185,198,117,334068,Americas
Armenia,08-05-2020,328400,1723,1179,327221,Europe
Australia,08-05-2020,319702,2024,413,319289,Western Pacific
Australia,08-05-2020,330442,931,650,329792,Western Pacific
Australia,08-05-2020,215159,1555,190,214969,Western Pacific
Australia,08-05-2020,341881,174,963,340918,Western Pacific
Australia,08-05-2020,63119,1851,969,62150,Western Pacific
Australia,08-05-2020,302621,2047,515,302106,Western Pacific
Australia,08-05-2020,274275,1567,113,274162,Western Pacific
Australia,08-05-2020,217767,709,499,217268,Western Pacific
Austria,08-05-2020,333474,1215,128,333346,Europe
Azerbaijan,08-05-2020,290361,1320,869,289492,Europe
Bahamas,08-05-2020,421990,145,870,421120,Americas
Bahrain,08-05-2020,208957,1729,184,208773,Eastern Mediterranean
Bangladesh,08-05-2020,46024,2345,422,45602,South-East Asia
Barbados,08-05-2020,189828,2118,291,189537,Americas
Belarus,08-05-2020,103635,2109,988,102647,Europe
Belgium,08-05-2020,263103,1424,384,262719,Europe
Benin,08-05-2020,89622,1018,320,89302,Africa
Bhutan,08-05-2020,67920,1870,183,67737,South-East Asia
Bolivia,08-05-2020,68400,20,171,68229,Americas
Bosnia and Herzegovina,08-05-2020,237948,2212,1062,236886,Europe
Brazil,08-05-2020,378633,1072,115,378518,Americas
Brunei,08-05-2020,204816,1364,497,204319,Western Pacific
Bulgaria,08-05-2020,299191,461,309,298882,Europe
Burkina Faso,08-05-2020,31176,987,615,30561,Africa
Cabo Verde,08-05-2020,270901,2416,648,270253,Africa
Cambodia,08-05-2020,349614,1658,986,348628,Western Pacific
Cameroon,08-05-2020,83632,1965,424,83208,Africa
Canada,08-05-2020,238327,971,1182,237145,Americas
Canada,08-05-2020,291853,272,957,290896,Americas
Canada,08-05-2020,44363,544,621,43742,Americas
Canada,08-05-2020,213186,825,727,212459,Americas
Canada,08-05-2020,271213,324,7,271206,Americas
Canada,08-05-2020,76912,1330,1140,75772,Americas
Canada,08-05-2020,66342,1656,372,65970,Americas
Canada,08-05-2020,24355,1294,1192,23163,Americas
Canada,08-05-2020,368651,1768,78,368573,Americas
Canada,08-05-2020,40880,1075,500,40380,Americas
Central African Republic,08-05-2020,249532,198,1008,248524,Africa
Chad,08-05-2020,240983,2062,987,239996,Africa
Chile,08-05-2020,273836,1785,63,273773,Americas
China,08-05-2020,271805,2115,1054,270751,Western Pacific
China,08-05-2020,124747,1423,1053,123694,Western Pacific
China,08-05-2020,374639,1199,945,373694,Western Pacific
China,08-05-2020,160142,84,632,159510,Western Pacific
China,08-05-2020,379773,1986,610,379163,Western Pacific
China,08-05-2020,124307,1664,66,124241,Western Pacific
China,08-05-2020,181100,1334,1084,180016,Western Pacific
China,08-05-2020,18975,881,953,18022,Western Pacific
China,08-05-2020,11103,463,754,10349,Western Pacific
China,08-05-2020,30159,154,352,29807,Western Pacific
China,08-05-2020,397101,2010,796,396305,Western Pacific
China,08-05-2020,11810,1761,249,11561,Western Pacific
China,08-05-2020,75412,1103,1189,74223,Western Pacific
China,08-05-2020,16466,1919,389,16077,Western Pacific
China,08-05-2020,241347,1234,1123,240224,Western Pacific
China,08-05-2020,111531,2131,929,110602,Western Pacific
China,08-05-2020,42502,1632,919,41583,Western Pacific
China,08-05-2020,121175,500,673,120502,Western Pacific
China,08-05-2020,427708,933,933,426775,Western Pacific
China,08-05-2020,212336,2233,639,211697,Western Pacific
China,08-05-2020,125995,145,281,125714,Western Pacific
China,08-05-2020,172774,2181,986,171788,Western Pacific
China,08-05-2020,349271,1267,1029,348242,Western Pacific
China,08-05-2020,154367,1841,581,153786,Western Pacific
China,08-05-2020,270686,1695,747,269939,Western Pacific
China,08-05-2020,205879,393,86,205793,Western Pacific
China,08-05-2020,368936,96,748,368188,Western Pacific
China,08-05-2020,245625,367,79,245546,Western Pacific
China,08-05-2020,230626,2191,715,229911,Western Pacific
China,08-05-2020,177436,555,32,177404,Western Pacific
China,08-05-2020,412973,2375,1127,411846,Western Pacific
China,08-05-2020,43784,1112,219,43565,Western Pacific
China,08-05-2020,223931,1763,808,223123,Western Pacific
Colombia,08-05-2020,320847,940,272,320575,Americas
Congo (Brazzaville),08-05-2020,231523,1138,420,231103,Africa
Congo (Kinshasa),08-05-2020,163598,1764,628,162970,Africa
Costa Rica,08-05-2020,287161,839,507,286654,Americas
Cote d'Ivoire,08-05-2020,145867,574,358,145509,Africa
Croatia,08-05-2020,300729,1052,106,300623,Europe
Cuba,08-05-2020,81214,877,730,80484,Americas
Cyprus,08-05-2020,42742,1964,394,42348,Europe
Czechia,08-05-2020,328143,1993,1086,327057,Europe
Denmark,08-05-2020,170752,788,271,170481,Europe
Greenland,08-05-2020,323238,1258,944,322294,Europe
Denmark,08-05-2020,252899,1089,246,252653,Europe
Djibouti,08-05-2020,412907,44,196,412711,Eastern Mediterranean
Dominican Republic,08-05-2020,336744,2500,518,336226,Americas
Ecuador,08-05-2020,229117,2124,56,229061,Americas
Egypt,08-05-2020,187980,341,821,187159,Eastern Mediterranean
El Salvador,08-05-2020,268998,1467,945,268053,Americas
Equatorial Guinea,08-05-2020,36525,338,895,35630,Africa
Eritrea,08-05-2020,228061,1436,85,227976,Africa
Estonia,08-05-2020,321917,1747,1105,320812,Europe
Eswatini,08-05-2020,343164,1119,352,342812,Africa
Ethiopia,08-05-2020,67579,1503,17,67562,Africa
Fiji,08-05-2020,330046,2117,216,329830,Western Pacific
Finland,08-05-2020,164647,713,846,163801,Europe
France,08-05-2020,221308,358,600,220708,Europe
France,08-05-2020,341747,1797,1104,340643,Europe
France,08-05-2020,407460,1002,292,407168,Europe
France,08-05-2020,449528,368,440,449088,Europe
France,08-05-2020,186984,1147,621,186363,Europe
France,08-05-2020,222711,2050,1134,221577,Europe
France,08-05-2020,283211,789,927,282284,Europe
France,08-05-2020,22365,1068,952,21413,Europe
France,08-05-2020,170580,617,13,170567,Europe
France,08-05-2020,98464,2169,707,97757,Europe
Gabon,08-05-2020,172270,660,1105,171165,Africa
Gambia,08-05-2020,397169,752,141,397028,Africa
Georgia,08-05-2020,307504,2383,1036,306468,Europe
Germany,08-05-2020,112754,1682,859,111895,Europe
Ghana,08-05-2020,310116,906,828,309288,Africa
Greece,08-05-2020,217681,1378,630,217051,Europe
Guatemala,08-05-2020,156590,1467,1198,155392,Americas
Guinea,08-05-2020,28574,1818,1014,27560,Africa
Guyana,08-05-2020,93044,1448,385,92659,Americas
Haiti,08-05-2020,139003,1206,511,138492,Americas
Holy See,08-05-2020,272418,70,908,271510,Europe
Honduras,08-05-2020,252801,886,113,252688,Americas
Hungary,08-05-2020,208240,889,609,207631,Europe
Iceland,08-05-2020,356734,626,849,355885,Europe
India,08-05-2020,274593,229,515,274078,South-East Asia
Indonesia,08-05-2020,204112,116,661,203451,South-East Asia
Iran,08-05-2020,44815,1829,168,44647,Eastern Mediterranean
Iraq,08-05-2020,224280,225,196,224084,Eastern Mediterranean
Ireland,08-05-2020,171103,2290,931,170172,Europe
Israel,08-05-2020,110733,1211,912,109821,Europe
Italy,08-05-2020,32197,1402,757,31440,Europe
Jamaica,08-05-2020,437652,340,299,437353,Americas
Japan,08-05-2020,307430,2490,648,306782,Western Pacific
Jordan,08-05-2020,250153,1800,508,249645,Eastern Mediterranean
Kazakhstan,08-05-2020,302265,2231,716,301549,Europe
Kenya,08-05-2020,213015,1413,9,213006,Africa
South Korea,08-05-2020,204487,2344,728,203759,Western Pacific
Kuwait,08-05-2020,258857,321,839,258018,Eastern Mediterranean
Kyrgyzstan,08-05-2020,323953,2085,143,323810,Europe
Latvia,08-05-2020,264112,2177,366,263746,Europe
Lebanon,08-05-2020,297841,625,107,297734,Eastern Mediterranean
Liberia,08-05-2020,56835,819,1136,55699,Africa
Liechtenstein,08-05-2020,365114,1542,405,364709,Europe
Lithuania,08-05-2020,320250,1894,677,319573,Europe
Luxembourg,08-05-2020,195589,1451,1028,194561,Europe
Madagascar,08-05-2020,440898,387,809,440089,Africa
Malaysia,08-05-2020,237010,1441,1028,235982,Western Pacific
Maldives,08-05-2020,441415,646,770,440645,South-East Asia
Malta,08-05-2020,28352,1691,508,27844,Europe
Mauritania,08-05-2020,393228,1047,198,393030,Africa
Mauritius,08-05-2020,68403,2239,736,67667,Africa
Mexico,08-05-2020,167569,229,361,167208,Americas
Moldova,08-05-2020,83895,1633,192,83703,Europe
Monaco,08-05-2020,438887,139,43,438844,Europe
Mongolia,08-05-2020,48485,940,1247,47238,Western Pacific
Montenegro,08-05-2020,5890,300,813,5077,Europe
Morocco,08-05-2020,233652,1495,1055,232597,Eastern Mediterranean
Namibia,08-05-2020,172140,770,1081,171059,Africa
Nepal,08-05-2020,373881,503,294,373587,South-East Asia
Netherlands,08-05-2020,263090,2087,772,262318,Europe
Netherlands,08-05-2020,309241,1176,23,309218,Europe
Netherlands,08-05-2020,193646,1059,861,192785,Europe
Netherlands,08-05-2020,104381,1485,1063,103318,Europe
New Zealand,08-05-2020,272312,2278,433,271879,Western Pacific
Nicaragua,08-05-2020,347671,464,105,347566,Americas
Niger,08-05-2020,431086,1987,1094,429992,Africa
Nigeria,08-05-2020,18970,1025,446,18524,Africa
North Macedonia,08-05-2020,13331,2107,1200,12131,Europe
Norway,08-05-2020,423108,1296,649,422459,Europe
Oman,08-05-2020,60052,2204,1001,59051,Eastern Mediterranean
Pakistan,08-05-2020,99926,2345,54,99872,Eastern Mediterranean
Panama,08-05-2020,201295,1789,498,200797,Americas
Papua New Guinea,08-05-2020,301384,2429,858,300526,Western Pacific
Paraguay,08-05-2020,410276,2414,247,410029,Americas
Peru,08-05-2020,74346,370,496,73850,Americas
Philippines,08-05-2020,11388,502,983,10405,Western Pacific
Poland,08-05-2020,237717,319,247,237470,Europe
Portugal,08-05-2020,76661,1196,911,75750,Europe
Qatar,08-05-2020,157388,1323,627,156761,Eastern Mediterranean
Romania,08-05-2020,8858,549,1054,7804,Europe
Russia,08-05-2020,330642,2015,935,329707,Europe
Rwanda,08-05-2020,328127,36,1036,327091,Africa
Saint Lucia,08-05-2020,314891,433,33,314858,Americas
Saint Vincent and the Grenadines,08-05-2020,338356,949,13,338343,Americas
San Marino,08-05-2020,413142,520,68,413074,Europe
Saudi Arabia,08-05-2020,238576,1726,866,237710,Eastern Mediterranean
Senegal,08-05-2020,207575,1585,95,207480,Africa
Serbia,08-05-2020,28690,560,310,28380,Europe
Seychelles,08-05-2020,190565,479,161,190404,Africa
Singapore,08-05-2020,234464,1125,1103,233361,Western Pacific
Slovakia,08-05-2020,21372,955,468,20904,Europe
Slovenia,08-05-2020,334221,1868,490,333731,Europe
Somalia,08-05-2020,202798,2018,902,201896,Eastern Mediterranean
South Africa,08-05-2020,137122,2224,168,136954,Africa
Spain,08-05-2020,359352,2390,147,359205,Europe
Sri Lanka,08-05-2020,281098,1114,945,280153,South-East Asia
Sudan,08-05-2020,289040,2194,690,288350,Eastern Mediterranean
Suriname,08-05-2020,345151,746,483,344668,Americas
Sweden,08-05-2020,332607,219,453,332154,Europe
Switzerland,08-05-2020,216202,564,543,215659,Europe
Taiwan*,08-05-2020,44522,2040,725,43797,Western Pacific
Tanzania,08-05-2020,441236,1472,217,441019,Africa
Thailand,08-05-2020,282303,1258,508,281795,South-East Asia
Togo,08-05-2020,144473,1638,1113,143360,Africa
Trinidad and Tobago,08-05-2020,267636,1484,686,266950,Americas
Tunisia,08-05-2020,137981,1337,786,137195,Eastern Mediterranean
Turkey,08-05-2020,351903,935,909,350994,Europe
Uganda,08-05-2020,174656,1719,53,174603,Africa
Ukraine,08-05-2020,303033,2135,835,302198,Europe
United Arab Emirates,08-05-2020,73909,103,745,73164,Eastern Mediterranean
United Kingdom,08-05-2020,340876,574,757,340119,Europe
United Kingdom,08-05-2020,314153,313,950,313203,Europe
United Kingdom,08-05-2020,85172,224,100,85072,Europe
United Kingdom,08-05-2020,1217,1022,518,699,Europe
United Kingdom,08-05-2020,408444,1676,790,407654,Europe
United Kingdom,08-05-2020,282655,387,420,282235,Europe
United Kingdom,08-05-2020,20080,217,714,19366,Europe
Uruguay,08-05-2020,271712,1691,733,270979,Americas
US,08-05-2020,179090,2331,178,178912,Americas
Uzbekistan,08-05-2020,434370,631,403,433967,Europe
Venezuela,08-05-2020,319620,1400,370,319250,Americas
Vietnam,08-05-2020,366949,2351,254,366695,Western Pacific
Zambia,08-05-2020,90215,27,260,89955,Africa
Zimbabwe,08-05-2020,326277,1051,1220,325057,Africa
Dominica,08-05-2020,141221,1077,385,140836,Americas
Grenada,08-05-2020,90999,1165,1004,89995,Americas
Mozambique,08-05-2020,129059,299,599,128460,Africa
Syria,08-05-2020,147783,2255,264,147519,Eastern Mediterranean
Timor-Leste,08-05-2020,334035,192,47,333988,South-East Asia
Belize,08-05-2020,229000,1228,68,228932,Americas
Laos,08-05-2020,255961,2124,659,255302,Western Pacific
Libya,08-05-2020,379007,1687,190,378817,Eastern Mediterranean
West Bank and Gaza,08-05-2020,418002,1688,440,417562,Eastern Mediterranean
Guinea-Bissau,08-05-2020,216107,664,789,215318,Africa
Mali,08-05-2020,249888,2031,399,249489,Africa
Saint Kitts and Nevis,08-05-2020,148994,118,158,148836,Americas
Canada,08-05-2020,231534,815,1223,230311,Americas
Canada,08-05-2020,265020,1370,534,264486,Americas
Kosovo,08-05-2020,342071,294,1023,341048,Europe
Burma,08-05-2020,139413,204,39,139374,South-East Asia
United Kingdom,08-05-2020,279772,1232,251,279521,Europe
United Kingdom,08-05-2020,117363,1864,933,116430,Europe
United Kingdom,08-05-2020,38898,2446,561,38337,Europe
Botswana,08-05-2020,435268,1991,391,434877,Africa
Burundi,08-05-2020,353259,2125,376,352883,Africa
Sierra Leone,08-05-2020,233262,1573,571,232691,Africa
Malawi,08-05-2020,236156,1352,501,235655,Africa
United Kingdom,08-05-2020,210685,240,671,210014,Europe
France,08-05-2020,432321,251,188,432133,Europe
South Sudan,08-05-2020,347599,998,606,346993,Africa
Western Sahara,08-05-2020,364419,1776,993,363426,Africa
Sao Tome and Principe,08-05-2020,9277,1589,304,8973,Africa
Yemen,08-05-2020,373046,119,288,372758,Eastern Mediterranean
Comoros,08-05-2020,173862,2138,1233,172629,Africa
Tajikistan,08-05-2020,66521,484,921,65600,Europe
Lesotho,08-05-2020,4532,2065,1135,3397,Africa
Afghanistan,09-05-2020,36480,309,396,36084,Eastern Mediterranean
Albania,09-05-2020,69610,1774,274,69336,Europe
Algeria,09-05-2020,172469,2497,495,171974,Africa
Andorra,09-05-2020,218076,1882,940,217136,Europe
Angola,09-05-2020,126769,365,753,126016,Africa
Antigua and Barbuda,09-05-2020,151120,3,271,150849,Americas
Argentina,09-05-2020,227592,797,530,227062,Americas
Armenia,09-05-2020,129327,2355,824,128503,Europe
Australia,09-05-2020,37211,2164,107,37104,Western Pacific
Australia,09-05-2020,341569,2279,708,340861,Western Pacific
Australia,09-05-2020,435141,1840,1185,433956,Western Pacific
Australia,09-05-2020,406663,1638,527,406136,Western Pacific
Australia,09-05-2020,335997,876,42,335955,Western Pacific
Australia,09-05-2020,368868,530,605,368263,Western Pacific
Australia,09-05-2020,438053,697,570,437483,Western Pacific
Australia,09-05-2020,374724,1240,592,374132,Western Pacific
Austria,09-05-2020,114343,1017,1132,113211,Europe
Azerbaijan,09-05-2020,331145,1106,704,330441,Europe
Bahamas,09-05-2020,341892,1325,902,340990,Americas
Bahrain,09-05-2020,2636,162,1221,1415,Eastern Mediterranean
Bangladesh,09-05-2020,171216,1418,389,170827,South-East Asia
Barbados,09-05-2020,410806,193,691,410115,Americas
Belarus,09-05-2020,357377,594,1061,356316,Europe
Belgium,09-05-2020,59938,923,628,59310,Europe
Benin,09-05-2020,189333,1666,865,188468,Africa
Bhutan,09-05-2020,270264,2279,506,269758,South-East Asia
Bolivia,09-05-2020,265640,2130,528,265112,Americas
Bosnia and Herzegovina,09-05-2020,306282,1015,481,305801,Europe
Brazil,09-05-2020,38919,140,1244,37675,Americas
Brunei,09-05-2020,350688,1248,812,349876,Western Pacific
Bulgaria,09-05-2020,89634,1070,1021,88613,Europe
Burkina Faso,09-05-2020,440581,437,1185,439396,Africa
Cabo Verde,09-05-2020,439530,56,589,438941,Africa
Cambodia,09-05-2020,131712,1978,852,130860,Western Pacific
Cameroon,09-05-2020,38482,1605,604,37878,Africa
Canada,09-05-2020,96653,971,121,96532,Americas
Canada,09-05-2020,422290,43,864,421426,Americas
Canada,09-05-2020,326952,144,44,326908,Americas
Canada,09-05-2020,79151,1041,128,79023,Americas
Canada,09-05-2020,92272,626,204,92068,Americas
Canada,09-05-2020,1038,2194,1189,-151,Americas
Canada,09-05-2020,27936,730,554,27382,Americas
Canada,09-05-2020,287996,215,1177,286819,Americas
Canada,09-05-2020,224880,2187,561,224319,Americas
Canada,09-05-2020,275407,2475,830,274577,Americas
Central African Republic,09-05-2020,337850,414,495,337355,Africa
Chad,09-05-2020,43040,887,1048,41992,Africa
Chile,09-05-2020,399508,1097,342,399166,Americas
China,09-05-2020,173849,1025,606,173243,Western Pacific
China,09-05-2020,262104,1292,1154,260950,Western Pacific
China,09-05-2020,152899,456,12,152887,Western Pacific
China,09-05-2020,301779,1607,859,300920,Western Pacific
China,09-05-2020,419192,1510,1098,418094,Western Pacific
China,09-05-2020,112358,568,4,112354,Western Pacific
China,09-05-2020,115713,1457,978,114735,Western Pacific
China,09-05-2020,225521,1258,711,224810,Western Pacific
China,09-05-2020,323564,1337,1079,322485,Western Pacific
China,09-05-2020,352796,1400,83,352713,Western Pacific
China,09-05-2020,122811,1716,655,122156,Western Pacific
China,09-05-2020,212141,1104,1119,211022,Western Pacific
China,09-05-2020,64901,1416,663,64238,Western Pacific
China,09-05-2020,63102,698,715,62387,Western Pacific
China,09-05-2020,449412,51,118,449294,Western Pacific
China,09-05-2020,299674,699,1055,298619,Western Pacific
China,09-05-2020,227756,79,1173,226583,Western Pacific
China,09-05-2020,274293,535,511,273782,Western Pacific
China,09-05-2020,217849,914,122,217727,Western Pacific
China,09-05-2020,58379,2156,60,58319,Western Pacific
China,09-05-2020,181159,913,830,180329,Western Pacific
China,09-05-2020,162753,379,728,162025,Western Pacific
China,09-05-2020,64609,292,679,63930,Western Pacific
China,09-05-2020,46311,2201,466,45845,Western Pacific
China,09-05-2020,179998,595,417,179581,Western Pacific
China,09-05-2020,146915,1965,444,146471,Western Pacific
China,09-05-2020,74493,317,1058,73435,Western Pacific
China,09-05-2020,254367,1180,499,253868,Western Pacific
China,09-05-2020,410747,172,481,410266,Western Pacific
China,09-05-2020,174055,2375,1006,173049,Western Pacific
China,09-05-2020,444282,1528,582,443700,Western Pacific
China,09-05-2020,207226,274,337,206889,Western Pacific
China,09-05-2020,318906,2412,38,318868,Western Pacific
Colombia,09-05-2020,32149,2050,529,31620,Americas
Congo (Brazzaville),09-05-2020,105018,1915,433,104585,Africa
Congo (Kinshasa),09-05-2020,301475,2248,959,300516,Africa
Costa Rica,09-05-2020,372973,245,885,372088,Americas
Cote d'Ivoire,09-05-2020,184226,569,720,183506,Africa
Croatia,09-05-2020,18059,1913,700,17359,Europe
Cuba,09-05-2020,299182,283,1177,298005,Americas
Cyprus,09-05-2020,162427,1765,509,161918,Europe
Czechia,09-05-2020,377398,75,972,376426,Europe
Denmark,09-05-2020,426146,534,1233,424913,Europe
Greenland,09-05-2020,138248,156,557,137691,Europe
Denmark,09-05-2020,362255,142,749,361506,Europe
Djibouti,09-05-2020,244360,1998,744,243616,Eastern Mediterranean
Dominican Republic,09-05-2020,151764,2380,152,151612,Americas
Ecuador,09-05-2020,252145,11,234,251911,Americas
Egypt,09-05-2020,221803,536,131,221672,Eastern Mediterranean
El Salvador,09-05-2020,368111,909,738,367373,Americas
Equatorial Guinea,09-05-2020,312915,1861,64,312851,Africa
Eritrea,09-05-2020,164466,1634,1201,163265,Africa
Estonia,09-05-2020,224327,834,760,223567,Europe
Eswatini,09-05-2020,238060,439,969,237091,Africa
Ethiopia,09-05-2020,40665,719,1136,39529,Africa
Fiji,09-05-2020,233165,176,1033,232132,Western Pacific
Finland,09-05-2020,132114,2101,83,132031,Europe
France,09-05-2020,441938,484,63,441875,Europe
France,09-05-2020,430914,1856,531,430383,Europe
France,09-05-2020,35561,2147,18,35543,Europe
France,09-05-2020,11968,1029,179,11789,Europe
France,09-05-2020,101072,104,1129,99943,Europe
France,09-05-2020,336559,2328,976,335583,Europe
France,09-05-2020,271839,595,587,271252,Europe
France,09-05-2020,290876,621,297,290579,Europe
France,09-05-2020,18123,2323,1043,17080,Europe
France,09-05-2020,443736,1238,677,443059,Europe
Gabon,09-05-2020,195651,839,996,194655,Africa
Gambia,09-05-2020,204782,2423,160,204622,Africa
Georgia,09-05-2020,422448,1160,508,421940,Europe
Germany,09-05-2020,53243,1578,261,52982,Europe
Ghana,09-05-2020,363307,307,603,362704,Africa
Greece,09-05-2020,324124,1690,414,323710,Europe
Guatemala,09-05-2020,52168,906,240,51928,Americas
Guinea,09-05-2020,415324,1469,478,414846,Africa
Guyana,09-05-2020,310949,1068,1178,309771,Americas
Haiti,09-05-2020,249549,65,1163,248386,Americas
Holy See,09-05-2020,250770,556,622,250148,Europe
Honduras,09-05-2020,92252,792,86,92166,Americas
Hungary,09-05-2020,61662,803,11,61651,Europe
Iceland,09-05-2020,440433,707,1236,439197,Europe
India,09-05-2020,100069,128,385,99684,South-East Asia
Indonesia,09-05-2020,310343,748,905,309438,South-East Asia
Iran,09-05-2020,147692,335,10,147682,Eastern Mediterranean
Iraq,09-05-2020,198273,852,211,198062,Eastern Mediterranean
Ireland,09-05-2020,29895,1180,62,29833,Europe
Israel,09-05-2020,385780,1504,1065,384715,Europe
Italy,09-05-2020,121289,917,1028,120261,Europe
Jamaica,09-05-2020,373291,1345,702,372589,Americas
Japan,09-05-2020,357123,1935,1054,356069,Western Pacific
Jordan,09-05-2020,369664,2498,105,369559,Eastern Mediterranean
Kazakhstan,09-05-2020,355734,852,969,354765,Europe
Kenya,09-05-2020,7909,737,709,7200,Africa
South Korea,09-05-2020,340393,2088,80,340313,Western Pacific
Kuwait,09-05-2020,429055,164,79,428976,Eastern Mediterranean
Kyrgyzstan,09-05-2020,147403,850,701,146702,Europe
Latvia,09-05-2020,246875,1994,19,246856,Europe
Lebanon,09-05-2020,64063,1173,959,63104,Eastern Mediterranean
Liberia,09-05-2020,332015,1043,1035,330980,Africa
Liechtenstein,09-05-2020,352476,1084,576,351900,Europe
Lithuania,09-05-2020,304488,1852,369,304119,Europe
Luxembourg,09-05-2020,3161,151,276,2885,Europe
Madagascar,09-05-2020,205648,648,29,205619,Africa
Malaysia,09-05-2020,372788,1012,1086,371702,Western Pacific
Maldives,09-05-2020,406186,1807,911,405275,South-East Asia
Malta,09-05-2020,169358,1559,581,168777,Europe
Mauritania,09-05-2020,55988,937,1214,54774,Africa
Mauritius,09-05-2020,337459,2128,1044,336415,Africa
Mexico,09-05-2020,381697,1858,675,381022,Americas
Moldova,09-05-2020,84733,1177,188,84545,Europe
Monaco,09-05-2020,158524,2155,1191,157333,Europe
Mongolia,09-05-2020,41561,1367,539,41022,Western Pacific
Montenegro,09-05-2020,232464,2245,774,231690,Europe
Morocco,09-05-2020,28806,861,1060,27746,Eastern Mediterranean
Namibia,09-05-2020,99252,710,864,98388,Africa
Nepal,09-05-2020,430784,1088,762,430022,South-East Asia
Netherlands,09-05-2020,411859,147,636,411223,Europe
Netherlands,09-05-2020,147508,139,967,146541,Europe
Netherlands,09-05-2020,436,1826,1183,-747,Europe
Netherlands,09-05-2020,273985,320,313,273672,Europe
New Zealand,09-05-2020,358752,224,802,357950,Western Pacific
Nicaragua,09-05-2020,169427,1115,199,169228,Americas
Niger,09-05-2020,135142,1280,1100,134042,Africa
Nigeria,09-05-2020,418417,2218,951,417466,Africa
North Macedonia,09-05-2020,183830,84,776,183054,Europe
Norway,09-05-2020,429552,2182,162,429390,Europe
Oman,09-05-2020,288547,1073,269,288278,Eastern Mediterranean
Pakistan,09-05-2020,319454,236,22,319432,Eastern Mediterranean
Panama,09-05-2020,421050,1735,1069,419981,Americas
Papua New Guinea,09-05-2020,167475,1646,421,167054,Western Pacific
Paraguay,09-05-2020,171253,1704,557,170696,Americas
Peru,09-05-2020,49938,107,605,49333,Americas
Philippines,09-05-2020,396345,325,775,395570,Western Pacific
Poland,09-05-2020,343063,1504,471,342592,Europe
Portugal,09-05-2020,336508,169,804,335704,Europe
Qatar,09-05-2020,246499,1324,572,245927,Eastern Mediterranean
Romania,09-05-2020,445392,2367,465,444927,Europe
Russia,09-05-2020,276238,1929,603,275635,Europe
Rwanda,09-05-2020,356456,2030,405,356051,Africa
Saint Lucia,09-05-2020,385494,2113,99,385395,Americas
Saint Vincent and the Grenadines,09-05-2020,247407,411,6,247401,Americas
San Marino,09-05-2020,251271,148,1170,250101,Europe
Saudi Arabia,09-05-2020,226640,1356,1192,225448,Eastern Mediterranean
Senegal,09-05-2020,265285,506,1198,264087,Africa
Serbia,09-05-2020,145041,933,726,144315,Europe
Seychelles,09-05-2020,239848,1477,1172,238676,Africa
Singapore,09-05-2020,238629,2492,76,238553,Western Pacific
Slovakia,09-05-2020,218663,333,299,218364,Europe
Slovenia,09-05-2020,167082,1693,921,166161,Europe
Somalia,09-05-2020,340146,1493,18,340128,Eastern Mediterranean
South Africa,09-05-2020,126283,2197,565,125718,Africa
Spain,09-05-2020,211137,2342,662,210475,Europe
Sri Lanka,09-05-2020,38826,1241,244,38582,South-East Asia
Sudan,09-05-2020,138133,910,95,138038,Eastern Mediterranean
Suriname,09-05-2020,389486,467,312,389174,Americas
Sweden,09-05-2020,421351,851,204,421147,Europe
Switzerland,09-05-2020,180728,395,129,180599,Europe
Taiwan*,09-05-2020,187872,1504,949,186923,Western Pacific
Tanzania,09-05-2020,198976,1901,62,198914,Africa
Thailand,09-05-2020,75986,1440,908,75078,South-East Asia
Togo,09-05-2020,376971,803,3,376968,Africa
Trinidad and Tobago,09-05-2020,50409,237,864,49545,Americas
Tunisia,09-05-2020,220013,2388,481,219532,Eastern Mediterranean
Turkey,09-05-2020,40990,2345,315,40675,Europe
Uganda,09-05-2020,16404,2397,672,15732,Africa
Ukraine,09-05-2020,400128,2133,128,400000,Europe
United Arab Emirates,09-05-2020,76022,2084,56,75966,Eastern Mediterranean
United Kingdom,09-05-2020,115195,2378,1039,114156,Europe
United Kingdom,09-05-2020,49238,296,584,48654,Europe
United Kingdom,09-05-2020,100202,779,654,99548,Europe
United Kingdom,09-05-2020,117124,1154,1040,116084,Europe
United Kingdom,09-05-2020,155061,2194,426,154635,Europe
United Kingdom,09-05-2020,436811,1304,259,436552,Europe
United Kingdom,09-05-2020,127462,1100,751,126711,Europe
Uruguay,09-05-2020,266255,1680,421,265834,Americas
US,09-05-2020,75832,2097,1027,74805,Americas
Uzbekistan,09-05-2020,230115,577,705,229410,Europe
Venezuela,09-05-2020,301343,2013,103,301240,Americas
Vietnam,09-05-2020,164253,1820,205,164048,Western Pacific
Zambia,09-05-2020,201238,1569,909,200329,Africa
Zimbabwe,09-05-2020,300431,1272,715,299716,Africa
Dominica,09-05-2020,235293,1949,1125,234168,Americas
Grenada,09-05-2020,278825,951,636,278189,Americas
Mozambique,09-05-2020,160701,2367,293,160408,Africa
Syria,09-05-2020,46871,1319,606,46265,Eastern Mediterranean
Timor-Leste,09-05-2020,188374,305,316,188058,South-East Asia
Belize,09-05-2020,436119,417,917,435202,Americas
Laos,09-05-2020,155006,432,703,154303,Western Pacific
Libya,09-05-2020,350969,1008,1057,349912,Eastern Mediterranean
West Bank and Gaza,09-05-2020,444069,511,764,443305,Eastern Mediterranean
Guinea-Bissau,09-05-2020,107530,411,57,107473,Africa
Mali,09-05-2020,62759,1455,410,62349,Africa
Saint Kitts and Nevis,09-05-2020,18342,896,1214,17128,Americas
Canada,09-05-2020,128739,1112,290,128449,Americas
Canada,09-05-2020,224605,2100,1154,223451,Americas
Kosovo,09-05-2020,376194,1162,984,375210,Europe
Burma,09-05-2020,51994,2028,540,51454,South-East Asia
United Kingdom,09-05-2020,153373,443,770,152603,Europe
United Kingdom,09-05-2020,315148,1651,1183,313965,Europe
United Kingdom,09-05-2020,377688,2038,740,376948,Europe
Botswana,09-05-2020,435214,595,168,435046,Africa
Burundi,09-05-2020,76193,806,1078,75115,Africa
Sierra Leone,09-05-2020,128502,560,381,128121,Africa
Malawi,09-05-2020,57458,789,183,57275,Africa
United Kingdom,09-05-2020,181890,1499,206,181684,Europe
France,09-05-2020,554,2177,1191,-637,Europe
South Sudan,09-05-2020,308725,2103,146,308579,Africa
Western Sahara,09-05-2020,443755,2184,962,442793,Africa
Sao Tome and Principe,09-05-2020,206451,2368,769,205682,Africa
Yemen,09-05-2020,154890,2380,111,154779,Eastern Mediterranean
Comoros,09-05-2020,223679,337,1196,222483,Africa
Tajikistan,09-05-2020,362639,876,403,362236,Europe
Lesotho,09-05-2020,436766,1102,363,436403,Africa
Afghanistan,10-05-2020,54672,956,1193,53479,Eastern Mediterranean
Albania,10-05-2020,34458,1924,293,34165,Europe
Algeria,10-05-2020,76411,451,109,76302,Africa
Andorra,10-05-2020,155837,2263,1024,154813,Europe
Angola,10-05-2020,45782,994,635,45147,Africa
Antigua and Barbuda,10-05-2020,199608,2237,903,198705,Americas
Argentina,10-05-2020,312494,1184,583,311911,Americas
Armenia,10-05-2020,434198,1173,653,433545,Europe
Australia,10-05-2020,404021,1484,544,403477,Western Pacific
Australia,10-05-2020,23048,1729,254,22794,Western Pacific
Australia,10-05-2020,264680,472,538,264142,Western Pacific
Australia,10-05-2020,210892,2350,436,210456,Western Pacific
Australia,10-05-2020,439380,1542,505,438875,Western Pacific
Australia,10-05-2020,79867,102,214,79653,Western Pacific
Australia,10-05-2020,192527,1635,432,192095,Western Pacific
Australia,10-05-2020,116903,1211,1189,115714,Western Pacific
Austria,10-05-2020,364106,1747,163,363943,Europe
Azerbaijan,10-05-2020,16049,149,1125,14924,Europe
Bahamas,10-05-2020,296095,1830,206,295889,Americas
Bahrain,10-05-2020,170658,2035,800,169858,Eastern Mediterranean
Bangladesh,10-05-2020,21497,1210,142,21355,South-East Asia
Barbados,10-05-2020,275692,844,212,275480,Americas
Belarus,10-05-2020,129650,2475,389,129261,Europe
Belgium,10-05-2020,45924,106,19,45905,Europe
Benin,10-05-2020,233272,1492,497,232775,Africa
Bhutan,10-05-2020,220173,1247,492,219681,South-East Asia
Bolivia,10-05-2020,378596,2253,837,377759,Americas
Bosnia and Herzegovina,10-05-2020,387678,570,1087,386591,Europe
Brazil,10-05-2020,105643,475,932,104711,Americas
Brunei,10-05-2020,163114,1013,594,162520,Western Pacific
Bulgaria,10-05-2020,56307,202,252,56055,Europe
Burkina Faso,10-05-2020,175376,1871,1130,174246,Africa
Cabo Verde,10-05-2020,111430,2183,943,110487,Africa
Cambodia,10-05-2020,51989,1807,955,51034,Western Pacific
Cameroon,10-05-2020,102429,1414,852,101577,Africa
Canada,10-05-2020,127291,661,427,126864,Americas
Canada,10-05-2020,297636,87,484,297152,Americas
Canada,10-05-2020,417454,2450,845,416609,Americas
Canada,10-05-2020,330878,1641,104,330774,Americas
Canada,10-05-2020,194239,2262,935,193304,Americas
Canada,10-05-2020,84919,1071,58,84861,Americas
Canada,10-05-2020,401756,1081,142,401614,Americas
Canada,10-05-2020,219726,2304,1172,218554,Americas
Canada,10-05-2020,354477,1661,287,354190,Americas
Canada,10-05-2020,188844,1198,133,188711,Americas
Central African Republic,10-05-2020,397396,1075,653,396743,Africa
Chad,10-05-2020,434729,2044,801,433928,Africa
Chile,10-05-2020,279858,774,18,279840,Americas
China,10-05-2020,314091,2029,1229,312862,Western Pacific
China,10-05-2020,70923,211,125,70798,Western Pacific
China,10-05-2020,173736,2269,148,173588,Western Pacific
China,10-05-2020,80957,1701,574,80383,Western Pacific
China,10-05-2020,420654,959,714,419940,Western Pacific
China,10-05-2020,86546,1207,1172,85374,Western Pacific
China,10-05-2020,156954,1595,165,156789,Western Pacific
China,10-05-2020,348518,1096,415,348103,Western Pacific
China,10-05-2020,254585,328,450,254135,Western Pacific
China,10-05-2020,99613,914,955,98658,Western Pacific
China,10-05-2020,106267,1836,1001,105266,Western Pacific
China,10-05-2020,253940,1580,521,253419,Western Pacific
China,10-05-2020,79463,1043,572,78891,Western Pacific
China,10-05-2020,21461,283,941,20520,Western Pacific
China,10-05-2020,319772,943,1032,318740,Western Pacific
China,10-05-2020,155905,457,279,155626,Western Pacific
China,10-05-2020,173140,1405,238,172902,Western Pacific
China,10-05-2020,71690,307,649,71041,Western Pacific
China,10-05-2020,392821,2438,394,392427,Western Pacific
China,10-05-2020,198723,900,326,198397,Western Pacific
China,10-05-2020,261607,146,230,261377,Western Pacific
China,10-05-2020,426017,906,1186,424831,Western Pacific
China,10-05-2020,110040,63,444,109596,Western Pacific
China,10-05-2020,411272,1396,463,410809,Western Pacific
China,10-05-2020,360865,278,1015,359850,Western Pacific
China,10-05-2020,336623,1416,131,336492,Western Pacific
China,10-05-2020,283503,2114,200,283303,Western Pacific
China,10-05-2020,363519,692,790,362729,Western Pacific
China,10-05-2020,37945,480,1036,36909,Western Pacific
China,10-05-2020,424157,1012,366,423791,Western Pacific
China,10-05-2020,426209,1505,475,425734,Western Pacific
China,10-05-2020,329176,1879,901,328275,Western Pacific
China,10-05-2020,338711,1014,16,338695,Western Pacific
Colombia,10-05-2020,122741,915,1196,121545,Americas
Congo (Brazzaville),10-05-2020,229009,1287,119,228890,Africa
Congo (Kinshasa),10-05-2020,339690,1166,252,339438,Africa
Costa Rica,10-05-2020,280800,1788,294,280506,Americas
Cote d'Ivoire,10-05-2020,138336,1435,735,137601,Africa
Croatia,10-05-2020,277004,2232,1222,275782,Europe
Cuba,10-05-2020,171052,567,1112,169940,Americas
Cyprus,10-05-2020,305992,1410,895,305097,Europe
Czechia,10-05-2020,307024,842,585,306439,Europe
Denmark,10-05-2020,440735,758,504,440231,Europe
Greenland,10-05-2020,149980,1530,719,149261,Europe
Denmark,10-05-2020,440608,2299,591,440017,Europe
Djibouti,10-05-2020,101189,455,102,101087,Eastern Mediterranean
Dominican Republic,10-05-2020,306064,1775,861,305203,Americas
Ecuador,10-05-2020,265369,1444,103,265266,Americas
Egypt,10-05-2020,324063,890,421,323642,Eastern Mediterranean
El Salvador,10-05-2020,410859,224,655,410204,Americas
Equatorial Guinea,10-05-2020,29404,1423,40,29364,Africa
Eritrea,10-05-2020,91266,2468,1091,90175,Africa
Estonia,10-05-2020,242423,1860,523,241900,Europe
Eswatini,10-05-2020,175543,1923,1062,174481,Africa
Ethiopia,10-05-2020,59162,2104,1126,58036,Africa
Fiji,10-05-2020,122310,1836,937,121373,Western Pacific
Finland,10-05-2020,441569,1096,251,441318,Europe
France,10-05-2020,115485,1037,1011,114474,Europe
France,10-05-2020,415258,2395,178,415080,Europe
France,10-05-2020,240619,1835,880,239739,Europe
France,10-05-2020,51488,779,1244,50244,Europe
France,10-05-2020,214554,1600,803,213751,Europe
France,10-05-2020,429381,910,285,429096,Europe
France,10-05-2020,127172,589,261,126911,Europe
France,10-05-2020,159874,1368,893,158981,Europe
France,10-05-2020,12849,1871,800,12049,Europe
France,10-05-2020,356097,285,30,356067,Europe
Gabon,10-05-2020,317371,1137,573,316798,Africa
Gambia,10-05-2020,178953,1820,210,178743,Africa
Georgia,10-05-2020,118514,2142,309,118205,Europe
Germany,10-05-2020,414851,2181,1098,413753,Europe
Ghana,10-05-2020,164273,912,83,164190,Africa
Greece,10-05-2020,43617,671,408,43209,Europe
Guatemala,10-05-2020,146221,766,818,145403,Americas
Guinea,10-05-2020,178603,1088,917,177686,Africa
Guyana,10-05-2020,365974,2054,498,365476,Americas
Haiti,10-05-2020,218056,2216,415,217641,Americas
Holy See,10-05-2020,254989,792,541,254448,Europe
Honduras,10-05-2020,106064,2425,385,105679,Americas
Hungary,10-05-2020,5946,2006,746,5200,Europe
Iceland,10-05-2020,368901,2155,696,368205,Europe
India,10-05-2020,72651,2453,1203,71448,South-East Asia
Indonesia,10-05-2020,100576,1499,63,100513,South-East Asia
Iran,10-05-2020,17004,65,845,16159,Eastern Mediterranean
Iraq,10-05-2020,93538,624,833,92705,Eastern Mediterranean
Ireland,10-05-2020,42992,2449,997,41995,Europe
Israel,10-05-2020,384567,1074,808,383759,Europe
Italy,10-05-2020,67932,1777,248,67684,Europe
Jamaica,10-05-2020,99413,1728,935,98478,Americas
Japan,10-05-2020,271601,243,234,271367,Western Pacific
Jordan,10-05-2020,233058,1055,264,232794,Eastern Mediterranean
Kazakhstan,10-05-2020,68872,336,1095,67777,Europe
Kenya,10-05-2020,339521,2108,43,339478,Africa
South Korea,10-05-2020,330246,328,931,329315,Western Pacific
Kuwait,10-05-2020,123167,1500,264,122903,Eastern Mediterranean
Kyrgyzstan,10-05-2020,72740,2080,352,72388,Europe
Latvia,10-05-2020,267690,2305,975,266715,Europe
Lebanon,10-05-2020,125931,2076,119,125812,Eastern Mediterranean
Liberia,10-05-2020,54052,2466,213,53839,Africa
Liechtenstein,10-05-2020,425862,2389,723,425139,Europe
Lithuania,10-05-2020,413880,1087,402,413478,Europe
Luxembourg,10-05-2020,281820,623,1045,280775,Europe
Madagascar,10-05-2020,43556,741,790,42766,Africa
Malaysia,10-05-2020,74787,2111,1137,73650,Western Pacific
Maldives,10-05-2020,113542,2376,569,112973,South-East Asia
Malta,10-05-2020,161862,589,458,161404,Europe
Mauritania,10-05-2020,211653,787,1248,210405,Africa
Mauritius,10-05-2020,357695,2193,621,357074,Africa
Mexico,10-05-2020,442191,1883,865,441326,Americas
Moldova,10-05-2020,191098,227,1142,189956,Europe
Monaco,10-05-2020,232159,926,1013,231146,Europe
Mongolia,10-05-2020,432002,630,1098,430904,Western Pacific
Montenegro,10-05-2020,112724,235,779,111945,Europe
Morocco,10-05-2020,384224,397,8,384216,Eastern Mediterranean
Namibia,10-05-2020,415058,1257,1166,413892,Africa
Nepal,10-05-2020,12305,1687,769,11536,South-East Asia
Netherlands,10-05-2020,383438,2177,256,383182,Europe
Netherlands,10-05-2020,327889,711,226,327663,Europe
Netherlands,10-05-2020,310231,2218,400,309831,Europe
Netherlands,10-05-2020,915,2448,606,309,Europe
New Zealand,10-05-2020,22462,371,1109,21353,Western Pacific
Nicaragua,10-05-2020,179794,1241,222,179572,Americas
Niger,10-05-2020,194271,745,1163,193108,Africa
Nigeria,10-05-2020,34610,1892,112,34498,Africa
North Macedonia,10-05-2020,139648,551,580,139068,Europe
Norway,10-05-2020,132074,915,457,131617,Europe
Oman,10-05-2020,62884,136,294,62590,Eastern Mediterranean
Pakistan,10-05-2020,12772,2288,613,12159,Eastern Mediterranean
Panama,10-05-2020,397045,174,719,396326,Americas
Papua New Guinea,10-05-2020,423848,2447,293,423555,Western Pacific
Paraguay,10-05-2020,363166,1535,913,362253,Americas
Peru,10-05-2020,435356,2202,1090,434266,Americas
Philippines,10-05-2020,136667,694,784,135883,Western Pacific
Poland,10-05-2020,12581,106,1187,11394,Europe
Portugal,10-05-2020,94992,1575,79,94913,Europe
Qatar,10-05-2020,161487,2479,256,161231,Eastern Mediterranean
Romania,10-05-2020,167389,276,1182,166207,Europe
Russia,10-05-2020,55327,38,1104,54223,Europe
Rwanda,10-05-2020,140817,1020,207,140610,Africa
Saint Lucia,10-05-2020,290063,169,848,289215,Americas
Saint Vincent and the Grenadines,10-05-2020,305804,239,121,305683,Americas
San Marino,10-05-2020,106098,128,1161,104937,Europe
Saudi Arabia,10-05-2020,115803,686,312,115491,Eastern Mediterranean
Senegal,10-05-2020,44886,1437,827,44059,Africa
Serbia,10-05-2020,159360,2248,945,158415,Europe
Seychelles,10-05-2020,325998,168,1203,324795,Africa
Singapore,10-05-2020,48409,457,799,47610,Western Pacific
Slovakia,10-05-2020,188658,1204,86,188572,Europe
Slovenia,10-05-2020,186893,1211,539,186354,Europe
Somalia,10-05-2020,276026,498,417,275609,Eastern Mediterranean
South Africa,10-05-2020,280620,826,106,280514,Africa
Spain,10-05-2020,87115,1890,839,86276,Europe
Sri Lanka,10-05-2020,400209,627,1179,399030,South-East Asia
Sudan,10-05-2020,248380,222,922,247458,Eastern Mediterranean
Suriname,10-05-2020,398114,560,1007,397107,Americas
Sweden,10-05-2020,108062,577,738,107324,Europe
Switzerland,10-05-2020,263484,1987,317,263167,Europe
Taiwan*,10-05-2020,143911,2119,549,143362,Western Pacific
Tanzania,10-05-2020,322354,337,676,321678,Africa
Thailand,10-05-2020,148159,596,3,148156,South-East Asia
Togo,10-05-2020,289618,2379,430,289188,Africa
Trinidad and Tobago,10-05-2020,129352,2401,1151,128201,Americas
Tunisia,10-05-2020,259127,2474,505,258622,Eastern Mediterranean
Turkey,10-05-2020,233621,1916,1045,232576,Europe
Uganda,10-05-2020,367579,2265,917,366662,Africa
Ukraine,10-05-2020,64273,77,205,64068,Europe
United Arab Emirates,10-05-2020,32715,411,79,32636,Eastern Mediterranean
United Kingdom,10-05-2020,259967,876,704,259263,Europe
United Kingdom,10-05-2020,218225,1722,244,217981,Europe
United Kingdom,10-05-2020,125184,326,94,125090,Europe
United Kingdom,10-05-2020,269337,2073,1095,268242,Europe
United Kingdom,10-05-2020,406077,112,493,405584,Europe
United Kingdom,10-05-2020,48676,506,607,48069,Europe
United Kingdom,10-05-2020,2271,769,1113,1158,Europe
Uruguay,10-05-2020,23695,1299,844,22851,Americas
US,10-05-2020,124549,1598,1223,123326,Americas
Uzbekistan,10-05-2020,341848,2299,1112,340736,Europe
Venezuela,10-05-2020,63218,1701,651,62567,Americas
Vietnam,10-05-2020,196244,1605,695,195549,Western Pacific
Zambia,10-05-2020,426684,1925,894,425790,Africa
Zimbabwe,10-05-2020,373951,143,14,373937,Africa
Dominica,10-05-2020,325920,490,689,325231,Americas
Grenada,10-05-2020,66531,1773,894,65637,Americas
Mozambique,10-05-2020,403750,1514,469,403281,Africa
Syria,10-05-2020,329616,1037,419,329197,Eastern Mediterranean
Timor-Leste,10-05-2020,187242,2380,405,186837,South-East Asia
Belize,10-05-2020,201365,330,81,201284,Americas
Laos,10-05-2020,181351,2396,492,180859,Western Pacific
Libya,10-05-2020,373345,214,353,372992,Eastern Mediterranean
West Bank and Gaza,10-05-2020,440397,658,900,439497,Eastern Mediterranean
Guinea-Bissau,10-05-2020,449425,1060,517,448908,Africa
Mali,10-05-2020,141355,2133,99,141256,Africa
Saint Kitts and Nevis,10-05-2020,62789,1700,1162,61627,Americas
Canada,10-05-2020,160089,91,915,159174,Americas
Canada,10-05-2020,320618,1086,68,320550,Americas
Kosovo,10-05-2020,130785,1842,614,130171,Europe
Burma,10-05-2020,245196,1817,878,244318,South-East Asia
United Kingdom,10-05-2020,372282,2030,165,372117,Europe
United Kingdom,10-05-2020,196481,117,290,196191,Europe
United Kingdom,10-05-2020,52949,819,709,52240,Europe
Botswana,10-05-2020,156835,254,461,156374,Africa
Burundi,10-05-2020,352043,2449,461,351582,Africa
Sierra Leone,10-05-2020,364125,29,1052,363073,Africa
Malawi,10-05-2020,364139,381,803,363336,Africa
United Kingdom,10-05-2020,238952,1864,816,238136,Europe
France,10-05-2020,241529,538,113,241416,Europe
South Sudan,10-05-2020,302504,746,825,301679,Africa
Western Sahara,10-05-2020,57358,126,497,56861,Africa
Sao Tome and Principe,10-05-2020,131694,1256,41,131653,Africa
Yemen,10-05-2020,415196,2252,405,414791,Eastern Mediterranean
Comoros,10-05-2020,29542,1428,60,29482,Africa
Tajikistan,10-05-2020,135080,1296,363,134717,Europe
Lesotho,10-05-2020,193253,235,450,192803,Africa
Afghanistan,11-05-2020,67556,589,494,67062,Eastern Mediterranean
Albania,11-05-2020,73094,832,486,72608,Europe
Algeria,11-05-2020,434789,2360,221,434568,Africa
Andorra,11-05-2020,157710,160,485,157225,Europe
Angola,11-05-2020,139797,2425,460,139337,Africa
Antigua and Barbuda,11-05-2020,193943,138,1117,192826,Americas
Argentina,11-05-2020,193125,1739,648,192477,Americas
Armenia,11-05-2020,181490,1172,1172,180318,Europe
Australia,11-05-2020,370622,2177,520,370102,Western Pacific
Australia,11-05-2020,208987,493,623,208364,Western Pacific
Australia,11-05-2020,284183,1477,489,283694,Western Pacific
Australia,11-05-2020,187879,1269,317,187562,Western Pacific
Australia,11-05-2020,228045,485,212,227833,Western Pacific
Australia,11-05-2020,117168,735,1065,116103,Western Pacific
Australia,11-05-2020,442448,162,122,442326,Western Pacific
Australia,11-05-2020,67090,367,120,66970,Western Pacific
Austria,11-05-2020,143950,2041,655,143295,Europe
Azerbaijan,11-05-2020,371082,1375,229,370853,Europe
Bahamas,11-05-2020,220813,980,1107,219706,Americas
Bahrain,11-05-2020,185432,510,385,185047,Eastern Mediterranean
Bangladesh,11-05-2020,427082,1509,992,426090,South-East Asia
Barbados,11-05-2020,112408,681,1203,111205,Americas
Belarus,11-05-2020,145763,2353,1169,144594,Europe
Belgium,11-05-2020,154503,1809,1068,153435,Europe
Benin,11-05-2020,387245,325,719,386526,Africa
Bhutan,11-05-2020,98919,618,806,98113,South-East Asia
Bolivia,11-05-2020,251016,777,1209,249807,Americas
Bosnia and Herzegovina,11-05-2020,362895,2152,537,362358,Europe
Brazil,11-05-2020,248696,1782,1203,247493,Americas
Brunei,11-05-2020,367592,1003,700,366892,Western Pacific
Bulgaria,11-05-2020,384207,82,556,383651,Europe
Burkina Faso,11-05-2020,40526,626,1062,39464,Africa
Cabo Verde,11-05-2020,253715,532,181,253534,Africa
Cambodia,11-05-2020,17603,2269,623,16980,Western Pacific
Cameroon,11-05-2020,342296,2148,1133,341163,Africa
Canada,11-05-2020,185044,357,1059,183985,Americas
Canada,11-05-2020,91907,2259,880,91027,Americas
Canada,11-05-2020,126186,1129,494,125692,Americas
Canada,11-05-2020,304417,1104,883,303534,Americas
Canada,11-05-2020,152171,462,504,151667,Americas
Canada,11-05-2020,196632,1493,1152,195480,Americas
Canada,11-05-2020,145134,2446,960,144174,Americas
Canada,11-05-2020,22079,1568,1079,21000,Americas
Canada,11-05-2020,113697,2115,1098,112599,Americas
Canada,11-05-2020,288005,1926,921,287084,Americas
Central African Republic,11-05-2020,297105,1407,1046,296059,Africa
Chad,11-05-2020,391915,1293,1051,390864,Africa
Chile,11-05-2020,157773,1863,262,157511,Americas
China,11-05-2020,146322,2357,821,145501,Western Pacific
China,11-05-2020,95531,2127,1021,94510,Western Pacific
China,11-05-2020,350027,1120,1139,348888,Western Pacific
China,11-05-2020,377826,1739,1173,376653,Western Pacific
China,11-05-2020,272618,316,397,272221,Western Pacific
China,11-05-2020,147942,1839,974,146968,Western Pacific
China,11-05-2020,300322,852,1086,299236,Western Pacific
China,11-05-2020,202078,870,219,201859,Western Pacific
China,11-05-2020,364169,1813,507,363662,Western Pacific
China,11-05-2020,77954,790,92,77862,Western Pacific
China,11-05-2020,2487,19,408,2079,Western Pacific
China,11-05-2020,226987,1659,911,226076,Western Pacific
China,11-05-2020,6562,1929,230,6332,Western Pacific
China,11-05-2020,60075,1000,1071,59004,Western Pacific
China,11-05-2020,147642,2368,9,147633,Western Pacific
China,11-05-2020,434834,428,45,434789,Western Pacific
China,11-05-2020,121186,1041,813,120373,Western Pacific
China,11-05-2020,173366,174,49,173317,Western Pacific
China,11-05-2020,437247,434,239,437008,Western Pacific
China,11-05-2020,305325,720,1182,304143,Western Pacific
China,11-05-2020,432899,1351,1,432898,Western Pacific
China,11-05-2020,402722,1611,627,402095,Western Pacific
China,11-05-2020,26631,1736,897,25734,Western Pacific
China,11-05-2020,208783,841,1247,207536,Western Pacific
China,11-05-2020,362000,2001,479,361521,Western Pacific
China,11-05-2020,58157,1950,113,58044,Western Pacific
China,11-05-2020,216951,1163,733,216218,Western Pacific
China,11-05-2020,271518,1982,960,270558,Western Pacific
China,11-05-2020,128249,265,1174,127075,Western Pacific
China,11-05-2020,356323,1532,217,356106,Western Pacific
China,11-05-2020,23328,1177,566,22762,Western Pacific
China,11-05-2020,290255,1481,1220,289035,Western Pacific
China,11-05-2020,266119,917,622,265497,Western Pacific
Colombia,11-05-2020,414050,2308,306,413744,Americas
Congo (Brazzaville),11-05-2020,84182,769,242,83940,Africa
Congo (Kinshasa),11-05-2020,136934,483,468,136466,Africa
Costa Rica,11-05-2020,64904,1760,262,64642,Americas
Cote d'Ivoire,11-05-2020,401059,1522,360,400699,Africa
Croatia,11-05-2020,28943,1328,1026,27917,Europe
Cuba,11-05-2020,196122,2259,454,195668,Americas
Cyprus,11-05-2020,427111,1343,1001,426110,Europe
Czechia,11-05-2020,174713,1725,177,174536,Europe
Denmark,11-05-2020,148493,1036,803,147690,Europe
Greenland,11-05-2020,243277,411,929,242348,Europe
Denmark,11-05-2020,57641,1920,205,57436,Europe
Djibouti,11-05-2020,370769,536,482,370287,Eastern Mediterranean
Dominican Republic,11-05-2020,429039,377,557,428482,Americas
Ecuador,11-05-2020,4084,985,1203,2881,Americas
Egypt,11-05-2020,278740,603,286,278454,Eastern Mediterranean
El Salvador,11-05-2020,74234,1343,1222,73012,Americas
Equatorial Guinea,11-05-2020,317696,1017,440,317256,Africa
Eritrea,11-05-2020,421780,849,623,421157,Africa
Estonia,11-05-2020,340711,107,1070,339641,Europe
Eswatini,11-05-2020,66939,2319,1063,65876,Africa
Ethiopia,11-05-2020,1391,528,14,1377,Africa
Fiji,11-05-2020,30847,1678,183,30664,Western Pacific
Finland,11-05-2020,38765,286,785,37980,Europe
France,11-05-2020,299946,855,1032,298914,Europe
France,11-05-2020,298735,1837,1154,297581,Europe
France,11-05-2020,436201,2045,368,435833,Europe
France,11-05-2020,401318,2473,819,400499,Europe
France,11-05-2020,446181,228,1084,445097,Europe
France,11-05-2020,14995,1355,755,14240,Europe
France,11-05-2020,163534,1458,570,162964,Europe
France,11-05-2020,245874,585,801,245073,Europe
France,11-05-2020,246409,1465,1136,245273,Europe
France,11-05-2020,403260,670,1025,402235,Europe
Gabon,11-05-2020,323899,1546,272,323627,Africa
Gambia,11-05-2020,401067,2278,534,400533,Africa
Georgia,11-05-2020,224847,1638,250,224597,Europe
Germany,11-05-2020,446674,613,237,446437,Europe
Ghana,11-05-2020,432213,899,346,431867,Africa
Greece,11-05-2020,413371,729,97,413274,Europe
Guatemala,11-05-2020,425790,2331,1223,424567,Americas
Guinea,11-05-2020,341625,2193,41,341584,Africa
Guyana,11-05-2020,220351,1086,814,219537,Americas
Haiti,11-05-2020,39716,762,600,39116,Americas
Holy See,11-05-2020,309334,125,304,309030,Europe
Honduras,11-05-2020,72786,601,989,71797,Americas
Hungary,11-05-2020,326638,787,301,326337,Europe
Iceland,11-05-2020,72230,1331,231,71999,Europe
India,11-05-2020,419061,1148,568,418493,South-East Asia
Indonesia,11-05-2020,39773,1680,593,39180,South-East Asia
Iran,11-05-2020,152032,2041,1226,150806,Eastern Mediterranean
Iraq,11-05-2020,250557,1076,271,250286,Eastern Mediterranean
Ireland,11-05-2020,186271,1623,861,185410,Europe
Israel,11-05-2020,430726,2062,479,430247,Europe
Italy,11-05-2020,18590,217,844,17746,Europe
Jamaica,11-05-2020,87475,305,1017,86458,Americas
Japan,11-05-2020,87847,1907,466,87381,Western Pacific
Jordan,11-05-2020,234203,363,505,233698,Eastern Mediterranean
Kazakhstan,11-05-2020,242658,1707,365,242293,Europe
Kenya,11-05-2020,382933,1275,812,382121,Africa
South Korea,11-05-2020,45215,2136,455,44760,Western Pacific
Kuwait,11-05-2020,83819,1654,77,83742,Eastern Mediterranean
Kyrgyzstan,11-05-2020,278993,2125,354,278639,Europe
Latvia,11-05-2020,207059,1423,398,206661,Europe
Lebanon,11-05-2020,430171,1706,418,429753,Eastern Mediterranean
Liberia,11-05-2020,432779,461,1184,431595,Africa
Liechtenstein,11-05-2020,218449,973,731,217718,Europe
Lithuania,11-05-2020,93560,725,93,93467,Europe
Luxembourg,11-05-2020,85410,1060,590,84820,Europe
Madagascar,11-05-2020,443528,1564,683,442845,Africa
Malaysia,11-05-2020,260003,1205,1172,258831,Western Pacific
Maldives,11-05-2020,311528,1876,450,311078,South-East Asia
Malta,11-05-2020,21880,2096,428,21452,Europe
Mauritania,11-05-2020,250373,1725,765,249608,Africa
Mauritius,11-05-2020,226348,25,617,225731,Africa
Mexico,11-05-2020,113187,227,130,113057,Americas
Moldova,11-05-2020,9633,507,110,9523,Europe
Monaco,11-05-2020,411267,2365,315,410952,Europe
Mongolia,11-05-2020,133635,2251,1087,132548,Western Pacific
Montenegro,11-05-2020,440674,785,1125,439549,Europe
Morocco,11-05-2020,398308,2301,234,398074,Eastern Mediterranean
Namibia,11-05-2020,52162,486,66,52096,Africa
Nepal,11-05-2020,72736,856,914,71822,South-East Asia
Netherlands,11-05-2020,253833,650,672,253161,Europe
Netherlands,11-05-2020,396624,1093,78,396546,Europe
Netherlands,11-05-2020,426145,191,624,425521,Europe
Netherlands,11-05-2020,428907,1790,142,428765,Europe
New Zealand,11-05-2020,379599,2241,969,378630,Western Pacific
Nicaragua,11-05-2020,181956,1732,300,181656,Americas
Niger,11-05-2020,396450,561,34,396416,Africa
Nigeria,11-05-2020,370876,1351,100,370776,Africa
North Macedonia,11-05-2020,396828,624,632,396196,Europe
Norway,11-05-2020,26899,27,1111,25788,Europe
Oman,11-05-2020,159510,917,1245,158265,Eastern Mediterranean
Pakistan,11-05-2020,178203,486,721,177482,Eastern Mediterranean
Panama,11-05-2020,189893,1629,378,189515,Americas
Papua New Guinea,11-05-2020,116557,2435,19,116538,Western Pacific
Paraguay,11-05-2020,252569,2193,955,251614,Americas
Peru,11-05-2020,384349,1306,351,383998,Americas
Philippines,11-05-2020,4882,1627,1024,3858,Western Pacific
Poland,11-05-2020,182596,1509,1187,181409,Europe
Portugal,11-05-2020,118462,849,607,117855,Europe
Qatar,11-05-2020,236479,1011,923,235556,Eastern Mediterranean
Romania,11-05-2020,386049,1679,714,385335,Europe
Russia,11-05-2020,395715,1525,138,395577,Europe
Rwanda,11-05-2020,10674,1460,25,10649,Africa
Saint Lucia,11-05-2020,247372,224,439,246933,Americas
Saint Vincent and the Grenadines,11-05-2020,310350,217,142,310208,Americas
San Marino,11-05-2020,74306,2115,978,73328,Europe
Saudi Arabia,11-05-2020,191463,903,1235,190228,Eastern Mediterranean
Senegal,11-05-2020,210108,2084,358,209750,Africa
Serbia,11-05-2020,163771,1116,1015,162756,Europe
Seychelles,11-05-2020,3314,1056,991,2323,Africa
Singapore,11-05-2020,322737,2259,1084,321653,Western Pacific
Slovakia,11-05-2020,79443,638,828,78615,Europe
Slovenia,11-05-2020,132577,1479,1235,131342,Europe
Somalia,11-05-2020,101558,2476,794,100764,Eastern Mediterranean
South Africa,11-05-2020,443319,1274,1003,442316,Africa
Spain,11-05-2020,137047,593,690,136357,Europe
Sri Lanka,11-05-2020,386,563,941,-555,South-East Asia
Sudan,11-05-2020,361192,254,190,361002,Eastern Mediterranean
Suriname,11-05-2020,368038,1414,971,367067,Americas
Sweden,11-05-2020,126917,723,191,126726,Europe
Switzerland,11-05-2020,447248,1840,1221,446027,Europe
Taiwan*,11-05-2020,119870,1049,422,119448,Western Pacific
Tanzania,11-05-2020,449383,1178,1047,448336,Africa
Thailand,11-05-2020,298581,929,16,298565,South-East Asia
Togo,11-05-2020,308672,612,1003,307669,Africa
Trinidad and Tobago,11-05-2020,161292,1082,236,161056,Americas
Tunisia,11-05-2020,53868,1519,44,53824,Eastern Mediterranean
Turkey,11-05-2020,68482,356,1047,67435,Europe
Uganda,11-05-2020,437301,2481,654,436647,Africa
Ukraine,11-05-2020,221108,1978,892,220216,Europe
United Arab Emirates,11-05-2020,245326,764,308,245018,Eastern Mediterranean
United Kingdom,11-05-2020,59465,221,138,59327,Europe
United Kingdom,11-05-2020,50461,2272,308,50153,Europe
United Kingdom,11-05-2020,117803,1284,207,117596,Europe
United Kingdom,11-05-2020,327788,642,1153,326635,Europe
United Kingdom,11-05-2020,165457,2090,103,165354,Europe
United Kingdom,11-05-2020,400823,100,206,400617,Europe
United Kingdom,11-05-2020,407566,2108,364,407202,Europe
Uruguay,11-05-2020,34425,1597,877,33548,Americas
US,11-05-2020,56176,49,922,55254,Americas
Uzbekistan,11-05-2020,384603,714,655,383948,Europe
Venezuela,11-05-2020,292390,2210,544,291846,Americas
Vietnam,11-05-2020,198842,2337,475,198367,Western Pacific
Zambia,11-05-2020,256249,1018,1002,255247,Africa
Zimbabwe,11-05-2020,312427,2483,130,312297,Africa
Dominica,11-05-2020,12240,1534,860,11380,Americas
Grenada,11-05-2020,58851,963,824,58027,Americas
Mozambique,11-05-2020,153614,1177,713,152901,Africa
Syria,11-05-2020,8709,494,745,7964,Eastern Mediterranean
Timor-Leste,11-05-2020,157392,1809,1117,156275,South-East Asia
Belize,11-05-2020,76417,1198,91,76326,Americas
Laos,11-05-2020,395715,1933,969,394746,Western Pacific
Libya,11-05-2020,377873,1486,828,377045,Eastern Mediterranean
West Bank and Gaza,11-05-2020,325719,1355,526,325193,Eastern Mediterranean
Guinea-Bissau,11-05-2020,94465,980,163,94302,Africa
Mali,11-05-2020,314905,1197,100,314805,Africa
Saint Kitts and Nevis,11-05-2020,55848,1226,457,55391,Americas
Canada,11-05-2020,73046,1190,796,72250,Americas
Canada,11-05-2020,16555,2087,730,15825,Americas
Kosovo,11-05-2020,180703,2214,50,180653,Europe
Burma,11-05-2020,8970,1637,940,8030,South-East Asia
United Kingdom,11-05-2020,317448,2074,1101,316347,Europe
United Kingdom,11-05-2020,56924,1409,1178,55746,Europe
United Kingdom,11-05-2020,46217,1924,336,45881,Europe
Botswana,11-05-2020,62844,1121,740,62104,Africa
Burundi,11-05-2020,139311,2451,237,139074,Africa
Sierra Leone,11-05-2020,73832,2350,609,73223,Africa
Malawi,11-05-2020,444529,1766,799,443730,Africa
United Kingdom,11-05-2020,427802,439,196,427606,Europe
France,11-05-2020,77614,1903,664,76950,Europe
South Sudan,11-05-2020,131671,847,528,131143,Africa
Western Sahara,11-05-2020,223182,23,1037,222145,Africa
Sao Tome and Principe,11-05-2020,209435,1498,210,209225,Africa
Yemen,11-05-2020,349872,2325,705,349167,Eastern Mediterranean
Comoros,11-05-2020,356221,730,1176,355045,Africa
Tajikistan,11-05-2020,353127,995,86,353041,Europe
Lesotho,11-05-2020,85442,1497,1189,84253,Africa
Afghanistan,12-05-2020,230122,1031,868,229254,Eastern Mediterranean
Albania,12-05-2020,235339,139,448,234891,Europe
Algeria,12-05-2020,86831,1428,317,86514,Africa
Andorra,12-05-2020,37762,2437,1083,36679,Europe
Angola,12-05-2020,287674,1125,955,286719,Africa
Antigua and Barbuda,12-05-2020,120107,1268,1090,119017,Americas
Argentina,12-05-2020,318132,1710,841,317291,Americas
Armenia,12-05-2020,315922,1220,643,315279,Europe
Australia,12-05-2020,156265,1932,990,155275,Western Pacific
Australia,12-05-2020,377798,1330,908,376890,Western Pacific
Australia,12-05-2020,22274,446,109,22165,Western Pacific
Australia,12-05-2020,41763,1079,1093,40670,Western Pacific
Australia,12-05-2020,254898,360,1224,253674,Western Pacific
Australia,12-05-2020,272274,2135,322,271952,Western Pacific
Australia,12-05-2020,154805,664,121,154684,Western Pacific
Australia,12-05-2020,273777,195,966,272811,Western Pacific
Austria,12-05-2020,333462,806,1141,332321,Europe
Azerbaijan,12-05-2020,219637,149,981,218656,Europe
Bahamas,12-05-2020,32916,597,526,32390,Americas
Bahrain,12-05-2020,123180,904,108,123072,Eastern Mediterranean
Bangladesh,12-05-2020,187075,991,353,186722,South-East Asia
Barbados,12-05-2020,182835,903,548,182287,Americas
Belarus,12-05-2020,257834,218,940,256894,Europe
Belgium,12-05-2020,122841,2038,813,122028,Europe
Benin,12-05-2020,102807,561,1041,101766,Africa
Bhutan,12-05-2020,55986,346,860,55126,South-East Asia
Bolivia,12-05-2020,416392,26,816,415576,Americas
Bosnia and Herzegovina,12-05-2020,388748,870,978,387770,Europe
Brazil,12-05-2020,375521,1590,126,375395,Americas
Brunei,12-05-2020,116871,1970,6,116865,Western Pacific
Bulgaria,12-05-2020,360688,501,1096,359592,Europe
Burkina Faso,12-05-2020,6710,2214,876,5834,Africa
Cabo Verde,12-05-2020,166591,658,264,166327,Africa
Cambodia,12-05-2020,356744,428,421,356323,Western Pacific
Cameroon,12-05-2020,413035,1430,929,412106,Africa
Canada,12-05-2020,9373,1980,321,9052,Americas
Canada,12-05-2020,211304,1409,766,210538,Americas
Canada,12-05-2020,340887,941,1206,339681,Americas
Canada,12-05-2020,233700,127,694,233006,Americas
Canada,12-05-2020,220147,717,607,219540,Americas
Canada,12-05-2020,330371,821,439,329932,Americas
Canada,12-05-2020,386160,2436,3,386157,Americas
Canada,12-05-2020,247673,2320,961,246712,Americas
Canada,12-05-2020,368829,266,687,368142,Americas
Canada,12-05-2020,344196,648,411,343785,Americas
Central African Republic,12-05-2020,384865,2262,507,384358,Africa
Chad,12-05-2020,339072,197,793,338279,Africa
Chile,12-05-2020,88114,1152,338,87776,Americas
China,12-05-2020,306505,260,1059,305446,Western Pacific
China,12-05-2020,249764,1949,483,249281,Western Pacific
China,12-05-2020,215085,69,1169,213916,Western Pacific
China,12-05-2020,229856,2078,78,229778,Western Pacific
China,12-05-2020,242762,526,809,241953,Western Pacific
China,12-05-2020,153646,2171,997,152649,Western Pacific
China,12-05-2020,254349,1785,231,254118,Western Pacific
China,12-05-2020,292928,111,193,292735,Western Pacific
China,12-05-2020,111538,831,703,110835,Western Pacific
China,12-05-2020,427630,421,1222,426408,Western Pacific
China,12-05-2020,239558,1814,1076,238482,Western Pacific
China,12-05-2020,244798,1772,24,244774,Western Pacific
China,12-05-2020,248388,771,330,248058,Western Pacific
China,12-05-2020,49115,2021,889,48226,Western Pacific
China,12-05-2020,269420,2381,12,269408,Western Pacific
China,12-05-2020,278570,95,336,278234,Western Pacific
China,12-05-2020,158258,169,506,157752,Western Pacific
China,12-05-2020,325958,2413,379,325579,Western Pacific
China,12-05-2020,317974,2027,191,317783,Western Pacific
China,12-05-2020,12147,106,407,11740,Western Pacific
China,12-05-2020,437425,1901,751,436674,Western Pacific
China,12-05-2020,82585,2060,127,82458,Western Pacific
China,12-05-2020,307379,934,133,307246,Western Pacific
China,12-05-2020,250266,259,803,249463,Western Pacific
China,12-05-2020,386946,865,176,386770,Western Pacific
China,12-05-2020,198270,1151,517,197753,Western Pacific
China,12-05-2020,306552,1219,82,306470,Western Pacific
China,12-05-2020,27033,302,145,26888,Western Pacific
China,12-05-2020,153667,1882,1220,152447,Western Pacific
China,12-05-2020,181697,2259,888,180809,Western Pacific
China,12-05-2020,302531,271,597,301934,Western Pacific
China,12-05-2020,247010,1233,1239,245771,Western Pacific
China,12-05-2020,444744,206,216,444528,Western Pacific
Colombia,12-05-2020,52944,1051,879,52065,Americas
Congo (Brazzaville),12-05-2020,321452,2195,1028,320424,Africa
Congo (Kinshasa),12-05-2020,110920,1277,220,110700,Africa
Costa Rica,12-05-2020,198119,872,918,197201,Americas
Cote d'Ivoire,12-05-2020,447302,44,298,447004,Africa
Croatia,12-05-2020,356476,397,820,355656,Europe
Cuba,12-05-2020,14289,341,635,13654,Americas
Cyprus,12-05-2020,402073,139,1096,400977,Europe
Czechia,12-05-2020,265930,2227,1082,264848,Europe
Denmark,12-05-2020,303466,160,82,303384,Europe
Greenland,12-05-2020,60298,317,954,59344,Europe
Denmark,12-05-2020,285649,2094,576,285073,Europe
Djibouti,12-05-2020,204494,2450,459,204035,Eastern Mediterranean
Dominican Republic,12-05-2020,123489,2,579,122910,Americas
Ecuador,12-05-2020,423951,526,958,422993,Americas
Egypt,12-05-2020,255710,1047,346,255364,Eastern Mediterranean
El Salvador,12-05-2020,276194,1026,1080,275114,Americas
Equatorial Guinea,12-05-2020,189620,963,1050,188570,Africa
Eritrea,12-05-2020,303396,2042,653,302743,Africa
Estonia,12-05-2020,177261,873,30,177231,Europe
Eswatini,12-05-2020,150973,2313,196,150777,Africa
Ethiopia,12-05-2020,380998,56,710,380288,Africa
Fiji,12-05-2020,401961,532,903,401058,Western Pacific
Finland,12-05-2020,284145,382,1054,283091,Europe
France,12-05-2020,71059,1306,632,70427,Europe
France,12-05-2020,144502,588,1104,143398,Europe
France,12-05-2020,1652,511,381,1271,Europe
France,12-05-2020,300100,91,562,299538,Europe
France,12-05-2020,325505,494,120,325385,Europe
France,12-05-2020,261991,1067,439,261552,Europe
France,12-05-2020,344993,2256,570,344423,Europe
France,12-05-2020,406058,2007,1033,405025,Europe
France,12-05-2020,94856,1294,84,94772,Europe
France,12-05-2020,389386,399,533,388853,Europe
Gabon,12-05-2020,25180,1387,770,24410,Africa
Gambia,12-05-2020,332708,2162,1247,331461,Africa
Georgia,12-05-2020,381948,2007,102,381846,Europe
Germany,12-05-2020,159682,1829,860,158822,Europe
Ghana,12-05-2020,359273,534,276,358997,Africa
Greece,12-05-2020,224641,1135,702,223939,Europe
Guatemala,12-05-2020,429799,1966,52,429747,Americas
Guinea,12-05-2020,436324,377,1206,435118,Africa
Guyana,12-05-2020,154244,658,368,153876,Americas
Haiti,12-05-2020,323931,2496,618,323313,Americas
Holy See,12-05-2020,392522,708,1096,391426,Europe
Honduras,12-05-2020,143274,665,623,142651,Americas
Hungary,12-05-2020,241609,1824,257,241352,Europe
Iceland,12-05-2020,430329,1856,209,430120,Europe
India,12-05-2020,55131,1955,640,54491,South-East Asia
Indonesia,12-05-2020,179822,2118,442,179380,South-East Asia
Iran,12-05-2020,205826,961,526,205300,Eastern Mediterranean
Iraq,12-05-2020,433472,2101,185,433287,Eastern Mediterranean
Ireland,12-05-2020,271004,447,180,270824,Europe
Israel,12-05-2020,354520,1115,1068,353452,Europe
Italy,12-05-2020,355124,998,1115,354009,Europe
Jamaica,12-05-2020,9756,927,740,9016,Americas
Japan,12-05-2020,94783,155,1166,93617,Western Pacific
Jordan,12-05-2020,154830,2049,782,154048,Eastern Mediterranean
Kazakhstan,12-05-2020,414328,219,929,413399,Europe
Kenya,12-05-2020,383590,912,677,382913,Africa
South Korea,12-05-2020,173659,118,636,173023,Western Pacific
Kuwait,12-05-2020,23464,1588,764,22700,Eastern Mediterranean
Kyrgyzstan,12-05-2020,425846,1867,164,425682,Europe
Latvia,12-05-2020,344087,1960,627,343460,Europe
Lebanon,12-05-2020,288043,2336,1081,286962,Eastern Mediterranean
Liberia,12-05-2020,398720,1475,470,398250,Africa
Liechtenstein,12-05-2020,164015,1380,536,163479,Europe
Lithuania,12-05-2020,181366,1550,1021,180345,Europe
Luxembourg,12-05-2020,81009,536,411,80598,Europe
Madagascar,12-05-2020,221736,1611,183,221553,Africa
Malaysia,12-05-2020,272113,525,186,271927,Western Pacific
Maldives,12-05-2020,323821,1630,1122,322699,South-East Asia
Malta,12-05-2020,306529,431,783,305746,Europe
Mauritania,12-05-2020,317794,2298,592,317202,Africa
Mauritius,12-05-2020,222225,2247,671,221554,Africa
Mexico,12-05-2020,301097,2491,749,300348,Americas
Moldova,12-05-2020,45593,141,708,44885,Europe
Monaco,12-05-2020,231292,424,50,231242,Europe
Mongolia,12-05-2020,441179,2165,1153,440026,Western Pacific
Montenegro,12-05-2020,389799,2238,93,389706,Europe
Morocco,12-05-2020,135402,135,648,134754,Eastern Mediterranean
Namibia,12-05-2020,210142,1921,962,209180,Africa
Nepal,12-05-2020,5496,1450,1238,4258,South-East Asia
Netherlands,12-05-2020,241733,2444,97,241636,Europe
Netherlands,12-05-2020,266664,242,242,266422,Europe
Netherlands,12-05-2020,291517,2062,935,290582,Europe
Netherlands,12-05-2020,55795,2349,367,55428,Europe
New Zealand,12-05-2020,363013,110,457,362556,Western Pacific
Nicaragua,12-05-2020,241032,1145,507,240525,Americas
Niger,12-05-2020,245137,427,1050,244087,Africa
Nigeria,12-05-2020,289100,2077,61,289039,Africa
North Macedonia,12-05-2020,220484,1111,147,220337,Europe
Norway,12-05-2020,107889,1997,700,107189,Europe
Oman,12-05-2020,447054,582,493,446561,Eastern Mediterranean
Pakistan,12-05-2020,86428,892,709,85719,Eastern Mediterranean
Panama,12-05-2020,26352,241,820,25532,Americas
Papua New Guinea,12-05-2020,76505,2274,492,76013,Western Pacific
Paraguay,12-05-2020,448078,200,168,447910,Americas
Peru,12-05-2020,185571,1281,298,185273,Americas
Philippines,12-05-2020,234810,717,670,234140,Western Pacific
Poland,12-05-2020,5266,811,121,5145,Europe
Portugal,12-05-2020,66435,948,1098,65337,Europe
Qatar,12-05-2020,254443,1761,79,254364,Eastern Mediterranean
Romania,12-05-2020,437267,416,302,436965,Europe
Russia,12-05-2020,111424,2498,5,111419,Europe
Rwanda,12-05-2020,171733,1706,30,171703,Africa
Saint Lucia,12-05-2020,25929,1732,172,25757,Americas
Saint Vincent and the Grenadines,12-05-2020,267380,1355,297,267083,Americas
San Marino,12-05-2020,443095,2246,980,442115,Europe
Saudi Arabia,12-05-2020,387726,1994,940,386786,Eastern Mediterranean
Senegal,12-05-2020,373945,1956,1169,372776,Africa
Serbia,12-05-2020,86602,1691,968,85634,Europe
Seychelles,12-05-2020,29667,31,653,29014,Africa
Singapore,12-05-2020,438221,844,499,437722,Western Pacific
Slovakia,12-05-2020,151916,112,200,151716,Europe
Slovenia,12-05-2020,332300,336,320,331980,Europe
Somalia,12-05-2020,346130,1995,754,345376,Eastern Mediterranean
South Africa,12-05-2020,107823,1697,215,107608,Africa
Spain,12-05-2020,147434,1943,902,146532,Europe
Sri Lanka,12-05-2020,311208,1516,735,310473,South-East Asia
Sudan,12-05-2020,95331,168,1084,94247,Eastern Mediterranean
Suriname,12-05-2020,415324,2129,282,415042,Americas
Sweden,12-05-2020,206400,1135,1122,205278,Europe
Switzerland,12-05-2020,211616,1203,555,211061,Europe
Taiwan*,12-05-2020,430838,1869,594,430244,Western Pacific
Tanzania,12-05-2020,32384,1381,569,31815,Africa
Thailand,12-05-2020,146042,2016,699,145343,South-East Asia
Togo,12-05-2020,178970,2438,1208,177762,Africa
Trinidad and Tobago,12-05-2020,254854,1069,811,254043,Americas
Tunisia,12-05-2020,132539,1138,426,132113,Eastern Mediterranean
Turkey,12-05-2020,409555,205,1211,408344,Europe
Uganda,12-05-2020,174898,618,640,174258,Africa
Ukraine,12-05-2020,84473,2214,1006,83467,Europe
United Arab Emirates,12-05-2020,274337,337,737,273600,Eastern Mediterranean
United Kingdom,12-05-2020,432730,1935,988,431742,Europe
United Kingdom,12-05-2020,418263,1980,654,417609,Europe
United Kingdom,12-05-2020,272849,2214,56,272793,Europe
United Kingdom,12-05-2020,167334,1777,456,166878,Europe
United Kingdom,12-05-2020,393945,1511,693,393252,Europe
United Kingdom,12-05-2020,418964,26,624,418340,Europe
United Kingdom,12-05-2020,395719,2222,495,395224,Europe
Uruguay,12-05-2020,404393,2169,696,403697,Americas
US,12-05-2020,38033,494,784,37249,Americas
Uzbekistan,12-05-2020,31002,2096,614,30388,Europe
Venezuela,12-05-2020,35233,2068,267,34966,Americas
Vietnam,12-05-2020,39358,994,736,38622,Western Pacific
Zambia,12-05-2020,401028,1767,678,400350,Africa
Zimbabwe,12-05-2020,29412,228,524,28888,Africa
Dominica,12-05-2020,206398,2452,342,206056,Americas
Grenada,12-05-2020,97894,696,1212,96682,Americas
Mozambique,12-05-2020,189130,1308,799,188331,Africa
Syria,12-05-2020,2198,55,526,1672,Eastern Mediterranean
Timor-Leste,12-05-2020,449306,1880,397,448909,South-East Asia
Belize,12-05-2020,102712,102,34,102678,Americas
Laos,12-05-2020,4572,1110,110,4462,Western Pacific
Libya,12-05-2020,315577,13,706,314871,Eastern Mediterranean
West Bank and Gaza,12-05-2020,41981,1152,482,41499,Eastern Mediterranean
Guinea-Bissau,12-05-2020,379080,2244,1204,377876,Africa
Mali,12-05-2020,37103,1367,1224,35879,Africa
Saint Kitts and Nevis,12-05-2020,124406,1426,797,123609,Americas
Canada,12-05-2020,240772,1425,122,240650,Americas
Canada,12-05-2020,372797,596,1004,371793,Americas
Kosovo,12-05-2020,55238,362,917,54321,Europe
Burma,12-05-2020,146217,1024,344,145873,South-East Asia
United Kingdom,12-05-2020,264851,818,210,264641,Europe
United Kingdom,12-05-2020,280288,1008,1092,279196,Europe
United Kingdom,12-05-2020,192317,334,275,192042,Europe
Botswana,12-05-2020,70681,2129,1090,69591,Africa
Burundi,12-05-2020,358198,2227,385,357813,Africa
Sierra Leone,12-05-2020,130472,728,1221,129251,Africa
Malawi,12-05-2020,168626,1881,137,168489,Africa
United Kingdom,12-05-2020,41264,2118,656,40608,Europe
France,12-05-2020,99943,2364,1145,98798,Europe
South Sudan,12-05-2020,60912,1625,722,60190,Africa
Western Sahara,12-05-2020,328578,1841,334,328244,Africa
Sao Tome and Principe,12-05-2020,257498,1728,651,256847,Africa
Yemen,12-05-2020,432516,403,430,432086,Eastern Mediterranean
Comoros,12-05-2020,255114,906,995,254119,Africa
Tajikistan,12-05-2020,402244,277,239,402005,Europe
Lesotho,12-05-2020,219821,626,913,218908,Africa
Afghanistan,13-05-2020,232285,1815,1025,231260,Eastern Mediterranean
Albania,13-05-2020,53751,213,310,53441,Europe
Algeria,13-05-2020,402166,2497,999,401167,Africa
Andorra,13-05-2020,41053,867,848,40205,Europe
Angola,13-05-2020,161484,1922,1138,160346,Africa
Antigua and Barbuda,13-05-2020,257320,320,510,256810,Americas
Argentina,13-05-2020,168687,1405,700,167987,Americas
Armenia,13-05-2020,324831,1151,415,324416,Europe
Australia,13-05-2020,23748,1977,532,23216,Western Pacific
Australia,13-05-2020,23314,1490,932,22382,Western Pacific
Australia,13-05-2020,37681,2019,785,36896,Western Pacific
Australia,13-05-2020,443736,2375,558,443178,Western Pacific
Australia,13-05-2020,162925,1247,134,162791,Western Pacific
Australia,13-05-2020,188517,1799,283,188234,Western Pacific
Australia,13-05-2020,78500,1257,931,77569,Western Pacific
Australia,13-05-2020,350699,634,1183,349516,Western Pacific
Austria,13-05-2020,195712,62,1222,194490,Europe
Azerbaijan,13-05-2020,165379,589,498,164881,Europe
Bahamas,13-05-2020,106678,687,71,106607,Americas
Bahrain,13-05-2020,358189,755,355,357834,Eastern Mediterranean
Bangladesh,13-05-2020,335596,2109,543,335053,South-East Asia
Barbados,13-05-2020,199541,307,13,199528,Americas
Belarus,13-05-2020,132339,215,1195,131144,Europe
Belgium,13-05-2020,206749,1335,282,206467,Europe
Benin,13-05-2020,153054,496,1107,151947,Africa
Bhutan,13-05-2020,169529,1591,534,168995,South-East Asia
Bolivia,13-05-2020,346815,499,52,346763,Americas
Bosnia and Herzegovina,13-05-2020,316967,417,775,316192,Europe
Brazil,13-05-2020,422092,774,209,421883,Americas
Brunei,13-05-2020,23653,212,838,22815,Western Pacific
Bulgaria,13-05-2020,211181,870,711,210470,Europe
Burkina Faso,13-05-2020,277594,1170,1019,276575,Africa
Cabo Verde,13-05-2020,254496,1489,744,253752,Africa
Cambodia,13-05-2020,413263,2269,159,413104,Western Pacific
Cameroon,13-05-2020,170773,9,1227,169546,Africa
Canada,13-05-2020,369760,1338,1063,368697,Americas
Canada,13-05-2020,260326,434,1146,259180,Americas
Canada,13-05-2020,59207,1440,105,59102,Americas
Canada,13-05-2020,440778,543,208,440570,Americas
Canada,13-05-2020,228469,1614,1228,227241,Americas
Canada,13-05-2020,131888,1818,574,131314,Americas
Canada,13-05-2020,122814,98,1041,121773,Americas
Canada,13-05-2020,367014,931,122,366892,Americas
Canada,13-05-2020,360816,2031,515,360301,Americas
Canada,13-05-2020,5977,1450,147,5830,Americas
Central African Republic,13-05-2020,117218,689,537,116681,Africa
Chad,13-05-2020,274326,130,613,273713,Africa
Chile,13-05-2020,166310,2181,777,165533,Americas
China,13-05-2020,59302,74,1205,58097,Western Pacific
China,13-05-2020,293722,1797,1009,292713,Western Pacific
China,13-05-2020,142068,122,143,141925,Western Pacific
China,13-05-2020,106582,1100,827,105755,Western Pacific
China,13-05-2020,388200,2076,1120,387080,Western Pacific
China,13-05-2020,395417,476,112,395305,Western Pacific
China,13-05-2020,411184,36,1155,410029,Western Pacific
China,13-05-2020,25983,1416,486,25497,Western Pacific
China,13-05-2020,321975,25,1165,320810,Western Pacific
China,13-05-2020,296119,1461,776,295343,Western Pacific
China,13-05-2020,75135,1350,634,74501,Western Pacific
China,13-05-2020,51888,1953,1040,50848,Western Pacific
China,13-05-2020,75868,1459,335,75533,Western Pacific
China,13-05-2020,172876,1059,450,172426,Western Pacific
China,13-05-2020,429841,2230,553,429288,Western Pacific
China,13-05-2020,38337,599,290,38047,Western Pacific
China,13-05-2020,217743,1483,395,217348,Western Pacific
China,13-05-2020,59883,2278,207,59676,Western Pacific
China,13-05-2020,58386,2374,720,57666,Western Pacific
China,13-05-2020,357689,1805,1078,356611,Western Pacific
China,13-05-2020,347571,491,202,347369,Western Pacific
China,13-05-2020,13619,466,494,13125,Western Pacific
China,13-05-2020,246995,1054,637,246358,Western Pacific
China,13-05-2020,76123,323,1037,75086,Western Pacific
China,13-05-2020,385124,442,1089,384035,Western Pacific
China,13-05-2020,38564,2308,459,38105,Western Pacific
China,13-05-2020,301942,1522,953,300989,Western Pacific
China,13-05-2020,405711,195,1051,404660,Western Pacific
China,13-05-2020,68633,1971,59,68574,Western Pacific
China,13-05-2020,252434,1029,1119,251315,Western Pacific
China,13-05-2020,442835,848,875,441960,Western Pacific
China,13-05-2020,214124,611,0,214124,Western Pacific
China,13-05-2020,181695,2366,577,181118,Western Pacific
Colombia,13-05-2020,373470,1407,70,373400,Americas
Congo (Brazzaville),13-05-2020,441829,1607,616,441213,Africa
Congo (Kinshasa),13-05-2020,179305,652,830,178475,Africa
Costa Rica,13-05-2020,204254,2140,1096,203158,Americas
Cote d'Ivoire,13-05-2020,270693,1363,440,270253,Africa
Croatia,13-05-2020,224828,2161,44,224784,Europe
Cuba,13-05-2020,328563,1100,765,327798,Americas
Cyprus,13-05-2020,219657,1836,845,218812,Europe
Czechia,13-05-2020,132909,312,246,132663,Europe
Denmark,13-05-2020,3007,1192,991,2016,Europe
Greenland,13-05-2020,739,2154,290,449,Europe
Denmark,13-05-2020,168257,2191,822,167435,Europe
Djibouti,13-05-2020,213137,1887,994,212143,Eastern Mediterranean
Dominican Republic,13-05-2020,81900,428,288,81612,Americas
Ecuador,13-05-2020,114552,2008,1029,113523,Americas
Egypt,13-05-2020,177795,922,773,177022,Eastern Mediterranean
El Salvador,13-05-2020,115469,1311,183,115286,Americas
Equatorial Guinea,13-05-2020,252864,2082,880,251984,Africa
Eritrea,13-05-2020,38700,926,248,38452,Africa
Estonia,13-05-2020,171380,2052,891,170489,Europe
Eswatini,13-05-2020,69618,2381,519,69099,Africa
Ethiopia,13-05-2020,382250,835,212,382038,Africa
Fiji,13-05-2020,348888,277,479,348409,Western Pacific
Finland,13-05-2020,220630,214,253,220377,Europe
France,13-05-2020,296587,1610,248,296339,Europe
France,13-05-2020,127927,2058,859,127068,Europe
France,13-05-2020,398280,1540,82,398198,Europe
France,13-05-2020,125676,1699,79,125597,Europe
France,13-05-2020,122671,1507,815,121856,Europe
France,13-05-2020,397541,2191,645,396896,Europe
France,13-05-2020,427740,915,1046,426694,Europe
France,13-05-2020,66046,820,1078,64968,Europe
France,13-05-2020,277518,2304,240,277278,Europe
France,13-05-2020,29669,1666,345,29324,Europe
Gabon,13-05-2020,63133,2368,1130,62003,Africa
Gambia,13-05-2020,262124,330,491,261633,Africa
Georgia,13-05-2020,421892,1910,254,421638,Europe
Germany,13-05-2020,277526,1228,256,277270,Europe
Ghana,13-05-2020,12211,689,627,11584,Africa
Greece,13-05-2020,129304,81,532,128772,Europe
Guatemala,13-05-2020,186346,1048,347,185999,Americas
Guinea,13-05-2020,118462,2471,911,117551,Africa
Guyana,13-05-2020,16654,705,815,15839,Americas
Haiti,13-05-2020,48739,1915,752,47987,Americas
Holy See,13-05-2020,38282,66,1171,37111,Europe
Honduras,13-05-2020,321424,1145,975,320449,Americas
Hungary,13-05-2020,65010,963,524,64486,Europe
Iceland,13-05-2020,172586,698,231,172355,Europe
India,13-05-2020,137914,1380,139,137775,South-East Asia
Indonesia,13-05-2020,101451,823,1088,100363,South-East Asia
Iran,13-05-2020,105435,666,634,104801,Eastern Mediterranean
Iraq,13-05-2020,123795,391,541,123254,Eastern Mediterranean
Ireland,13-05-2020,357771,801,1070,356701,Europe
Israel,13-05-2020,19205,1683,687,18518,Europe
Italy,13-05-2020,209033,1542,865,208168,Europe
Jamaica,13-05-2020,144045,177,103,143942,Americas
Japan,13-05-2020,359783,995,748,359035,Western Pacific
Jordan,13-05-2020,313718,562,374,313344,Eastern Mediterranean
Kazakhstan,13-05-2020,104673,616,876,103797,Europe
Kenya,13-05-2020,220899,1070,940,219959,Africa
South Korea,13-05-2020,103913,574,803,103110,Western Pacific
Kuwait,13-05-2020,204696,1764,815,203881,Eastern Mediterranean
Kyrgyzstan,13-05-2020,237267,1707,416,236851,Europe
Latvia,13-05-2020,227693,495,945,226748,Europe
Lebanon,13-05-2020,29797,1702,654,29143,Eastern Mediterranean
Liberia,13-05-2020,129088,1481,820,128268,Africa
Liechtenstein,13-05-2020,160670,1544,1100,159570,Europe
Lithuania,13-05-2020,21351,1891,650,20701,Europe
Luxembourg,13-05-2020,20220,1729,1044,19176,Europe
Madagascar,13-05-2020,248919,1066,224,248695,Africa
Malaysia,13-05-2020,358725,1235,975,357750,Western Pacific
Maldives,13-05-2020,204621,1076,546,204075,South-East Asia
Malta,13-05-2020,18535,460,564,17971,Europe
Mauritania,13-05-2020,163193,331,1115,162078,Africa
Mauritius,13-05-2020,239235,1556,139,239096,Africa
Mexico,13-05-2020,197933,1335,390,197543,Americas
Moldova,13-05-2020,70868,454,71,70797,Europe
Monaco,13-05-2020,418221,1775,364,417857,Europe
Mongolia,13-05-2020,70344,630,885,69459,Western Pacific
Montenegro,13-05-2020,272111,1003,1174,270937,Europe
Morocco,13-05-2020,203449,133,84,203365,Eastern Mediterranean
Namibia,13-05-2020,157336,2335,1012,156324,Africa
Nepal,13-05-2020,384224,2145,95,384129,South-East Asia
Netherlands,13-05-2020,289655,587,574,289081,Europe
Netherlands,13-05-2020,342955,823,1186,341769,Europe
Netherlands,13-05-2020,140443,2054,170,140273,Europe
Netherlands,13-05-2020,383747,1984,157,383590,Europe
New Zealand,13-05-2020,38582,164,1044,37538,Western Pacific
Nicaragua,13-05-2020,318028,1565,800,317228,Americas
Niger,13-05-2020,68467,497,784,67683,Africa
Nigeria,13-05-2020,332038,1330,1099,330939,Africa
North Macedonia,13-05-2020,270895,2216,1201,269694,Europe
Norway,13-05-2020,238691,1687,757,237934,Europe
Oman,13-05-2020,99990,113,55,99935,Eastern Mediterranean
Pakistan,13-05-2020,278874,119,350,278524,Eastern Mediterranean
Panama,13-05-2020,296510,26,235,296275,Americas
Papua New Guinea,13-05-2020,277093,201,243,276850,Western Pacific
Paraguay,13-05-2020,245225,2040,1086,244139,Americas
Peru,13-05-2020,193546,1544,882,192664,Americas
Philippines,13-05-2020,214101,1979,1150,212951,Western Pacific
Poland,13-05-2020,413996,1121,625,413371,Europe
Portugal,13-05-2020,448792,1231,1013,447779,Europe
Qatar,13-05-2020,248540,611,127,248413,Eastern Mediterranean
Romania,13-05-2020,29858,935,626,29232,Europe
Russia,13-05-2020,202964,1397,869,202095,Europe
Rwanda,13-05-2020,16201,137,24,16177,Africa
Saint Lucia,13-05-2020,24714,778,85,24629,Americas
Saint Vincent and the Grenadines,13-05-2020,110388,1250,619,109769,Americas
San Marino,13-05-2020,222332,1275,875,221457,Europe
Saudi Arabia,13-05-2020,241227,265,1108,240119,Eastern Mediterranean
Senegal,13-05-2020,134477,2494,528,133949,Africa
Serbia,13-05-2020,416791,849,470,416321,Europe
Seychelles,13-05-2020,446847,1521,354,446493,Africa
Singapore,13-05-2020,224309,463,110,224199,Western Pacific
Slovakia,13-05-2020,242033,1956,1,242032,Europe
Slovenia,13-05-2020,37662,646,861,36801,Europe
Somalia,13-05-2020,188397,114,1238,187159,Eastern Mediterranean
South Africa,13-05-2020,437491,1271,44,437447,Africa
Spain,13-05-2020,265782,673,966,264816,Europe
Sri Lanka,13-05-2020,148835,2374,565,148270,South-East Asia
Sudan,13-05-2020,430627,2320,1102,429525,Eastern Mediterranean
Suriname,13-05-2020,199476,907,181,199295,Americas
Sweden,13-05-2020,30841,586,693,30148,Europe
Switzerland,13-05-2020,333920,888,1085,332835,Europe
Taiwan*,13-05-2020,263230,1567,1018,262212,Western Pacific
Tanzania,13-05-2020,320921,204,695,320226,Africa
Thailand,13-05-2020,302550,1032,1078,301472,South-East Asia
Togo,13-05-2020,263130,165,84,263046,Africa
Trinidad and Tobago,13-05-2020,419648,1347,427,419221,Americas
Tunisia,13-05-2020,235948,2196,627,235321,Eastern Mediterranean
Turkey,13-05-2020,336967,209,407,336560,Europe
Uganda,13-05-2020,303072,2465,1002,302070,Africa
Ukraine,13-05-2020,124620,2414,240,124380,Europe
United Arab Emirates,13-05-2020,55232,1649,453,54779,Eastern Mediterranean
United Kingdom,13-05-2020,38149,1595,1107,37042,Europe
United Kingdom,13-05-2020,347021,2211,128,346893,Europe
United Kingdom,13-05-2020,112349,1721,674,111675,Europe
United Kingdom,13-05-2020,373511,942,31,373480,Europe
United Kingdom,13-05-2020,108579,1495,365,108214,Europe
United Kingdom,13-05-2020,327508,1216,460,327048,Europe
United Kingdom,13-05-2020,109390,1579,1026,108364,Europe
Uruguay,13-05-2020,144490,627,976,143514,Americas
US,13-05-2020,221560,827,214,221346,Americas
Uzbekistan,13-05-2020,371591,46,661,370930,Europe
Venezuela,13-05-2020,46797,321,146,46651,Americas
Vietnam,13-05-2020,383357,2072,118,383239,Western Pacific
Zambia,13-05-2020,183400,2061,512,182888,Africa
Zimbabwe,13-05-2020,19039,19,985,18054,Africa
Dominica,13-05-2020,146316,1621,884,145432,Americas
Grenada,13-05-2020,22148,338,128,22020,Americas
Mozambique,13-05-2020,268127,1746,896,267231,Africa
Syria,13-05-2020,204781,378,938,203843,Eastern Mediterranean
Timor-Leste,13-05-2020,22936,1561,848,22088,South-East Asia
Belize,13-05-2020,395852,1103,1168,394684,Americas
Laos,13-05-2020,296758,1710,595,296163,Western Pacific
Libya,13-05-2020,6351,2061,786,5565,Eastern Mediterranean
West Bank and Gaza,13-05-2020,39938,355,731,39207,Eastern Mediterranean
Guinea-Bissau,13-05-2020,303542,867,477,303065,Africa
Mali,13-05-2020,423795,1246,706,423089,Africa
Saint Kitts and Nevis,13-05-2020,224212,413,590,223622,Americas
Canada,13-05-2020,370271,1891,546,369725,Americas
Canada,13-05-2020,209879,2430,531,209348,Americas
Kosovo,13-05-2020,92563,509,658,91905,Europe
Burma,13-05-2020,10616,2038,741,9875,South-East Asia
United Kingdom,13-05-2020,361474,2259,885,360589,Europe
United Kingdom,13-05-2020,142415,1584,1093,141322,Europe
United Kingdom,13-05-2020,167044,408,406,166638,Europe
Botswana,13-05-2020,29178,205,657,28521,Africa
Burundi,13-05-2020,101025,375,1177,99848,Africa
Sierra Leone,13-05-2020,274042,641,610,273432,Africa
Malawi,13-05-2020,132687,70,886,131801,Africa
United Kingdom,13-05-2020,47945,582,456,47489,Europe
France,13-05-2020,345727,199,492,345235,Europe
South Sudan,13-05-2020,297422,2491,175,297247,Africa
Western Sahara,13-05-2020,439903,2498,996,438907,Africa
Sao Tome and Principe,13-05-2020,192841,981,1088,191753,Africa
Yemen,13-05-2020,274057,2186,170,273887,Eastern Mediterranean
Comoros,13-05-2020,160342,1745,196,160146,Africa
Tajikistan,13-05-2020,406119,1830,646,405473,Europe
Lesotho,13-05-2020,412602,2291,344,412258,Africa
Afghanistan,14-05-2020,28462,836,554,27908,Eastern Mediterranean
Albania,14-05-2020,201182,856,1108,200074,Europe
Algeria,14-05-2020,80896,1117,1052,79844,Africa
Andorra,14-05-2020,366369,931,72,366297,Europe
Angola,14-05-2020,27276,1033,1118,26158,Africa
Antigua and Barbuda,14-05-2020,383436,1486,683,382753,Americas
Argentina,14-05-2020,226617,1265,1088,225529,Americas
Armenia,14-05-2020,282367,205,789,281578,Europe
Australia,14-05-2020,253569,2474,1228,252341,Western Pacific
Australia,14-05-2020,311820,785,181,311639,Western Pacific
Australia,14-05-2020,58833,1942,72,58761,Western Pacific
Australia,14-05-2020,117485,1752,859,116626,Western Pacific
Australia,14-05-2020,232868,208,591,232277,Western Pacific
Australia,14-05-2020,213878,1766,843,213035,Western Pacific
Australia,14-05-2020,184671,670,55,184616,Western Pacific
Australia,14-05-2020,45599,2392,382,45217,Western Pacific
Austria,14-05-2020,362130,591,716,361414,Europe
Azerbaijan,14-05-2020,239297,134,121,239176,Europe
Bahamas,14-05-2020,296819,1767,870,295949,Americas
Bahrain,14-05-2020,217913,864,354,217559,Eastern Mediterranean
Bangladesh,14-05-2020,114331,1595,44,114287,South-East Asia
Barbados,14-05-2020,434910,1881,945,433965,Americas
Belarus,14-05-2020,246360,1185,502,245858,Europe
Belgium,14-05-2020,319994,85,1182,318812,Europe
Benin,14-05-2020,125410,725,948,124462,Africa
Bhutan,14-05-2020,259194,737,1158,258036,South-East Asia
Bolivia,14-05-2020,133852,650,378,133474,Americas
Bosnia and Herzegovina,14-05-2020,277922,1837,971,276951,Europe
Brazil,14-05-2020,151042,2004,444,150598,Americas
Brunei,14-05-2020,412262,297,291,411971,Western Pacific
Bulgaria,14-05-2020,352215,1664,254,351961,Europe
Burkina Faso,14-05-2020,103060,779,1242,101818,Africa
Cabo Verde,14-05-2020,377164,81,984,376180,Africa
Cambodia,14-05-2020,271045,737,117,270928,Western Pacific
Cameroon,14-05-2020,97271,137,1101,96170,Africa
Canada,14-05-2020,383449,1351,1076,382373,Americas
Canada,14-05-2020,421265,1174,616,420649,Americas
Canada,14-05-2020,129414,690,1163,128251,Americas
Canada,14-05-2020,99697,863,1172,98525,Americas
Canada,14-05-2020,2646,867,1236,1410,Americas
Canada,14-05-2020,32542,203,425,32117,Americas
Canada,14-05-2020,275235,1992,128,275107,Americas
Canada,14-05-2020,336133,755,1079,335054,Americas
Canada,14-05-2020,361312,2275,254,361058,Americas
Canada,14-05-2020,228079,1915,295,227784,Americas
Central African Republic,14-05-2020,90742,1180,166,90576,Africa
Chad,14-05-2020,411553,2457,293,411260,Africa
Chile,14-05-2020,117285,2064,916,116369,Americas
China,14-05-2020,377039,221,815,376224,Western Pacific
China,14-05-2020,142026,316,1149,140877,Western Pacific
China,14-05-2020,184997,1699,188,184809,Western Pacific
China,14-05-2020,18222,875,309,17913,Western Pacific
China,14-05-2020,57832,19,387,57445,Western Pacific
China,14-05-2020,173118,31,1103,172015,Western Pacific
China,14-05-2020,226230,1445,507,225723,Western Pacific
China,14-05-2020,215765,228,375,215390,Western Pacific
China,14-05-2020,262136,557,764,261372,Western Pacific
China,14-05-2020,166321,1097,552,165769,Western Pacific
China,14-05-2020,4432,302,563,3869,Western Pacific
China,14-05-2020,442129,1113,989,441140,Western Pacific
China,14-05-2020,122115,515,314,121801,Western Pacific
China,14-05-2020,214009,233,491,213518,Western Pacific
China,14-05-2020,174585,2416,281,174304,Western Pacific
China,14-05-2020,56884,429,653,56231,Western Pacific
China,14-05-2020,358743,2282,527,358216,Western Pacific
China,14-05-2020,285832,1128,903,284929,Western Pacific
China,14-05-2020,133050,1643,310,132740,Western Pacific
China,14-05-2020,58545,2018,1119,57426,Western Pacific
China,14-05-2020,212733,2074,185,212548,Western Pacific
China,14-05-2020,406155,1732,8,406147,Western Pacific
China,14-05-2020,279905,2372,437,279468,Western Pacific
China,14-05-2020,195900,324,13,195887,Western Pacific
China,14-05-2020,58553,562,772,57781,Western Pacific
China,14-05-2020,75388,1604,440,74948,Western Pacific
China,14-05-2020,238800,587,914,237886,Western Pacific
China,14-05-2020,392468,1013,113,392355,Western Pacific
China,14-05-2020,96271,341,908,95363,Western Pacific
China,14-05-2020,252792,2221,130,252662,Western Pacific
China,14-05-2020,249546,1499,489,249057,Western Pacific
China,14-05-2020,74484,1564,966,73518,Western Pacific
China,14-05-2020,337207,947,1222,335985,Western Pacific
Colombia,14-05-2020,409162,382,1101,408061,Americas
Congo (Brazzaville),14-05-2020,306606,583,755,305851,Africa
Congo (Kinshasa),14-05-2020,403378,1802,242,403136,Africa
Costa Rica,14-05-2020,42650,1070,712,41938,Americas
Cote d'Ivoire,14-05-2020,159154,730,1086,158068,Africa
Croatia,14-05-2020,54149,1421,551,53598,Europe
Cuba,14-05-2020,282599,2169,857,281742,Americas
Cyprus,14-05-2020,72180,449,830,71350,Europe
Czechia,14-05-2020,303286,1840,37,303249,Europe
Denmark,14-05-2020,66983,1486,474,66509,Europe
Greenland,14-05-2020,124846,1866,490,124356,Europe
Denmark,14-05-2020,444392,353,1109,443283,Europe
Djibouti,14-05-2020,431314,1023,191,431123,Eastern Mediterranean
Dominican Republic,14-05-2020,186413,1587,148,186265,Americas
Ecuador,14-05-2020,62031,774,221,61810,Americas
Egypt,14-05-2020,14785,2006,748,14037,Eastern Mediterranean
El Salvador,14-05-2020,414571,659,368,414203,Americas
Equatorial Guinea,14-05-2020,385120,1240,1107,384013,Africa
Eritrea,14-05-2020,31128,915,413,30715,Africa
Estonia,14-05-2020,157265,1099,20,157245,Europe
Eswatini,14-05-2020,259685,1220,576,259109,Africa
Ethiopia,14-05-2020,84088,1197,1066,83022,Africa
Fiji,14-05-2020,237721,1186,1129,236592,Western Pacific
Finland,14-05-2020,103736,902,54,103682,Europe
France,14-05-2020,215744,443,781,214963,Europe
France,14-05-2020,228085,335,637,227448,Europe
France,14-05-2020,68594,84,468,68126,Europe
France,14-05-2020,358216,1734,405,357811,Europe
France,14-05-2020,16537,412,986,15551,Europe
France,14-05-2020,417354,1564,1243,416111,Europe
France,14-05-2020,47348,1050,1162,46186,Europe
France,14-05-2020,370139,1604,911,369228,Europe
France,14-05-2020,345796,1101,607,345189,Europe
France,14-05-2020,60373,1195,651,59722,Europe
Gabon,14-05-2020,148160,428,398,147762,Africa
Gambia,14-05-2020,238325,1778,1081,237244,Africa
Georgia,14-05-2020,420677,2271,1081,419596,Europe
Germany,14-05-2020,242775,936,114,242661,Europe
Ghana,14-05-2020,161785,786,473,161312,Africa
Greece,14-05-2020,301865,1574,1044,300821,Europe
Guatemala,14-05-2020,112390,890,736,111654,Americas
Guinea,14-05-2020,365079,1024,625,364454,Africa
Guyana,14-05-2020,50354,1668,1106,49248,Americas
Haiti,14-05-2020,271458,1287,1178,270280,Americas
Holy See,14-05-2020,402142,198,1186,400956,Europe
Honduras,14-05-2020,282703,806,1009,281694,Americas
Hungary,14-05-2020,393786,2476,49,393737,Europe
Iceland,14-05-2020,385979,1201,598,385381,Europe
India,14-05-2020,190000,1614,1192,188808,South-East Asia
Indonesia,14-05-2020,255560,1790,92,255468,South-East Asia
Iran,14-05-2020,325932,1184,760,325172,Eastern Mediterranean
Iraq,14-05-2020,106513,1428,159,106354,Eastern Mediterranean
Ireland,14-05-2020,448366,1171,28,448338,Europe
Israel,14-05-2020,315418,563,14,315404,Europe
Italy,14-05-2020,360853,2460,1055,359798,Europe
Jamaica,14-05-2020,184518,2022,556,183962,Americas
Japan,14-05-2020,317539,853,282,317257,Western Pacific
Jordan,14-05-2020,200771,963,232,200539,Eastern Mediterranean
Kazakhstan,14-05-2020,213177,1149,937,212240,Europe
Kenya,14-05-2020,115168,2184,1060,114108,Africa
South Korea,14-05-2020,231539,813,418,231121,Western Pacific
Kuwait,14-05-2020,61465,109,414,61051,Eastern Mediterranean
Kyrgyzstan,14-05-2020,187060,1782,603,186457,Europe
Latvia,14-05-2020,284962,2217,995,283967,Europe
Lebanon,14-05-2020,12245,1581,590,11655,Eastern Mediterranean
Liberia,14-05-2020,257278,1440,505,256773,Africa
Liechtenstein,14-05-2020,384889,2348,1119,383770,Europe
Lithuania,14-05-2020,423817,684,1242,422575,Europe
Luxembourg,14-05-2020,31357,2209,355,31002,Europe
Madagascar,14-05-2020,219964,655,492,219472,Africa
Malaysia,14-05-2020,103013,1513,855,102158,Western Pacific
Maldives,14-05-2020,74736,1949,1121,73615,South-East Asia
Malta,14-05-2020,441703,1106,1145,440558,Europe
Mauritania,14-05-2020,389277,2097,339,388938,Africa
Mauritius,14-05-2020,412092,2155,489,411603,Africa
Mexico,14-05-2020,10854,1841,127,10727,Americas
Moldova,14-05-2020,351328,1212,652,350676,Europe
Monaco,14-05-2020,419330,966,623,418707,Europe
Mongolia,14-05-2020,21453,1732,847,20606,Western Pacific
Montenegro,14-05-2020,142634,522,714,141920,Europe
Morocco,14-05-2020,382674,1197,52,382622,Eastern Mediterranean
Namibia,14-05-2020,381025,1015,988,380037,Africa
Nepal,14-05-2020,287685,68,226,287459,South-East Asia
Netherlands,14-05-2020,430578,61,328,430250,Europe
Netherlands,14-05-2020,329545,1704,216,329329,Europe
Netherlands,14-05-2020,322787,549,1091,321696,Europe
Netherlands,14-05-2020,427077,2386,686,426391,Europe
New Zealand,14-05-2020,422511,53,1112,421399,Western Pacific
Nicaragua,14-05-2020,429400,2362,464,428936,Americas
Niger,14-05-2020,391045,909,1238,389807,Africa
Nigeria,14-05-2020,266692,1520,388,266304,Africa
North Macedonia,14-05-2020,294391,644,1212,293179,Europe
Norway,14-05-2020,206419,2259,610,205809,Europe
Oman,14-05-2020,254284,329,1237,253047,Eastern Mediterranean
Pakistan,14-05-2020,175408,1661,36,175372,Eastern Mediterranean
Panama,14-05-2020,107193,37,365,106828,Americas
Papua New Guinea,14-05-2020,305202,1265,702,304500,Western Pacific
Paraguay,14-05-2020,238497,1508,1195,237302,Americas
Peru,14-05-2020,21682,315,276,21406,Americas
Philippines,14-05-2020,378397,1152,165,378232,Western Pacific
Poland,14-05-2020,299742,2090,1237,298505,Europe
Portugal,14-05-2020,415136,1216,159,414977,Europe
Qatar,14-05-2020,49372,1148,749,48623,Eastern Mediterranean
Romania,14-05-2020,56955,2350,544,56411,Europe
Russia,14-05-2020,321084,1148,543,320541,Europe
Rwanda,14-05-2020,432946,991,334,432612,Africa
Saint Lucia,14-05-2020,397498,1762,346,397152,Americas
Saint Vincent and the Grenadines,14-05-2020,374259,2369,835,373424,Americas
San Marino,14-05-2020,427916,1643,22,427894,Europe
Saudi Arabia,14-05-2020,378801,220,86,378715,Eastern Mediterranean
Senegal,14-05-2020,252923,2274,1172,251751,Africa
Serbia,14-05-2020,164380,1834,1063,163317,Europe
Seychelles,14-05-2020,349524,678,264,349260,Africa
Singapore,14-05-2020,148900,2477,1138,147762,Western Pacific
Slovakia,14-05-2020,22423,1331,489,21934,Europe
Slovenia,14-05-2020,424354,2011,318,424036,Europe
Somalia,14-05-2020,106819,131,351,106468,Eastern Mediterranean
South Africa,14-05-2020,286075,2212,686,285389,Africa
Spain,14-05-2020,18838,2228,475,18363,Europe
Sri Lanka,14-05-2020,355906,1224,975,354931,South-East Asia
Sudan,14-05-2020,350291,607,879,349412,Eastern Mediterranean
Suriname,14-05-2020,402987,2083,1099,401888,Americas
Sweden,14-05-2020,110620,650,946,109674,Europe
Switzerland,14-05-2020,38229,21,879,37350,Europe
Taiwan*,14-05-2020,407069,1273,463,406606,Western Pacific
Tanzania,14-05-2020,448379,1887,296,448083,Africa
Thailand,14-05-2020,265688,2256,702,264986,South-East Asia
Togo,14-05-2020,376673,393,1105,375568,Africa
Trinidad and Tobago,14-05-2020,182683,1822,27,182656,Americas
Tunisia,14-05-2020,222441,1899,36,222405,Eastern Mediterranean
Turkey,14-05-2020,379317,1213,951,378366,Europe
Uganda,14-05-2020,114172,2213,513,113659,Africa
Ukraine,14-05-2020,303305,676,345,302960,Europe
United Arab Emirates,14-05-2020,432457,240,1200,431257,Eastern Mediterranean
United Kingdom,14-05-2020,385358,2431,916,384442,Europe
United Kingdom,14-05-2020,239228,1753,528,238700,Europe
United Kingdom,14-05-2020,220399,2430,70,220329,Europe
United Kingdom,14-05-2020,80887,1833,63,80824,Europe
United Kingdom,14-05-2020,297167,2203,1181,295986,Europe
United Kingdom,14-05-2020,164473,2481,147,164326,Europe
United Kingdom,14-05-2020,296117,1743,1094,295023,Europe
Uruguay,14-05-2020,222485,13,68,222417,Americas
US,14-05-2020,152063,1884,718,151345,Americas
Uzbekistan,14-05-2020,87603,1978,632,86971,Europe
Venezuela,14-05-2020,151861,1535,1141,150720,Americas
Vietnam,14-05-2020,194360,816,376,193984,Western Pacific
Zambia,14-05-2020,67283,1614,661,66622,Africa
Zimbabwe,14-05-2020,95476,729,318,95158,Africa
Dominica,14-05-2020,360969,26,421,360548,Americas
Grenada,14-05-2020,281427,1179,699,280728,Americas
Mozambique,14-05-2020,118735,2079,667,118068,Africa
Syria,14-05-2020,39180,205,883,38297,Eastern Mediterranean
Timor-Leste,14-05-2020,216726,2077,923,215803,South-East Asia
Belize,14-05-2020,12419,2277,230,12189,Americas
Laos,14-05-2020,179202,2137,80,179122,Western Pacific
Libya,14-05-2020,281333,1534,1181,280152,Eastern Mediterranean
West Bank and Gaza,14-05-2020,191959,2469,1174,190785,Eastern Mediterranean
Guinea-Bissau,14-05-2020,203372,2435,561,202811,Africa
Mali,14-05-2020,448843,49,962,447881,Africa
Saint Kitts and Nevis,14-05-2020,302843,161,817,302026,Americas
Canada,14-05-2020,31320,1169,865,30455,Americas
Canada,14-05-2020,372294,608,1239,371055,Americas
Kosovo,14-05-2020,118460,880,906,117554,Europe
Burma,14-05-2020,243873,169,777,243096,South-East Asia
United Kingdom,14-05-2020,185820,2361,36,185784,Europe
United Kingdom,14-05-2020,264931,858,224,264707,Europe
United Kingdom,14-05-2020,117595,35,150,117445,Europe
Botswana,14-05-2020,106463,1866,203,106260,Africa
Burundi,14-05-2020,112725,68,775,111950,Africa
Sierra Leone,14-05-2020,340854,1668,336,340518,Africa
Malawi,14-05-2020,146491,660,266,146225,Africa
United Kingdom,14-05-2020,426185,381,230,425955,Europe
France,14-05-2020,376609,1729,766,375843,Europe
South Sudan,14-05-2020,31248,1771,770,30478,Africa
Western Sahara,14-05-2020,414828,2297,856,413972,Africa
Sao Tome and Principe,14-05-2020,95030,1190,376,94654,Africa
Yemen,14-05-2020,140891,1975,733,140158,Eastern Mediterranean
Comoros,14-05-2020,140046,1098,477,139569,Africa
Tajikistan,14-05-2020,240928,2209,1094,239834,Europe
Lesotho,14-05-2020,377123,442,731,376392,Africa
Afghanistan,15-05-2020,280828,860,1168,279660,Eastern Mediterranean
Albania,15-05-2020,446115,1098,142,445973,Europe
Algeria,15-05-2020,241637,895,919,240718,Africa
Andorra,15-05-2020,114817,1380,138,114679,Europe
Angola,15-05-2020,347725,1999,785,346940,Africa
Antigua and Barbuda,15-05-2020,206254,2035,454,205800,Americas
Argentina,15-05-2020,314156,1384,216,313940,Americas
Armenia,15-05-2020,87038,668,808,86230,Europe
Australia,15-05-2020,70050,1651,41,70009,Western Pacific
Australia,15-05-2020,449996,730,919,449077,Western Pacific
Australia,15-05-2020,438479,1008,92,438387,Western Pacific
Australia,15-05-2020,318956,2293,900,318056,Western Pacific
Australia,15-05-2020,140233,907,434,139799,Western Pacific
Australia,15-05-2020,367067,508,920,366147,Western Pacific
Australia,15-05-2020,194919,1923,90,194829,Western Pacific
Australia,15-05-2020,289458,403,1072,288386,Western Pacific
Austria,15-05-2020,341779,12,127,341652,Europe
Azerbaijan,15-05-2020,273799,166,523,273276,Europe
Bahamas,15-05-2020,303542,948,124,303418,Americas
Bahrain,15-05-2020,148442,247,103,148339,Eastern Mediterranean
Bangladesh,15-05-2020,141069,1607,440,140629,South-East Asia
Barbados,15-05-2020,207923,869,1204,206719,Americas
Belarus,15-05-2020,332933,903,329,332604,Europe
Belgium,15-05-2020,416316,52,538,415778,Europe
Benin,15-05-2020,299073,664,267,298806,Africa
Bhutan,15-05-2020,143016,1138,142,142874,South-East Asia
Bolivia,15-05-2020,330782,1848,538,330244,Americas
Bosnia and Herzegovina,15-05-2020,386728,1609,103,386625,Europe
Brazil,15-05-2020,112723,986,1111,111612,Americas
Brunei,15-05-2020,268791,2497,714,268077,Western Pacific
Bulgaria,15-05-2020,261149,1189,482,260667,Europe
Burkina Faso,15-05-2020,197708,2327,635,197073,Africa
Cabo Verde,15-05-2020,37350,452,623,36727,Africa
Cambodia,15-05-2020,334874,2426,221,334653,Western Pacific
Cameroon,15-05-2020,224149,628,277,223872,Africa
Canada,15-05-2020,416493,220,734,415759,Americas
Canada,15-05-2020,151584,1960,1213,150371,Americas
Canada,15-05-2020,347478,481,1110,346368,Americas
Canada,15-05-2020,338029,713,87,337942,Americas
Canada,15-05-2020,399949,896,222,399727,Americas
Canada,15-05-2020,245301,288,1113,244188,Americas
Canada,15-05-2020,368743,1332,1044,367699,Americas
Canada,15-05-2020,275515,143,1240,274275,Americas
Canada,15-05-2020,198135,76,336,197799,Americas
Canada,15-05-2020,148712,1734,306,148406,Americas
Central African Republic,15-05-2020,344010,25,972,343038,Africa
Chad,15-05-2020,388468,325,432,388036,Africa
Chile,15-05-2020,283914,1238,583,283331,Americas
China,15-05-2020,315494,91,582,314912,Western Pacific
China,15-05-2020,164666,355,1118,163548,Western Pacific
China,15-05-2020,449056,582,600,448456,Western Pacific
China,15-05-2020,394581,1307,1232,393349,Western Pacific
China,15-05-2020,155708,529,160,155548,Western Pacific
China,15-05-2020,108010,1680,325,107685,Western Pacific
China,15-05-2020,61906,2270,796,61110,Western Pacific
China,15-05-2020,362824,1004,351,362473,Western Pacific
China,15-05-2020,414660,1372,1234,413426,Western Pacific
China,15-05-2020,8774,1890,898,7876,Western Pacific
China,15-05-2020,414406,1645,373,414033,Western Pacific
China,15-05-2020,241891,1778,639,241252,Western Pacific
China,15-05-2020,160420,1813,610,159810,Western Pacific
China,15-05-2020,332544,1530,704,331840,Western Pacific
China,15-05-2020,161758,1667,896,160862,Western Pacific
China,15-05-2020,299151,2200,161,298990,Western Pacific
China,15-05-2020,355243,408,720,354523,Western Pacific
China,15-05-2020,281126,723,453,280673,Western Pacific
China,15-05-2020,294043,1045,946,293097,Western Pacific
China,15-05-2020,163841,911,489,163352,Western Pacific
China,15-05-2020,338797,842,754,338043,Western Pacific
China,15-05-2020,449541,1927,496,449045,Western Pacific
China,15-05-2020,302104,2235,67,302037,Western Pacific
China,15-05-2020,3004,148,1030,1974,Western Pacific
China,15-05-2020,14270,1689,395,13875,Western Pacific
China,15-05-2020,62804,69,37,62767,Western Pacific
China,15-05-2020,186559,243,431,186128,Western Pacific
China,15-05-2020,335153,805,851,334302,Western Pacific
China,15-05-2020,230262,1344,753,229509,Western Pacific
China,15-05-2020,201881,466,911,200970,Western Pacific
China,15-05-2020,422742,1254,320,422422,Western Pacific
China,15-05-2020,23492,881,851,22641,Western Pacific
China,15-05-2020,390355,830,480,389875,Western Pacific
Colombia,15-05-2020,165747,1359,682,165065,Americas
Congo (Brazzaville),15-05-2020,386576,792,407,386169,Africa
Congo (Kinshasa),15-05-2020,82269,739,38,82231,Africa
Costa Rica,15-05-2020,295118,336,844,294274,Americas
Cote d'Ivoire,15-05-2020,167624,765,181,167443,Africa
Croatia,15-05-2020,244374,2139,173,244201,Europe
Cuba,15-05-2020,170730,2367,817,169913,Americas
Cyprus,15-05-2020,130614,490,473,130141,Europe
Czechia,15-05-2020,372859,2313,427,372432,Europe
Denmark,15-05-2020,196715,340,118,196597,Europe
Greenland,15-05-2020,186669,2062,849,185820,Europe
Denmark,15-05-2020,387947,1405,1072,386875,Europe
Djibouti,15-05-2020,242801,350,614,242187,Eastern Mediterranean
Dominican Republic,15-05-2020,322752,2495,1136,321616,Americas
Ecuador,15-05-2020,390328,1450,632,389696,Americas
Egypt,15-05-2020,405401,2385,149,405252,Eastern Mediterranean
El Salvador,15-05-2020,90820,2354,506,90314,Americas
Equatorial Guinea,15-05-2020,264784,1211,209,264575,Africa
Eritrea,15-05-2020,158050,1118,240,157810,Africa
Estonia,15-05-2020,225059,1667,525,224534,Europe
Eswatini,15-05-2020,85854,1112,684,85170,Africa
Ethiopia,15-05-2020,56754,207,665,56089,Africa
Fiji,15-05-2020,309023,1580,442,308581,Western Pacific
Finland,15-05-2020,156276,249,246,156030,Europe
France,15-05-2020,146219,1981,128,146091,Europe
France,15-05-2020,315950,2115,1205,314745,Europe
France,15-05-2020,65726,1361,507,65219,Europe
France,15-05-2020,53756,983,821,52935,Europe
France,15-05-2020,2675,1164,1183,1492,Europe
France,15-05-2020,255556,2335,1198,254358,Europe
France,15-05-2020,165144,992,449,164695,Europe
France,15-05-2020,224993,1745,701,224292,Europe
France,15-05-2020,78642,1656,1,78641,Europe
France,15-05-2020,313093,1652,164,312929,Europe
Gabon,15-05-2020,186303,1967,240,186063,Africa
Gambia,15-05-2020,63044,113,1059,61985,Africa
Georgia,15-05-2020,296762,555,12,296750,Europe
Germany,15-05-2020,314965,151,261,314704,Europe
Ghana,15-05-2020,388394,1218,857,387537,Africa
Greece,15-05-2020,174102,1603,1171,172931,Europe
Guatemala,15-05-2020,175305,1038,846,174459,Americas
Guinea,15-05-2020,184558,838,244,184314,Africa
Guyana,15-05-2020,333858,1227,804,333054,Americas
Haiti,15-05-2020,132189,1964,586,131603,Americas
Holy See,15-05-2020,354633,116,763,353870,Europe
Honduras,15-05-2020,416550,2408,273,416277,Americas
Hungary,15-05-2020,163742,1541,503,163239,Europe
Iceland,15-05-2020,260440,176,54,260386,Europe
India,15-05-2020,157365,571,1167,156198,South-East Asia
Indonesia,15-05-2020,50228,66,1241,48987,South-East Asia
Iran,15-05-2020,318299,1974,523,317776,Eastern Mediterranean
Iraq,15-05-2020,226485,1205,1246,225239,Eastern Mediterranean
Ireland,15-05-2020,55024,179,522,54502,Europe
Israel,15-05-2020,133772,35,1042,132730,Europe
Italy,15-05-2020,225516,261,614,224902,Europe
Jamaica,15-05-2020,427758,2277,1141,426617,Americas
Japan,15-05-2020,309893,1791,213,309680,Western Pacific
Jordan,15-05-2020,378730,2010,478,378252,Eastern Mediterranean
Kazakhstan,15-05-2020,106482,820,885,105597,Europe
Kenya,15-05-2020,167148,763,1178,165970,Africa
South Korea,15-05-2020,140731,1255,540,140191,Western Pacific
Kuwait,15-05-2020,333956,1598,120,333836,Eastern Mediterranean
Kyrgyzstan,15-05-2020,53321,579,44,53277,Europe
Latvia,15-05-2020,334730,501,1157,333573,Europe
Lebanon,15-05-2020,54337,1777,988,53349,Eastern Mediterranean
Liberia,15-05-2020,249472,1936,1014,248458,Africa
Liechtenstein,15-05-2020,296466,517,458,296008,Europe
Lithuania,15-05-2020,39513,1034,338,39175,Europe
Luxembourg,15-05-2020,408608,1139,642,407966,Europe
Madagascar,15-05-2020,38414,543,223,38191,Africa
Malaysia,15-05-2020,311712,987,792,310920,Western Pacific
Maldives,15-05-2020,31582,957,1151,30431,South-East Asia
Malta,15-05-2020,331886,1914,503,331383,Europe
Mauritania,15-05-2020,16502,2006,946,15556,Africa
Mauritius,15-05-2020,362498,1343,599,361899,Africa
Mexico,15-05-2020,29061,1890,1236,27825,Americas
Moldova,15-05-2020,421338,1804,44,421294,Europe
Monaco,15-05-2020,256813,894,1031,255782,Europe
Mongolia,15-05-2020,114634,628,158,114476,Western Pacific
Montenegro,15-05-2020,250573,716,534,250039,Europe
Morocco,15-05-2020,95048,1367,667,94381,Eastern Mediterranean
Namibia,15-05-2020,16364,2035,684,15680,Africa
Nepal,15-05-2020,371590,746,1050,370540,South-East Asia
Netherlands,15-05-2020,323577,432,606,322971,Europe
Netherlands,15-05-2020,186027,2226,848,185179,Europe
Netherlands,15-05-2020,324416,1447,627,323789,Europe
Netherlands,15-05-2020,402977,2431,770,402207,Europe
New Zealand,15-05-2020,138101,896,400,137701,Western Pacific
Nicaragua,15-05-2020,207230,1993,691,206539,Americas
Niger,15-05-2020,387006,2013,1050,385956,Africa
Nigeria,15-05-2020,295755,1232,280,295475,Africa
North Macedonia,15-05-2020,223848,192,636,223212,Europe
Norway,15-05-2020,236582,1261,183,236399,Europe
Oman,15-05-2020,101651,1984,827,100824,Eastern Mediterranean
Pakistan,15-05-2020,163403,2274,719,162684,Eastern Mediterranean
Panama,15-05-2020,224520,1329,244,224276,Americas
Papua New Guinea,15-05-2020,212763,434,117,212646,Western Pacific
Paraguay,15-05-2020,116834,1160,862,115972,Americas
Peru,15-05-2020,312488,643,715,311773,Americas
Philippines,15-05-2020,88986,1388,318,88668,Western Pacific
Poland,15-05-2020,35402,678,1155,34247,Europe
Portugal,15-05-2020,438549,1495,634,437915,Europe
Qatar,15-05-2020,306234,920,945,305289,Eastern Mediterranean
Romania,15-05-2020,60157,1971,919,59238,Europe
Russia,15-05-2020,185994,2211,820,185174,Europe
Rwanda,15-05-2020,422300,1111,279,422021,Africa
Saint Lucia,15-05-2020,414879,142,1203,413676,Americas
Saint Vincent and the Grenadines,15-05-2020,170973,1702,647,170326,Americas
San Marino,15-05-2020,277212,57,404,276808,Europe
Saudi Arabia,15-05-2020,263979,157,179,263800,Eastern Mediterranean
Senegal,15-05-2020,315357,2017,241,315116,Africa
Serbia,15-05-2020,351809,582,757,351052,Europe
Seychelles,15-05-2020,92184,651,539,91645,Africa
Singapore,15-05-2020,275375,1209,898,274477,Western Pacific
Slovakia,15-05-2020,397743,1148,306,397437,Europe
Slovenia,15-05-2020,114295,2089,776,113519,Europe
Somalia,15-05-2020,199973,695,900,199073,Eastern Mediterranean
South Africa,15-05-2020,426789,415,950,425839,Africa
Spain,15-05-2020,124427,1075,865,123562,Europe
Sri Lanka,15-05-2020,208126,1826,1159,206967,South-East Asia
Sudan,15-05-2020,303196,1014,1036,302160,Eastern Mediterranean
Suriname,15-05-2020,359655,844,443,359212,Americas
Sweden,15-05-2020,388453,2466,1165,387288,Europe
Switzerland,15-05-2020,23403,1502,1179,22224,Europe
Taiwan*,15-05-2020,177389,850,1023,176366,Western Pacific
Tanzania,15-05-2020,286472,690,512,285960,Africa
Thailand,15-05-2020,206742,1999,199,206543,South-East Asia
Togo,15-05-2020,363796,604,1179,362617,Africa
Trinidad and Tobago,15-05-2020,402245,1894,1071,401174,Americas
Tunisia,15-05-2020,254992,2440,428,254564,Eastern Mediterranean
Turkey,15-05-2020,285956,1780,873,285083,Europe
Uganda,15-05-2020,175815,2449,628,175187,Africa
Ukraine,15-05-2020,151678,2341,501,151177,Europe
United Arab Emirates,15-05-2020,231227,2078,846,230381,Eastern Mediterranean
United Kingdom,15-05-2020,277695,1940,123,277572,Europe
United Kingdom,15-05-2020,222942,1164,948,221994,Europe
United Kingdom,15-05-2020,269751,278,899,268852,Europe
United Kingdom,15-05-2020,89598,1635,1131,88467,Europe
United Kingdom,15-05-2020,59370,2397,30,59340,Europe
United Kingdom,15-05-2020,324774,799,1225,323549,Europe
United Kingdom,15-05-2020,254393,1611,147,254246,Europe
Uruguay,15-05-2020,406759,1508,607,406152,Americas
US,15-05-2020,307812,1320,271,307541,Americas
Uzbekistan,15-05-2020,409569,906,244,409325,Europe
Venezuela,15-05-2020,124847,397,152,124695,Americas
Vietnam,15-05-2020,185896,2413,573,185323,Western Pacific
Zambia,15-05-2020,226583,385,628,225955,Africa
Zimbabwe,15-05-2020,145602,2245,956,144646,Africa
Dominica,15-05-2020,95659,1474,863,94796,Americas
Grenada,15-05-2020,375345,1567,1058,374287,Americas
Mozambique,15-05-2020,299027,2129,272,298755,Africa
Syria,15-05-2020,63591,1911,308,63283,Eastern Mediterranean
Timor-Leste,15-05-2020,263195,1960,76,263119,South-East Asia
Belize,15-05-2020,133571,2017,165,133406,Americas
Laos,15-05-2020,381580,1127,762,380818,Western Pacific
Libya,15-05-2020,331163,819,491,330672,Eastern Mediterranean
West Bank and Gaza,15-05-2020,402993,2493,688,402305,Eastern Mediterranean
Guinea-Bissau,15-05-2020,250932,1448,862,250070,Africa
Mali,15-05-2020,99438,72,62,99376,Africa
Saint Kitts and Nevis,15-05-2020,157656,1248,404,157252,Americas
Canada,15-05-2020,353762,17,1040,352722,Americas
Canada,15-05-2020,413538,1047,1176,412362,Americas
Kosovo,15-05-2020,387943,824,1174,386769,Europe
Burma,15-05-2020,214463,2027,1048,213415,South-East Asia
United Kingdom,15-05-2020,202251,1309,998,201253,Europe
United Kingdom,15-05-2020,262732,1841,931,261801,Europe
United Kingdom,15-05-2020,114340,2450,450,113890,Europe
Botswana,15-05-2020,50459,875,148,50311,Africa
Burundi,15-05-2020,275322,2408,571,274751,Africa
Sierra Leone,15-05-2020,328114,2217,371,327743,Africa
Malawi,15-05-2020,401516,891,105,401411,Africa
United Kingdom,15-05-2020,184810,2429,658,184152,Europe
France,15-05-2020,185787,554,465,185322,Europe
South Sudan,15-05-2020,163985,616,1067,162918,Africa
Western Sahara,15-05-2020,32266,1135,965,31301,Africa
Sao Tome and Principe,15-05-2020,102142,177,96,102046,Africa
Yemen,15-05-2020,65797,833,436,65361,Eastern Mediterranean
Comoros,15-05-2020,282220,1602,87,282133,Africa
Tajikistan,15-05-2020,318914,541,974,317940,Europe
Lesotho,15-05-2020,43712,1421,110,43602,Africa
Afghanistan,16-05-2020,278302,1392,667,277635,Eastern Mediterranean
Albania,16-05-2020,295495,601,360,295135,Europe
Algeria,16-05-2020,50938,2077,939,49999,Africa
Andorra,16-05-2020,275835,1210,178,275657,Europe
Angola,16-05-2020,273514,1811,197,273317,Africa
Antigua and Barbuda,16-05-2020,186135,760,1149,184986,Americas
Argentina,16-05-2020,202472,1596,499,201973,Americas
Armenia,16-05-2020,436946,1818,897,436049,Europe
Australia,16-05-2020,162861,1565,102,162759,Western Pacific
Australia,16-05-2020,340417,1372,121,340296,Western Pacific
Australia,16-05-2020,163265,2082,978,162287,Western Pacific
Australia,16-05-2020,54926,2330,1174,53752,Western Pacific
Australia,16-05-2020,55532,1739,163,55369,Western Pacific
Australia,16-05-2020,75325,1988,641,74684,Western Pacific
Australia,16-05-2020,25107,2484,1065,24042,Western Pacific
Australia,16-05-2020,415132,2477,27,415105,Western Pacific
Austria,16-05-2020,285966,2030,1199,284767,Europe
Azerbaijan,16-05-2020,67473,341,1032,66441,Europe
Bahamas,16-05-2020,99098,661,877,98221,Americas
Bahrain,16-05-2020,153147,2343,948,152199,Eastern Mediterranean
Bangladesh,16-05-2020,267786,820,740,267046,South-East Asia
Barbados,16-05-2020,278531,1310,486,278045,Americas
Belarus,16-05-2020,223302,127,1103,222199,Europe
Belgium,16-05-2020,223037,1822,340,222697,Europe
Benin,16-05-2020,112480,1488,180,112300,Africa
Bhutan,16-05-2020,153569,1293,919,152650,South-East Asia
Bolivia,16-05-2020,376352,2143,18,376334,Americas
Bosnia and Herzegovina,16-05-2020,1449,241,685,764,Europe
Brazil,16-05-2020,174898,562,299,174599,Americas
Brunei,16-05-2020,270137,1127,180,269957,Western Pacific
Bulgaria,16-05-2020,33637,725,590,33047,Europe
Burkina Faso,16-05-2020,408592,273,475,408117,Africa
Cabo Verde,16-05-2020,432907,1130,283,432624,Africa
Cambodia,16-05-2020,116802,2311,452,116350,Western Pacific
Cameroon,16-05-2020,64541,976,1090,63451,Africa
Canada,16-05-2020,79801,495,1013,78788,Americas
Canada,16-05-2020,372268,1609,675,371593,Americas
Canada,16-05-2020,207613,1620,132,207481,Americas
Canada,16-05-2020,386844,1951,106,386738,Americas
Canada,16-05-2020,290772,980,723,290049,Americas
Canada,16-05-2020,170682,426,351,170331,Americas
Canada,16-05-2020,135813,650,1167,134646,Americas
Canada,16-05-2020,341539,516,66,341473,Americas
Canada,16-05-2020,282475,851,498,281977,Americas
Canada,16-05-2020,339439,126,302,339137,Americas
Central African Republic,16-05-2020,281746,1264,951,280795,Africa
Chad,16-05-2020,81167,1139,902,80265,Africa
Chile,16-05-2020,132584,10,150,132434,Americas
China,16-05-2020,82835,256,51,82784,Western Pacific
China,16-05-2020,122950,564,110,122840,Western Pacific
China,16-05-2020,319748,1682,793,318955,Western Pacific
China,16-05-2020,257920,2163,881,257039,Western Pacific
China,16-05-2020,160831,330,837,159994,Western Pacific
China,16-05-2020,225165,2079,362,224803,Western Pacific
China,16-05-2020,420230,379,68,420162,Western Pacific
China,16-05-2020,88351,2460,1065,87286,Western Pacific
China,16-05-2020,364278,268,336,363942,Western Pacific
China,16-05-2020,255638,355,221,255417,Western Pacific
China,16-05-2020,163424,586,136,163288,Western Pacific
China,16-05-2020,296217,2479,785,295432,Western Pacific
China,16-05-2020,331318,2159,233,331085,Western Pacific
China,16-05-2020,289556,1596,486,289070,Western Pacific
China,16-05-2020,374597,995,328,374269,Western Pacific
China,16-05-2020,409113,734,149,408964,Western Pacific
China,16-05-2020,362488,1308,632,361856,Western Pacific
China,16-05-2020,328211,2366,1179,327032,Western Pacific
China,16-05-2020,233899,1254,753,233146,Western Pacific
China,16-05-2020,153346,2202,246,153100,Western Pacific
China,16-05-2020,237355,1767,304,237051,Western Pacific
China,16-05-2020,51867,21,668,51199,Western Pacific
China,16-05-2020,340115,350,536,339579,Western Pacific
China,16-05-2020,25349,961,59,25290,Western Pacific
China,16-05-2020,113682,1861,1206,112476,Western Pacific
China,16-05-2020,161022,1693,1101,159921,Western Pacific
China,16-05-2020,319958,17,468,319490,Western Pacific
China,16-05-2020,402189,174,958,401231,Western Pacific
China,16-05-2020,203625,1613,988,202637,Western Pacific
China,16-05-2020,101071,585,638,100433,Western Pacific
China,16-05-2020,288519,1907,1058,287461,Western Pacific
China,16-05-2020,14506,1276,537,13969,Western Pacific
China,16-05-2020,23193,940,685,22508,Western Pacific
Colombia,16-05-2020,138987,1817,1151,137836,Americas
Congo (Brazzaville),16-05-2020,277695,2140,419,277276,Africa
Congo (Kinshasa),16-05-2020,231711,35,831,230880,Africa
Costa Rica,16-05-2020,24610,1987,979,23631,Americas
Cote d'Ivoire,16-05-2020,77052,765,50,77002,Africa
Croatia,16-05-2020,31403,1780,318,31085,Europe
Cuba,16-05-2020,380424,156,694,379730,Americas
Cyprus,16-05-2020,280444,1748,821,279623,Europe
Czechia,16-05-2020,100373,502,1074,99299,Europe
Denmark,16-05-2020,88791,1848,768,88023,Europe
Greenland,16-05-2020,85199,1821,1088,84111,Europe
Denmark,16-05-2020,81837,329,742,81095,Europe
Djibouti,16-05-2020,403515,1015,113,403402,Eastern Mediterranean
Dominican Republic,16-05-2020,99064,1650,774,98290,Americas
Ecuador,16-05-2020,73634,405,554,73080,Americas
Egypt,16-05-2020,347343,2358,1160,346183,Eastern Mediterranean
El Salvador,16-05-2020,73429,1595,833,72596,Americas
Equatorial Guinea,16-05-2020,69994,251,522,69472,Africa
Eritrea,16-05-2020,402082,1982,1243,400839,Africa
Estonia,16-05-2020,359494,1389,627,358867,Europe
Eswatini,16-05-2020,295879,1491,870,295009,Africa
Ethiopia,16-05-2020,405091,1086,952,404139,Africa
Fiji,16-05-2020,255580,1838,1243,254337,Western Pacific
Finland,16-05-2020,198585,1010,1234,197351,Europe
France,16-05-2020,181507,2485,1069,180438,Europe
France,16-05-2020,341853,1850,987,340866,Europe
France,16-05-2020,87962,1214,714,87248,Europe
France,16-05-2020,371021,602,228,370793,Europe
France,16-05-2020,49682,1721,267,49415,Europe
France,16-05-2020,60797,279,62,60735,Europe
France,16-05-2020,430337,1048,810,429527,Europe
France,16-05-2020,241385,1752,1167,240218,Europe
France,16-05-2020,160892,851,480,160412,Europe
France,16-05-2020,414833,2114,788,414045,Europe
Gabon,16-05-2020,80025,1122,1125,78900,Africa
Gambia,16-05-2020,90355,2086,821,89534,Africa
Georgia,16-05-2020,195152,1131,197,194955,Europe
Germany,16-05-2020,302712,871,65,302647,Europe
Ghana,16-05-2020,382243,1810,778,381465,Africa
Greece,16-05-2020,33083,1457,704,32379,Europe
Guatemala,16-05-2020,330729,2318,476,330253,Americas
Guinea,16-05-2020,196008,518,840,195168,Africa
Guyana,16-05-2020,368527,1423,150,368377,Americas
Haiti,16-05-2020,239438,1847,878,238560,Americas
Holy See,16-05-2020,391804,2181,832,390972,Europe
Honduras,16-05-2020,300534,1698,299,300235,Americas
Hungary,16-05-2020,346601,543,172,346429,Europe
Iceland,16-05-2020,129347,1036,513,128834,Europe
India,16-05-2020,242426,2121,958,241468,South-East Asia
Indonesia,16-05-2020,324413,639,1215,323198,South-East Asia
Iran,16-05-2020,7412,1391,895,6517,Eastern Mediterranean
Iraq,16-05-2020,130408,726,8,130400,Eastern Mediterranean
Ireland,16-05-2020,311332,502,1108,310224,Europe
Israel,16-05-2020,93563,1105,82,93481,Europe
Italy,16-05-2020,16563,1963,1224,15339,Europe
Jamaica,16-05-2020,206365,965,737,205628,Americas
Japan,16-05-2020,327982,661,870,327112,Western Pacific
Jordan,16-05-2020,259465,2392,791,258674,Eastern Mediterranean
Kazakhstan,16-05-2020,100959,890,61,100898,Europe
Kenya,16-05-2020,134580,1664,317,134263,Africa
South Korea,16-05-2020,401597,1815,45,401552,Western Pacific
Kuwait,16-05-2020,394014,980,1190,392824,Eastern Mediterranean
Kyrgyzstan,16-05-2020,257034,1900,1169,255865,Europe
Latvia,16-05-2020,352725,1603,897,351828,Europe
Lebanon,16-05-2020,33565,1510,638,32927,Eastern Mediterranean
Liberia,16-05-2020,39243,1766,300,38943,Africa
Liechtenstein,16-05-2020,14241,1601,1173,13068,Europe
Lithuania,16-05-2020,319686,1224,1165,318521,Europe
Luxembourg,16-05-2020,256254,2118,579,255675,Europe
Madagascar,16-05-2020,218259,1945,1085,217174,Africa
Malaysia,16-05-2020,321743,494,520,321223,Western Pacific
Maldives,16-05-2020,380977,1065,699,380278,South-East Asia
Malta,16-05-2020,433128,1788,481,432647,Europe
Mauritania,16-05-2020,19753,1616,410,19343,Africa
Mauritius,16-05-2020,147103,2411,921,146182,Africa
Mexico,16-05-2020,123156,2452,631,122525,Americas
Moldova,16-05-2020,337355,2065,2,337353,Europe
Monaco,16-05-2020,148154,854,820,147334,Europe
Mongolia,16-05-2020,221783,1484,55,221728,Western Pacific
Montenegro,16-05-2020,427224,13,601,426623,Europe
Morocco,16-05-2020,104155,1649,613,103542,Eastern Mediterranean
Namibia,16-05-2020,251889,1651,445,251444,Africa
Nepal,16-05-2020,241529,1694,341,241188,South-East Asia
Netherlands,16-05-2020,74527,2396,981,73546,Europe
Netherlands,16-05-2020,322147,1425,952,321195,Europe
Netherlands,16-05-2020,284467,551,957,283510,Europe
Netherlands,16-05-2020,129733,138,117,129616,Europe
New Zealand,16-05-2020,34365,2374,116,34249,Western Pacific
Nicaragua,16-05-2020,333757,2314,515,333242,Americas
Niger,16-05-2020,68803,967,382,68421,Africa
Nigeria,16-05-2020,367813,215,137,367676,Africa
North Macedonia,16-05-2020,91630,1862,1177,90453,Europe
Norway,16-05-2020,312189,1009,957,311232,Europe
Oman,16-05-2020,109111,2123,848,108263,Eastern Mediterranean
Pakistan,16-05-2020,393233,452,70,393163,Eastern Mediterranean
Panama,16-05-2020,79411,1287,319,79092,Americas
Papua New Guinea,16-05-2020,173447,938,1051,172396,Western Pacific
Paraguay,16-05-2020,96858,1053,938,95920,Americas
Peru,16-05-2020,168347,1769,181,168166,Americas
Philippines,16-05-2020,308627,1000,430,308197,Western Pacific
Poland,16-05-2020,260706,564,639,260067,Europe
Portugal,16-05-2020,345935,2449,1006,344929,Europe
Qatar,16-05-2020,132549,2291,1008,131541,Eastern Mediterranean
Romania,16-05-2020,199955,1729,672,199283,Europe
Russia,16-05-2020,215879,2019,1145,214734,Europe
Rwanda,16-05-2020,10020,17,1215,8805,Africa
Saint Lucia,16-05-2020,38798,1818,651,38147,Americas
Saint Vincent and the Grenadines,16-05-2020,409462,1662,1186,408276,Americas
San Marino,16-05-2020,215890,2363,703,215187,Europe
Saudi Arabia,16-05-2020,162719,651,116,162603,Eastern Mediterranean
Senegal,16-05-2020,23405,617,162,23243,Africa
Serbia,16-05-2020,282013,351,498,281515,Europe
Seychelles,16-05-2020,226553,1672,152,226401,Africa
Singapore,16-05-2020,425826,2359,206,425620,Western Pacific
Slovakia,16-05-2020,335399,755,743,334656,Europe
Slovenia,16-05-2020,279880,2212,1016,278864,Europe
Somalia,16-05-2020,152623,159,805,151818,Eastern Mediterranean
South Africa,16-05-2020,225808,279,1049,224759,Africa
Spain,16-05-2020,427999,946,134,427865,Europe
Sri Lanka,16-05-2020,352589,1756,180,352409,South-East Asia
Sudan,16-05-2020,396886,323,1128,395758,Eastern Mediterranean
Suriname,16-05-2020,333672,2495,1049,332623,Americas
Sweden,16-05-2020,267478,1933,900,266578,Europe
Switzerland,16-05-2020,173933,1219,782,173151,Europe
Taiwan*,16-05-2020,338675,829,601,338074,Western Pacific
Tanzania,16-05-2020,307526,2318,525,307001,Africa
Thailand,16-05-2020,116352,31,330,116022,South-East Asia
Togo,16-05-2020,338515,2460,447,338068,Africa
Trinidad and Tobago,16-05-2020,190926,1283,899,190027,Americas
Tunisia,16-05-2020,134921,1655,433,134488,Eastern Mediterranean
Turkey,16-05-2020,372245,715,1122,371123,Europe
Uganda,16-05-2020,205973,903,1070,204903,Africa
Ukraine,16-05-2020,21710,995,16,21694,Europe
United Arab Emirates,16-05-2020,93473,1337,1220,92253,Eastern Mediterranean
United Kingdom,16-05-2020,235229,1229,286,234943,Europe
United Kingdom,16-05-2020,157880,375,456,157424,Europe
United Kingdom,16-05-2020,309384,300,784,308600,Europe
United Kingdom,16-05-2020,171154,905,898,170256,Europe
United Kingdom,16-05-2020,106508,30,1051,105457,Europe
United Kingdom,16-05-2020,93030,2333,253,92777,Europe
United Kingdom,16-05-2020,230857,2471,1185,229672,Europe
Uruguay,16-05-2020,230243,487,458,229785,Americas
US,16-05-2020,443040,1227,535,442505,Americas
Uzbekistan,16-05-2020,273544,2290,355,273189,Europe
Venezuela,16-05-2020,28393,1720,97,28296,Americas
Vietnam,16-05-2020,378372,400,544,377828,Western Pacific
Zambia,16-05-2020,216807,2261,806,216001,Africa
Zimbabwe,16-05-2020,157620,1985,633,156987,Africa
Dominica,16-05-2020,363931,1869,620,363311,Americas
Grenada,16-05-2020,71309,1434,586,70723,Americas
Mozambique,16-05-2020,281984,1514,386,281598,Africa
Syria,16-05-2020,425578,1920,882,424696,Eastern Mediterranean
Timor-Leste,16-05-2020,242812,595,135,242677,South-East Asia
Belize,16-05-2020,178064,2281,1219,176845,Americas
Laos,16-05-2020,428619,1778,1026,427593,Western Pacific
Libya,16-05-2020,270948,1663,148,270800,Eastern Mediterranean
West Bank and Gaza,16-05-2020,212484,1073,1184,211300,Eastern Mediterranean
Guinea-Bissau,16-05-2020,164638,988,642,163996,Africa
Mali,16-05-2020,15650,1195,1159,14491,Africa
Saint Kitts and Nevis,16-05-2020,347530,250,744,346786,Americas
Canada,16-05-2020,307695,32,124,307571,Americas
Canada,16-05-2020,323085,625,675,322410,Americas
Kosovo,16-05-2020,406308,1466,246,406062,Europe
Burma,16-05-2020,314450,1914,266,314184,South-East Asia
United Kingdom,16-05-2020,115034,1001,579,114455,Europe
United Kingdom,16-05-2020,126949,615,1024,125925,Europe
United Kingdom,16-05-2020,444443,1655,300,444143,Europe
Botswana,16-05-2020,155571,2010,244,155327,Africa
Burundi,16-05-2020,190979,1610,1205,189774,Africa
Sierra Leone,16-05-2020,112044,942,832,111212,Africa
Malawi,16-05-2020,202452,1291,1158,201294,Africa
United Kingdom,16-05-2020,293771,1282,461,293310,Europe
France,16-05-2020,188633,1622,108,188525,Europe
South Sudan,16-05-2020,302446,1028,264,302182,Africa
Western Sahara,16-05-2020,387811,1789,251,387560,Africa
Sao Tome and Principe,16-05-2020,97181,368,595,96586,Africa
Yemen,16-05-2020,300744,1402,1105,299639,Eastern Mediterranean
Comoros,16-05-2020,401717,528,708,401009,Africa
Tajikistan,16-05-2020,240405,538,914,239491,Europe
Lesotho,16-05-2020,324140,526,559,323581,Africa
Afghanistan,17-05-2020,201351,93,810,200541,Eastern Mediterranean
Albania,17-05-2020,136569,453,712,135857,Europe
Algeria,17-05-2020,111218,1737,348,110870,Africa
Andorra,17-05-2020,23187,375,1003,22184,Europe
Angola,17-05-2020,112645,1370,297,112348,Africa
Antigua and Barbuda,17-05-2020,164955,1420,1186,163769,Americas
Argentina,17-05-2020,446478,140,861,445617,Americas
Armenia,17-05-2020,103887,801,658,103229,Europe
Australia,17-05-2020,438648,2030,863,437785,Western Pacific
Australia,17-05-2020,190602,1841,266,190336,Western Pacific
Australia,17-05-2020,285867,427,446,285421,Western Pacific
Australia,17-05-2020,351941,738,1180,350761,Western Pacific
Australia,17-05-2020,259987,2363,1112,258875,Western Pacific
Australia,17-05-2020,100005,2323,1035,98970,Western Pacific
Australia,17-05-2020,130790,1186,288,130502,Western Pacific
Australia,17-05-2020,407664,1697,978,406686,Western Pacific
Austria,17-05-2020,427667,2111,299,427368,Europe
Azerbaijan,17-05-2020,318519,282,60,318459,Europe
Bahamas,17-05-2020,374811,1217,149,374662,Americas
Bahrain,17-05-2020,158227,327,433,157794,Eastern Mediterranean
Bangladesh,17-05-2020,392943,561,520,392423,South-East Asia
Barbados,17-05-2020,170598,1091,506,170092,Americas
Belarus,17-05-2020,30497,1225,1053,29444,Europe
Belgium,17-05-2020,433688,2085,681,433007,Europe
Benin,17-05-2020,98286,1555,27,98259,Africa
Bhutan,17-05-2020,153744,1408,1214,152530,South-East Asia
Bolivia,17-05-2020,27995,1180,1181,26814,Americas
Bosnia and Herzegovina,17-05-2020,217066,101,21,217045,Europe
Brazil,17-05-2020,386929,63,1076,385853,Americas
Brunei,17-05-2020,364016,1804,735,363281,Western Pacific
Bulgaria,17-05-2020,95451,338,19,95432,Europe
Burkina Faso,17-05-2020,216084,1278,938,215146,Africa
Cabo Verde,17-05-2020,310643,2135,1176,309467,Africa
Cambodia,17-05-2020,49584,729,1124,48460,Western Pacific
Cameroon,17-05-2020,184118,1375,1217,182901,Africa
Canada,17-05-2020,326019,171,47,325972,Americas
Canada,17-05-2020,328515,2021,458,328057,Americas
Canada,17-05-2020,27324,2450,729,26595,Americas
Canada,17-05-2020,141401,232,237,141164,Americas
Canada,17-05-2020,67030,1404,578,66452,Americas
Canada,17-05-2020,332448,72,304,332144,Americas
Canada,17-05-2020,443333,540,667,442666,Americas
Canada,17-05-2020,375443,2389,294,375149,Americas
Canada,17-05-2020,332740,2199,1111,331629,Americas
Canada,17-05-2020,140420,2287,109,140311,Americas
Central African Republic,17-05-2020,289035,979,673,288362,Africa
Chad,17-05-2020,390396,520,256,390140,Africa
Chile,17-05-2020,302825,689,959,301866,Americas
China,17-05-2020,390450,1875,104,390346,Western Pacific
China,17-05-2020,303498,1886,391,303107,Western Pacific
China,17-05-2020,267947,1146,923,267024,Western Pacific
China,17-05-2020,82858,2051,807,82051,Western Pacific
China,17-05-2020,33211,1886,270,32941,Western Pacific
China,17-05-2020,24695,1449,549,24146,Western Pacific
China,17-05-2020,76807,1694,324,76483,Western Pacific
China,17-05-2020,14973,1778,644,14329,Western Pacific
China,17-05-2020,383241,417,523,382718,Western Pacific
China,17-05-2020,243840,2211,554,243286,Western Pacific
China,17-05-2020,274180,1087,35,274145,Western Pacific
China,17-05-2020,167857,824,967,166890,Western Pacific
China,17-05-2020,403096,1610,259,402837,Western Pacific
China,17-05-2020,291561,1480,1117,290444,Western Pacific
China,17-05-2020,332390,532,450,331940,Western Pacific
China,17-05-2020,16267,199,573,15694,Western Pacific
China,17-05-2020,340381,1227,776,339605,Western Pacific
China,17-05-2020,232928,399,1242,231686,Western Pacific
China,17-05-2020,253178,52,1021,252157,Western Pacific
China,17-05-2020,267710,1724,997,266713,Western Pacific
China,17-05-2020,53574,140,711,52863,Western Pacific
China,17-05-2020,143668,2259,1018,142650,Western Pacific
China,17-05-2020,187977,644,421,187556,Western Pacific
China,17-05-2020,126132,471,285,125847,Western Pacific
China,17-05-2020,114240,94,398,113842,Western Pacific
China,17-05-2020,281311,2101,508,280803,Western Pacific
China,17-05-2020,296365,472,1022,295343,Western Pacific
China,17-05-2020,318876,286,400,318476,Western Pacific
China,17-05-2020,242671,1247,706,241965,Western Pacific
China,17-05-2020,102967,235,1072,101895,Western Pacific
China,17-05-2020,10587,2273,658,9929,Western Pacific
China,17-05-2020,7589,2186,696,6893,Western Pacific
China,17-05-2020,233476,1403,644,232832,Western Pacific
Colombia,17-05-2020,233691,1635,562,233129,Americas
Congo (Brazzaville),17-05-2020,51676,871,929,50747,Africa
Congo (Kinshasa),17-05-2020,310978,988,841,310137,Africa
Costa Rica,17-05-2020,245317,1368,524,244793,Americas
Cote d'Ivoire,17-05-2020,190750,1364,930,189820,Africa
Croatia,17-05-2020,320415,2160,536,319879,Europe
Cuba,17-05-2020,130834,58,974,129860,Americas
Cyprus,17-05-2020,368579,1834,558,368021,Europe
Czechia,17-05-2020,437554,886,811,436743,Europe
Denmark,17-05-2020,160716,521,93,160623,Europe
Greenland,17-05-2020,132820,1823,553,132267,Europe
Denmark,17-05-2020,239741,670,503,239238,Europe
Djibouti,17-05-2020,260624,1074,521,260103,Eastern Mediterranean
Dominican Republic,17-05-2020,46987,384,1070,45917,Americas
Ecuador,17-05-2020,308894,154,204,308690,Americas
Egypt,17-05-2020,17930,1594,1162,16768,Eastern Mediterranean
El Salvador,17-05-2020,91780,936,380,91400,Americas
Equatorial Guinea,17-05-2020,406953,673,535,406418,Africa
Eritrea,17-05-2020,395826,19,203,395623,Africa
Estonia,17-05-2020,291586,1784,68,291518,Europe
Eswatini,17-05-2020,306568,2368,829,305739,Africa
Ethiopia,17-05-2020,37710,876,1162,36548,Africa
Fiji,17-05-2020,356347,881,990,355357,Western Pacific
Finland,17-05-2020,180565,2365,705,179860,Europe
France,17-05-2020,345527,1460,204,345323,Europe
France,17-05-2020,31521,1726,631,30890,Europe
France,17-05-2020,441776,689,514,441262,Europe
France,17-05-2020,405234,878,67,405167,Europe
France,17-05-2020,193541,2255,10,193531,Europe
France,17-05-2020,385230,1623,797,384433,Europe
France,17-05-2020,101751,54,800,100951,Europe
France,17-05-2020,119342,1086,556,118786,Europe
France,17-05-2020,387409,39,671,386738,Europe
France,17-05-2020,242381,522,1121,241260,Europe
Gabon,17-05-2020,1616,484,919,697,Africa
Gambia,17-05-2020,298524,1963,188,298336,Africa
Georgia,17-05-2020,15026,2298,1234,13792,Europe
Germany,17-05-2020,179137,889,1225,177912,Europe
Ghana,17-05-2020,152488,1769,622,151866,Africa
Greece,17-05-2020,132019,868,861,131158,Europe
Guatemala,17-05-2020,270502,2231,918,269584,Americas
Guinea,17-05-2020,253995,1027,1058,252937,Africa
Guyana,17-05-2020,306926,1692,1132,305794,Americas
Haiti,17-05-2020,77931,2343,616,77315,Americas
Holy See,17-05-2020,411869,1684,218,411651,Europe
Honduras,17-05-2020,287739,1058,1120,286619,Americas
Hungary,17-05-2020,180796,672,973,179823,Europe
Iceland,17-05-2020,198721,1506,814,197907,Europe
India,17-05-2020,119577,453,1174,118403,South-East Asia
Indonesia,17-05-2020,448458,495,581,447877,South-East Asia
Iran,17-05-2020,93325,863,396,92929,Eastern Mediterranean
Iraq,17-05-2020,444845,708,1200,443645,Eastern Mediterranean
Ireland,17-05-2020,430255,153,134,430121,Europe
Israel,17-05-2020,177600,2168,241,177359,Europe
Italy,17-05-2020,247603,931,657,246946,Europe
Jamaica,17-05-2020,115755,2052,915,114840,Americas
Japan,17-05-2020,107711,1781,29,107682,Western Pacific
Jordan,17-05-2020,150100,1091,982,149118,Eastern Mediterranean
Kazakhstan,17-05-2020,33622,2179,502,33120,Europe
Kenya,17-05-2020,258925,1750,904,258021,Africa
South Korea,17-05-2020,180885,84,190,180695,Western Pacific
Kuwait,17-05-2020,275992,1938,934,275058,Eastern Mediterranean
Kyrgyzstan,17-05-2020,418565,2187,575,417990,Europe
Latvia,17-05-2020,248289,232,361,247928,Europe
Lebanon,17-05-2020,82087,120,107,81980,Eastern Mediterranean
Liberia,17-05-2020,97138,891,597,96541,Africa
Liechtenstein,17-05-2020,191628,1100,318,191310,Europe
Lithuania,17-05-2020,431070,893,537,430533,Europe
Luxembourg,17-05-2020,261469,70,508,260961,Europe
Madagascar,17-05-2020,209907,2074,768,209139,Africa
Malaysia,17-05-2020,196019,980,923,195096,Western Pacific
Maldives,17-05-2020,116396,1638,210,116186,South-East Asia
Malta,17-05-2020,145603,2284,1078,144525,Europe
Mauritania,17-05-2020,171181,1106,495,170686,Africa
Mauritius,17-05-2020,121830,737,832,120998,Africa
Mexico,17-05-2020,350024,2296,804,349220,Americas
Moldova,17-05-2020,294295,359,713,293582,Europe
Monaco,17-05-2020,71708,1129,612,71096,Europe
Mongolia,17-05-2020,232453,921,434,232019,Western Pacific
Montenegro,17-05-2020,224747,2134,463,224284,Europe
Morocco,17-05-2020,71231,2075,581,70650,Eastern Mediterranean
Namibia,17-05-2020,335634,971,1120,334514,Africa
Nepal,17-05-2020,132773,1064,207,132566,South-East Asia
Netherlands,17-05-2020,430300,78,610,429690,Europe
Netherlands,17-05-2020,411085,962,278,410807,Europe
Netherlands,17-05-2020,401196,1832,847,400349,Europe
Netherlands,17-05-2020,367447,1326,790,366657,Europe
New Zealand,17-05-2020,244633,1658,718,243915,Western Pacific
Nicaragua,17-05-2020,156903,654,549,156354,Americas
Niger,17-05-2020,239927,858,238,239689,Africa
Nigeria,17-05-2020,67139,1843,1123,66016,Africa
North Macedonia,17-05-2020,86540,1220,597,85943,Europe
Norway,17-05-2020,241519,1085,635,240884,Europe
Oman,17-05-2020,30838,1178,367,30471,Eastern Mediterranean
Pakistan,17-05-2020,80115,304,39,80076,Eastern Mediterranean
Panama,17-05-2020,221365,1008,106,221259,Americas
Papua New Guinea,17-05-2020,247899,2479,303,247596,Western Pacific
Paraguay,17-05-2020,10395,709,65,10330,Americas
Peru,17-05-2020,295020,1611,246,294774,Americas
Philippines,17-05-2020,9663,647,1076,8587,Western Pacific
Poland,17-05-2020,175263,1444,955,174308,Europe
Portugal,17-05-2020,41490,1477,843,40647,Europe
Qatar,17-05-2020,337097,1335,472,336625,Eastern Mediterranean
Romania,17-05-2020,217805,1406,1180,216625,Europe
Russia,17-05-2020,389526,1316,1181,388345,Europe
Rwanda,17-05-2020,188533,870,740,187793,Africa
Saint Lucia,17-05-2020,154609,1212,699,153910,Americas
Saint Vincent and the Grenadines,17-05-2020,54378,1008,132,54246,Americas
San Marino,17-05-2020,439243,349,1048,438195,Europe
Saudi Arabia,17-05-2020,241739,1750,430,241309,Eastern Mediterranean
Senegal,17-05-2020,294088,1421,1196,292892,Africa
Serbia,17-05-2020,234969,620,712,234257,Europe
Seychelles,17-05-2020,317524,2213,410,317114,Africa
Singapore,17-05-2020,25088,1293,119,24969,Western Pacific
Slovakia,17-05-2020,411166,267,187,410979,Europe
Slovenia,17-05-2020,391803,69,848,390955,Europe
Somalia,17-05-2020,149596,414,519,149077,Eastern Mediterranean
South Africa,17-05-2020,48012,1429,94,47918,Africa
Spain,17-05-2020,60258,2066,961,59297,Europe
Sri Lanka,17-05-2020,189014,592,142,188872,South-East Asia
Sudan,17-05-2020,66812,2205,320,66492,Eastern Mediterranean
Suriname,17-05-2020,340278,1930,856,339422,Americas
Sweden,17-05-2020,310844,1896,683,310161,Europe
Switzerland,17-05-2020,56868,670,566,56302,Europe
Taiwan*,17-05-2020,377362,291,288,377074,Western Pacific
Tanzania,17-05-2020,338111,1459,1017,337094,Africa
Thailand,17-05-2020,404402,861,1146,403256,South-East Asia
Togo,17-05-2020,28039,2132,576,27463,Africa
Trinidad and Tobago,17-05-2020,246123,457,1031,245092,Americas
Tunisia,17-05-2020,31059,2439,539,30520,Eastern Mediterranean
Turkey,17-05-2020,242407,786,130,242277,Europe
Uganda,17-05-2020,115956,1983,188,115768,Africa
Ukraine,17-05-2020,158056,757,428,157628,Europe
United Arab Emirates,17-05-2020,436133,1409,639,435494,Eastern Mediterranean
United Kingdom,17-05-2020,144108,1527,107,144001,Europe
United Kingdom,17-05-2020,405971,2024,932,405039,Europe
United Kingdom,17-05-2020,335223,1778,169,335054,Europe
United Kingdom,17-05-2020,41783,2234,115,41668,Europe
United Kingdom,17-05-2020,321462,1890,842,320620,Europe
United Kingdom,17-05-2020,21034,1100,260,20774,Europe
United Kingdom,17-05-2020,168745,1018,204,168541,Europe
Uruguay,17-05-2020,323174,552,544,322630,Americas
US,17-05-2020,27145,433,960,26185,Americas
Uzbekistan,17-05-2020,406245,2374,1095,405150,Europe
Venezuela,17-05-2020,90484,558,977,89507,Americas
Vietnam,17-05-2020,410983,1639,1186,409797,Western Pacific
Zambia,17-05-2020,7122,1145,122,7000,Africa
Zimbabwe,17-05-2020,361337,1967,57,361280,Africa
Dominica,17-05-2020,199159,708,807,198352,Americas
Grenada,17-05-2020,232356,1678,918,231438,Americas
Mozambique,17-05-2020,170620,169,338,170282,Africa
Syria,17-05-2020,98228,1622,484,97744,Eastern Mediterranean
Timor-Leste,17-05-2020,44936,2268,970,43966,South-East Asia
Belize,17-05-2020,366437,147,1221,365216,Americas
Laos,17-05-2020,414343,669,1031,413312,Western Pacific
Libya,17-05-2020,286585,882,807,285778,Eastern Mediterranean
West Bank and Gaza,17-05-2020,353878,1863,25,353853,Eastern Mediterranean
Guinea-Bissau,17-05-2020,319907,494,704,319203,Africa
Mali,17-05-2020,73861,882,586,73275,Africa
Saint Kitts and Nevis,17-05-2020,150317,237,896,149421,Americas
Canada,17-05-2020,102581,282,134,102447,Americas
Canada,17-05-2020,351047,522,194,350853,Americas
Kosovo,17-05-2020,84517,1047,11,84506,Europe
Burma,17-05-2020,9162,1139,1217,7945,South-East Asia
United Kingdom,17-05-2020,252565,1991,1019,251546,Europe
United Kingdom,17-05-2020,111128,1365,669,110459,Europe
United Kingdom,17-05-2020,107297,1824,243,107054,Europe
Botswana,17-05-2020,93604,1591,837,92767,Africa
Burundi,17-05-2020,315978,2389,838,315140,Africa
Sierra Leone,17-05-2020,394928,2460,658,394270,Africa
Malawi,17-05-2020,329145,2195,6,329139,Africa
United Kingdom,17-05-2020,299131,764,1032,298099,Europe
France,17-05-2020,301768,1022,617,301151,Europe
South Sudan,17-05-2020,37490,920,24,37466,Africa
Western Sahara,17-05-2020,340694,398,182,340512,Africa
Sao Tome and Principe,17-05-2020,86575,1832,499,86076,Africa
Yemen,17-05-2020,34151,1657,104,34047,Eastern Mediterranean
Comoros,17-05-2020,135460,2430,623,134837,Africa
Tajikistan,17-05-2020,436211,1496,99,436112,Europe
Lesotho,17-05-2020,23121,1447,113,23008,Africa
Afghanistan,18-05-2020,333994,2001,946,333048,Eastern Mediterranean
Albania,18-05-2020,23093,1461,521,22572,Europe
Algeria,18-05-2020,20250,1886,310,19940,Africa
Andorra,18-05-2020,43456,1173,686,42770,Europe
Angola,18-05-2020,190513,853,141,190372,Africa
Antigua and Barbuda,18-05-2020,399357,1642,749,398608,Americas
Argentina,18-05-2020,424183,1912,682,423501,Americas
Armenia,18-05-2020,283632,1864,961,282671,Europe
Australia,18-05-2020,183534,2101,34,183500,Western Pacific
Australia,18-05-2020,266594,1591,80,266514,Western Pacific
Australia,18-05-2020,40217,1924,237,39980,Western Pacific
Australia,18-05-2020,256456,427,1042,255414,Western Pacific
Australia,18-05-2020,193095,721,687,192408,Western Pacific
Australia,18-05-2020,300523,1118,1029,299494,Western Pacific
Australia,18-05-2020,439316,2305,63,439253,Western Pacific
Australia,18-05-2020,120967,477,538,120429,Western Pacific
Austria,18-05-2020,120771,1130,747,120024,Europe
Azerbaijan,18-05-2020,229895,898,308,229587,Europe
Bahamas,18-05-2020,274929,174,400,274529,Americas
Bahrain,18-05-2020,405766,1423,284,405482,Eastern Mediterranean
Bangladesh,18-05-2020,133576,2325,577,132999,South-East Asia
Barbados,18-05-2020,319417,1943,830,318587,Americas
Belarus,18-05-2020,214700,184,534,214166,Europe
Belgium,18-05-2020,27290,598,401,26889,Europe
Benin,18-05-2020,383696,1514,438,383258,Africa
Bhutan,18-05-2020,17400,2254,146,17254,South-East Asia
Bolivia,18-05-2020,237916,434,487,237429,Americas
Bosnia and Herzegovina,18-05-2020,107663,1374,569,107094,Europe
Brazil,18-05-2020,188830,1574,1151,187679,Americas
Brunei,18-05-2020,43214,1307,748,42466,Western Pacific
Bulgaria,18-05-2020,32548,69,802,31746,Europe
Burkina Faso,18-05-2020,235362,2244,3,235359,Africa
Cabo Verde,18-05-2020,211659,118,340,211319,Africa
Cambodia,18-05-2020,189379,1936,354,189025,Western Pacific
Cameroon,18-05-2020,448850,1824,905,447945,Africa
Canada,18-05-2020,295547,1274,747,294800,Americas
Canada,18-05-2020,281716,1411,334,281382,Americas
Canada,18-05-2020,35723,20,169,35554,Americas
Canada,18-05-2020,345374,64,368,345006,Americas
Canada,18-05-2020,317727,1231,440,317287,Americas
Canada,18-05-2020,53058,145,829,52229,Americas
Canada,18-05-2020,433026,115,1197,431829,Americas
Canada,18-05-2020,367485,1529,194,367291,Americas
Canada,18-05-2020,424078,154,1067,423011,Americas
Canada,18-05-2020,44526,551,308,44218,Americas
Central African Republic,18-05-2020,174530,2416,848,173682,Africa
Chad,18-05-2020,444377,988,390,443987,Africa
Chile,18-05-2020,229876,1079,537,229339,Americas
China,18-05-2020,95356,1079,992,94364,Western Pacific
China,18-05-2020,411057,1978,247,410810,Western Pacific
China,18-05-2020,322345,1708,565,321780,Western Pacific
China,18-05-2020,121756,1409,3,121753,Western Pacific
China,18-05-2020,45109,2418,336,44773,Western Pacific
China,18-05-2020,341340,735,1235,340105,Western Pacific
China,18-05-2020,244735,1302,676,244059,Western Pacific
China,18-05-2020,136926,486,736,136190,Western Pacific
China,18-05-2020,298385,2490,1069,297316,Western Pacific
China,18-05-2020,243907,2310,1007,242900,Western Pacific
China,18-05-2020,372373,814,256,372117,Western Pacific
China,18-05-2020,162679,1883,1030,161649,Western Pacific
China,18-05-2020,199324,718,1198,198126,Western Pacific
China,18-05-2020,307838,1118,584,307254,Western Pacific
China,18-05-2020,422933,1178,819,422114,Western Pacific
China,18-05-2020,250167,1657,551,249616,Western Pacific
China,18-05-2020,414296,1433,447,413849,Western Pacific
China,18-05-2020,369621,768,974,368647,Western Pacific
China,18-05-2020,280463,1860,1169,279294,Western Pacific
China,18-05-2020,296390,2357,42,296348,Western Pacific
China,18-05-2020,448437,11,1195,447242,Western Pacific
China,18-05-2020,64702,2380,149,64553,Western Pacific
China,18-05-2020,199290,152,1167,198123,Western Pacific
China,18-05-2020,36601,2031,1003,35598,Western Pacific
China,18-05-2020,359720,419,735,358985,Western Pacific
China,18-05-2020,283090,763,456,282634,Western Pacific
China,18-05-2020,316195,831,668,315527,Western Pacific
China,18-05-2020,213526,1701,302,213224,Western Pacific
China,18-05-2020,50678,643,335,50343,Western Pacific
China,18-05-2020,122855,2312,1190,121665,Western Pacific
China,18-05-2020,10544,310,248,10296,Western Pacific
China,18-05-2020,290032,991,118,289914,Western Pacific
China,18-05-2020,98845,1797,965,97880,Western Pacific
Colombia,18-05-2020,292869,1525,132,292737,Americas
Congo (Brazzaville),18-05-2020,408363,2427,799,407564,Africa
Congo (Kinshasa),18-05-2020,395917,1573,271,395646,Africa
Costa Rica,18-05-2020,276599,2365,1112,275487,Americas
Cote d'Ivoire,18-05-2020,397453,1793,379,397074,Africa
Croatia,18-05-2020,189948,2343,369,189579,Europe
Cuba,18-05-2020,443462,272,110,443352,Americas
Cyprus,18-05-2020,428203,881,1046,427157,Europe
Czechia,18-05-2020,73654,246,48,73606,Europe
Denmark,18-05-2020,22950,449,386,22564,Europe
Greenland,18-05-2020,192327,2208,300,192027,Europe
Denmark,18-05-2020,55478,1035,857,54621,Europe
Djibouti,18-05-2020,299121,1659,665,298456,Eastern Mediterranean
Dominican Republic,18-05-2020,81454,2482,999,80455,Americas
Ecuador,18-05-2020,406712,435,522,406190,Americas
Egypt,18-05-2020,296133,1848,907,295226,Eastern Mediterranean
El Salvador,18-05-2020,409167,2376,109,409058,Americas
Equatorial Guinea,18-05-2020,417386,1519,101,417285,Africa
Eritrea,18-05-2020,126137,727,622,125515,Africa
Estonia,18-05-2020,101415,122,559,100856,Europe
Eswatini,18-05-2020,233900,1892,655,233245,Africa
Ethiopia,18-05-2020,71,1660,168,-97,Africa
Fiji,18-05-2020,157279,2027,866,156413,Western Pacific
Finland,18-05-2020,316826,541,1152,315674,Europe
France,18-05-2020,21809,1185,1225,20584,Europe
France,18-05-2020,392782,1223,1184,391598,Europe
France,18-05-2020,291957,2149,282,291675,Europe
France,18-05-2020,171999,771,1011,170988,Europe
France,18-05-2020,407712,1909,723,406989,Europe
France,18-05-2020,53343,688,492,52851,Europe
France,18-05-2020,434316,556,381,433935,Europe
France,18-05-2020,226538,1479,844,225694,Europe
France,18-05-2020,343456,496,194,343262,Europe
France,18-05-2020,201461,2225,333,201128,Europe
Gabon,18-05-2020,372544,2185,806,371738,Africa
Gambia,18-05-2020,99333,2496,549,98784,Africa
Georgia,18-05-2020,87693,666,660,87033,Europe
Germany,18-05-2020,301344,2354,1205,300139,Europe
Ghana,18-05-2020,82957,1272,165,82792,Africa
Greece,18-05-2020,304260,1992,342,303918,Europe
Guatemala,18-05-2020,128500,1310,287,128213,Americas
Guinea,18-05-2020,276456,1776,358,276098,Africa
Guyana,18-05-2020,51683,1803,499,51184,Americas
Haiti,18-05-2020,46047,1219,137,45910,Americas
Holy See,18-05-2020,361820,459,615,361205,Europe
Honduras,18-05-2020,125561,1525,771,124790,Americas
Hungary,18-05-2020,205060,111,519,204541,Europe
Iceland,18-05-2020,125073,781,69,125004,Europe
India,18-05-2020,302369,2008,921,301448,South-East Asia
Indonesia,18-05-2020,16473,908,495,15978,South-East Asia
Iran,18-05-2020,257273,1054,237,257036,Eastern Mediterranean
Iraq,18-05-2020,412559,1770,438,412121,Eastern Mediterranean
Ireland,18-05-2020,120617,1922,455,120162,Europe
Israel,18-05-2020,55671,1273,742,54929,Europe
Italy,18-05-2020,209005,1804,884,208121,Europe
Jamaica,18-05-2020,373474,2209,433,373041,Americas
Japan,18-05-2020,280428,679,1118,279310,Western Pacific
Jordan,18-05-2020,122866,1867,566,122300,Eastern Mediterranean
Kazakhstan,18-05-2020,317486,129,437,317049,Europe
Kenya,18-05-2020,84639,1315,1085,83554,Africa
South Korea,18-05-2020,53027,1291,469,52558,Western Pacific
Kuwait,18-05-2020,142917,2001,327,142590,Eastern Mediterranean
Kyrgyzstan,18-05-2020,326908,1156,221,326687,Europe
Latvia,18-05-2020,375732,846,265,375467,Europe
Lebanon,18-05-2020,280838,2023,424,280414,Eastern Mediterranean
Liberia,18-05-2020,92672,1778,1220,91452,Africa
Liechtenstein,18-05-2020,33221,659,65,33156,Europe
Lithuania,18-05-2020,302470,2301,744,301726,Europe
Luxembourg,18-05-2020,267145,533,455,266690,Europe
Madagascar,18-05-2020,162537,1523,173,162364,Africa
Malaysia,18-05-2020,393567,1648,315,393252,Western Pacific
Maldives,18-05-2020,154735,85,962,153773,South-East Asia
Malta,18-05-2020,146127,294,1210,144917,Europe
Mauritania,18-05-2020,126376,1072,440,125936,Africa
Mauritius,18-05-2020,432421,759,1239,431182,Africa
Mexico,18-05-2020,110777,1937,579,110198,Americas
Moldova,18-05-2020,330355,2238,206,330149,Europe
Monaco,18-05-2020,361677,675,1198,360479,Europe
Mongolia,18-05-2020,221517,1288,1204,220313,Western Pacific
Montenegro,18-05-2020,215252,255,854,214398,Europe
Morocco,18-05-2020,127128,253,713,126415,Eastern Mediterranean
Namibia,18-05-2020,35625,2089,79,35546,Africa
Nepal,18-05-2020,186024,2449,407,185617,South-East Asia
Netherlands,18-05-2020,262119,2195,551,261568,Europe
Netherlands,18-05-2020,400761,618,569,400192,Europe
Netherlands,18-05-2020,76992,2396,980,76012,Europe
Netherlands,18-05-2020,403897,2289,651,403246,Europe
New Zealand,18-05-2020,215904,1268,465,215439,Western Pacific
Nicaragua,18-05-2020,281632,1597,878,280754,Americas
Niger,18-05-2020,1419,1701,139,1280,Africa
Nigeria,18-05-2020,69560,1850,830,68730,Africa
North Macedonia,18-05-2020,90742,2306,907,89835,Europe
Norway,18-05-2020,345587,1462,1068,344519,Europe
Oman,18-05-2020,165334,1145,1222,164112,Eastern Mediterranean
Pakistan,18-05-2020,348244,2354,298,347946,Eastern Mediterranean
Panama,18-05-2020,118831,1539,430,118401,Americas
Papua New Guinea,18-05-2020,415912,2199,918,414994,Western Pacific
Paraguay,18-05-2020,199322,2205,547,198775,Americas
Peru,18-05-2020,22130,417,277,21853,Americas
Philippines,18-05-2020,446272,2314,486,445786,Western Pacific
Poland,18-05-2020,115848,1852,720,115128,Europe
Portugal,18-05-2020,383750,668,504,383246,Europe
Qatar,18-05-2020,266628,2081,1229,265399,Eastern Mediterranean
Romania,18-05-2020,297750,2135,700,297050,Europe
Russia,18-05-2020,70379,1968,125,70254,Europe
Rwanda,18-05-2020,309517,2163,706,308811,Africa
Saint Lucia,18-05-2020,232988,1969,748,232240,Americas
Saint Vincent and the Grenadines,18-05-2020,75362,957,662,74700,Americas
San Marino,18-05-2020,145533,243,827,144706,Europe
Saudi Arabia,18-05-2020,220014,1511,186,219828,Eastern Mediterranean
Senegal,18-05-2020,174083,1697,875,173208,Africa
Serbia,18-05-2020,424121,791,877,423244,Europe
Seychelles,18-05-2020,31347,121,244,31103,Africa
Singapore,18-05-2020,392616,1691,753,391863,Western Pacific
Slovakia,18-05-2020,145121,1034,1017,144104,Europe
Slovenia,18-05-2020,20125,1191,1104,19021,Europe
Somalia,18-05-2020,344456,1877,932,343524,Eastern Mediterranean
South Africa,18-05-2020,399447,2283,581,398866,Africa
Spain,18-05-2020,37742,854,270,37472,Europe
Sri Lanka,18-05-2020,370756,1281,214,370542,South-East Asia
Sudan,18-05-2020,71445,1119,292,71153,Eastern Mediterranean
Suriname,18-05-2020,270074,1340,83,269991,Americas
Sweden,18-05-2020,290910,921,45,290865,Europe
Switzerland,18-05-2020,294935,1784,1047,293888,Europe
Taiwan*,18-05-2020,285000,1757,461,284539,Western Pacific
Tanzania,18-05-2020,228664,1051,772,227892,Africa
Thailand,18-05-2020,336766,380,87,336679,South-East Asia
Togo,18-05-2020,294490,870,116,294374,Africa
Trinidad and Tobago,18-05-2020,142168,684,1096,141072,Americas
Tunisia,18-05-2020,294881,15,994,293887,Eastern Mediterranean
Turkey,18-05-2020,223707,527,536,223171,Europe
Uganda,18-05-2020,311058,1784,139,310919,Africa
Ukraine,18-05-2020,12781,1385,723,12058,Europe
United Arab Emirates,18-05-2020,398165,956,1053,397112,Eastern Mediterranean
United Kingdom,18-05-2020,39418,2140,525,38893,Europe
United Kingdom,18-05-2020,100424,1999,599,99825,Europe
United Kingdom,18-05-2020,67991,2430,1183,66808,Europe
United Kingdom,18-05-2020,58386,1070,756,57630,Europe
United Kingdom,18-05-2020,105455,1960,613,104842,Europe
United Kingdom,18-05-2020,347466,72,98,347368,Europe
United Kingdom,18-05-2020,157081,938,394,156687,Europe
Uruguay,18-05-2020,394722,1807,219,394503,Americas
US,18-05-2020,384832,276,291,384541,Americas
Uzbekistan,18-05-2020,375197,2179,128,375069,Europe
Venezuela,18-05-2020,339439,501,934,338505,Americas
Vietnam,18-05-2020,126568,942,993,125575,Western Pacific
Zambia,18-05-2020,153661,1233,1134,152527,Africa
Zimbabwe,18-05-2020,432806,2477,513,432293,Africa
Dominica,18-05-2020,65031,1803,1153,63878,Americas
Grenada,18-05-2020,298467,1091,1022,297445,Americas
Mozambique,18-05-2020,358954,47,377,358577,Africa
Syria,18-05-2020,253843,2177,28,253815,Eastern Mediterranean
Timor-Leste,18-05-2020,332105,855,1092,331013,South-East Asia
Belize,18-05-2020,317775,631,929,316846,Americas
Laos,18-05-2020,113274,1180,722,112552,Western Pacific
Libya,18-05-2020,315057,1121,270,314787,Eastern Mediterranean
West Bank and Gaza,18-05-2020,7771,1152,1178,6593,Eastern Mediterranean
Guinea-Bissau,18-05-2020,353769,416,621,353148,Africa
Mali,18-05-2020,270985,350,769,270216,Africa
Saint Kitts and Nevis,18-05-2020,350384,2399,186,350198,Americas
Canada,18-05-2020,109880,2063,1228,108652,Americas
Canada,18-05-2020,232104,879,1062,231042,Americas
Kosovo,18-05-2020,80927,1439,1194,79733,Europe
Burma,18-05-2020,174213,2010,1102,173111,South-East Asia
United Kingdom,18-05-2020,180785,1972,438,180347,Europe
United Kingdom,18-05-2020,276832,1369,1221,275611,Europe
United Kingdom,18-05-2020,248693,413,1223,247470,Europe
Botswana,18-05-2020,247160,1932,35,247125,Africa
Burundi,18-05-2020,18540,1207,519,18021,Africa
Sierra Leone,18-05-2020,140472,2086,560,139912,Africa
Malawi,18-05-2020,13770,1076,862,12908,Africa
United Kingdom,18-05-2020,280251,1461,820,279431,Europe
France,18-05-2020,370986,884,241,370745,Europe
South Sudan,18-05-2020,375035,1897,335,374700,Africa
Western Sahara,18-05-2020,203283,1076,1034,202249,Africa
Sao Tome and Principe,18-05-2020,36467,2333,264,36203,Africa
Yemen,18-05-2020,169563,1866,313,169250,Eastern Mediterranean
Comoros,18-05-2020,283892,2211,951,282941,Africa
Tajikistan,18-05-2020,196606,1419,381,196225,Europe
Lesotho,18-05-2020,175412,2461,713,174699,Africa
Afghanistan,19-05-2020,180065,812,131,179934,Eastern Mediterranean
Albania,19-05-2020,99156,2432,1167,97989,Europe
Algeria,19-05-2020,412798,1543,176,412622,Africa
Andorra,19-05-2020,401322,334,113,401209,Europe
Angola,19-05-2020,204676,1384,1020,203656,Africa
Antigua and Barbuda,19-05-2020,393654,2427,1151,392503,Americas
Argentina,19-05-2020,323870,2087,349,323521,Americas
Armenia,19-05-2020,272140,1739,327,271813,Europe
Australia,19-05-2020,200267,950,856,199411,Western Pacific
Australia,19-05-2020,390905,1895,647,390258,Western Pacific
Australia,19-05-2020,361233,1763,951,360282,Western Pacific
Australia,19-05-2020,14358,488,153,14205,Western Pacific
Australia,19-05-2020,249119,582,191,248928,Western Pacific
Australia,19-05-2020,325177,2028,536,324641,Western Pacific
Australia,19-05-2020,28437,2300,1002,27435,Western Pacific
Australia,19-05-2020,315708,683,893,314815,Western Pacific
Austria,19-05-2020,304263,330,442,303821,Europe
Azerbaijan,19-05-2020,278667,2098,1221,277446,Europe
Bahamas,19-05-2020,260475,360,753,259722,Americas
Bahrain,19-05-2020,134980,914,818,134162,Eastern Mediterranean
Bangladesh,19-05-2020,27627,1355,541,27086,South-East Asia
Barbados,19-05-2020,332268,1348,1085,331183,Americas
Belarus,19-05-2020,300739,36,1180,299559,Europe
Belgium,19-05-2020,310467,945,898,309569,Europe
Benin,19-05-2020,14046,1124,802,13244,Africa
Bhutan,19-05-2020,207675,2091,951,206724,South-East Asia
Bolivia,19-05-2020,282079,370,1111,280968,Americas
Bosnia and Herzegovina,19-05-2020,378544,185,129,378415,Europe
Brazil,19-05-2020,212779,1880,527,212252,Americas
Brunei,19-05-2020,346960,317,964,345996,Western Pacific
Bulgaria,19-05-2020,267671,253,79,267592,Europe
Burkina Faso,19-05-2020,127647,1547,1174,126473,Africa
Cabo Verde,19-05-2020,394718,2206,514,394204,Africa
Cambodia,19-05-2020,315673,966,1064,314609,Western Pacific
Cameroon,19-05-2020,60607,1916,1111,59496,Africa
Canada,19-05-2020,387229,1366,440,386789,Americas
Canada,19-05-2020,217851,1609,1117,216734,Americas
Canada,19-05-2020,102354,1336,878,101476,Americas
Canada,19-05-2020,427839,1337,421,427418,Americas
Canada,19-05-2020,224143,2118,269,223874,Americas
Canada,19-05-2020,67794,2398,314,67480,Americas
Canada,19-05-2020,424767,933,642,424125,Americas
Canada,19-05-2020,359344,2045,494,358850,Americas
Canada,19-05-2020,7950,1159,203,7747,Americas
Canada,19-05-2020,10796,645,359,10437,Americas
Central African Republic,19-05-2020,432204,1724,853,431351,Africa
Chad,19-05-2020,424992,1292,569,424423,Africa
Chile,19-05-2020,96293,357,714,95579,Americas
China,19-05-2020,401131,489,1117,400014,Western Pacific
China,19-05-2020,207405,1697,812,206593,Western Pacific
China,19-05-2020,13053,1762,794,12259,Western Pacific
China,19-05-2020,176336,585,1184,175152,Western Pacific
China,19-05-2020,80079,1305,530,79549,Western Pacific
China,19-05-2020,108624,73,736,107888,Western Pacific
China,19-05-2020,80322,1423,1247,79075,Western Pacific
China,19-05-2020,223557,528,819,222738,Western Pacific
China,19-05-2020,161279,1494,864,160415,Western Pacific
China,19-05-2020,421249,1383,623,420626,Western Pacific
China,19-05-2020,378722,1009,765,377957,Western Pacific
China,19-05-2020,256821,2251,340,256481,Western Pacific
China,19-05-2020,30702,726,116,30586,Western Pacific
China,19-05-2020,449916,1191,777,449139,Western Pacific
China,19-05-2020,443973,645,1224,442749,Western Pacific
China,19-05-2020,437770,1260,1064,436706,Western Pacific
China,19-05-2020,85057,856,458,84599,Western Pacific
China,19-05-2020,321101,1376,377,320724,Western Pacific
China,19-05-2020,327146,492,675,326471,Western Pacific
China,19-05-2020,447874,326,444,447430,Western Pacific
China,19-05-2020,421595,684,7,421588,Western Pacific
China,19-05-2020,78841,2009,129,78712,Western Pacific
China,19-05-2020,405006,1892,394,404612,Western Pacific
China,19-05-2020,57654,871,974,56680,Western Pacific
China,19-05-2020,209580,2064,856,208724,Western Pacific
China,19-05-2020,49057,2489,1082,47975,Western Pacific
China,19-05-2020,313725,1301,463,313262,Western Pacific
China,19-05-2020,185834,671,945,184889,Western Pacific
China,19-05-2020,48898,2075,138,48760,Western Pacific
China,19-05-2020,422065,1997,289,421776,Western Pacific
China,19-05-2020,348006,1146,23,347983,Western Pacific
China,19-05-2020,293134,3,572,292562,Western Pacific
China,19-05-2020,226411,431,690,225721,Western Pacific
Colombia,19-05-2020,245480,1027,1095,244385,Americas
Congo (Brazzaville),19-05-2020,390393,835,1170,389223,Africa
Congo (Kinshasa),19-05-2020,19429,598,158,19271,Africa
Costa Rica,19-05-2020,20360,164,50,20310,Americas
Cote d'Ivoire,19-05-2020,335021,870,490,334531,Africa
Croatia,19-05-2020,548,2415,31,517,Europe
Cuba,19-05-2020,136546,640,1080,135466,Americas
Cyprus,19-05-2020,256692,1376,656,256036,Europe
Czechia,19-05-2020,121291,1845,1236,120055,Europe
Denmark,19-05-2020,42440,2245,165,42275,Europe
Greenland,19-05-2020,134360,1292,767,133593,Europe
Denmark,19-05-2020,375649,1973,1248,374401,Europe
Djibouti,19-05-2020,148749,865,111,148638,Eastern Mediterranean
Dominican Republic,19-05-2020,447393,135,631,446762,Americas
Ecuador,19-05-2020,102894,1346,656,102238,Americas
Egypt,19-05-2020,93892,1943,779,93113,Eastern Mediterranean
El Salvador,19-05-2020,446701,1890,213,446488,Americas
Equatorial Guinea,19-05-2020,262364,1568,423,261941,Africa
Eritrea,19-05-2020,69076,1134,925,68151,Africa
Estonia,19-05-2020,45751,676,329,45422,Europe
Eswatini,19-05-2020,315536,2020,1066,314470,Africa
Ethiopia,19-05-2020,397494,1362,464,397030,Africa
Fiji,19-05-2020,296836,1243,215,296621,Western Pacific
Finland,19-05-2020,71399,85,844,70555,Europe
France,19-05-2020,165622,2078,215,165407,Europe
France,19-05-2020,397969,4,557,397412,Europe
France,19-05-2020,355982,4,994,354988,Europe
France,19-05-2020,292760,1360,223,292537,Europe
France,19-05-2020,248002,366,1150,246852,Europe
France,19-05-2020,286970,1842,941,286029,Europe
France,19-05-2020,384004,1517,898,383106,Europe
France,19-05-2020,409757,1608,451,409306,Europe
France,19-05-2020,426986,1613,547,426439,Europe
France,19-05-2020,37550,770,424,37126,Europe
Gabon,19-05-2020,212209,2469,321,211888,Africa
Gambia,19-05-2020,447826,2404,588,447238,Africa
Georgia,19-05-2020,229414,1548,656,228758,Europe
Germany,19-05-2020,388326,1040,576,387750,Europe
Ghana,19-05-2020,388237,144,1122,387115,Africa
Greece,19-05-2020,149138,449,491,148647,Europe
Guatemala,19-05-2020,24112,1964,639,23473,Americas
Guinea,19-05-2020,260212,782,1028,259184,Africa
Guyana,19-05-2020,35285,400,700,34585,Americas
Haiti,19-05-2020,173504,870,1101,172403,Americas
Holy See,19-05-2020,311382,1734,431,310951,Europe
Honduras,19-05-2020,92044,1610,202,91842,Americas
Hungary,19-05-2020,223668,2160,1182,222486,Europe
Iceland,19-05-2020,234329,1139,1079,233250,Europe
India,19-05-2020,386612,349,120,386492,South-East Asia
Indonesia,19-05-2020,155626,1666,639,154987,South-East Asia
Iran,19-05-2020,449884,640,333,449551,Eastern Mediterranean
Iraq,19-05-2020,14235,1216,165,14070,Eastern Mediterranean
Ireland,19-05-2020,324242,2163,880,323362,Europe
Israel,19-05-2020,426259,1849,753,425506,Europe
Italy,19-05-2020,400601,2421,1072,399529,Europe
Jamaica,19-05-2020,376488,790,386,376102,Americas
Japan,19-05-2020,3622,2479,791,2831,Western Pacific
Jordan,19-05-2020,208978,319,283,208695,Eastern Mediterranean
Kazakhstan,19-05-2020,72435,839,956,71479,Europe
Kenya,19-05-2020,183424,1440,962,182462,Africa
South Korea,19-05-2020,377704,1112,205,377499,Western Pacific
Kuwait,19-05-2020,56747,1748,439,56308,Eastern Mediterranean
Kyrgyzstan,19-05-2020,21369,2319,1091,20278,Europe
Latvia,19-05-2020,162930,1862,997,161933,Europe
Lebanon,19-05-2020,5136,1277,937,4199,Eastern Mediterranean
Liberia,19-05-2020,157140,149,796,156344,Africa
Liechtenstein,19-05-2020,265828,232,745,265083,Europe
Lithuania,19-05-2020,234878,1992,936,233942,Europe
Luxembourg,19-05-2020,99502,1723,171,99331,Europe
Madagascar,19-05-2020,24761,1065,1173,23588,Africa
Malaysia,19-05-2020,222904,27,294,222610,Western Pacific
Maldives,19-05-2020,97319,2024,466,96853,South-East Asia
Malta,19-05-2020,318440,1094,1124,317316,Europe
Mauritania,19-05-2020,316887,1889,830,316057,Africa
Mauritius,19-05-2020,343202,1839,971,342231,Africa
Mexico,19-05-2020,142950,622,709,142241,Americas
Moldova,19-05-2020,356767,1725,553,356214,Europe
Monaco,19-05-2020,293987,2221,1060,292927,Europe
Mongolia,19-05-2020,17460,363,377,17083,Western Pacific
Montenegro,19-05-2020,127088,243,349,126739,Europe
Morocco,19-05-2020,26716,553,1011,25705,Eastern Mediterranean
Namibia,19-05-2020,20525,1071,539,19986,Africa
Nepal,19-05-2020,87397,54,1228,86169,South-East Asia
Netherlands,19-05-2020,246440,1791,629,245811,Europe
Netherlands,19-05-2020,91694,1231,1149,90545,Europe
Netherlands,19-05-2020,86165,265,188,85977,Europe
Netherlands,19-05-2020,196054,138,236,195818,Europe
New Zealand,19-05-2020,341189,2338,29,341160,Western Pacific
Nicaragua,19-05-2020,265933,60,326,265607,Americas
Niger,19-05-2020,236614,1738,265,236349,Africa
Nigeria,19-05-2020,222485,1231,48,222437,Africa
North Macedonia,19-05-2020,271424,271,818,270606,Europe
Norway,19-05-2020,76573,690,251,76322,Europe
Oman,19-05-2020,96611,748,219,96392,Eastern Mediterranean
Pakistan,19-05-2020,439530,22,1177,438353,Eastern Mediterranean
Panama,19-05-2020,230265,1369,473,229792,Americas
Papua New Guinea,19-05-2020,210189,1328,936,209253,Western Pacific
Paraguay,19-05-2020,447573,2238,238,447335,Americas
Peru,19-05-2020,84684,2447,136,84548,Americas
Philippines,19-05-2020,295510,1932,788,294722,Western Pacific
Poland,19-05-2020,105428,1626,543,104885,Europe
Portugal,19-05-2020,155587,2492,421,155166,Europe
Qatar,19-05-2020,149372,1056,732,148640,Eastern Mediterranean
Romania,19-05-2020,31626,444,763,30863,Europe
Russia,19-05-2020,378246,745,548,377698,Europe
Rwanda,19-05-2020,4312,104,331,3981,Africa
Saint Lucia,19-05-2020,401865,1972,479,401386,Americas
Saint Vincent and the Grenadines,19-05-2020,286509,2321,650,285859,Americas
San Marino,19-05-2020,295193,1943,893,294300,Europe
Saudi Arabia,19-05-2020,369642,1665,1185,368457,Eastern Mediterranean
Senegal,19-05-2020,102134,83,562,101572,Africa
Serbia,19-05-2020,61035,1998,871,60164,Europe
Seychelles,19-05-2020,218530,149,526,218004,Africa
Singapore,19-05-2020,325359,1502,699,324660,Western Pacific
Slovakia,19-05-2020,218593,425,742,217851,Europe
Slovenia,19-05-2020,305964,1833,847,305117,Europe
Somalia,19-05-2020,239646,2248,522,239124,Eastern Mediterranean
South Africa,19-05-2020,146951,711,107,146844,Africa
Spain,19-05-2020,419944,2052,97,419847,Europe
Sri Lanka,19-05-2020,20035,520,777,19258,South-East Asia
Sudan,19-05-2020,277611,1994,547,277064,Eastern Mediterranean
Suriname,19-05-2020,51838,760,690,51148,Americas
Sweden,19-05-2020,128692,808,1196,127496,Europe
Switzerland,19-05-2020,444247,943,975,443272,Europe
Taiwan*,19-05-2020,115806,2240,963,114843,Western Pacific
Tanzania,19-05-2020,220269,1220,588,219681,Africa
Thailand,19-05-2020,414201,663,760,413441,South-East Asia
Togo,19-05-2020,20102,1057,187,19915,Africa
Trinidad and Tobago,19-05-2020,84701,2091,1040,83661,Americas
Tunisia,19-05-2020,100962,1437,1177,99785,Eastern Mediterranean
Turkey,19-05-2020,23111,1439,214,22897,Europe
Uganda,19-05-2020,283925,2356,1018,282907,Africa
Ukraine,19-05-2020,276364,1947,1199,275165,Europe
United Arab Emirates,19-05-2020,175811,649,817,174994,Eastern Mediterranean
United Kingdom,19-05-2020,203002,1363,688,202314,Europe
United Kingdom,19-05-2020,256053,1334,193,255860,Europe
United Kingdom,19-05-2020,305778,1148,254,305524,Europe
United Kingdom,19-05-2020,102146,1889,878,101268,Europe
United Kingdom,19-05-2020,331454,2428,1099,330355,Europe
United Kingdom,19-05-2020,12429,196,36,12393,Europe
United Kingdom,19-05-2020,104884,2356,224,104660,Europe
Uruguay,19-05-2020,242996,449,856,242140,Americas
US,19-05-2020,417744,692,907,416837,Americas
Uzbekistan,19-05-2020,406343,1875,996,405347,Europe
Venezuela,19-05-2020,138843,1671,991,137852,Americas
Vietnam,19-05-2020,246476,1566,876,245600,Western Pacific
Zambia,19-05-2020,66555,2435,595,65960,Africa
Zimbabwe,19-05-2020,30571,930,575,29996,Africa
Dominica,19-05-2020,306222,499,1207,305015,Americas
Grenada,19-05-2020,120056,1358,1033,119023,Americas
Mozambique,19-05-2020,141866,534,1177,140689,Africa
Syria,19-05-2020,445095,672,634,444461,Eastern Mediterranean
Timor-Leste,19-05-2020,344659,508,288,344371,South-East Asia
Belize,19-05-2020,236511,2485,883,235628,Americas
Laos,19-05-2020,402682,1862,523,402159,Western Pacific
Libya,19-05-2020,304335,1148,312,304023,Eastern Mediterranean
West Bank and Gaza,19-05-2020,446945,1461,402,446543,Eastern Mediterranean
Guinea-Bissau,19-05-2020,413612,1959,826,412786,Africa
Mali,19-05-2020,148156,2189,84,148072,Africa
Saint Kitts and Nevis,19-05-2020,395470,1160,408,395062,Americas
Canada,19-05-2020,16748,708,601,16147,Americas
Canada,19-05-2020,267125,1668,1168,265957,Americas
Kosovo,19-05-2020,128803,2139,433,128370,Europe
Burma,19-05-2020,417034,1612,773,416261,South-East Asia
United Kingdom,19-05-2020,335304,301,712,334592,Europe
United Kingdom,19-05-2020,269968,1304,966,269002,Europe
United Kingdom,19-05-2020,193265,172,438,192827,Europe
Botswana,19-05-2020,378979,1402,647,378332,Africa
Burundi,19-05-2020,391921,1215,27,391894,Africa
Sierra Leone,19-05-2020,134183,1015,1164,133019,Africa
Malawi,19-05-2020,148507,763,382,148125,Africa
United Kingdom,19-05-2020,274056,1673,134,273922,Europe
France,19-05-2020,22517,340,10,22507,Europe
South Sudan,19-05-2020,56209,1027,607,55602,Africa
Western Sahara,19-05-2020,28846,773,1124,27722,Africa
Sao Tome and Principe,19-05-2020,40637,1108,1172,39465,Africa
Yemen,19-05-2020,80530,1526,674,79856,Eastern Mediterranean
Comoros,19-05-2020,194736,984,853,193883,Africa
Tajikistan,19-05-2020,35525,2244,290,35235,Europe
Lesotho,19-05-2020,3942,1360,838,3104,Africa
Afghanistan,20-05-2020,160295,1150,635,159660,Eastern Mediterranean
Albania,20-05-2020,426261,2023,316,425945,Europe
Algeria,20-05-2020,200856,2418,110,200746,Africa
Andorra,20-05-2020,60218,1554,1163,59055,Europe
Angola,20-05-2020,196199,132,1165,195034,Africa
Antigua and Barbuda,20-05-2020,360402,1081,1044,359358,Americas
Argentina,20-05-2020,346021,1834,617,345404,Americas
Armenia,20-05-2020,168876,1617,245,168631,Europe
Australia,20-05-2020,295066,1775,291,294775,Western Pacific
Australia,20-05-2020,185896,166,614,185282,Western Pacific
Australia,20-05-2020,349264,1549,635,348629,Western Pacific
Australia,20-05-2020,373528,2362,248,373280,Western Pacific
Australia,20-05-2020,96665,1736,549,96116,Western Pacific
Australia,20-05-2020,191723,542,701,191022,Western Pacific
Australia,20-05-2020,126573,2247,837,125736,Western Pacific
Australia,20-05-2020,120964,1679,955,120009,Western Pacific
Austria,20-05-2020,4391,1846,363,4028,Europe
Azerbaijan,20-05-2020,276627,2204,681,275946,Europe
Bahamas,20-05-2020,264396,1561,1024,263372,Americas
Bahrain,20-05-2020,40548,509,472,40076,Eastern Mediterranean
Bangladesh,20-05-2020,367250,1739,568,366682,South-East Asia
Barbados,20-05-2020,434047,1894,103,433944,Americas
Belarus,20-05-2020,269653,2308,560,269093,Europe
Belgium,20-05-2020,363094,2188,872,362222,Europe
Benin,20-05-2020,398631,2230,171,398460,Africa
Bhutan,20-05-2020,345097,2452,769,344328,South-East Asia
Bolivia,20-05-2020,442895,894,1086,441809,Americas
Bosnia and Herzegovina,20-05-2020,258664,118,973,257691,Europe
Brazil,20-05-2020,53769,1944,1062,52707,Americas
Brunei,20-05-2020,228291,590,985,227306,Western Pacific
Bulgaria,20-05-2020,36178,704,1200,34978,Europe
Burkina Faso,20-05-2020,227870,1221,520,227350,Africa
Cabo Verde,20-05-2020,55723,241,743,54980,Africa
Cambodia,20-05-2020,399229,134,167,399062,Western Pacific
Cameroon,20-05-2020,226192,48,409,225783,Africa
Canada,20-05-2020,244181,1085,1063,243118,Americas
Canada,20-05-2020,312010,437,1135,310875,Americas
Canada,20-05-2020,372545,2091,40,372505,Americas
Canada,20-05-2020,370362,2336,1224,369138,Americas
Canada,20-05-2020,129858,351,106,129752,Americas
Canada,20-05-2020,54082,1988,1126,52956,Americas
Canada,20-05-2020,128857,1361,238,128619,Americas
Canada,20-05-2020,67553,2112,432,67121,Americas
Canada,20-05-2020,159957,1424,407,159550,Americas
Canada,20-05-2020,221546,1770,466,221080,Americas
Central African Republic,20-05-2020,13903,1824,369,13534,Africa
Chad,20-05-2020,238904,1744,201,238703,Africa
Chile,20-05-2020,308834,1828,686,308148,Americas
China,20-05-2020,256188,2247,629,255559,Western Pacific
China,20-05-2020,110913,2089,1030,109883,Western Pacific
China,20-05-2020,358568,753,638,357930,Western Pacific
China,20-05-2020,344987,615,937,344050,Western Pacific
China,20-05-2020,98062,2004,1102,96960,Western Pacific
China,20-05-2020,280585,711,777,279808,Western Pacific
China,20-05-2020,173612,1008,974,172638,Western Pacific
China,20-05-2020,232610,39,702,231908,Western Pacific
China,20-05-2020,334588,443,352,334236,Western Pacific
China,20-05-2020,148762,1137,252,148510,Western Pacific
China,20-05-2020,307930,995,167,307763,Western Pacific
China,20-05-2020,215806,2319,1012,214794,Western Pacific
China,20-05-2020,179805,2199,528,179277,Western Pacific
China,20-05-2020,161731,1649,723,161008,Western Pacific
China,20-05-2020,430408,473,540,429868,Western Pacific
China,20-05-2020,113166,1849,161,113005,Western Pacific
China,20-05-2020,384323,231,868,383455,Western Pacific
China,20-05-2020,306368,124,1216,305152,Western Pacific
China,20-05-2020,38968,2236,301,38667,Western Pacific
China,20-05-2020,132436,193,1213,131223,Western Pacific
China,20-05-2020,260093,655,415,259678,Western Pacific
China,20-05-2020,406557,1070,670,405887,Western Pacific
China,20-05-2020,338970,269,473,338497,Western Pacific
China,20-05-2020,152337,2267,816,151521,Western Pacific
China,20-05-2020,272039,693,1048,270991,Western Pacific
China,20-05-2020,159144,1135,1157,157987,Western Pacific
China,20-05-2020,76779,2475,904,75875,Western Pacific
China,20-05-2020,135080,210,447,134633,Western Pacific
China,20-05-2020,363279,2232,374,362905,Western Pacific
China,20-05-2020,296773,2037,208,296565,Western Pacific
China,20-05-2020,69372,1116,699,68673,Western Pacific
China,20-05-2020,198850,2489,1190,197660,Western Pacific
China,20-05-2020,71592,51,310,71282,Western Pacific
Colombia,20-05-2020,18843,1971,716,18127,Americas
Congo (Brazzaville),20-05-2020,276425,859,1039,275386,Africa
Congo (Kinshasa),20-05-2020,259872,2123,1246,258626,Africa
Costa Rica,20-05-2020,351263,1331,119,351144,Americas
Cote d'Ivoire,20-05-2020,320075,1354,721,319354,Africa
Croatia,20-05-2020,220278,2378,591,219687,Europe
Cuba,20-05-2020,4211,768,432,3779,Americas
Cyprus,20-05-2020,317296,992,225,317071,Europe
Czechia,20-05-2020,313486,713,297,313189,Europe
Denmark,20-05-2020,35849,2226,550,35299,Europe
Greenland,20-05-2020,56137,796,1107,55030,Europe
Denmark,20-05-2020,129119,1129,578,128541,Europe
Djibouti,20-05-2020,169044,2026,614,168430,Eastern Mediterranean
Dominican Republic,20-05-2020,79740,357,201,79539,Americas
Ecuador,20-05-2020,371517,620,736,370781,Americas
Egypt,20-05-2020,324450,1010,721,323729,Eastern Mediterranean
El Salvador,20-05-2020,242350,1328,819,241531,Americas
Equatorial Guinea,20-05-2020,129285,1805,129,129156,Africa
Eritrea,20-05-2020,51192,105,812,50380,Africa
Estonia,20-05-2020,298454,2007,491,297963,Europe
Eswatini,20-05-2020,349986,1053,138,349848,Africa
Ethiopia,20-05-2020,96352,45,375,95977,Africa
Fiji,20-05-2020,392389,504,836,391553,Western Pacific
Finland,20-05-2020,263702,434,175,263527,Europe
France,20-05-2020,74735,767,750,73985,Europe
France,20-05-2020,229849,2361,1200,228649,Europe
France,20-05-2020,129824,1519,610,129214,Europe
France,20-05-2020,94972,1269,633,94339,Europe
France,20-05-2020,263721,230,220,263501,Europe
France,20-05-2020,180322,2276,660,179662,Europe
France,20-05-2020,74732,1399,938,73794,Europe
France,20-05-2020,348452,1729,186,348266,Europe
France,20-05-2020,337079,394,836,336243,Europe
France,20-05-2020,215104,1441,969,214135,Europe
Gabon,20-05-2020,140710,1336,1014,139696,Africa
Gambia,20-05-2020,245793,1205,71,245722,Africa
Georgia,20-05-2020,266333,902,426,265907,Europe
Germany,20-05-2020,260879,736,655,260224,Europe
Ghana,20-05-2020,201332,814,852,200480,Africa
Greece,20-05-2020,52086,524,944,51142,Europe
Guatemala,20-05-2020,321657,1902,899,320758,Americas
Guinea,20-05-2020,30971,1867,400,30571,Africa
Guyana,20-05-2020,230862,599,723,230139,Americas
Haiti,20-05-2020,307282,718,1221,306061,Americas
Holy See,20-05-2020,137443,214,157,137286,Europe
Honduras,20-05-2020,156181,1636,596,155585,Americas
Hungary,20-05-2020,65219,1745,1137,64082,Europe
Iceland,20-05-2020,116496,509,899,115597,Europe
India,20-05-2020,87127,1788,512,86615,South-East Asia
Indonesia,20-05-2020,30713,383,751,29962,South-East Asia
Iran,20-05-2020,220793,301,476,220317,Eastern Mediterranean
Iraq,20-05-2020,188971,1636,420,188551,Eastern Mediterranean
Ireland,20-05-2020,129187,1754,449,128738,Europe
Israel,20-05-2020,216551,1526,1001,215550,Europe
Italy,20-05-2020,227690,1095,1119,226571,Europe
Jamaica,20-05-2020,11403,264,955,10448,Americas
Japan,20-05-2020,22889,789,980,21909,Western Pacific
Jordan,20-05-2020,402894,692,565,402329,Eastern Mediterranean
Kazakhstan,20-05-2020,362274,1147,877,361397,Europe
Kenya,20-05-2020,137290,1199,689,136601,Africa
South Korea,20-05-2020,310568,1,275,310293,Western Pacific
Kuwait,20-05-2020,105777,1071,738,105039,Eastern Mediterranean
Kyrgyzstan,20-05-2020,390577,1752,1130,389447,Europe
Latvia,20-05-2020,100112,1776,756,99356,Europe
Lebanon,20-05-2020,349924,1038,1143,348781,Eastern Mediterranean
Liberia,20-05-2020,410895,434,1049,409846,Africa
Liechtenstein,20-05-2020,317191,899,1102,316089,Europe
Lithuania,20-05-2020,397081,1683,361,396720,Europe
Luxembourg,20-05-2020,431211,1185,319,430892,Europe
Madagascar,20-05-2020,243340,270,149,243191,Africa
Malaysia,20-05-2020,76231,1134,167,76064,Western Pacific
Maldives,20-05-2020,364655,1941,433,364222,South-East Asia
Malta,20-05-2020,374962,2259,438,374524,Europe
Mauritania,20-05-2020,41271,1502,1214,40057,Africa
Mauritius,20-05-2020,357392,397,354,357038,Africa
Mexico,20-05-2020,395636,2135,75,395561,Americas
Moldova,20-05-2020,304027,934,549,303478,Europe
Monaco,20-05-2020,247686,145,649,247037,Europe
Mongolia,20-05-2020,176489,1126,705,175784,Western Pacific
Montenegro,20-05-2020,372561,1559,616,371945,Europe
Morocco,20-05-2020,436267,107,703,435564,Eastern Mediterranean
Namibia,20-05-2020,178087,1723,53,178034,Africa
Nepal,20-05-2020,266243,89,595,265648,South-East Asia
Netherlands,20-05-2020,227352,42,641,226711,Europe
Netherlands,20-05-2020,126025,1631,169,125856,Europe
Netherlands,20-05-2020,297144,532,1192,295952,Europe
Netherlands,20-05-2020,411103,2363,727,410376,Europe
New Zealand,20-05-2020,229600,2353,1212,228388,Western Pacific
Nicaragua,20-05-2020,368972,1813,360,368612,Americas
Niger,20-05-2020,352286,1697,319,351967,Africa
Nigeria,20-05-2020,27210,910,529,26681,Africa
North Macedonia,20-05-2020,148549,927,325,148224,Europe
Norway,20-05-2020,1250,182,1200,50,Europe
Oman,20-05-2020,358231,593,1068,357163,Eastern Mediterranean
Pakistan,20-05-2020,427321,2401,73,427248,Eastern Mediterranean
Panama,20-05-2020,333427,2306,306,333121,Americas
Papua New Guinea,20-05-2020,246981,205,70,246911,Western Pacific
Paraguay,20-05-2020,422175,146,349,421826,Americas
Peru,20-05-2020,224109,1487,41,224068,Americas
Philippines,20-05-2020,68270,39,924,67346,Western Pacific
Poland,20-05-2020,276483,983,238,276245,Europe
Portugal,20-05-2020,307104,2085,1049,306055,Europe
Qatar,20-05-2020,74589,1494,411,74178,Eastern Mediterranean
Romania,20-05-2020,273987,886,596,273391,Europe
Russia,20-05-2020,137023,1138,1203,135820,Europe
Rwanda,20-05-2020,94901,1455,1121,93780,Africa
Saint Lucia,20-05-2020,223355,614,585,222770,Americas
Saint Vincent and the Grenadines,20-05-2020,189479,1464,138,189341,Americas
San Marino,20-05-2020,261390,2104,438,260952,Europe
Saudi Arabia,20-05-2020,307757,1796,408,307349,Eastern Mediterranean
Senegal,20-05-2020,295888,183,1135,294753,Africa
Serbia,20-05-2020,172120,1667,257,171863,Europe
Seychelles,20-05-2020,225345,852,626,224719,Africa
Singapore,20-05-2020,34272,1654,1004,33268,Western Pacific
Slovakia,20-05-2020,445741,2405,263,445478,Europe
Slovenia,20-05-2020,13518,1932,776,12742,Europe
Somalia,20-05-2020,320053,598,971,319082,Eastern Mediterranean
South Africa,20-05-2020,392054,1044,426,391628,Africa
Spain,20-05-2020,256508,417,159,256349,Europe
Sri Lanka,20-05-2020,408329,619,279,408050,South-East Asia
Sudan,20-05-2020,87269,179,791,86478,Eastern Mediterranean
Suriname,20-05-2020,316993,186,45,316948,Americas
Sweden,20-05-2020,278974,1269,488,278486,Europe
Switzerland,20-05-2020,185212,416,55,185157,Europe
Taiwan*,20-05-2020,208635,467,866,207769,Western Pacific
Tanzania,20-05-2020,317317,1316,721,316596,Africa
Thailand,20-05-2020,92677,1201,927,91750,South-East Asia
Togo,20-05-2020,340714,635,502,340212,Africa
Trinidad and Tobago,20-05-2020,363557,77,1173,362384,Americas
Tunisia,20-05-2020,302273,2147,184,302089,Eastern Mediterranean
Turkey,20-05-2020,194047,2381,2,194045,Europe
Uganda,20-05-2020,304515,1689,1031,303484,Africa
Ukraine,20-05-2020,142710,623,124,142586,Europe
United Arab Emirates,20-05-2020,103128,768,912,102216,Eastern Mediterranean
United Kingdom,20-05-2020,292778,39,432,292346,Europe
United Kingdom,20-05-2020,322833,806,26,322807,Europe
United Kingdom,20-05-2020,426781,859,915,425866,Europe
United Kingdom,20-05-2020,228183,1341,349,227834,Europe
United Kingdom,20-05-2020,72260,1520,974,71286,Europe
United Kingdom,20-05-2020,47877,262,184,47693,Europe
United Kingdom,20-05-2020,116925,156,401,116524,Europe
Uruguay,20-05-2020,13673,1748,403,13270,Americas
US,20-05-2020,237334,1297,526,236808,Americas
Uzbekistan,20-05-2020,166012,431,219,165793,Europe
Venezuela,20-05-2020,35577,2120,120,35457,Americas
Vietnam,20-05-2020,204918,107,854,204064,Western Pacific
Zambia,20-05-2020,269184,2344,624,268560,Africa
Zimbabwe,20-05-2020,247567,1350,1027,246540,Africa
Dominica,20-05-2020,400797,1355,800,399997,Americas
Grenada,20-05-2020,439215,1114,811,438404,Americas
Mozambique,20-05-2020,287868,1879,463,287405,Africa
Syria,20-05-2020,178600,2500,185,178415,Eastern Mediterranean
Timor-Leste,20-05-2020,193095,866,291,192804,South-East Asia
Belize,20-05-2020,91091,1056,487,90604,Americas
Laos,20-05-2020,254936,2325,1125,253811,Western Pacific
Libya,20-05-2020,231524,1705,1226,230298,Eastern Mediterranean
West Bank and Gaza,20-05-2020,211580,1846,50,211530,Eastern Mediterranean
Guinea-Bissau,20-05-2020,177376,629,346,177030,Africa
Mali,20-05-2020,137675,936,412,137263,Africa
Saint Kitts and Nevis,20-05-2020,171120,544,784,170336,Americas
Canada,20-05-2020,143619,718,1122,142497,Americas
Canada,20-05-2020,292323,2405,102,292221,Americas
Kosovo,20-05-2020,250158,1985,985,249173,Europe
Burma,20-05-2020,121396,2191,874,120522,South-East Asia
United Kingdom,20-05-2020,439800,166,86,439714,Europe
United Kingdom,20-05-2020,412112,1542,975,411137,Europe
United Kingdom,20-05-2020,152516,326,1127,151389,Europe
Botswana,20-05-2020,195185,2236,1231,193954,Africa
Burundi,20-05-2020,7688,606,1193,6495,Africa
Sierra Leone,20-05-2020,138553,801,808,137745,Africa
Malawi,20-05-2020,348465,485,1172,347293,Africa
United Kingdom,20-05-2020,370513,398,338,370175,Europe
France,20-05-2020,221440,375,9,221431,Europe
South Sudan,20-05-2020,67887,2259,1074,66813,Africa
Western Sahara,20-05-2020,86804,1846,135,86669,Africa
Sao Tome and Principe,20-05-2020,148274,96,487,147787,Africa
Yemen,20-05-2020,436873,1012,805,436068,Eastern Mediterranean
Comoros,20-05-2020,257154,777,96,257058,Africa
Tajikistan,20-05-2020,303827,1305,935,302892,Europe
Lesotho,20-05-2020,178850,1731,241,178609,Africa
Afghanistan,21-05-2020,419269,891,1212,418057,Eastern Mediterranean
Albania,21-05-2020,88742,1662,1136,87606,Europe
Algeria,21-05-2020,400403,619,858,399545,Africa
Andorra,21-05-2020,31453,436,284,31169,Europe
Angola,21-05-2020,82411,107,1078,81333,Africa
Antigua and Barbuda,21-05-2020,228344,444,325,228019,Americas
Argentina,21-05-2020,299260,1457,1212,298048,Americas
Armenia,21-05-2020,322247,1128,1065,321182,Europe
Australia,21-05-2020,267944,667,1232,266712,Western Pacific
Australia,21-05-2020,176332,1363,320,176012,Western Pacific
Australia,21-05-2020,186864,1068,936,185928,Western Pacific
Australia,21-05-2020,271728,1643,193,271535,Western Pacific
Australia,21-05-2020,245566,1970,794,244772,Western Pacific
Australia,21-05-2020,167113,822,1200,165913,Western Pacific
Australia,21-05-2020,114520,1736,1032,113488,Western Pacific
Australia,21-05-2020,415732,278,690,415042,Western Pacific
Austria,21-05-2020,403661,829,230,403431,Europe
Azerbaijan,21-05-2020,4050,2336,84,3966,Europe
Bahamas,21-05-2020,288271,755,611,287660,Americas
Bahrain,21-05-2020,243220,1455,958,242262,Eastern Mediterranean
Bangladesh,21-05-2020,251677,671,364,251313,South-East Asia
Barbados,21-05-2020,68004,194,819,67185,Americas
Belarus,21-05-2020,392126,544,1232,390894,Europe
Belgium,21-05-2020,300785,157,668,300117,Europe
Benin,21-05-2020,41741,2379,1118,40623,Africa
Bhutan,21-05-2020,311996,135,402,311594,South-East Asia
Bolivia,21-05-2020,202509,469,776,201733,Americas
Bosnia and Herzegovina,21-05-2020,286351,1884,581,285770,Europe
Brazil,21-05-2020,302017,822,549,301468,Americas
Brunei,21-05-2020,150515,2495,906,149609,Western Pacific
Bulgaria,21-05-2020,214838,305,1016,213822,Europe
Burkina Faso,21-05-2020,256587,762,647,255940,Africa
Cabo Verde,21-05-2020,344849,131,699,344150,Africa
Cambodia,21-05-2020,127846,2199,131,127715,Western Pacific
Cameroon,21-05-2020,199831,1320,764,199067,Africa
Canada,21-05-2020,286969,771,851,286118,Americas
Canada,21-05-2020,43467,1222,666,42801,Americas
Canada,21-05-2020,427023,878,284,426739,Americas
Canada,21-05-2020,264812,910,845,263967,Americas
Canada,21-05-2020,442946,1958,553,442393,Americas
Canada,21-05-2020,205531,295,492,205039,Americas
Canada,21-05-2020,93814,129,1024,92790,Americas
Canada,21-05-2020,80404,837,534,79870,Americas
Canada,21-05-2020,142065,856,572,141493,Americas
Canada,21-05-2020,315701,715,455,315246,Americas
Central African Republic,21-05-2020,135365,2254,892,134473,Africa
Chad,21-05-2020,25687,1791,556,25131,Africa
Chile,21-05-2020,112540,78,1006,111534,Americas
China,21-05-2020,377728,1117,698,377030,Western Pacific
China,21-05-2020,220271,944,1104,219167,Western Pacific
China,21-05-2020,128580,1168,667,127913,Western Pacific
China,21-05-2020,126182,1862,46,126136,Western Pacific
China,21-05-2020,168216,2118,580,167636,Western Pacific
China,21-05-2020,272391,1456,980,271411,Western Pacific
China,21-05-2020,3794,2072,783,3011,Western Pacific
China,21-05-2020,168660,525,90,168570,Western Pacific
China,21-05-2020,230948,1178,1060,229888,Western Pacific
China,21-05-2020,291552,1755,176,291376,Western Pacific
China,21-05-2020,57729,633,951,56778,Western Pacific
China,21-05-2020,146515,743,452,146063,Western Pacific
China,21-05-2020,62824,1929,1087,61737,Western Pacific
China,21-05-2020,215150,565,398,214752,Western Pacific
China,21-05-2020,62902,2498,348,62554,Western Pacific
China,21-05-2020,138863,426,632,138231,Western Pacific
China,21-05-2020,158081,1881,701,157380,Western Pacific
China,21-05-2020,235625,1272,395,235230,Western Pacific
China,21-05-2020,43705,657,866,42839,Western Pacific
China,21-05-2020,38428,645,214,38214,Western Pacific
China,21-05-2020,207584,416,1102,206482,Western Pacific
China,21-05-2020,222077,316,899,221178,Western Pacific
China,21-05-2020,347772,578,761,347011,Western Pacific
China,21-05-2020,165294,1137,494,164800,Western Pacific
China,21-05-2020,328614,1638,854,327760,Western Pacific
China,21-05-2020,115358,1284,1071,114287,Western Pacific
China,21-05-2020,206524,551,639,205885,Western Pacific
China,21-05-2020,92197,2421,1207,90990,Western Pacific
China,21-05-2020,93181,2290,689,92492,Western Pacific
China,21-05-2020,325233,2325,653,324580,Western Pacific
China,21-05-2020,64410,304,242,64168,Western Pacific
China,21-05-2020,232608,1021,167,232441,Western Pacific
China,21-05-2020,113831,1032,89,113742,Western Pacific
Colombia,21-05-2020,43960,1202,940,43020,Americas
Congo (Brazzaville),21-05-2020,206567,1481,967,205600,Africa
Congo (Kinshasa),21-05-2020,258838,2277,831,258007,Africa
Costa Rica,21-05-2020,95573,1662,901,94672,Americas
Cote d'Ivoire,21-05-2020,261062,2459,1126,259936,Africa
Croatia,21-05-2020,289046,2181,1245,287801,Europe
Cuba,21-05-2020,55856,2280,450,55406,Americas
Cyprus,21-05-2020,302186,355,1098,301088,Europe
Czechia,21-05-2020,152004,1481,810,151194,Europe
Denmark,21-05-2020,426809,116,999,425810,Europe
Greenland,21-05-2020,291964,1472,266,291698,Europe
Denmark,21-05-2020,228402,1952,28,228374,Europe
Djibouti,21-05-2020,155291,1314,20,155271,Eastern Mediterranean
Dominican Republic,21-05-2020,1924,2297,1172,752,Americas
Ecuador,21-05-2020,301529,706,666,300863,Americas
Egypt,21-05-2020,35156,110,621,34535,Eastern Mediterranean
El Salvador,21-05-2020,300249,2325,814,299435,Americas
Equatorial Guinea,21-05-2020,169054,1005,1126,167928,Africa
Eritrea,21-05-2020,245557,1700,235,245322,Africa
Estonia,21-05-2020,139307,293,267,139040,Europe
Eswatini,21-05-2020,398750,838,1049,397701,Africa
Ethiopia,21-05-2020,186999,1241,383,186616,Africa
Fiji,21-05-2020,364135,2376,1189,362946,Western Pacific
Finland,21-05-2020,215032,1988,81,214951,Europe
France,21-05-2020,15966,2409,797,15169,Europe
France,21-05-2020,105170,189,705,104465,Europe
France,21-05-2020,350227,1518,108,350119,Europe
France,21-05-2020,272717,919,331,272386,Europe
France,21-05-2020,139395,2035,1200,138195,Europe
France,21-05-2020,77933,69,1021,76912,Europe
France,21-05-2020,294008,153,434,293574,Europe
France,21-05-2020,341276,345,811,340465,Europe
France,21-05-2020,218516,1008,1143,217373,Europe
France,21-05-2020,304498,350,493,304005,Europe
Gabon,21-05-2020,221640,1917,1044,220596,Africa
Gambia,21-05-2020,92873,1504,49,92824,Africa
Georgia,21-05-2020,16109,7,43,16066,Europe
Germany,21-05-2020,124657,2071,765,123892,Europe
Ghana,21-05-2020,264905,1961,194,264711,Africa
Greece,21-05-2020,176389,1106,105,176284,Europe
Guatemala,21-05-2020,357232,1258,816,356416,Americas
Guinea,21-05-2020,109676,1976,1121,108555,Africa
Guyana,21-05-2020,55075,339,666,54409,Americas
Haiti,21-05-2020,80038,2333,600,79438,Americas
Holy See,21-05-2020,383750,1760,947,382803,Europe
Honduras,21-05-2020,41991,1276,1195,40796,Americas
Hungary,21-05-2020,413653,905,286,413367,Europe
Iceland,21-05-2020,359391,713,661,358730,Europe
India,21-05-2020,432062,545,1137,430925,South-East Asia
Indonesia,21-05-2020,275224,2043,303,274921,South-East Asia
Iran,21-05-2020,329334,2054,1042,328292,Eastern Mediterranean
Iraq,21-05-2020,92390,1398,927,91463,Eastern Mediterranean
Ireland,21-05-2020,231982,2077,1206,230776,Europe
Israel,21-05-2020,18453,706,1197,17256,Europe
Italy,21-05-2020,96997,2497,666,96331,Europe
Jamaica,21-05-2020,115288,1692,44,115244,Americas
Japan,21-05-2020,389190,1695,865,388325,Western Pacific
Jordan,21-05-2020,196715,334,946,195769,Eastern Mediterranean
Kazakhstan,21-05-2020,8973,952,622,8351,Europe
Kenya,21-05-2020,92030,1087,850,91180,Africa
South Korea,21-05-2020,185286,1092,384,184902,Western Pacific
Kuwait,21-05-2020,384794,10,838,383956,Eastern Mediterranean
Kyrgyzstan,21-05-2020,200718,1495,793,199925,Europe
Latvia,21-05-2020,169959,1470,1131,168828,Europe
Lebanon,21-05-2020,404520,2222,625,403895,Eastern Mediterranean
Liberia,21-05-2020,237067,1733,1095,235972,Africa
Liechtenstein,21-05-2020,153816,605,88,153728,Europe
Lithuania,21-05-2020,207020,2052,267,206753,Europe
Luxembourg,21-05-2020,124000,1523,147,123853,Europe
Madagascar,21-05-2020,190972,475,69,190903,Africa
Malaysia,21-05-2020,424740,1419,698,424042,Western Pacific
Maldives,21-05-2020,240439,703,1088,239351,South-East Asia
Malta,21-05-2020,353611,1431,286,353325,Europe
Mauritania,21-05-2020,168702,1005,659,168043,Africa
Mauritius,21-05-2020,41596,2313,349,41247,Africa
Mexico,21-05-2020,246113,2477,396,245717,Americas
Moldova,21-05-2020,245353,863,938,244415,Europe
Monaco,21-05-2020,391083,40,136,390947,Europe
Mongolia,21-05-2020,171010,2427,450,170560,Western Pacific
Montenegro,21-05-2020,109870,1533,738,109132,Europe
Morocco,21-05-2020,321794,1761,533,321261,Eastern Mediterranean
Namibia,21-05-2020,401451,1203,586,400865,Africa
Nepal,21-05-2020,442013,1845,278,441735,South-East Asia
Netherlands,21-05-2020,18190,1882,665,17525,Europe
Netherlands,21-05-2020,228029,271,56,227973,Europe
Netherlands,21-05-2020,10280,1078,862,9418,Europe
Netherlands,21-05-2020,409736,2195,7,409729,Europe
New Zealand,21-05-2020,416890,959,1139,415751,Western Pacific
Nicaragua,21-05-2020,406875,651,732,406143,Americas
Niger,21-05-2020,335363,1543,275,335088,Africa
Nigeria,21-05-2020,331764,1618,878,330886,Africa
North Macedonia,21-05-2020,25953,696,1180,24773,Europe
Norway,21-05-2020,185746,436,880,184866,Europe
Oman,21-05-2020,311949,793,543,311406,Eastern Mediterranean
Pakistan,21-05-2020,55429,1255,875,54554,Eastern Mediterranean
Panama,21-05-2020,83908,833,71,83837,Americas
Papua New Guinea,21-05-2020,412247,461,519,411728,Western Pacific
Paraguay,21-05-2020,375125,654,821,374304,Americas
Peru,21-05-2020,441525,1158,506,441019,Americas
Philippines,21-05-2020,66448,580,898,65550,Western Pacific
Poland,21-05-2020,350905,2496,809,350096,Europe
Portugal,21-05-2020,367169,388,723,366446,Europe
Qatar,21-05-2020,229094,1269,725,228369,Eastern Mediterranean
Romania,21-05-2020,270423,2121,1224,269199,Europe
Russia,21-05-2020,409972,1229,73,409899,Europe
Rwanda,21-05-2020,138609,981,486,138123,Africa
Saint Lucia,21-05-2020,131546,1414,380,131166,Americas
Saint Vincent and the Grenadines,21-05-2020,66983,494,846,66137,Americas
San Marino,21-05-2020,60649,1792,432,60217,Europe
Saudi Arabia,21-05-2020,198989,1777,734,198255,Eastern Mediterranean
Senegal,21-05-2020,323205,400,928,322277,Africa
Serbia,21-05-2020,208005,72,965,207040,Europe
Seychelles,21-05-2020,196714,1283,811,195903,Africa
Singapore,21-05-2020,25716,164,1238,24478,Western Pacific
Slovakia,21-05-2020,115487,465,1087,114400,Europe
Slovenia,21-05-2020,444286,578,312,443974,Europe
Somalia,21-05-2020,74535,299,469,74066,Eastern Mediterranean
South Africa,21-05-2020,155072,1463,811,154261,Africa
Spain,21-05-2020,209036,1625,1024,208012,Europe
Sri Lanka,21-05-2020,264880,2093,895,263985,South-East Asia
Sudan,21-05-2020,160635,2050,886,159749,Eastern Mediterranean
Suriname,21-05-2020,254285,1646,867,253418,Americas
Sweden,21-05-2020,255569,906,593,254976,Europe
Switzerland,21-05-2020,440458,804,576,439882,Europe
Taiwan*,21-05-2020,256720,322,538,256182,Western Pacific
Tanzania,21-05-2020,91430,562,408,91022,Africa
Thailand,21-05-2020,203983,280,1117,202866,South-East Asia
Togo,21-05-2020,317381,1510,622,316759,Africa
Trinidad and Tobago,21-05-2020,313464,463,664,312800,Americas
Tunisia,21-05-2020,34139,1689,260,33879,Eastern Mediterranean
Turkey,21-05-2020,39091,2142,773,38318,Europe
Uganda,21-05-2020,157132,1057,356,156776,Africa
Ukraine,21-05-2020,319648,2406,256,319392,Europe
United Arab Emirates,21-05-2020,136013,226,572,135441,Eastern Mediterranean
United Kingdom,21-05-2020,165479,973,859,164620,Europe
United Kingdom,21-05-2020,336579,456,438,336141,Europe
United Kingdom,21-05-2020,321311,970,1036,320275,Europe
United Kingdom,21-05-2020,266713,530,357,266356,Europe
United Kingdom,21-05-2020,195407,349,198,195209,Europe
United Kingdom,21-05-2020,222931,788,1022,221909,Europe
United Kingdom,21-05-2020,49305,2117,512,48793,Europe
Uruguay,21-05-2020,15549,1728,854,14695,Americas
US,21-05-2020,41538,107,398,41140,Americas
Uzbekistan,21-05-2020,315161,932,1096,314065,Europe
Venezuela,21-05-2020,412439,23,527,411912,Americas
Vietnam,21-05-2020,301980,2036,499,301481,Western Pacific
Zambia,21-05-2020,99819,2395,342,99477,Africa
Zimbabwe,21-05-2020,216501,462,1003,215498,Africa
Dominica,21-05-2020,128285,767,679,127606,Americas
Grenada,21-05-2020,414172,100,853,413319,Americas
Mozambique,21-05-2020,74373,266,564,73809,Africa
Syria,21-05-2020,258876,214,56,258820,Eastern Mediterranean
Timor-Leste,21-05-2020,203829,2031,489,203340,South-East Asia
Belize,21-05-2020,303993,846,510,303483,Americas
Laos,21-05-2020,196492,855,1000,195492,Western Pacific
Libya,21-05-2020,307336,259,392,306944,Eastern Mediterranean
West Bank and Gaza,21-05-2020,438142,1442,144,437998,Eastern Mediterranean
Guinea-Bissau,21-05-2020,204933,946,330,204603,Africa
Mali,21-05-2020,128956,1005,507,128449,Africa
Saint Kitts and Nevis,21-05-2020,241741,612,780,240961,Americas
Canada,21-05-2020,298335,1995,161,298174,Americas
Canada,21-05-2020,303338,991,193,303145,Americas
Kosovo,21-05-2020,105208,1723,1228,103980,Europe
Burma,21-05-2020,337336,1230,598,336738,South-East Asia
United Kingdom,21-05-2020,248051,2295,557,247494,Europe
United Kingdom,21-05-2020,293422,833,250,293172,Europe
United Kingdom,21-05-2020,134688,2492,814,133874,Europe
Botswana,21-05-2020,104816,1655,779,104037,Africa
Burundi,21-05-2020,316458,2389,620,315838,Africa
Sierra Leone,21-05-2020,375918,1692,94,375824,Africa
Malawi,21-05-2020,162336,784,1077,161259,Africa
United Kingdom,21-05-2020,5677,593,833,4844,Europe
France,21-05-2020,65149,2045,682,64467,Europe
South Sudan,21-05-2020,93297,450,293,93004,Africa
Western Sahara,21-05-2020,130423,1125,384,130039,Africa
Sao Tome and Principe,21-05-2020,236705,968,796,235909,Africa
Yemen,21-05-2020,241413,1742,969,240444,Eastern Mediterranean
Comoros,21-05-2020,383864,620,623,383241,Africa
Tajikistan,21-05-2020,219625,2100,1141,218484,Europe
Lesotho,21-05-2020,197602,2322,1187,196415,Africa
Afghanistan,22-05-2020,312709,2093,879,311830,Eastern Mediterranean
Albania,22-05-2020,255111,1256,172,254939,Europe
Algeria,22-05-2020,14228,1654,1161,13067,Africa
Andorra,22-05-2020,77757,349,945,76812,Europe
Angola,22-05-2020,317610,1137,676,316934,Africa
Antigua and Barbuda,22-05-2020,265629,1893,356,265273,Americas
Argentina,22-05-2020,325823,1594,99,325724,Americas
Armenia,22-05-2020,106500,440,656,105844,Europe
Australia,22-05-2020,141040,2403,661,140379,Western Pacific
Australia,22-05-2020,398808,1586,901,397907,Western Pacific
Australia,22-05-2020,406011,2008,552,405459,Western Pacific
Australia,22-05-2020,314263,1680,948,313315,Western Pacific
Australia,22-05-2020,182192,1776,1232,180960,Western Pacific
Australia,22-05-2020,391378,1334,1217,390161,Western Pacific
Australia,22-05-2020,387936,150,79,387857,Western Pacific
Australia,22-05-2020,99968,1805,665,99303,Western Pacific
Austria,22-05-2020,382999,1164,572,382427,Europe
Azerbaijan,22-05-2020,22060,2300,396,21664,Europe
Bahamas,22-05-2020,230133,1395,633,229500,Americas
Bahrain,22-05-2020,161403,1314,128,161275,Eastern Mediterranean
Bangladesh,22-05-2020,296261,140,1165,295096,South-East Asia
Barbados,22-05-2020,163412,1878,1190,162222,Americas
Belarus,22-05-2020,32220,1412,235,31985,Europe
Belgium,22-05-2020,100328,458,1219,99109,Europe
Benin,22-05-2020,294787,482,169,294618,Africa
Bhutan,22-05-2020,351460,208,1077,350383,South-East Asia
Bolivia,22-05-2020,184061,781,196,183865,Americas
Bosnia and Herzegovina,22-05-2020,108453,826,247,108206,Europe
Brazil,22-05-2020,352480,1442,275,352205,Americas
Brunei,22-05-2020,6743,2111,105,6638,Western Pacific
Bulgaria,22-05-2020,250044,37,236,249808,Europe
Burkina Faso,22-05-2020,42144,886,99,42045,Africa
Cabo Verde,22-05-2020,29940,480,790,29150,Africa
Cambodia,22-05-2020,267684,2210,161,267523,Western Pacific
Cameroon,22-05-2020,437350,1460,546,436804,Africa
Canada,22-05-2020,83397,271,1011,82386,Americas
Canada,22-05-2020,357353,1707,1038,356315,Americas
Canada,22-05-2020,111111,1478,93,111018,Americas
Canada,22-05-2020,358519,615,1014,357505,Americas
Canada,22-05-2020,47154,1435,921,46233,Americas
Canada,22-05-2020,142074,3,217,141857,Americas
Canada,22-05-2020,391525,1187,374,391151,Americas
Canada,22-05-2020,396886,725,592,396294,Americas
Canada,22-05-2020,92055,260,664,91391,Americas
Canada,22-05-2020,371800,917,8,371792,Americas
Central African Republic,22-05-2020,236742,2219,1040,235702,Africa
Chad,22-05-2020,407806,1529,272,407534,Africa
Chile,22-05-2020,1592,633,642,950,Americas
China,22-05-2020,240312,2129,118,240194,Western Pacific
China,22-05-2020,164188,792,1188,163000,Western Pacific
China,22-05-2020,116161,2103,407,115754,Western Pacific
China,22-05-2020,271785,351,82,271703,Western Pacific
China,22-05-2020,436589,1717,414,436175,Western Pacific
China,22-05-2020,442423,149,849,441574,Western Pacific
China,22-05-2020,15724,1861,1243,14481,Western Pacific
China,22-05-2020,35758,353,95,35663,Western Pacific
China,22-05-2020,249120,691,169,248951,Western Pacific
China,22-05-2020,383208,15,248,382960,Western Pacific
China,22-05-2020,321919,1405,502,321417,Western Pacific
China,22-05-2020,174591,507,106,174485,Western Pacific
China,22-05-2020,206076,1258,679,205397,Western Pacific
China,22-05-2020,9200,245,1190,8010,Western Pacific
China,22-05-2020,377713,665,164,377549,Western Pacific
China,22-05-2020,149080,2450,733,148347,Western Pacific
China,22-05-2020,203823,2000,23,203800,Western Pacific
China,22-05-2020,173532,716,190,173342,Western Pacific
China,22-05-2020,110010,1845,152,109858,Western Pacific
China,22-05-2020,69269,583,623,68646,Western Pacific
China,22-05-2020,2957,159,1246,1711,Western Pacific
China,22-05-2020,177266,1441,1234,176032,Western Pacific
China,22-05-2020,197067,1039,1000,196067,Western Pacific
China,22-05-2020,99113,1210,830,98283,Western Pacific
China,22-05-2020,245401,1599,1192,244209,Western Pacific
China,22-05-2020,424051,1927,62,423989,Western Pacific
China,22-05-2020,419758,75,1073,418685,Western Pacific
China,22-05-2020,154567,1943,305,154262,Western Pacific
China,22-05-2020,340172,1671,824,339348,Western Pacific
China,22-05-2020,159977,1328,997,158980,Western Pacific
China,22-05-2020,9815,240,474,9341,Western Pacific
China,22-05-2020,374171,660,528,373643,Western Pacific
China,22-05-2020,226788,1937,224,226564,Western Pacific
Colombia,22-05-2020,254761,1760,1058,253703,Americas
Congo (Brazzaville),22-05-2020,374642,2043,404,374238,Africa
Congo (Kinshasa),22-05-2020,91499,859,707,90792,Africa
Costa Rica,22-05-2020,281993,1922,90,281903,Americas
Cote d'Ivoire,22-05-2020,378920,1943,1151,377769,Africa
Croatia,22-05-2020,371747,185,167,371580,Europe
Cuba,22-05-2020,175670,1358,959,174711,Americas
Cyprus,22-05-2020,184668,69,1226,183442,Europe
Czechia,22-05-2020,126473,1145,526,125947,Europe
Denmark,22-05-2020,159140,594,185,158955,Europe
Greenland,22-05-2020,444998,1087,196,444802,Europe
Denmark,22-05-2020,168694,2237,430,168264,Europe
Djibouti,22-05-2020,97578,2428,127,97451,Eastern Mediterranean
Dominican Republic,22-05-2020,103430,2309,182,103248,Americas
Ecuador,22-05-2020,155444,1113,490,154954,Americas
Egypt,22-05-2020,121145,573,993,120152,Eastern Mediterranean
El Salvador,22-05-2020,354468,1503,1082,353386,Americas
Equatorial Guinea,22-05-2020,156289,1721,166,156123,Africa
Eritrea,22-05-2020,375577,1254,1100,374477,Africa
Estonia,22-05-2020,375897,1562,138,375759,Europe
Eswatini,22-05-2020,137020,346,192,136828,Africa
Ethiopia,22-05-2020,271170,1064,32,271138,Africa
Fiji,22-05-2020,251578,1635,784,250794,Western Pacific
Finland,22-05-2020,48772,224,828,47944,Europe
France,22-05-2020,351927,428,994,350933,Europe
France,22-05-2020,232553,2231,305,232248,Europe
France,22-05-2020,201872,61,854,201018,Europe
France,22-05-2020,27544,2355,406,27138,Europe
France,22-05-2020,76689,812,889,75800,Europe
France,22-05-2020,51727,348,427,51300,Europe
France,22-05-2020,64972,1147,136,64836,Europe
France,22-05-2020,6338,2234,1007,5331,Europe
France,22-05-2020,331104,1474,318,330786,Europe
France,22-05-2020,272820,415,410,272410,Europe
Gabon,22-05-2020,308489,715,181,308308,Africa
Gambia,22-05-2020,219088,1520,988,218100,Africa
Georgia,22-05-2020,64825,490,616,64209,Europe
Germany,22-05-2020,397733,980,1073,396660,Europe
Ghana,22-05-2020,152580,864,1225,151355,Africa
Greece,22-05-2020,331027,1377,528,330499,Europe
Guatemala,22-05-2020,14052,2046,1045,13007,Americas
Guinea,22-05-2020,220799,1826,1159,219640,Africa
Guyana,22-05-2020,230874,1510,1094,229780,Americas
Haiti,22-05-2020,13744,47,918,12826,Americas
Holy See,22-05-2020,147325,1110,818,146507,Europe
Honduras,22-05-2020,385551,1019,327,385224,Americas
Hungary,22-05-2020,68303,321,919,67384,Europe
Iceland,22-05-2020,17187,1792,928,16259,Europe
India,22-05-2020,257883,1904,999,256884,South-East Asia
Indonesia,22-05-2020,267772,243,388,267384,South-East Asia
Iran,22-05-2020,26599,1027,1083,25516,Eastern Mediterranean
Iraq,22-05-2020,245870,71,742,245128,Eastern Mediterranean
Ireland,22-05-2020,278750,999,957,277793,Europe
Israel,22-05-2020,4661,1717,606,4055,Europe
Italy,22-05-2020,335224,2255,1193,334031,Europe
Jamaica,22-05-2020,81170,80,689,80481,Americas
Japan,22-05-2020,166426,2113,1232,165194,Western Pacific
Jordan,22-05-2020,366249,172,41,366208,Eastern Mediterranean
Kazakhstan,22-05-2020,152410,876,670,151740,Europe
Kenya,22-05-2020,43631,2410,996,42635,Africa
South Korea,22-05-2020,41023,2182,304,40719,Western Pacific
Kuwait,22-05-2020,395726,383,214,395512,Eastern Mediterranean
Kyrgyzstan,22-05-2020,304048,2043,1055,302993,Europe
Latvia,22-05-2020,60457,1322,828,59629,Europe
Lebanon,22-05-2020,106235,1178,754,105481,Eastern Mediterranean
Liberia,22-05-2020,124481,980,768,123713,Africa
Liechtenstein,22-05-2020,144110,1547,274,143836,Europe
Lithuania,22-05-2020,119887,485,941,118946,Europe
Luxembourg,22-05-2020,221146,187,1232,219914,Europe
Madagascar,22-05-2020,12007,2336,957,11050,Africa
Malaysia,22-05-2020,28316,326,887,27429,Western Pacific
Maldives,22-05-2020,363612,1027,422,363190,South-East Asia
Malta,22-05-2020,174412,1247,517,173895,Europe
Mauritania,22-05-2020,367766,973,49,367717,Africa
Mauritius,22-05-2020,68451,1962,389,68062,Africa
Mexico,22-05-2020,60083,1665,1071,59012,Americas
Moldova,22-05-2020,118550,1936,328,118222,Europe
Monaco,22-05-2020,410083,2189,197,409886,Europe
Mongolia,22-05-2020,20584,1408,139,20445,Western Pacific
Montenegro,22-05-2020,162679,324,607,162072,Europe
Morocco,22-05-2020,237089,234,78,237011,Eastern Mediterranean
Namibia,22-05-2020,120676,2288,154,120522,Africa
Nepal,22-05-2020,178285,80,526,177759,South-East Asia
Netherlands,22-05-2020,363842,2051,471,363371,Europe
Netherlands,22-05-2020,81630,222,361,81269,Europe
Netherlands,22-05-2020,114179,255,209,113970,Europe
Netherlands,22-05-2020,47291,1194,882,46409,Europe
New Zealand,22-05-2020,160912,2181,1158,159754,Western Pacific
Nicaragua,22-05-2020,177864,1876,1051,176813,Americas
Niger,22-05-2020,439705,1756,302,439403,Africa
Nigeria,22-05-2020,329813,810,1068,328745,Africa
North Macedonia,22-05-2020,296451,1831,821,295630,Europe
Norway,22-05-2020,360135,1473,635,359500,Europe
Oman,22-05-2020,271843,2070,872,270971,Eastern Mediterranean
Pakistan,22-05-2020,126236,2469,994,125242,Eastern Mediterranean
Panama,22-05-2020,269816,552,1173,268643,Americas
Papua New Guinea,22-05-2020,296787,1205,0,296787,Western Pacific
Paraguay,22-05-2020,220984,1405,766,220218,Americas
Peru,22-05-2020,91471,2079,907,90564,Americas
Philippines,22-05-2020,345043,692,498,344545,Western Pacific
Poland,22-05-2020,290578,2405,780,289798,Europe
Portugal,22-05-2020,147145,1609,773,146372,Europe
Qatar,22-05-2020,268027,1891,600,267427,Eastern Mediterranean
Romania,22-05-2020,212915,982,1181,211734,Europe
Russia,22-05-2020,215916,2024,101,215815,Europe
Rwanda,22-05-2020,259821,341,1085,258736,Africa
Saint Lucia,22-05-2020,96427,1672,691,95736,Americas
Saint Vincent and the Grenadines,22-05-2020,359086,173,93,358993,Americas
San Marino,22-05-2020,68445,2491,405,68040,Europe
Saudi Arabia,22-05-2020,385200,2246,927,384273,Eastern Mediterranean
Senegal,22-05-2020,39518,439,658,38860,Africa
Serbia,22-05-2020,261308,1733,312,260996,Europe
Seychelles,22-05-2020,21317,1534,452,20865,Africa
Singapore,22-05-2020,348074,431,245,347829,Western Pacific
Slovakia,22-05-2020,392876,980,431,392445,Europe
Slovenia,22-05-2020,158091,1049,141,157950,Europe
Somalia,22-05-2020,109294,1514,635,108659,Eastern Mediterranean
South Africa,22-05-2020,447674,372,754,446920,Africa
Spain,22-05-2020,348113,349,1077,347036,Europe
Sri Lanka,22-05-2020,120234,1578,1022,119212,South-East Asia
Sudan,22-05-2020,68155,1263,130,68025,Eastern Mediterranean
Suriname,22-05-2020,220411,1261,907,219504,Americas
Sweden,22-05-2020,409387,2178,660,408727,Europe
Switzerland,22-05-2020,72818,341,288,72530,Europe
Taiwan*,22-05-2020,276624,1998,1024,275600,Western Pacific
Tanzania,22-05-2020,309881,1867,976,308905,Africa
Thailand,22-05-2020,160527,281,852,159675,South-East Asia
Togo,22-05-2020,95805,727,1150,94655,Africa
Trinidad and Tobago,22-05-2020,335220,1885,602,334618,Americas
Tunisia,22-05-2020,333092,2170,688,332404,Eastern Mediterranean
Turkey,22-05-2020,235774,249,149,235625,Europe
Uganda,22-05-2020,112555,1549,639,111916,Africa
Ukraine,22-05-2020,390493,2106,688,389805,Europe
United Arab Emirates,22-05-2020,309682,1280,319,309363,Eastern Mediterranean
United Kingdom,22-05-2020,401943,2036,881,401062,Europe
United Kingdom,22-05-2020,45007,1740,836,44171,Europe
United Kingdom,22-05-2020,167144,2377,1230,165914,Europe
United Kingdom,22-05-2020,272982,1542,407,272575,Europe
United Kingdom,22-05-2020,114455,594,120,114335,Europe
United Kingdom,22-05-2020,434147,2058,61,434086,Europe
United Kingdom,22-05-2020,12965,1941,726,12239,Europe
Uruguay,22-05-2020,199512,1163,207,199305,Americas
US,22-05-2020,59028,76,159,58869,Americas
Uzbekistan,22-05-2020,449725,1790,882,448843,Europe
Venezuela,22-05-2020,116298,1998,918,115380,Americas
Vietnam,22-05-2020,219361,1967,129,219232,Western Pacific
Zambia,22-05-2020,126692,250,245,126447,Africa
Zimbabwe,22-05-2020,155245,2109,376,154869,Africa
Dominica,22-05-2020,262091,261,537,261554,Americas
Grenada,22-05-2020,96561,556,818,95743,Americas
Mozambique,22-05-2020,425364,548,746,424618,Africa
Syria,22-05-2020,402412,940,58,402354,Eastern Mediterranean
Timor-Leste,22-05-2020,62210,1232,362,61848,South-East Asia
Belize,22-05-2020,344070,2411,669,343401,Americas
Laos,22-05-2020,217890,849,550,217340,Western Pacific
Libya,22-05-2020,19564,1137,685,18879,Eastern Mediterranean
West Bank and Gaza,22-05-2020,239313,166,1090,238223,Eastern Mediterranean
Guinea-Bissau,22-05-2020,127805,1414,1016,126789,Africa
Mali,22-05-2020,365095,763,1047,364048,Africa
Saint Kitts and Nevis,22-05-2020,240187,1472,823,239364,Americas
Canada,22-05-2020,207484,1357,146,207338,Americas
Canada,22-05-2020,285056,1195,382,284674,Americas
Kosovo,22-05-2020,59778,1923,754,59024,Europe
Burma,22-05-2020,249875,1634,724,249151,South-East Asia
United Kingdom,22-05-2020,8451,2355,1081,7370,Europe
United Kingdom,22-05-2020,71932,2377,326,71606,Europe
United Kingdom,22-05-2020,17819,1920,977,16842,Europe
Botswana,22-05-2020,392789,2297,263,392526,Africa
Burundi,22-05-2020,229883,716,166,229717,Africa
Sierra Leone,22-05-2020,103408,886,280,103128,Africa
Malawi,22-05-2020,439745,2332,401,439344,Africa
United Kingdom,22-05-2020,439895,1872,528,439367,Europe
France,22-05-2020,364921,59,1122,363799,Europe
South Sudan,22-05-2020,109362,1656,842,108520,Africa
Western Sahara,22-05-2020,201186,1503,567,200619,Africa
Sao Tome and Principe,22-05-2020,191095,1835,97,190998,Africa
Yemen,22-05-2020,63919,525,406,63513,Eastern Mediterranean
Comoros,22-05-2020,140644,912,100,140544,Africa
Tajikistan,22-05-2020,314288,81,575,313713,Europe
Lesotho,22-05-2020,435205,629,296,434909,Africa
Afghanistan,23-05-2020,163603,649,619,162984,Eastern Mediterranean
Albania,23-05-2020,210567,2031,1229,209338,Europe
Algeria,23-05-2020,350369,2054,978,349391,Africa
Andorra,23-05-2020,432668,93,1243,431425,Europe
Angola,23-05-2020,86411,1986,197,86214,Africa
Antigua and Barbuda,23-05-2020,444079,289,57,444022,Americas
Argentina,23-05-2020,272537,2248,241,272296,Americas
Armenia,23-05-2020,51624,1973,196,51428,Europe
Australia,23-05-2020,319842,1873,354,319488,Western Pacific
Australia,23-05-2020,126319,1383,361,125958,Western Pacific
Australia,23-05-2020,180979,1769,1076,179903,Western Pacific
Australia,23-05-2020,440752,394,666,440086,Western Pacific
Australia,23-05-2020,342480,1211,729,341751,Western Pacific
Australia,23-05-2020,422886,210,771,422115,Western Pacific
Australia,23-05-2020,190247,752,718,189529,Western Pacific
Australia,23-05-2020,420296,1839,786,419510,Western Pacific
Austria,23-05-2020,9061,2052,999,8062,Europe
Azerbaijan,23-05-2020,124755,450,868,123887,Europe
Bahamas,23-05-2020,368725,673,709,368016,Americas
Bahrain,23-05-2020,251458,1876,475,250983,Eastern Mediterranean
Bangladesh,23-05-2020,28979,2145,411,28568,South-East Asia
Barbados,23-05-2020,152838,744,30,152808,Americas
Belarus,23-05-2020,116332,2350,165,116167,Europe
Belgium,23-05-2020,46778,808,388,46390,Europe
Benin,23-05-2020,296328,388,645,295683,Africa
Bhutan,23-05-2020,398401,1081,74,398327,South-East Asia
Bolivia,23-05-2020,227006,1862,1141,225865,Americas
Bosnia and Herzegovina,23-05-2020,409410,2237,1058,408352,Europe
Brazil,23-05-2020,354346,1016,1165,353181,Americas
Brunei,23-05-2020,255073,574,1107,253966,Western Pacific
Bulgaria,23-05-2020,248911,1918,498,248413,Europe
Burkina Faso,23-05-2020,294967,1302,866,294101,Africa
Cabo Verde,23-05-2020,104824,1007,380,104444,Africa
Cambodia,23-05-2020,313558,2324,950,312608,Western Pacific
Cameroon,23-05-2020,310590,2007,870,309720,Africa
Canada,23-05-2020,17767,1999,497,17270,Americas
Canada,23-05-2020,253577,417,667,252910,Americas
Canada,23-05-2020,211391,136,337,211054,Americas
Canada,23-05-2020,23755,2422,828,22927,Americas
Canada,23-05-2020,74054,1264,492,73562,Americas
Canada,23-05-2020,276765,2148,260,276505,Americas
Canada,23-05-2020,142603,1381,376,142227,Americas
Canada,23-05-2020,193765,1783,206,193559,Americas
Canada,23-05-2020,352792,1095,610,352182,Americas
Canada,23-05-2020,121329,253,689,120640,Americas
Central African Republic,23-05-2020,254616,2098,352,254264,Africa
Chad,23-05-2020,361794,2195,1234,360560,Africa
Chile,23-05-2020,58419,353,742,57677,Americas
China,23-05-2020,368444,490,1173,367271,Western Pacific
China,23-05-2020,375267,1813,343,374924,Western Pacific
China,23-05-2020,394141,779,765,393376,Western Pacific
China,23-05-2020,92705,283,64,92641,Western Pacific
China,23-05-2020,268351,1431,257,268094,Western Pacific
China,23-05-2020,262975,1678,910,262065,Western Pacific
China,23-05-2020,319941,627,882,319059,Western Pacific
China,23-05-2020,217391,235,1247,216144,Western Pacific
China,23-05-2020,430537,2162,853,429684,Western Pacific
China,23-05-2020,376907,243,1113,375794,Western Pacific
China,23-05-2020,78898,660,1237,77661,Western Pacific
China,23-05-2020,326296,512,564,325732,Western Pacific
China,23-05-2020,330402,728,131,330271,Western Pacific
China,23-05-2020,309636,1070,440,309196,Western Pacific
China,23-05-2020,18561,2222,17,18544,Western Pacific
China,23-05-2020,426742,2039,57,426685,Western Pacific
China,23-05-2020,363666,2208,728,362938,Western Pacific
China,23-05-2020,8078,2216,887,7191,Western Pacific
China,23-05-2020,233189,1080,1235,231954,Western Pacific
China,23-05-2020,325689,329,1054,324635,Western Pacific
China,23-05-2020,187331,545,883,186448,Western Pacific
China,23-05-2020,398498,2258,1152,397346,Western Pacific
China,23-05-2020,317992,27,1156,316836,Western Pacific
China,23-05-2020,92235,1507,508,91727,Western Pacific
China,23-05-2020,166501,524,268,166233,Western Pacific
China,23-05-2020,309672,1318,1132,308540,Western Pacific
China,23-05-2020,387849,1902,820,387029,Western Pacific
China,23-05-2020,77118,473,484,76634,Western Pacific
China,23-05-2020,221270,926,614,220656,Western Pacific
China,23-05-2020,387461,1588,1172,386289,Western Pacific
China,23-05-2020,326826,349,299,326527,Western Pacific
China,23-05-2020,151340,2233,84,151256,Western Pacific
China,23-05-2020,415232,1225,78,415154,Western Pacific
Colombia,23-05-2020,146516,1277,336,146180,Americas
Congo (Brazzaville),23-05-2020,436557,1188,1121,435436,Africa
Congo (Kinshasa),23-05-2020,5932,1743,765,5167,Africa
Costa Rica,23-05-2020,430188,109,1241,428947,Americas
Cote d'Ivoire,23-05-2020,212890,761,1055,211835,Africa
Croatia,23-05-2020,223163,1627,820,222343,Europe
Cuba,23-05-2020,126124,2008,866,125258,Americas
Cyprus,23-05-2020,104848,688,454,104394,Europe
Czechia,23-05-2020,209436,1345,148,209288,Europe
Denmark,23-05-2020,131410,1110,1022,130388,Europe
Greenland,23-05-2020,177491,264,885,176606,Europe
Denmark,23-05-2020,376507,1819,1143,375364,Europe
Djibouti,23-05-2020,311623,2458,724,310899,Eastern Mediterranean
Dominican Republic,23-05-2020,164183,1834,17,164166,Americas
Ecuador,23-05-2020,282921,638,725,282196,Americas
Egypt,23-05-2020,189836,1260,348,189488,Eastern Mediterranean
El Salvador,23-05-2020,184552,427,45,184507,Americas
Equatorial Guinea,23-05-2020,287782,316,1110,286672,Africa
Eritrea,23-05-2020,212997,194,604,212393,Africa
Estonia,23-05-2020,437751,620,844,436907,Europe
Eswatini,23-05-2020,26081,945,786,25295,Africa
Ethiopia,23-05-2020,376400,348,645,375755,Africa
Fiji,23-05-2020,182654,529,1142,181512,Western Pacific
Finland,23-05-2020,149559,854,85,149474,Europe
France,23-05-2020,95000,2265,744,94256,Europe
France,23-05-2020,26598,99,422,26176,Europe
France,23-05-2020,50638,2095,824,49814,Europe
France,23-05-2020,207169,562,294,206875,Europe
France,23-05-2020,231594,1632,363,231231,Europe
France,23-05-2020,267865,1646,55,267810,Europe
France,23-05-2020,211035,847,1105,209930,Europe
France,23-05-2020,54251,70,478,53773,Europe
France,23-05-2020,168703,2481,62,168641,Europe
France,23-05-2020,26420,1489,747,25673,Europe
Gabon,23-05-2020,3376,1231,763,2613,Africa
Gambia,23-05-2020,166844,1300,1038,165806,Africa
Georgia,23-05-2020,280277,2029,1012,279265,Europe
Germany,23-05-2020,177420,1349,448,176972,Europe
Ghana,23-05-2020,446720,1679,102,446618,Africa
Greece,23-05-2020,36907,2497,167,36740,Europe
Guatemala,23-05-2020,440095,2124,404,439691,Americas
Guinea,23-05-2020,148871,925,438,148433,Africa
Guyana,23-05-2020,323056,88,695,322361,Americas
Haiti,23-05-2020,150875,650,511,150364,Americas
Holy See,23-05-2020,81715,2496,711,81004,Europe
Honduras,23-05-2020,279136,288,358,278778,Americas
Hungary,23-05-2020,80920,99,53,80867,Europe
Iceland,23-05-2020,399423,490,1219,398204,Europe
India,23-05-2020,261375,379,787,260588,South-East Asia
Indonesia,23-05-2020,128495,2011,1053,127442,South-East Asia
Iran,23-05-2020,150507,1857,602,149905,Eastern Mediterranean
Iraq,23-05-2020,307994,744,403,307591,Eastern Mediterranean
Ireland,23-05-2020,181236,1475,940,180296,Europe
Israel,23-05-2020,422163,988,994,421169,Europe
Italy,23-05-2020,206336,1116,344,205992,Europe
Jamaica,23-05-2020,444163,806,588,443575,Americas
Japan,23-05-2020,8932,18,969,7963,Western Pacific
Jordan,23-05-2020,313395,1119,919,312476,Eastern Mediterranean
Kazakhstan,23-05-2020,363263,517,997,362266,Europe
Kenya,23-05-2020,178684,175,793,177891,Africa
South Korea,23-05-2020,128252,624,1235,127017,Western Pacific
Kuwait,23-05-2020,39434,2422,74,39360,Eastern Mediterranean
Kyrgyzstan,23-05-2020,335070,2140,84,334986,Europe
Latvia,23-05-2020,120145,285,877,119268,Europe
Lebanon,23-05-2020,205933,398,107,205826,Eastern Mediterranean
Liberia,23-05-2020,439773,1749,888,438885,Africa
Liechtenstein,23-05-2020,118463,1349,326,118137,Europe
Lithuania,23-05-2020,299965,109,1065,298900,Europe
Luxembourg,23-05-2020,388338,1701,1075,387263,Europe
Madagascar,23-05-2020,429509,2396,868,428641,Africa
Malaysia,23-05-2020,17826,864,150,17676,Western Pacific
Maldives,23-05-2020,272378,517,359,272019,South-East Asia
Malta,23-05-2020,417916,1794,1184,416732,Europe
Mauritania,23-05-2020,327440,2263,1108,326332,Africa
Mauritius,23-05-2020,387853,369,772,387081,Africa
Mexico,23-05-2020,57146,2308,592,56554,Americas
Moldova,23-05-2020,23717,1866,280,23437,Europe
Monaco,23-05-2020,313054,384,388,312666,Europe
Mongolia,23-05-2020,437089,53,171,436918,Western Pacific
Montenegro,23-05-2020,196313,49,830,195483,Europe
Morocco,23-05-2020,399576,2070,1135,398441,Eastern Mediterranean
Namibia,23-05-2020,409892,141,938,408954,Africa
Nepal,23-05-2020,219960,1579,990,218970,South-East Asia
Netherlands,23-05-2020,190360,432,240,190120,Europe
Netherlands,23-05-2020,210983,121,820,210163,Europe
Netherlands,23-05-2020,255623,1370,151,255472,Europe
Netherlands,23-05-2020,443286,1610,339,442947,Europe
New Zealand,23-05-2020,175350,1059,203,175147,Western Pacific
Nicaragua,23-05-2020,326103,193,837,325266,Americas
Niger,23-05-2020,239701,1546,398,239303,Africa
Nigeria,23-05-2020,43978,1329,120,43858,Africa
North Macedonia,23-05-2020,135604,2323,482,135122,Europe
Norway,23-05-2020,119751,547,348,119403,Europe
Oman,23-05-2020,298731,2480,1241,297490,Eastern Mediterranean
Pakistan,23-05-2020,236093,1838,235,235858,Eastern Mediterranean
Panama,23-05-2020,339211,963,522,338689,Americas
Papua New Guinea,23-05-2020,148014,498,349,147665,Western Pacific
Paraguay,23-05-2020,220534,1005,995,219539,Americas
Peru,23-05-2020,63206,1288,1137,62069,Americas
Philippines,23-05-2020,86296,987,561,85735,Western Pacific
Poland,23-05-2020,174188,1132,192,173996,Europe
Portugal,23-05-2020,404618,681,671,403947,Europe
Qatar,23-05-2020,376503,897,418,376085,Eastern Mediterranean
Romania,23-05-2020,292367,42,994,291373,Europe
Russia,23-05-2020,408941,676,559,408382,Europe
Rwanda,23-05-2020,177988,2221,283,177705,Africa
Saint Lucia,23-05-2020,323804,20,678,323126,Americas
Saint Vincent and the Grenadines,23-05-2020,160752,55,827,159925,Americas
San Marino,23-05-2020,277698,1214,770,276928,Europe
Saudi Arabia,23-05-2020,290287,998,279,290008,Eastern Mediterranean
Senegal,23-05-2020,67709,1373,630,67079,Africa
Serbia,23-05-2020,388575,747,571,388004,Europe
Seychelles,23-05-2020,34161,1987,593,33568,Africa
Singapore,23-05-2020,79705,2421,1064,78641,Western Pacific
Slovakia,23-05-2020,329656,438,828,328828,Europe
Slovenia,23-05-2020,373421,1490,114,373307,Europe
Somalia,23-05-2020,385935,1490,355,385580,Eastern Mediterranean
South Africa,23-05-2020,238870,2101,1219,237651,Africa
Spain,23-05-2020,46763,1693,763,46000,Europe
Sri Lanka,23-05-2020,98970,1975,411,98559,South-East Asia
Sudan,23-05-2020,63550,651,639,62911,Eastern Mediterranean
Suriname,23-05-2020,209536,484,1149,208387,Americas
Sweden,23-05-2020,279926,889,235,279691,Europe
Switzerland,23-05-2020,227688,2246,349,227339,Europe
Taiwan*,23-05-2020,124594,712,968,123626,Western Pacific
Tanzania,23-05-2020,79083,1219,956,78127,Africa
Thailand,23-05-2020,415349,1362,632,414717,South-East Asia
Togo,23-05-2020,90430,2385,710,89720,Africa
Trinidad and Tobago,23-05-2020,330191,1668,1087,329104,Americas
Tunisia,23-05-2020,207007,2179,1031,205976,Eastern Mediterranean
Turkey,23-05-2020,433229,1287,493,432736,Europe
Uganda,23-05-2020,180784,1527,197,180587,Africa
Ukraine,23-05-2020,186550,556,1105,185445,Europe
United Arab Emirates,23-05-2020,234651,2031,815,233836,Eastern Mediterranean
United Kingdom,23-05-2020,175429,2296,1114,174315,Europe
United Kingdom,23-05-2020,14742,739,4,14738,Europe
United Kingdom,23-05-2020,334725,1767,126,334599,Europe
United Kingdom,23-05-2020,130707,812,67,130640,Europe
United Kingdom,23-05-2020,298489,1312,523,297966,Europe
United Kingdom,23-05-2020,231801,2498,611,231190,Europe
United Kingdom,23-05-2020,180378,1342,828,179550,Europe
Uruguay,23-05-2020,430564,426,526,430038,Americas
US,23-05-2020,421159,978,94,421065,Americas
Uzbekistan,23-05-2020,366697,501,670,366027,Europe
Venezuela,23-05-2020,131158,2149,160,130998,Americas
Vietnam,23-05-2020,352836,2279,123,352713,Western Pacific
Zambia,23-05-2020,449637,2019,340,449297,Africa
Zimbabwe,23-05-2020,261322,1866,868,260454,Africa
Dominica,23-05-2020,22811,1675,487,22324,Americas
Grenada,23-05-2020,275899,2076,680,275219,Americas
Mozambique,23-05-2020,185320,1628,1029,184291,Africa
Syria,23-05-2020,285851,1661,987,284864,Eastern Mediterranean
Timor-Leste,23-05-2020,149561,477,409,149152,South-East Asia
Belize,23-05-2020,190179,1673,131,190048,Americas
Laos,23-05-2020,425306,874,674,424632,Western Pacific
Libya,23-05-2020,112887,1278,973,111914,Eastern Mediterranean
West Bank and Gaza,23-05-2020,328005,626,1000,327005,Eastern Mediterranean
Guinea-Bissau,23-05-2020,413691,1280,1152,412539,Africa
Mali,23-05-2020,143732,1957,538,143194,Africa
Saint Kitts and Nevis,23-05-2020,42352,1358,908,41444,Americas
Canada,23-05-2020,60944,712,964,59980,Americas
Canada,23-05-2020,299561,2397,982,298579,Americas
Kosovo,23-05-2020,301429,72,1010,300419,Europe
Burma,23-05-2020,142839,1830,1179,141660,South-East Asia
United Kingdom,23-05-2020,433170,604,886,432284,Europe
United Kingdom,23-05-2020,322124,2463,1177,320947,Europe
United Kingdom,23-05-2020,86287,691,443,85844,Europe
Botswana,23-05-2020,353326,2457,1063,352263,Africa
Burundi,23-05-2020,172882,1185,498,172384,Africa
Sierra Leone,23-05-2020,113299,282,205,113094,Africa
Malawi,23-05-2020,386538,583,968,385570,Africa
United Kingdom,23-05-2020,251230,2199,542,250688,Europe
France,23-05-2020,348611,329,810,347801,Europe
South Sudan,23-05-2020,51121,368,320,50801,Africa
Western Sahara,23-05-2020,289223,707,1202,288021,Africa
Sao Tome and Principe,23-05-2020,444740,1332,351,444389,Africa
Yemen,23-05-2020,409016,888,802,408214,Eastern Mediterranean
Comoros,23-05-2020,88835,507,650,88185,Africa
Tajikistan,23-05-2020,268508,936,684,267824,Europe
Lesotho,23-05-2020,311665,117,12,311653,Africa
Afghanistan,24-05-2020,345775,237,1123,344652,Eastern Mediterranean
Albania,24-05-2020,260225,546,1231,258994,Europe
Algeria,24-05-2020,20136,815,685,19451,Africa
Andorra,24-05-2020,96660,1846,68,96592,Europe
Angola,24-05-2020,133939,664,158,133781,Africa
Antigua and Barbuda,24-05-2020,194335,154,703,193632,Americas
Argentina,24-05-2020,194379,274,1065,193314,Americas
Armenia,24-05-2020,292043,1609,331,291712,Europe
Australia,24-05-2020,147306,2199,659,146647,Western Pacific
Australia,24-05-2020,283257,695,236,283021,Western Pacific
Australia,24-05-2020,274860,172,690,274170,Western Pacific
Australia,24-05-2020,337183,272,341,336842,Western Pacific
Australia,24-05-2020,367453,1786,43,367410,Western Pacific
Australia,24-05-2020,382827,1809,514,382313,Western Pacific
Australia,24-05-2020,53858,2269,623,53235,Western Pacific
Australia,24-05-2020,29580,2312,580,29000,Western Pacific
Austria,24-05-2020,167497,1499,804,166693,Europe
Azerbaijan,24-05-2020,169358,1272,383,168975,Europe
Bahamas,24-05-2020,410020,2473,795,409225,Americas
Bahrain,24-05-2020,198721,883,648,198073,Eastern Mediterranean
Bangladesh,24-05-2020,281940,337,777,281163,South-East Asia
Barbados,24-05-2020,260498,1314,267,260231,Americas
Belarus,24-05-2020,308917,1802,1168,307749,Europe
Belgium,24-05-2020,178189,2374,710,177479,Europe
Benin,24-05-2020,78522,900,1152,77370,Africa
Bhutan,24-05-2020,295762,65,486,295276,South-East Asia
Bolivia,24-05-2020,443411,77,500,442911,Americas
Bosnia and Herzegovina,24-05-2020,275794,388,1130,274664,Europe
Brazil,24-05-2020,280326,777,517,279809,Americas
Brunei,24-05-2020,174619,2180,445,174174,Western Pacific
Bulgaria,24-05-2020,422284,50,1225,421059,Europe
Burkina Faso,24-05-2020,237120,128,152,236968,Africa
Cabo Verde,24-05-2020,397538,807,718,396820,Africa
Cambodia,24-05-2020,57933,2238,1093,56840,Western Pacific
Cameroon,24-05-2020,266511,596,601,265910,Africa
Canada,24-05-2020,414363,943,669,413694,Americas
Canada,24-05-2020,14454,1515,459,13995,Americas
Canada,24-05-2020,269101,257,656,268445,Americas
Canada,24-05-2020,164592,1282,416,164176,Americas
Canada,24-05-2020,271573,879,1155,270418,Americas
Canada,24-05-2020,33697,1486,387,33310,Americas
Canada,24-05-2020,120587,1112,619,119968,Americas
Canada,24-05-2020,58545,491,659,57886,Americas
Canada,24-05-2020,320466,2357,1083,319383,Americas
Canada,24-05-2020,224813,668,187,224626,Americas
Central African Republic,24-05-2020,174839,896,978,173861,Africa
Chad,24-05-2020,86354,1556,138,86216,Africa
Chile,24-05-2020,328003,206,582,327421,Americas
China,24-05-2020,334261,327,277,333984,Western Pacific
China,24-05-2020,183297,1932,50,183247,Western Pacific
China,24-05-2020,276791,2234,87,276704,Western Pacific
China,24-05-2020,81071,2496,159,80912,Western Pacific
China,24-05-2020,150524,5,211,150313,Western Pacific
China,24-05-2020,186074,2416,669,185405,Western Pacific
China,24-05-2020,438286,1182,1082,437204,Western Pacific
China,24-05-2020,139820,1931,503,139317,Western Pacific
China,24-05-2020,11519,680,1242,10277,Western Pacific
China,24-05-2020,190642,1755,366,190276,Western Pacific
China,24-05-2020,239808,1067,719,239089,Western Pacific
China,24-05-2020,85446,1647,900,84546,Western Pacific
China,24-05-2020,44065,925,97,43968,Western Pacific
China,24-05-2020,168835,549,1173,167662,Western Pacific
China,24-05-2020,286718,1503,885,285833,Western Pacific
China,24-05-2020,76555,2421,1057,75498,Western Pacific
China,24-05-2020,78575,1134,126,78449,Western Pacific
China,24-05-2020,164751,2326,384,164367,Western Pacific
China,24-05-2020,149764,2440,1,149763,Western Pacific
China,24-05-2020,93987,2447,437,93550,Western Pacific
China,24-05-2020,151689,2191,796,150893,Western Pacific
China,24-05-2020,437494,920,588,436906,Western Pacific
China,24-05-2020,440093,1197,546,439547,Western Pacific
China,24-05-2020,393844,2144,975,392869,Western Pacific
China,24-05-2020,350157,615,488,349669,Western Pacific
China,24-05-2020,361723,835,874,360849,Western Pacific
China,24-05-2020,413805,723,545,413260,Western Pacific
China,24-05-2020,76832,1963,731,76101,Western Pacific
China,24-05-2020,334983,425,204,334779,Western Pacific
China,24-05-2020,3585,1126,119,3466,Western Pacific
China,24-05-2020,296185,1494,413,295772,Western Pacific
China,24-05-2020,119016,2164,64,118952,Western Pacific
China,24-05-2020,405708,1174,847,404861,Western Pacific
Colombia,24-05-2020,313587,451,619,312968,Americas
Congo (Brazzaville),24-05-2020,446834,1402,412,446422,Africa
Congo (Kinshasa),24-05-2020,125876,567,1079,124797,Africa
Costa Rica,24-05-2020,10241,2039,288,9953,Americas
Cote d'Ivoire,24-05-2020,230475,835,761,229714,Africa
Croatia,24-05-2020,44448,2186,499,43949,Europe
Cuba,24-05-2020,109478,1318,393,109085,Americas
Cyprus,24-05-2020,129060,1649,278,128782,Europe
Czechia,24-05-2020,273070,1231,444,272626,Europe
Denmark,24-05-2020,2183,561,572,1611,Europe
Greenland,24-05-2020,58375,1991,1243,57132,Europe
Denmark,24-05-2020,60950,1894,596,60354,Europe
Djibouti,24-05-2020,375216,589,978,374238,Eastern Mediterranean
Dominican Republic,24-05-2020,212058,600,36,212022,Americas
Ecuador,24-05-2020,445319,703,512,444807,Americas
Egypt,24-05-2020,299334,1577,172,299162,Eastern Mediterranean
El Salvador,24-05-2020,236658,2166,518,236140,Americas
Equatorial Guinea,24-05-2020,299691,1155,132,299559,Africa
Eritrea,24-05-2020,221047,1339,459,220588,Africa
Estonia,24-05-2020,11921,226,844,11077,Europe
Eswatini,24-05-2020,334766,1103,579,334187,Africa
Ethiopia,24-05-2020,321881,1685,1208,320673,Africa
Fiji,24-05-2020,374637,640,708,373929,Western Pacific
Finland,24-05-2020,428321,120,894,427427,Europe
France,24-05-2020,193519,1159,1161,192358,Europe
France,24-05-2020,267624,461,414,267210,Europe
France,24-05-2020,447522,218,740,446782,Europe
France,24-05-2020,244463,327,505,243958,Europe
France,24-05-2020,449110,1514,1160,447950,Europe
France,24-05-2020,249734,1434,119,249615,Europe
France,24-05-2020,266889,2077,497,266392,Europe
France,24-05-2020,320903,234,998,319905,Europe
France,24-05-2020,111996,2455,557,111439,Europe
France,24-05-2020,275355,1995,533,274822,Europe
Gabon,24-05-2020,330299,1007,963,329336,Africa
Gambia,24-05-2020,351419,62,857,350562,Africa
Georgia,24-05-2020,403902,2118,1103,402799,Europe
Germany,24-05-2020,309997,50,830,309167,Europe
Ghana,24-05-2020,153707,1125,1168,152539,Africa
Greece,24-05-2020,178843,1938,1020,177823,Europe
Guatemala,24-05-2020,267015,2291,57,266958,Americas
Guinea,24-05-2020,299758,1864,682,299076,Africa
Guyana,24-05-2020,6282,460,390,5892,Americas
Haiti,24-05-2020,350621,1051,486,350135,Americas
Holy See,24-05-2020,259841,1633,139,259702,Europe
Honduras,24-05-2020,348410,2286,383,348027,Americas
Hungary,24-05-2020,311814,1592,397,311417,Europe
Iceland,24-05-2020,422055,230,616,421439,Europe
India,24-05-2020,190666,2485,589,190077,South-East Asia
Indonesia,24-05-2020,170612,2198,869,169743,South-East Asia
Iran,24-05-2020,228018,660,680,227338,Eastern Mediterranean
Iraq,24-05-2020,401293,1019,816,400477,Eastern Mediterranean
Ireland,24-05-2020,73988,431,1113,72875,Europe
Israel,24-05-2020,16174,645,1121,15053,Europe
Italy,24-05-2020,279755,587,954,278801,Europe
Jamaica,24-05-2020,11112,375,664,10448,Americas
Japan,24-05-2020,131886,2487,674,131212,Western Pacific
Jordan,24-05-2020,247451,2378,1139,246312,Eastern Mediterranean
Kazakhstan,24-05-2020,172619,960,974,171645,Europe
Kenya,24-05-2020,85756,994,1141,84615,Africa
South Korea,24-05-2020,302876,23,1211,301665,Western Pacific
Kuwait,24-05-2020,151462,1769,1175,150287,Eastern Mediterranean
Kyrgyzstan,24-05-2020,338532,1143,945,337587,Europe
Latvia,24-05-2020,397208,318,1101,396107,Europe
Lebanon,24-05-2020,17662,671,527,17135,Eastern Mediterranean
Liberia,24-05-2020,67564,546,1132,66432,Africa
Liechtenstein,24-05-2020,353472,2456,858,352614,Europe
Lithuania,24-05-2020,81331,52,568,80763,Europe
Luxembourg,24-05-2020,306853,2021,1159,305694,Europe
Madagascar,24-05-2020,280248,1746,938,279310,Africa
Malaysia,24-05-2020,55631,2034,1244,54387,Western Pacific
Maldives,24-05-2020,164570,1912,806,163764,South-East Asia
Malta,24-05-2020,358191,421,615,357576,Europe
Mauritania,24-05-2020,109059,1920,813,108246,Africa
Mauritius,24-05-2020,8581,2138,1055,7526,Africa
Mexico,24-05-2020,214177,2440,930,213247,Americas
Moldova,24-05-2020,71662,1494,599,71063,Europe
Monaco,24-05-2020,323370,1259,649,322721,Europe
Mongolia,24-05-2020,416738,1545,228,416510,Western Pacific
Montenegro,24-05-2020,233703,1540,80,233623,Europe
Morocco,24-05-2020,421431,27,1199,420232,Eastern Mediterranean
Namibia,24-05-2020,306116,1700,230,305886,Africa
Nepal,24-05-2020,257868,2490,580,257288,South-East Asia
Netherlands,24-05-2020,249179,1540,436,248743,Europe
Netherlands,24-05-2020,146484,2199,1158,145326,Europe
Netherlands,24-05-2020,407972,2284,1053,406919,Europe
Netherlands,24-05-2020,176474,472,1230,175244,Europe
New Zealand,24-05-2020,2838,1799,9,2829,Western Pacific
Nicaragua,24-05-2020,310157,817,585,309572,Americas
Niger,24-05-2020,45049,1463,1249,43800,Africa
Nigeria,24-05-2020,13101,1481,461,12640,Africa
North Macedonia,24-05-2020,394058,1340,746,393312,Europe
Norway,24-05-2020,269907,150,781,269126,Europe
Oman,24-05-2020,34222,721,587,33635,Eastern Mediterranean
Pakistan,24-05-2020,418812,1111,402,418410,Eastern Mediterranean
Panama,24-05-2020,82212,1507,300,81912,Americas
Papua New Guinea,24-05-2020,283297,813,1248,282049,Western Pacific
Paraguay,24-05-2020,116720,1140,484,116236,Americas
Peru,24-05-2020,421031,2127,1048,419983,Americas
Philippines,24-05-2020,55497,1811,577,54920,Western Pacific
Poland,24-05-2020,98971,289,850,98121,Europe
Portugal,24-05-2020,237204,2486,301,236903,Europe
Qatar,24-05-2020,35752,1294,1128,34624,Eastern Mediterranean
Romania,24-05-2020,194702,2052,909,193793,Europe
Russia,24-05-2020,259458,1081,158,259300,Europe
Rwanda,24-05-2020,333886,1756,71,333815,Africa
Saint Lucia,24-05-2020,42627,1094,688,41939,Americas
Saint Vincent and the Grenadines,24-05-2020,298098,188,891,297207,Americas
San Marino,24-05-2020,116924,207,1096,115828,Europe
Saudi Arabia,24-05-2020,147917,1726,485,147432,Eastern Mediterranean
Senegal,24-05-2020,309329,815,412,308917,Africa
Serbia,24-05-2020,320641,71,938,319703,Europe
Seychelles,24-05-2020,431918,1738,478,431440,Africa
Singapore,24-05-2020,282541,308,1105,281436,Western Pacific
Slovakia,24-05-2020,169125,1196,883,168242,Europe
Slovenia,24-05-2020,40528,478,841,39687,Europe
Somalia,24-05-2020,220917,283,242,220675,Eastern Mediterranean
South Africa,24-05-2020,330438,2213,336,330102,Africa
Spain,24-05-2020,37539,20,1011,36528,Europe
Sri Lanka,24-05-2020,182266,1462,15,182251,South-East Asia
Sudan,24-05-2020,34620,1137,778,33842,Eastern Mediterranean
Suriname,24-05-2020,373823,2220,899,372924,Americas
Sweden,24-05-2020,396848,1916,1241,395607,Europe
Switzerland,24-05-2020,448036,309,172,447864,Europe
Taiwan*,24-05-2020,45033,1229,908,44125,Western Pacific
Tanzania,24-05-2020,432560,710,610,431950,Africa
Thailand,24-05-2020,145401,833,733,144668,South-East Asia
Togo,24-05-2020,324437,2466,738,323699,Africa
Trinidad and Tobago,24-05-2020,393983,300,495,393488,Americas
Tunisia,24-05-2020,233452,403,1151,232301,Eastern Mediterranean
Turkey,24-05-2020,327504,2113,1129,326375,Europe
Uganda,24-05-2020,330672,2197,584,330088,Africa
Ukraine,24-05-2020,378560,1862,1000,377560,Europe
United Arab Emirates,24-05-2020,198912,1676,578,198334,Eastern Mediterranean
United Kingdom,24-05-2020,265133,1834,931,264202,Europe
United Kingdom,24-05-2020,336645,1189,577,336068,Europe
United Kingdom,24-05-2020,281241,937,454,280787,Europe
United Kingdom,24-05-2020,382087,2144,557,381530,Europe
United Kingdom,24-05-2020,449319,1572,716,448603,Europe
United Kingdom,24-05-2020,132458,1645,1238,131220,Europe
United Kingdom,24-05-2020,184252,275,326,183926,Europe
Uruguay,24-05-2020,61315,599,1092,60223,Americas
US,24-05-2020,70620,1527,114,70506,Americas
Uzbekistan,24-05-2020,394063,1725,387,393676,Europe
Venezuela,24-05-2020,96028,897,358,95670,Americas
Vietnam,24-05-2020,339354,1566,555,338799,Western Pacific
Zambia,24-05-2020,181536,2042,360,181176,Africa
Zimbabwe,24-05-2020,324093,293,858,323235,Africa
Dominica,24-05-2020,157192,1560,420,156772,Americas
Grenada,24-05-2020,266343,2472,1089,265254,Americas
Mozambique,24-05-2020,178826,1385,159,178667,Africa
Syria,24-05-2020,255118,62,784,254334,Eastern Mediterranean
Timor-Leste,24-05-2020,44999,219,1087,43912,South-East Asia
Belize,24-05-2020,41014,670,1056,39958,Americas
Laos,24-05-2020,353338,1998,1222,352116,Western Pacific
Libya,24-05-2020,53283,129,925,52358,Eastern Mediterranean
West Bank and Gaza,24-05-2020,116166,673,95,116071,Eastern Mediterranean
Guinea-Bissau,24-05-2020,20572,602,1243,19329,Africa
Mali,24-05-2020,110522,949,993,109529,Africa
Saint Kitts and Nevis,24-05-2020,413260,1633,616,412644,Americas
Canada,24-05-2020,158197,382,900,157297,Americas
Canada,24-05-2020,295017,801,484,294533,Americas
Kosovo,24-05-2020,122280,1454,1166,121114,Europe
Burma,24-05-2020,321066,813,557,320509,South-East Asia
United Kingdom,24-05-2020,259367,49,716,258651,Europe
United Kingdom,24-05-2020,196602,31,264,196338,Europe
United Kingdom,24-05-2020,292410,395,1093,291317,Europe
Botswana,24-05-2020,289264,1654,37,289227,Africa
Burundi,24-05-2020,37742,832,1153,36589,Africa
Sierra Leone,24-05-2020,55152,1638,542,54610,Africa
Malawi,24-05-2020,192544,617,330,192214,Africa
United Kingdom,24-05-2020,234433,258,438,233995,Europe
France,24-05-2020,7715,1693,365,7350,Europe
South Sudan,24-05-2020,411058,161,1108,409950,Africa
Western Sahara,24-05-2020,313186,516,1131,312055,Africa
Sao Tome and Principe,24-05-2020,330691,1051,972,329719,Africa
Yemen,24-05-2020,189509,693,751,188758,Eastern Mediterranean
Comoros,24-05-2020,13479,30,1158,12321,Africa
Tajikistan,24-05-2020,446039,887,1135,444904,Europe
Lesotho,24-05-2020,323722,356,1114,322608,Africa
Afghanistan,25-05-2020,211670,2043,475,211195,Eastern Mediterranean
Albania,25-05-2020,26631,344,208,26423,Europe
Algeria,25-05-2020,195768,2492,315,195453,Africa
Andorra,25-05-2020,428641,1791,42,428599,Europe
Angola,25-05-2020,384891,1040,846,384045,Africa
Antigua and Barbuda,25-05-2020,140662,408,935,139727,Americas
Argentina,25-05-2020,61367,1293,189,61178,Americas
Armenia,25-05-2020,196821,2499,605,196216,Europe
Australia,25-05-2020,160669,519,784,159885,Western Pacific
Australia,25-05-2020,66434,2095,1175,65259,Western Pacific
Australia,25-05-2020,263415,2313,955,262460,Western Pacific
Australia,25-05-2020,144361,2141,608,143753,Western Pacific
Australia,25-05-2020,69386,65,212,69174,Western Pacific
Australia,25-05-2020,164876,197,138,164738,Western Pacific
Australia,25-05-2020,271774,1246,401,271373,Western Pacific
Australia,25-05-2020,224239,2343,73,224166,Western Pacific
Austria,25-05-2020,58943,108,345,58598,Europe
Azerbaijan,25-05-2020,352767,41,22,352745,Europe
Bahamas,25-05-2020,53558,906,516,53042,Americas
Bahrain,25-05-2020,441476,657,807,440669,Eastern Mediterranean
Bangladesh,25-05-2020,294388,389,626,293762,South-East Asia
Barbados,25-05-2020,438959,1531,1174,437785,Americas
Belarus,25-05-2020,367339,1113,1023,366316,Europe
Belgium,25-05-2020,192514,2434,824,191690,Europe
Benin,25-05-2020,164691,1438,1058,163633,Africa
Bhutan,25-05-2020,83689,255,331,83358,South-East Asia
Bolivia,25-05-2020,281068,571,160,280908,Americas
Bosnia and Herzegovina,25-05-2020,202582,1244,979,201603,Europe
Brazil,25-05-2020,338524,519,922,337602,Americas
Brunei,25-05-2020,152447,994,219,152228,Western Pacific
Bulgaria,25-05-2020,399998,2448,112,399886,Europe
Burkina Faso,25-05-2020,276823,1919,728,276095,Africa
Cabo Verde,25-05-2020,222396,2058,618,221778,Africa
Cambodia,25-05-2020,240610,1114,61,240549,Western Pacific
Cameroon,25-05-2020,250401,157,921,249480,Africa
Canada,25-05-2020,339412,1434,874,338538,Americas
Canada,25-05-2020,441102,1237,74,441028,Americas
Canada,25-05-2020,283882,168,276,283606,Americas
Canada,25-05-2020,48377,1616,651,47726,Americas
Canada,25-05-2020,255970,2105,936,255034,Americas
Canada,25-05-2020,212894,1505,620,212274,Americas
Canada,25-05-2020,420027,2220,267,419760,Americas
Canada,25-05-2020,309205,127,762,308443,Americas
Canada,25-05-2020,326735,794,1245,325490,Americas
Canada,25-05-2020,408424,2223,475,407949,Americas
Central African Republic,25-05-2020,331046,1294,1163,329883,Africa
Chad,25-05-2020,73107,502,768,72339,Africa
Chile,25-05-2020,438279,50,335,437944,Americas
China,25-05-2020,444502,1526,1152,443350,Western Pacific
China,25-05-2020,104291,1333,1060,103231,Western Pacific
China,25-05-2020,296110,882,568,295542,Western Pacific
China,25-05-2020,87474,756,703,86771,Western Pacific
China,25-05-2020,263557,1189,1120,262437,Western Pacific
China,25-05-2020,148099,2189,728,147371,Western Pacific
China,25-05-2020,170749,750,34,170715,Western Pacific
China,25-05-2020,210466,149,1101,209365,Western Pacific
China,25-05-2020,161716,1163,950,160766,Western Pacific
China,25-05-2020,190724,1994,820,189904,Western Pacific
China,25-05-2020,8635,1154,1228,7407,Western Pacific
China,25-05-2020,57689,1099,656,57033,Western Pacific
China,25-05-2020,22121,39,1215,20906,Western Pacific
China,25-05-2020,265512,370,370,265142,Western Pacific
China,25-05-2020,273626,837,1199,272427,Western Pacific
China,25-05-2020,5707,1706,576,5131,Western Pacific
China,25-05-2020,159799,2203,695,159104,Western Pacific
China,25-05-2020,203067,612,881,202186,Western Pacific
China,25-05-2020,23186,1264,659,22527,Western Pacific
China,25-05-2020,340257,1433,670,339587,Western Pacific
China,25-05-2020,198637,1841,419,198218,Western Pacific
China,25-05-2020,105099,209,1059,104040,Western Pacific
China,25-05-2020,268316,2144,94,268222,Western Pacific
China,25-05-2020,13486,2321,159,13327,Western Pacific
China,25-05-2020,152614,2147,442,152172,Western Pacific
China,25-05-2020,306628,2488,340,306288,Western Pacific
China,25-05-2020,52000,493,1138,50862,Western Pacific
China,25-05-2020,110966,137,269,110697,Western Pacific
China,25-05-2020,31213,1003,446,30767,Western Pacific
China,25-05-2020,129616,1639,1210,128406,Western Pacific
China,25-05-2020,420062,32,1080,418982,Western Pacific
China,25-05-2020,33013,21,311,32702,Western Pacific
China,25-05-2020,122168,197,416,121752,Western Pacific
Colombia,25-05-2020,158307,216,624,157683,Americas
Congo (Brazzaville),25-05-2020,381955,1768,991,380964,Africa
Congo (Kinshasa),25-05-2020,408044,799,208,407836,Africa
Costa Rica,25-05-2020,69897,1882,637,69260,Americas
Cote d'Ivoire,25-05-2020,401182,2423,1196,399986,Africa
Croatia,25-05-2020,113887,176,436,113451,Europe
Cuba,25-05-2020,226260,111,586,225674,Americas
Cyprus,25-05-2020,137764,1494,700,137064,Europe
Czechia,25-05-2020,419068,339,1137,417931,Europe
Denmark,25-05-2020,43965,813,1131,42834,Europe
Greenland,25-05-2020,138321,661,586,137735,Europe
Denmark,25-05-2020,84428,274,396,84032,Europe
Djibouti,25-05-2020,300545,2335,161,300384,Eastern Mediterranean
Dominican Republic,25-05-2020,419836,1348,778,419058,Americas
Ecuador,25-05-2020,440939,1950,460,440479,Americas
Egypt,25-05-2020,434966,2334,44,434922,Eastern Mediterranean
El Salvador,25-05-2020,354501,1355,763,353738,Americas
Equatorial Guinea,25-05-2020,295552,2140,1082,294470,Africa
Eritrea,25-05-2020,312644,768,229,312415,Africa
Estonia,25-05-2020,135258,1699,630,134628,Europe
Eswatini,25-05-2020,412207,602,316,411891,Africa
Ethiopia,25-05-2020,78067,564,1067,77000,Africa
Fiji,25-05-2020,357278,912,24,357254,Western Pacific
Finland,25-05-2020,404516,1460,353,404163,Europe
France,25-05-2020,339744,1787,437,339307,Europe
France,25-05-2020,69131,1092,860,68271,Europe
France,25-05-2020,59885,1226,651,59234,Europe
France,25-05-2020,300552,1344,832,299720,Europe
France,25-05-2020,101889,1706,993,100896,Europe
France,25-05-2020,427226,704,85,427141,Europe
France,25-05-2020,26305,1291,65,26240,Europe
France,25-05-2020,314958,860,766,314192,Europe
France,25-05-2020,112909,111,631,112278,Europe
France,25-05-2020,381385,1692,40,381345,Europe
Gabon,25-05-2020,116939,962,311,116628,Africa
Gambia,25-05-2020,6910,370,97,6813,Africa
Georgia,25-05-2020,247841,501,877,246964,Europe
Germany,25-05-2020,74494,1870,743,73751,Europe
Ghana,25-05-2020,339214,736,240,338974,Africa
Greece,25-05-2020,162903,1814,166,162737,Europe
Guatemala,25-05-2020,290444,1789,658,289786,Americas
Guinea,25-05-2020,116058,2413,332,115726,Africa
Guyana,25-05-2020,15982,1008,247,15735,Americas
Haiti,25-05-2020,110446,729,208,110238,Americas
Holy See,25-05-2020,121173,813,1137,120036,Europe
Honduras,25-05-2020,68363,756,1056,67307,Americas
Hungary,25-05-2020,342407,531,469,341938,Europe
Iceland,25-05-2020,432486,751,251,432235,Europe
India,25-05-2020,43692,1683,714,42978,South-East Asia
Indonesia,25-05-2020,364081,2384,989,363092,South-East Asia
Iran,25-05-2020,201017,1701,33,200984,Eastern Mediterranean
Iraq,25-05-2020,367532,538,481,367051,Eastern Mediterranean
Ireland,25-05-2020,317297,1000,753,316544,Europe
Israel,25-05-2020,13343,1765,924,12419,Europe
Italy,25-05-2020,130517,587,614,129903,Europe
Jamaica,25-05-2020,240277,1296,148,240129,Americas
Japan,25-05-2020,366141,734,759,365382,Western Pacific
Jordan,25-05-2020,300591,1191,660,299931,Eastern Mediterranean
Kazakhstan,25-05-2020,88750,2172,1035,87715,Europe
Kenya,25-05-2020,275280,730,24,275256,Africa
South Korea,25-05-2020,23443,1616,686,22757,Western Pacific
Kuwait,25-05-2020,180367,91,605,179762,Eastern Mediterranean
Kyrgyzstan,25-05-2020,97507,1425,37,97470,Europe
Latvia,25-05-2020,212539,985,1061,211478,Europe
Lebanon,25-05-2020,110161,2119,596,109565,Eastern Mediterranean
Liberia,25-05-2020,178397,1226,290,178107,Africa
Liechtenstein,25-05-2020,411909,970,452,411457,Europe
Lithuania,25-05-2020,176393,115,1160,175233,Europe
Luxembourg,25-05-2020,206548,170,211,206337,Europe
Madagascar,25-05-2020,286026,2225,836,285190,Africa
Malaysia,25-05-2020,288299,1594,572,287727,Western Pacific
Maldives,25-05-2020,223352,2302,699,222653,South-East Asia
Malta,25-05-2020,344585,728,509,344076,Europe
Mauritania,25-05-2020,378945,1984,510,378435,Africa
Mauritius,25-05-2020,322050,2001,1074,320976,Africa
Mexico,25-05-2020,256746,1665,898,255848,Americas
Moldova,25-05-2020,72641,307,269,72372,Europe
Monaco,25-05-2020,422423,1566,245,422178,Europe
Mongolia,25-05-2020,79765,772,762,79003,Western Pacific
Montenegro,25-05-2020,447415,398,436,446979,Europe
Morocco,25-05-2020,102332,299,969,101363,Eastern Mediterranean
Namibia,25-05-2020,359716,84,803,358913,Africa
Nepal,25-05-2020,26936,469,441,26495,South-East Asia
Netherlands,25-05-2020,128434,1896,1229,127205,Europe
Netherlands,25-05-2020,186128,199,842,185286,Europe
Netherlands,25-05-2020,116298,6,966,115332,Europe
Netherlands,25-05-2020,277154,2439,643,276511,Europe
New Zealand,25-05-2020,81398,1648,482,80916,Western Pacific
Nicaragua,25-05-2020,416807,1833,635,416172,Americas
Niger,25-05-2020,8542,1582,281,8261,Africa
Nigeria,25-05-2020,425675,488,1111,424564,Africa
North Macedonia,25-05-2020,382562,735,655,381907,Europe
Norway,25-05-2020,282194,2431,101,282093,Europe
Oman,25-05-2020,308729,1195,607,308122,Eastern Mediterranean
Pakistan,25-05-2020,325363,804,923,324440,Eastern Mediterranean
Panama,25-05-2020,239098,2333,218,238880,Americas
Papua New Guinea,25-05-2020,21464,2266,466,20998,Western Pacific
Paraguay,25-05-2020,403916,1565,547,403369,Americas
Peru,25-05-2020,322993,2421,1107,321886,Americas
Philippines,25-05-2020,11584,583,984,10600,Western Pacific
Poland,25-05-2020,240332,158,748,239584,Europe
Portugal,25-05-2020,277636,768,787,276849,Europe
Qatar,25-05-2020,331204,585,983,330221,Eastern Mediterranean
Romania,25-05-2020,113587,2240,438,113149,Europe
Russia,25-05-2020,145057,242,503,144554,Europe
Rwanda,25-05-2020,254117,355,1205,252912,Africa
Saint Lucia,25-05-2020,236458,812,720,235738,Americas
Saint Vincent and the Grenadines,25-05-2020,269799,934,35,269764,Americas
San Marino,25-05-2020,340405,1284,565,339840,Europe
Saudi Arabia,25-05-2020,84452,2063,415,84037,Eastern Mediterranean
Senegal,25-05-2020,371015,1608,1210,369805,Africa
Serbia,25-05-2020,275056,2315,119,274937,Europe
Seychelles,25-05-2020,67299,2358,441,66858,Africa
Singapore,25-05-2020,96217,1440,1136,95081,Western Pacific
Slovakia,25-05-2020,63793,843,292,63501,Europe
Slovenia,25-05-2020,57678,1432,966,56712,Europe
Somalia,25-05-2020,65498,1393,1016,64482,Eastern Mediterranean
South Africa,25-05-2020,19975,2280,1032,18943,Africa
Spain,25-05-2020,212809,1986,997,211812,Europe
Sri Lanka,25-05-2020,237662,72,859,236803,South-East Asia
Sudan,25-05-2020,284647,1629,701,283946,Eastern Mediterranean
Suriname,25-05-2020,20970,1251,386,20584,Americas
Sweden,25-05-2020,149598,351,393,149205,Europe
Switzerland,25-05-2020,409839,1644,165,409674,Europe
Taiwan*,25-05-2020,58622,1447,551,58071,Western Pacific
Tanzania,25-05-2020,187920,1116,362,187558,Africa
Thailand,25-05-2020,332765,2167,974,331791,South-East Asia
Togo,25-05-2020,140298,926,922,139376,Africa
Trinidad and Tobago,25-05-2020,115638,1361,636,115002,Americas
Tunisia,25-05-2020,397473,2236,835,396638,Eastern Mediterranean
Turkey,25-05-2020,394260,1317,1021,393239,Europe
Uganda,25-05-2020,297743,791,648,297095,Africa
Ukraine,25-05-2020,69041,1848,692,68349,Europe
United Arab Emirates,25-05-2020,250829,2361,469,250360,Eastern Mediterranean
United Kingdom,25-05-2020,363489,1607,881,362608,Europe
United Kingdom,25-05-2020,129388,216,317,129071,Europe
United Kingdom,25-05-2020,10607,559,642,9965,Europe
United Kingdom,25-05-2020,376559,755,794,375765,Europe
United Kingdom,25-05-2020,383253,1270,155,383098,Europe
United Kingdom,25-05-2020,165555,2288,831,164724,Europe
United Kingdom,25-05-2020,75288,1761,566,74722,Europe
Uruguay,25-05-2020,89834,1355,1118,88716,Americas
US,25-05-2020,122722,2192,361,122361,Americas
Uzbekistan,25-05-2020,224458,383,1158,223300,Europe
Venezuela,25-05-2020,19759,399,760,18999,Americas
Vietnam,25-05-2020,175513,2490,617,174896,Western Pacific
Zambia,25-05-2020,436857,2161,574,436283,Africa
Zimbabwe,25-05-2020,401285,1769,1244,400041,Africa
Dominica,25-05-2020,423704,2097,495,423209,Americas
Grenada,25-05-2020,354791,645,680,354111,Americas
Mozambique,25-05-2020,54840,805,117,54723,Africa
Syria,25-05-2020,131022,369,825,130197,Eastern Mediterranean
Timor-Leste,25-05-2020,361119,2050,150,360969,South-East Asia
Belize,25-05-2020,136389,1,697,135692,Americas
Laos,25-05-2020,441813,979,196,441617,Western Pacific
Libya,25-05-2020,290197,632,1063,289134,Eastern Mediterranean
West Bank and Gaza,25-05-2020,228955,364,29,228926,Eastern Mediterranean
Guinea-Bissau,25-05-2020,234177,590,274,233903,Africa
Mali,25-05-2020,63902,1469,149,63753,Africa
Saint Kitts and Nevis,25-05-2020,442423,1498,656,441767,Americas
Canada,25-05-2020,65950,56,1059,64891,Americas
Canada,25-05-2020,350369,252,295,350074,Americas
Kosovo,25-05-2020,200127,1364,876,199251,Europe
Burma,25-05-2020,121973,1431,964,121009,South-East Asia
United Kingdom,25-05-2020,245655,8,1216,244439,Europe
United Kingdom,25-05-2020,298004,1512,1172,296832,Europe
United Kingdom,25-05-2020,230505,2120,699,229806,Europe
Botswana,25-05-2020,217375,552,141,217234,Africa
Burundi,25-05-2020,178156,1588,769,177387,Africa
Sierra Leone,25-05-2020,437363,1238,1024,436339,Africa
Malawi,25-05-2020,190968,1177,228,190740,Africa
United Kingdom,25-05-2020,147034,1399,1049,145985,Europe
France,25-05-2020,173923,2336,10,173913,Europe
South Sudan,25-05-2020,229875,2011,67,229808,Africa
Western Sahara,25-05-2020,344915,1151,821,344094,Africa
Sao Tome and Principe,25-05-2020,289224,1133,383,288841,Africa
Yemen,25-05-2020,53230,920,454,52776,Eastern Mediterranean
Comoros,25-05-2020,59136,1562,315,58821,Africa
Tajikistan,25-05-2020,17229,2270,186,17043,Europe
Lesotho,25-05-2020,84232,2006,1105,83127,Africa
Afghanistan,26-05-2020,119556,640,147,119409,Eastern Mediterranean
Albania,26-05-2020,305734,1894,1147,304587,Europe
Algeria,26-05-2020,396522,493,443,396079,Africa
Andorra,26-05-2020,49223,2045,571,48652,Europe
Angola,26-05-2020,41880,669,867,41013,Africa
Antigua and Barbuda,26-05-2020,110207,1003,163,110044,Americas
Argentina,26-05-2020,266868,799,335,266533,Americas
Armenia,26-05-2020,160045,419,354,159691,Europe
Australia,26-05-2020,17955,1774,882,17073,Western Pacific
Australia,26-05-2020,269600,33,184,269416,Western Pacific
Australia,26-05-2020,421161,1022,714,420447,Western Pacific
Australia,26-05-2020,93901,2268,1172,92729,Western Pacific
Australia,26-05-2020,270796,2029,870,269926,Western Pacific
Australia,26-05-2020,138230,1981,575,137655,Western Pacific
Australia,26-05-2020,90734,1902,713,90021,Western Pacific
Australia,26-05-2020,241202,1211,194,241008,Western Pacific
Austria,26-05-2020,418726,2309,605,418121,Europe
Azerbaijan,26-05-2020,15852,433,932,14920,Europe
Bahamas,26-05-2020,13119,963,686,12433,Americas
Bahrain,26-05-2020,249203,689,179,249024,Eastern Mediterranean
Bangladesh,26-05-2020,26827,1533,1216,25611,South-East Asia
Barbados,26-05-2020,282767,211,159,282608,Americas
Belarus,26-05-2020,279053,779,750,278303,Europe
Belgium,26-05-2020,3470,1947,930,2540,Europe
Benin,26-05-2020,416339,2487,1010,415329,Africa
Bhutan,26-05-2020,48049,1068,503,47546,South-East Asia
Bolivia,26-05-2020,354597,903,140,354457,Americas
Bosnia and Herzegovina,26-05-2020,170387,300,616,169771,Europe
Brazil,26-05-2020,206938,2100,1200,205738,Americas
Brunei,26-05-2020,311365,1005,330,311035,Western Pacific
Bulgaria,26-05-2020,365499,94,1067,364432,Europe
Burkina Faso,26-05-2020,279874,940,1029,278845,Africa
Cabo Verde,26-05-2020,422626,792,280,422346,Africa
Cambodia,26-05-2020,178128,427,848,177280,Western Pacific
Cameroon,26-05-2020,370150,902,518,369632,Africa
Canada,26-05-2020,303412,1973,706,302706,Americas
Canada,26-05-2020,114317,744,425,113892,Americas
Canada,26-05-2020,227500,367,195,227305,Americas
Canada,26-05-2020,65445,1493,587,64858,Americas
Canada,26-05-2020,59747,279,847,58900,Americas
Canada,26-05-2020,421960,99,863,421097,Americas
Canada,26-05-2020,413629,2466,697,412932,Americas
Canada,26-05-2020,74735,2475,849,73886,Americas
Canada,26-05-2020,171667,1538,938,170729,Americas
Canada,26-05-2020,82206,2034,369,81837,Americas
Central African Republic,26-05-2020,59488,1059,619,58869,Africa
Chad,26-05-2020,32012,1517,883,31129,Africa
Chile,26-05-2020,30260,1489,984,29276,Americas
China,26-05-2020,265052,778,51,265001,Western Pacific
China,26-05-2020,62972,2103,113,62859,Western Pacific
China,26-05-2020,412885,8,107,412778,Western Pacific
China,26-05-2020,393972,363,941,393031,Western Pacific
China,26-05-2020,433653,75,610,433043,Western Pacific
China,26-05-2020,363331,2,1177,362154,Western Pacific
China,26-05-2020,271757,879,614,271143,Western Pacific
China,26-05-2020,332353,1105,1067,331286,Western Pacific
China,26-05-2020,424891,371,931,423960,Western Pacific
China,26-05-2020,12007,208,803,11204,Western Pacific
China,26-05-2020,439937,1161,370,439567,Western Pacific
China,26-05-2020,57028,2169,1228,55800,Western Pacific
China,26-05-2020,208042,1881,295,207747,Western Pacific
China,26-05-2020,223904,1066,1156,222748,Western Pacific
China,26-05-2020,64069,1244,696,63373,Western Pacific
China,26-05-2020,384857,1271,862,383995,Western Pacific
China,26-05-2020,229058,2457,218,228840,Western Pacific
China,26-05-2020,144641,136,1128,143513,Western Pacific
China,26-05-2020,294025,349,262,293763,Western Pacific
China,26-05-2020,166404,354,103,166301,Western Pacific
China,26-05-2020,63066,2051,159,62907,Western Pacific
China,26-05-2020,297607,129,769,296838,Western Pacific
China,26-05-2020,75330,458,794,74536,Western Pacific
China,26-05-2020,112307,1007,529,111778,Western Pacific
China,26-05-2020,440732,429,514,440218,Western Pacific
China,26-05-2020,329502,440,526,328976,Western Pacific
China,26-05-2020,106001,537,306,105695,Western Pacific
China,26-05-2020,2067,2329,282,1785,Western Pacific
China,26-05-2020,72523,2241,527,71996,Western Pacific
China,26-05-2020,61106,1548,1055,60051,Western Pacific
China,26-05-2020,233938,1023,859,233079,Western Pacific
China,26-05-2020,120983,1379,567,120416,Western Pacific
China,26-05-2020,370306,970,395,369911,Western Pacific
Colombia,26-05-2020,300419,1446,1106,299313,Americas
Congo (Brazzaville),26-05-2020,330105,2012,205,329900,Africa
Congo (Kinshasa),26-05-2020,190832,990,68,190764,Africa
Costa Rica,26-05-2020,284191,802,423,283768,Americas
Cote d'Ivoire,26-05-2020,91634,616,90,91544,Africa
Croatia,26-05-2020,287493,348,1081,286412,Europe
Cuba,26-05-2020,390948,509,1242,389706,Americas
Cyprus,26-05-2020,197873,2226,1004,196869,Europe
Czechia,26-05-2020,253633,1311,493,253140,Europe
Denmark,26-05-2020,54961,2311,902,54059,Europe
Greenland,26-05-2020,64683,1473,218,64465,Europe
Denmark,26-05-2020,6278,1019,844,5434,Europe
Djibouti,26-05-2020,432852,1611,307,432545,Eastern Mediterranean
Dominican Republic,26-05-2020,144665,1761,505,144160,Americas
Ecuador,26-05-2020,212935,385,695,212240,Americas
Egypt,26-05-2020,293081,1419,471,292610,Eastern Mediterranean
El Salvador,26-05-2020,293800,68,1044,292756,Americas
Equatorial Guinea,26-05-2020,110113,691,500,109613,Africa
Eritrea,26-05-2020,238015,1927,168,237847,Africa
Estonia,26-05-2020,386924,1501,216,386708,Europe
Eswatini,26-05-2020,186180,1189,176,186004,Africa
Ethiopia,26-05-2020,17320,1430,727,16593,Africa
Fiji,26-05-2020,5974,568,214,5760,Western Pacific
Finland,26-05-2020,37408,1124,133,37275,Europe
France,26-05-2020,404188,169,1226,402962,Europe
France,26-05-2020,128217,117,30,128187,Europe
France,26-05-2020,416493,1013,1225,415268,Europe
France,26-05-2020,77283,139,739,76544,Europe
France,26-05-2020,96526,1826,2,96524,Europe
France,26-05-2020,352251,2018,649,351602,Europe
France,26-05-2020,160057,619,1118,158939,Europe
France,26-05-2020,12968,2323,327,12641,Europe
France,26-05-2020,15953,1955,701,15252,Europe
France,26-05-2020,47021,212,198,46823,Europe
Gabon,26-05-2020,260453,1146,538,259915,Africa
Gambia,26-05-2020,358074,573,525,357549,Africa
Georgia,26-05-2020,113987,1115,531,113456,Europe
Germany,26-05-2020,70005,1457,1070,68935,Europe
Ghana,26-05-2020,59857,1070,262,59595,Africa
Greece,26-05-2020,369658,1005,126,369532,Europe
Guatemala,26-05-2020,317655,1708,898,316757,Americas
Guinea,26-05-2020,55590,1141,431,55159,Africa
Guyana,26-05-2020,103724,215,252,103472,Americas
Haiti,26-05-2020,125654,202,907,124747,Americas
Holy See,26-05-2020,319550,2447,1088,318462,Europe
Honduras,26-05-2020,67069,602,665,66404,Americas
Hungary,26-05-2020,295872,1121,74,295798,Europe
Iceland,26-05-2020,77547,1163,6,77541,Europe
India,26-05-2020,406411,2469,637,405774,South-East Asia
Indonesia,26-05-2020,173798,0,1211,172587,South-East Asia
Iran,26-05-2020,433560,1340,366,433194,Eastern Mediterranean
Iraq,26-05-2020,218309,1956,659,217650,Eastern Mediterranean
Ireland,26-05-2020,372960,2491,256,372704,Europe
Israel,26-05-2020,14268,2454,1210,13058,Europe
Italy,26-05-2020,228444,1747,971,227473,Europe
Jamaica,26-05-2020,188522,2202,608,187914,Americas
Japan,26-05-2020,333839,1522,1122,332717,Western Pacific
Jordan,26-05-2020,411213,710,1059,410154,Eastern Mediterranean
Kazakhstan,26-05-2020,95975,284,295,95680,Europe
Kenya,26-05-2020,5943,231,885,5058,Africa
South Korea,26-05-2020,404335,1426,705,403630,Western Pacific
Kuwait,26-05-2020,97863,1639,120,97743,Eastern Mediterranean
Kyrgyzstan,26-05-2020,273110,44,929,272181,Europe
Latvia,26-05-2020,132148,1659,610,131538,Europe
Lebanon,26-05-2020,202097,2281,1235,200862,Eastern Mediterranean
Liberia,26-05-2020,387920,371,588,387332,Africa
Liechtenstein,26-05-2020,86134,1921,657,85477,Europe
Lithuania,26-05-2020,109270,1233,186,109084,Europe
Luxembourg,26-05-2020,232042,789,31,232011,Europe
Madagascar,26-05-2020,319254,2085,33,319221,Africa
Malaysia,26-05-2020,77373,442,59,77314,Western Pacific
Maldives,26-05-2020,304465,719,753,303712,South-East Asia
Malta,26-05-2020,288236,1255,200,288036,Europe
Mauritania,26-05-2020,229657,47,592,229065,Africa
Mauritius,26-05-2020,437750,1019,828,436922,Africa
Mexico,26-05-2020,395119,2343,727,394392,Americas
Moldova,26-05-2020,182813,1136,106,182707,Europe
Monaco,26-05-2020,411221,1130,165,411056,Europe
Mongolia,26-05-2020,225130,1872,1095,224035,Western Pacific
Montenegro,26-05-2020,306202,183,883,305319,Europe
Morocco,26-05-2020,309224,457,1150,308074,Eastern Mediterranean
Namibia,26-05-2020,239543,1263,437,239106,Africa
Nepal,26-05-2020,268527,20,677,267850,South-East Asia
Netherlands,26-05-2020,154321,1922,1219,153102,Europe
Netherlands,26-05-2020,96960,1323,1055,95905,Europe
Netherlands,26-05-2020,375055,2072,493,374562,Europe
Netherlands,26-05-2020,195493,1932,138,195355,Europe
New Zealand,26-05-2020,387583,995,537,387046,Western Pacific
Nicaragua,26-05-2020,255083,430,694,254389,Americas
Niger,26-05-2020,299940,1930,366,299574,Africa
Nigeria,26-05-2020,183282,143,19,183263,Africa
North Macedonia,26-05-2020,77405,1145,64,77341,Europe
Norway,26-05-2020,243216,1931,843,242373,Europe
Oman,26-05-2020,211769,1757,1005,210764,Eastern Mediterranean
Pakistan,26-05-2020,177835,563,758,177077,Eastern Mediterranean
Panama,26-05-2020,274658,965,689,273969,Americas
Papua New Guinea,26-05-2020,441360,989,414,440946,Western Pacific
Paraguay,26-05-2020,232511,1736,717,231794,Americas
Peru,26-05-2020,309741,879,951,308790,Americas
Philippines,26-05-2020,343519,424,986,342533,Western Pacific
Poland,26-05-2020,416754,723,661,416093,Europe
Portugal,26-05-2020,334800,1856,559,334241,Europe
Qatar,26-05-2020,295304,1165,887,294417,Eastern Mediterranean
Romania,26-05-2020,415249,325,729,414520,Europe
Russia,26-05-2020,115119,1164,80,115039,Europe
Rwanda,26-05-2020,256286,1746,152,256134,Africa
Saint Lucia,26-05-2020,223076,2089,141,222935,Americas
Saint Vincent and the Grenadines,26-05-2020,444393,1064,24,444369,Americas
San Marino,26-05-2020,205769,1296,918,204851,Europe
Saudi Arabia,26-05-2020,368443,904,243,368200,Eastern Mediterranean
Senegal,26-05-2020,342387,753,236,342151,Africa
Serbia,26-05-2020,408874,1752,132,408742,Europe
Seychelles,26-05-2020,302267,1942,1002,301265,Africa
Singapore,26-05-2020,440125,1077,578,439547,Western Pacific
Slovakia,26-05-2020,76492,2128,733,75759,Europe
Slovenia,26-05-2020,64875,1363,295,64580,Europe
Somalia,26-05-2020,175761,1327,70,175691,Eastern Mediterranean
South Africa,26-05-2020,328526,1374,1241,327285,Africa
Spain,26-05-2020,3502,986,1091,2411,Europe
Sri Lanka,26-05-2020,154064,1842,968,153096,South-East Asia
Sudan,26-05-2020,115547,1207,323,115224,Eastern Mediterranean
Suriname,26-05-2020,321781,500,992,320789,Americas
Sweden,26-05-2020,193285,2055,407,192878,Europe
Switzerland,26-05-2020,448521,454,519,448002,Europe
Taiwan*,26-05-2020,240600,1357,921,239679,Western Pacific
Tanzania,26-05-2020,548,1426,1086,-538,Africa
Thailand,26-05-2020,270368,2479,261,270107,South-East Asia
Togo,26-05-2020,192539,1891,598,191941,Africa
Trinidad and Tobago,26-05-2020,79014,2380,168,78846,Americas
Tunisia,26-05-2020,264344,1583,1225,263119,Eastern Mediterranean
Turkey,26-05-2020,413865,1888,794,413071,Europe
Uganda,26-05-2020,215079,1577,137,214942,Africa
Ukraine,26-05-2020,429841,198,641,429200,Europe
United Arab Emirates,26-05-2020,355823,2032,276,355547,Eastern Mediterranean
United Kingdom,26-05-2020,190717,33,198,190519,Europe
United Kingdom,26-05-2020,207933,1192,499,207434,Europe
United Kingdom,26-05-2020,336329,1236,59,336270,Europe
United Kingdom,26-05-2020,423690,220,1239,422451,Europe
United Kingdom,26-05-2020,257982,699,210,257772,Europe
United Kingdom,26-05-2020,138114,2247,649,137465,Europe
United Kingdom,26-05-2020,310255,959,437,309818,Europe
Uruguay,26-05-2020,114971,1360,858,114113,Americas
US,26-05-2020,43536,1714,189,43347,Americas
Uzbekistan,26-05-2020,205281,482,301,204980,Europe
Venezuela,26-05-2020,349359,1630,521,348838,Americas
Vietnam,26-05-2020,29065,1025,434,28631,Western Pacific
Zambia,26-05-2020,115558,341,128,115430,Africa
Zimbabwe,26-05-2020,375983,2370,892,375091,Africa
Dominica,26-05-2020,16617,2257,561,16056,Americas
Grenada,26-05-2020,336365,350,871,335494,Americas
Mozambique,26-05-2020,112966,1450,1221,111745,Africa
Syria,26-05-2020,289263,2410,450,288813,Eastern Mediterranean
Timor-Leste,26-05-2020,202591,2019,1176,201415,South-East Asia
Belize,26-05-2020,242514,1553,1031,241483,Americas
Laos,26-05-2020,53278,1785,267,53011,Western Pacific
Libya,26-05-2020,102616,912,146,102470,Eastern Mediterranean
West Bank and Gaza,26-05-2020,226658,839,708,225950,Eastern Mediterranean
Guinea-Bissau,26-05-2020,6635,1519,839,5796,Africa
Mali,26-05-2020,263365,452,1203,262162,Africa
Saint Kitts and Nevis,26-05-2020,38862,193,1012,37850,Americas
Canada,26-05-2020,309179,230,148,309031,Americas
Canada,26-05-2020,215407,1376,793,214614,Americas
Kosovo,26-05-2020,312763,2232,921,311842,Europe
Burma,26-05-2020,298405,236,1052,297353,South-East Asia
United Kingdom,26-05-2020,107083,1353,139,106944,Europe
United Kingdom,26-05-2020,217719,943,678,217041,Europe
United Kingdom,26-05-2020,236505,1974,1155,235350,Europe
Botswana,26-05-2020,356535,1097,130,356405,Africa
Burundi,26-05-2020,342949,385,274,342675,Africa
Sierra Leone,26-05-2020,190455,393,682,189773,Africa
Malawi,26-05-2020,328319,308,967,327352,Africa
United Kingdom,26-05-2020,190207,1102,149,190058,Europe
France,26-05-2020,64341,986,1139,63202,Europe
South Sudan,26-05-2020,97645,646,8,97637,Africa
Western Sahara,26-05-2020,28102,690,471,27631,Africa
Sao Tome and Principe,26-05-2020,45303,1293,668,44635,Africa
Yemen,26-05-2020,7388,1450,625,6763,Eastern Mediterranean
Comoros,26-05-2020,405603,1364,1093,404510,Africa
Tajikistan,26-05-2020,293224,960,687,292537,Europe
Lesotho,26-05-2020,127830,1235,999,126831,Africa
Afghanistan,27-05-2020,215516,2124,1118,214398,Eastern Mediterranean
Albania,27-05-2020,167874,1133,638,167236,Europe
Algeria,27-05-2020,30665,1914,786,29879,Africa
Andorra,27-05-2020,242360,2312,1067,241293,Europe
Angola,27-05-2020,291917,1034,463,291454,Africa
Antigua and Barbuda,27-05-2020,245238,860,400,244838,Americas
Argentina,27-05-2020,26806,2405,1060,25746,Americas
Armenia,27-05-2020,317465,170,1180,316285,Europe
Australia,27-05-2020,246682,566,292,246390,Western Pacific
Australia,27-05-2020,261171,1436,591,260580,Western Pacific
Australia,27-05-2020,168794,1108,1086,167708,Western Pacific
Australia,27-05-2020,360894,1273,714,360180,Western Pacific
Australia,27-05-2020,398514,618,949,397565,Western Pacific
Australia,27-05-2020,413056,125,791,412265,Western Pacific
Australia,27-05-2020,163368,1769,407,162961,Western Pacific
Australia,27-05-2020,331759,1603,1247,330512,Western Pacific
Austria,27-05-2020,177894,428,617,177277,Europe
Azerbaijan,27-05-2020,416066,2419,998,415068,Europe
Bahamas,27-05-2020,323331,668,560,322771,Americas
Bahrain,27-05-2020,373503,1366,1233,372270,Eastern Mediterranean
Bangladesh,27-05-2020,373040,720,525,372515,South-East Asia
Barbados,27-05-2020,76633,81,760,75873,Americas
Belarus,27-05-2020,379658,560,1020,378638,Europe
Belgium,27-05-2020,298326,1552,1108,297218,Europe
Benin,27-05-2020,259843,85,691,259152,Africa
Bhutan,27-05-2020,14791,433,724,14067,South-East Asia
Bolivia,27-05-2020,23033,2347,704,22329,Americas
Bosnia and Herzegovina,27-05-2020,339211,708,310,338901,Europe
Brazil,27-05-2020,111103,2485,330,110773,Americas
Brunei,27-05-2020,233223,1958,589,232634,Western Pacific
Bulgaria,27-05-2020,418544,1155,1189,417355,Europe
Burkina Faso,27-05-2020,11931,1130,706,11225,Africa
Cabo Verde,27-05-2020,94090,1568,484,93606,Africa
Cambodia,27-05-2020,430695,1799,1042,429653,Western Pacific
Cameroon,27-05-2020,402523,2236,808,401715,Africa
Canada,27-05-2020,441441,569,1012,440429,Americas
Canada,27-05-2020,63554,1392,996,62558,Americas
Canada,27-05-2020,253292,481,362,252930,Americas
Canada,27-05-2020,302482,1024,596,301886,Americas
Canada,27-05-2020,159045,1105,11,159034,Americas
Canada,27-05-2020,176188,1252,557,175631,Americas
Canada,27-05-2020,401990,1392,360,401630,Americas
Canada,27-05-2020,346826,669,907,345919,Americas
Canada,27-05-2020,62822,2349,976,61846,Americas
Canada,27-05-2020,66686,1824,291,66395,Americas
Central African Republic,27-05-2020,423502,902,1159,422343,Africa
Chad,27-05-2020,422918,2211,71,422847,Africa
Chile,27-05-2020,166966,1138,194,166772,Americas
China,27-05-2020,139286,1524,1231,138055,Western Pacific
China,27-05-2020,223944,1446,169,223775,Western Pacific
China,27-05-2020,279805,270,106,279699,Western Pacific
China,27-05-2020,357800,2061,1168,356632,Western Pacific
China,27-05-2020,110938,1947,386,110552,Western Pacific
China,27-05-2020,123057,837,169,122888,Western Pacific
China,27-05-2020,367776,2186,507,367269,Western Pacific
China,27-05-2020,159697,757,234,159463,Western Pacific
China,27-05-2020,187350,804,70,187280,Western Pacific
China,27-05-2020,129802,2493,1055,128747,Western Pacific
China,27-05-2020,293023,647,552,292471,Western Pacific
China,27-05-2020,235493,521,1150,234343,Western Pacific
China,27-05-2020,221561,1624,863,220698,Western Pacific
China,27-05-2020,43679,891,791,42888,Western Pacific
China,27-05-2020,98672,1097,158,98514,Western Pacific
China,27-05-2020,199505,1046,70,199435,Western Pacific
China,27-05-2020,425578,1474,1212,424366,Western Pacific
China,27-05-2020,444146,2005,833,443313,Western Pacific
China,27-05-2020,283022,697,1133,281889,Western Pacific
China,27-05-2020,428692,1595,371,428321,Western Pacific
China,27-05-2020,383275,859,39,383236,Western Pacific
China,27-05-2020,378677,2344,42,378635,Western Pacific
China,27-05-2020,178192,17,105,178087,Western Pacific
China,27-05-2020,54972,193,304,54668,Western Pacific
China,27-05-2020,344622,1955,263,344359,Western Pacific
China,27-05-2020,362035,38,448,361587,Western Pacific
China,27-05-2020,128311,1393,159,128152,Western Pacific
China,27-05-2020,335103,2016,907,334196,Western Pacific
China,27-05-2020,97308,969,734,96574,Western Pacific
China,27-05-2020,334184,2097,863,333321,Western Pacific
China,27-05-2020,319336,1753,386,318950,Western Pacific
China,27-05-2020,271856,2425,476,271380,Western Pacific
China,27-05-2020,265912,673,419,265493,Western Pacific
Colombia,27-05-2020,449442,1698,220,449222,Americas
Congo (Brazzaville),27-05-2020,147742,1375,363,147379,Africa
Congo (Kinshasa),27-05-2020,270103,1321,1012,269091,Africa
Costa Rica,27-05-2020,189468,231,934,188534,Americas
Cote d'Ivoire,27-05-2020,182238,1478,487,181751,Africa
Croatia,27-05-2020,120742,1653,733,120009,Europe
Cuba,27-05-2020,94679,637,883,93796,Americas
Cyprus,27-05-2020,219582,853,142,219440,Europe
Czechia,27-05-2020,51559,882,791,50768,Europe
Denmark,27-05-2020,23720,813,1133,22587,Europe
Greenland,27-05-2020,11109,2417,205,10904,Europe
Denmark,27-05-2020,120329,1093,1084,119245,Europe
Djibouti,27-05-2020,77270,1041,393,76877,Eastern Mediterranean
Dominican Republic,27-05-2020,61063,681,207,60856,Americas
Ecuador,27-05-2020,129512,1954,849,128663,Americas
Egypt,27-05-2020,68716,1723,642,68074,Eastern Mediterranean
El Salvador,27-05-2020,264697,1319,316,264381,Americas
Equatorial Guinea,27-05-2020,324887,1203,50,324837,Africa
Eritrea,27-05-2020,149438,399,757,148681,Africa
Estonia,27-05-2020,178965,2402,777,178188,Europe
Eswatini,27-05-2020,148072,1889,1120,146952,Africa
Ethiopia,27-05-2020,267718,1758,813,266905,Africa
Fiji,27-05-2020,443264,814,68,443196,Western Pacific
Finland,27-05-2020,61123,620,228,60895,Europe
France,27-05-2020,445516,1187,105,445411,Europe
France,27-05-2020,371980,333,453,371527,Europe
France,27-05-2020,94047,2268,970,93077,Europe
France,27-05-2020,30965,449,603,30362,Europe
France,27-05-2020,383175,1999,974,382201,Europe
France,27-05-2020,342796,68,386,342410,Europe
France,27-05-2020,340840,89,741,340099,Europe
France,27-05-2020,220545,1110,34,220511,Europe
France,27-05-2020,262651,455,978,261673,Europe
France,27-05-2020,285685,2097,1136,284549,Europe
Gabon,27-05-2020,184564,661,637,183927,Africa
Gambia,27-05-2020,247478,1881,196,247282,Africa
Georgia,27-05-2020,118824,2192,1039,117785,Europe
Germany,27-05-2020,248061,1852,1236,246825,Europe
Ghana,27-05-2020,285959,418,1164,284795,Africa
Greece,27-05-2020,429478,252,85,429393,Europe
Guatemala,27-05-2020,420077,239,12,420065,Americas
Guinea,27-05-2020,96758,508,88,96670,Africa
Guyana,27-05-2020,149733,811,229,149504,Americas
Haiti,27-05-2020,240688,2263,859,239829,Americas
Holy See,27-05-2020,221009,1532,939,220070,Europe
Honduras,27-05-2020,253059,1060,479,252580,Americas
Hungary,27-05-2020,51963,879,1176,50787,Europe
Iceland,27-05-2020,42736,965,1015,41721,Europe
India,27-05-2020,400402,229,170,400232,South-East Asia
Indonesia,27-05-2020,144545,1684,677,143868,South-East Asia
Iran,27-05-2020,439490,2013,793,438697,Eastern Mediterranean
Iraq,27-05-2020,24650,1665,582,24068,Eastern Mediterranean
Ireland,27-05-2020,447881,2100,270,447611,Europe
Israel,27-05-2020,334561,734,1048,333513,Europe
Italy,27-05-2020,230758,145,494,230264,Europe
Jamaica,27-05-2020,260366,1016,665,259701,Americas
Japan,27-05-2020,220764,624,614,220150,Western Pacific
Jordan,27-05-2020,409386,2134,1195,408191,Eastern Mediterranean
Kazakhstan,27-05-2020,253705,1939,141,253564,Europe
Kenya,27-05-2020,29840,2492,810,29030,Africa
South Korea,27-05-2020,385361,733,56,385305,Western Pacific
Kuwait,27-05-2020,381018,136,598,380420,Eastern Mediterranean
Kyrgyzstan,27-05-2020,442380,1579,227,442153,Europe
Latvia,27-05-2020,428746,1245,111,428635,Europe
Lebanon,27-05-2020,400946,1357,758,400188,Eastern Mediterranean
Liberia,27-05-2020,312074,1895,1110,310964,Africa
Liechtenstein,27-05-2020,215871,1287,1186,214685,Europe
Lithuania,27-05-2020,106302,1442,887,105415,Europe
Luxembourg,27-05-2020,299575,97,646,298929,Europe
Madagascar,27-05-2020,409557,386,965,408592,Africa
Malaysia,27-05-2020,87489,1822,1100,86389,Western Pacific
Maldives,27-05-2020,230352,16,38,230314,South-East Asia
Malta,27-05-2020,327959,2007,641,327318,Europe
Mauritania,27-05-2020,289544,2343,811,288733,Africa
Mauritius,27-05-2020,331640,1238,530,331110,Africa
Mexico,27-05-2020,138068,802,903,137165,Americas
Moldova,27-05-2020,342155,1263,636,341519,Europe
Monaco,27-05-2020,13444,176,1088,12356,Europe
Mongolia,27-05-2020,295960,1108,34,295926,Western Pacific
Montenegro,27-05-2020,198410,1247,386,198024,Europe
Morocco,27-05-2020,14450,882,218,14232,Eastern Mediterranean
Namibia,27-05-2020,56355,1933,988,55367,Africa
Nepal,27-05-2020,240851,1531,850,240001,South-East Asia
Netherlands,27-05-2020,138689,1918,14,138675,Europe
Netherlands,27-05-2020,214709,2098,1229,213480,Europe
Netherlands,27-05-2020,263439,1411,156,263283,Europe
Netherlands,27-05-2020,216358,974,953,215405,Europe
New Zealand,27-05-2020,67649,436,88,67561,Western Pacific
Nicaragua,27-05-2020,418344,1971,687,417657,Americas
Niger,27-05-2020,105105,963,712,104393,Africa
Nigeria,27-05-2020,233292,1114,249,233043,Africa
North Macedonia,27-05-2020,41481,2294,808,40673,Europe
Norway,27-05-2020,23246,1717,538,22708,Europe
Oman,27-05-2020,88303,1837,989,87314,Eastern Mediterranean
Pakistan,27-05-2020,118757,2355,535,118222,Eastern Mediterranean
Panama,27-05-2020,167768,424,1227,166541,Americas
Papua New Guinea,27-05-2020,351153,903,786,350367,Western Pacific
Paraguay,27-05-2020,416770,2145,413,416357,Americas
Peru,27-05-2020,143868,1738,460,143408,Americas
Philippines,27-05-2020,438464,510,876,437588,Western Pacific
Poland,27-05-2020,122645,1042,407,122238,Europe
Portugal,27-05-2020,368367,1645,283,368084,Europe
Qatar,27-05-2020,301129,1476,1105,300024,Eastern Mediterranean
Romania,27-05-2020,216773,1900,111,216662,Europe
Russia,27-05-2020,238313,1610,599,237714,Europe
Rwanda,27-05-2020,337872,1159,1209,336663,Africa
Saint Lucia,27-05-2020,425181,2223,950,424231,Americas
Saint Vincent and the Grenadines,27-05-2020,195455,1977,176,195279,Americas
San Marino,27-05-2020,270309,1238,905,269404,Europe
Saudi Arabia,27-05-2020,124618,1676,1007,123611,Eastern Mediterranean
Senegal,27-05-2020,220006,1867,118,219888,Africa
Serbia,27-05-2020,196216,421,529,195687,Europe
Seychelles,27-05-2020,331831,335,705,331126,Africa
Singapore,27-05-2020,362435,1989,798,361637,Western Pacific
Slovakia,27-05-2020,160466,1039,1062,159404,Europe
Slovenia,27-05-2020,443041,1448,171,442870,Europe
Somalia,27-05-2020,427703,1682,456,427247,Eastern Mediterranean
South Africa,27-05-2020,94843,1122,815,94028,Africa
Spain,27-05-2020,412499,1477,215,412284,Europe
Sri Lanka,27-05-2020,315741,1333,775,314966,South-East Asia
Sudan,27-05-2020,29238,35,953,28285,Eastern Mediterranean
Suriname,27-05-2020,143114,1639,280,142834,Americas
Sweden,27-05-2020,199766,31,949,198817,Europe
Switzerland,27-05-2020,264043,1484,627,263416,Europe
Taiwan*,27-05-2020,402204,2066,338,401866,Western Pacific
Tanzania,27-05-2020,256261,675,691,255570,Africa
Thailand,27-05-2020,16078,329,1141,14937,South-East Asia
Togo,27-05-2020,133516,262,617,132899,Africa
Trinidad and Tobago,27-05-2020,351579,1481,854,350725,Americas
Tunisia,27-05-2020,73551,1431,838,72713,Eastern Mediterranean
Turkey,27-05-2020,146639,554,58,146581,Europe
Uganda,27-05-2020,355467,1538,390,355077,Africa
Ukraine,27-05-2020,34239,1441,237,34002,Europe
United Arab Emirates,27-05-2020,268685,1957,1200,267485,Eastern Mediterranean
United Kingdom,27-05-2020,214809,734,973,213836,Europe
United Kingdom,27-05-2020,210938,570,1130,209808,Europe
United Kingdom,27-05-2020,94287,1966,388,93899,Europe
United Kingdom,27-05-2020,17883,1333,524,17359,Europe
United Kingdom,27-05-2020,194411,610,624,193787,Europe
United Kingdom,27-05-2020,286216,2257,168,286048,Europe
United Kingdom,27-05-2020,311595,1599,87,311508,Europe
Uruguay,27-05-2020,234615,1781,870,233745,Americas
US,27-05-2020,344359,1728,844,343515,Americas
Uzbekistan,27-05-2020,342599,2414,570,342029,Europe
Venezuela,27-05-2020,123519,1375,620,122899,Americas
Vietnam,27-05-2020,271707,1517,608,271099,Western Pacific
Zambia,27-05-2020,110385,822,731,109654,Africa
Zimbabwe,27-05-2020,126832,1300,167,126665,Africa
Dominica,27-05-2020,130380,108,263,130117,Americas
Grenada,27-05-2020,375765,1077,173,375592,Americas
Mozambique,27-05-2020,679,82,573,106,Africa
Syria,27-05-2020,30916,839,361,30555,Eastern Mediterranean
Timor-Leste,27-05-2020,168584,552,778,167806,South-East Asia
Belize,27-05-2020,141361,1608,869,140492,Americas
Laos,27-05-2020,194740,1653,1163,193577,Western Pacific
Libya,27-05-2020,339302,700,365,338937,Eastern Mediterranean
West Bank and Gaza,27-05-2020,339264,219,456,338808,Eastern Mediterranean
Guinea-Bissau,27-05-2020,274214,2038,112,274102,Africa
Mali,27-05-2020,98431,2200,497,97934,Africa
Saint Kitts and Nevis,27-05-2020,210056,1831,18,210038,Americas
Canada,27-05-2020,402383,1284,863,401520,Americas
Canada,27-05-2020,439154,258,133,439021,Americas
Kosovo,27-05-2020,38356,2195,14,38342,Europe
Burma,27-05-2020,321955,494,349,321606,South-East Asia
United Kingdom,27-05-2020,248644,2433,579,248065,Europe
United Kingdom,27-05-2020,192653,2099,362,192291,Europe
United Kingdom,27-05-2020,81431,2169,891,80540,Europe
Botswana,27-05-2020,223205,522,14,223191,Africa
Burundi,27-05-2020,269949,1217,1227,268722,Africa
Sierra Leone,27-05-2020,380477,293,652,379825,Africa
Malawi,27-05-2020,154130,1797,879,153251,Africa
United Kingdom,27-05-2020,230414,1021,304,230110,Europe
France,27-05-2020,403276,2493,825,402451,Europe
South Sudan,27-05-2020,109593,516,473,109120,Africa
Western Sahara,27-05-2020,422190,564,1032,421158,Africa
Sao Tome and Principe,27-05-2020,379069,596,169,378900,Africa
Yemen,27-05-2020,132465,884,761,131704,Eastern Mediterranean
Comoros,27-05-2020,183505,772,527,182978,Africa
Tajikistan,27-05-2020,408276,854,1081,407195,Europe
Lesotho,27-05-2020,203390,2427,1141,202249,Africa
Afghanistan,28-05-2020,98900,1079,593,98307,Eastern Mediterranean
Albania,28-05-2020,265217,2448,311,264906,Europe
Algeria,28-05-2020,50012,434,574,49438,Africa
Andorra,28-05-2020,68253,956,206,68047,Europe
Angola,28-05-2020,26158,2406,1002,25156,Africa
Antigua and Barbuda,28-05-2020,286663,1080,14,286649,Americas
Argentina,28-05-2020,419984,297,758,419226,Americas
Armenia,28-05-2020,87628,358,256,87372,Europe
Australia,28-05-2020,380162,2213,691,379471,Western Pacific
Australia,28-05-2020,332203,2464,652,331551,Western Pacific
Australia,28-05-2020,414442,204,734,413708,Western Pacific
Australia,28-05-2020,372323,713,522,371801,Western Pacific
Australia,28-05-2020,299439,1446,1136,298303,Western Pacific
Australia,28-05-2020,402328,395,375,401953,Western Pacific
Australia,28-05-2020,156734,58,760,155974,Western Pacific
Australia,28-05-2020,51070,721,335,50735,Western Pacific
Austria,28-05-2020,449332,1459,130,449202,Europe
Azerbaijan,28-05-2020,424236,1998,19,424217,Europe
Bahamas,28-05-2020,173951,2012,850,173101,Americas
Bahrain,28-05-2020,234319,1048,1181,233138,Eastern Mediterranean
Bangladesh,28-05-2020,129699,130,292,129407,South-East Asia
Barbados,28-05-2020,256578,811,993,255585,Americas
Belarus,28-05-2020,431635,1122,502,431133,Europe
Belgium,28-05-2020,435180,1998,851,434329,Europe
Benin,28-05-2020,416798,2359,572,416226,Africa
Bhutan,28-05-2020,79649,2411,1025,78624,South-East Asia
Bolivia,28-05-2020,44599,1397,634,43965,Americas
Bosnia and Herzegovina,28-05-2020,316025,903,1047,314978,Europe
Brazil,28-05-2020,197086,2399,713,196373,Americas
Brunei,28-05-2020,182167,8,587,181580,Western Pacific
Bulgaria,28-05-2020,434912,0,520,434392,Europe
Burkina Faso,28-05-2020,326209,2311,1051,325158,Africa
Cabo Verde,28-05-2020,62095,1343,294,61801,Africa
Cambodia,28-05-2020,60495,1461,267,60228,Western Pacific
Cameroon,28-05-2020,267364,1726,327,267037,Africa
Canada,28-05-2020,103810,145,1076,102734,Americas
Canada,28-05-2020,328318,1456,1055,327263,Americas
Canada,28-05-2020,39327,2133,637,38690,Americas
Canada,28-05-2020,90031,827,362,89669,Americas
Canada,28-05-2020,169958,793,547,169411,Americas
Canada,28-05-2020,343227,467,1151,342076,Americas
Canada,28-05-2020,439728,1275,620,439108,Americas
Canada,28-05-2020,128637,628,275,128362,Americas
Canada,28-05-2020,22076,439,980,21096,Americas
Canada,28-05-2020,212505,825,987,211518,Americas
Central African Republic,28-05-2020,20586,178,464,20122,Africa
Chad,28-05-2020,149273,1440,1067,148206,Africa
Chile,28-05-2020,322542,714,572,321970,Americas
China,28-05-2020,62181,315,67,62114,Western Pacific
China,28-05-2020,90458,576,1122,89336,Western Pacific
China,28-05-2020,438735,14,321,438414,Western Pacific
China,28-05-2020,276314,1991,850,275464,Western Pacific
China,28-05-2020,204121,1233,30,204091,Western Pacific
China,28-05-2020,130688,343,1001,129687,Western Pacific
China,28-05-2020,317425,1980,205,317220,Western Pacific
China,28-05-2020,121901,552,142,121759,Western Pacific
China,28-05-2020,82598,1855,459,82139,Western Pacific
China,28-05-2020,230549,2099,1134,229415,Western Pacific
China,28-05-2020,143080,804,721,142359,Western Pacific
China,28-05-2020,1667,4,511,1156,Western Pacific
China,28-05-2020,9047,788,134,8913,Western Pacific
China,28-05-2020,175887,1820,908,174979,Western Pacific
China,28-05-2020,266892,2322,793,266099,Western Pacific
China,28-05-2020,256263,578,925,255338,Western Pacific
China,28-05-2020,287181,793,489,286692,Western Pacific
China,28-05-2020,230939,739,994,229945,Western Pacific
China,28-05-2020,224768,374,283,224485,Western Pacific
China,28-05-2020,146948,335,786,146162,Western Pacific
China,28-05-2020,129051,1810,103,128948,Western Pacific
China,28-05-2020,140769,1424,1116,139653,Western Pacific
China,28-05-2020,292271,357,589,291682,Western Pacific
China,28-05-2020,216306,995,918,215388,Western Pacific
China,28-05-2020,271191,897,1219,269972,Western Pacific
China,28-05-2020,233205,1182,467,232738,Western Pacific
China,28-05-2020,362957,496,433,362524,Western Pacific
China,28-05-2020,397816,812,76,397740,Western Pacific
China,28-05-2020,3102,2404,69,3033,Western Pacific
China,28-05-2020,156026,1531,884,155142,Western Pacific
China,28-05-2020,55203,2380,1218,53985,Western Pacific
China,28-05-2020,234533,2005,402,234131,Western Pacific
China,28-05-2020,415824,2388,758,415066,Western Pacific
Colombia,28-05-2020,449520,1322,1040,448480,Americas
Congo (Brazzaville),28-05-2020,229704,881,227,229477,Africa
Congo (Kinshasa),28-05-2020,75744,2337,359,75385,Africa
Costa Rica,28-05-2020,303645,1469,15,303630,Americas
Cote d'Ivoire,28-05-2020,150964,25,131,150833,Africa
Croatia,28-05-2020,401638,16,751,400887,Europe
Cuba,28-05-2020,369215,1567,674,368541,Americas
Cyprus,28-05-2020,12007,740,750,11257,Europe
Czechia,28-05-2020,117376,1806,810,116566,Europe
Denmark,28-05-2020,100546,2380,1250,99296,Europe
Greenland,28-05-2020,96554,199,916,95638,Europe
Denmark,28-05-2020,173118,675,1126,171992,Europe
Djibouti,28-05-2020,80900,632,980,79920,Eastern Mediterranean
Dominican Republic,28-05-2020,12113,616,614,11499,Americas
Ecuador,28-05-2020,312586,809,470,312116,Americas
Egypt,28-05-2020,275415,1169,1040,274375,Eastern Mediterranean
El Salvador,28-05-2020,435477,622,318,435159,Americas
Equatorial Guinea,28-05-2020,64779,12,407,64372,Africa
Eritrea,28-05-2020,124180,207,155,124025,Africa
Estonia,28-05-2020,22270,1513,1184,21086,Europe
Eswatini,28-05-2020,315099,2062,487,314612,Africa
Ethiopia,28-05-2020,429961,449,700,429261,Africa
Fiji,28-05-2020,367850,1304,1246,366604,Western Pacific
Finland,28-05-2020,191429,1520,1022,190407,Europe
France,28-05-2020,143945,1564,569,143376,Europe
France,28-05-2020,246990,1861,577,246413,Europe
France,28-05-2020,119451,1109,308,119143,Europe
France,28-05-2020,28678,590,970,27708,Europe
France,28-05-2020,427414,2264,148,427266,Europe
France,28-05-2020,41690,754,1025,40665,Europe
France,28-05-2020,41785,1132,640,41145,Europe
France,28-05-2020,395163,2128,1101,394062,Europe
France,28-05-2020,46359,160,732,45627,Europe
France,28-05-2020,50852,2131,122,50730,Europe
Gabon,28-05-2020,291991,864,852,291139,Africa
Gambia,28-05-2020,115735,314,781,114954,Africa
Georgia,28-05-2020,270276,196,805,269471,Europe
Germany,28-05-2020,64616,1891,373,64243,Europe
Ghana,28-05-2020,123321,672,1019,122302,Africa
Greece,28-05-2020,58387,793,13,58374,Europe
Guatemala,28-05-2020,290305,2088,1098,289207,Americas
Guinea,28-05-2020,82748,2272,1209,81539,Africa
Guyana,28-05-2020,392083,1847,606,391477,Americas
Haiti,28-05-2020,125554,439,434,125120,Americas
Holy See,28-05-2020,12535,423,2,12533,Europe
Honduras,28-05-2020,341187,1599,95,341092,Americas
Hungary,28-05-2020,30860,1751,281,30579,Europe
Iceland,28-05-2020,3645,1735,1072,2573,Europe
India,28-05-2020,171862,591,171,171691,South-East Asia
Indonesia,28-05-2020,445473,2160,875,444598,South-East Asia
Iran,28-05-2020,314849,1372,806,314043,Eastern Mediterranean
Iraq,28-05-2020,210576,285,249,210327,Eastern Mediterranean
Ireland,28-05-2020,157036,1484,97,156939,Europe
Israel,28-05-2020,133857,707,166,133691,Europe
Italy,28-05-2020,72762,2482,605,72157,Europe
Jamaica,28-05-2020,406791,241,221,406570,Americas
Japan,28-05-2020,206963,1731,704,206259,Western Pacific
Jordan,28-05-2020,354916,367,805,354111,Eastern Mediterranean
Kazakhstan,28-05-2020,148770,968,1141,147629,Europe
Kenya,28-05-2020,196322,1704,895,195427,Africa
South Korea,28-05-2020,73183,2202,343,72840,Western Pacific
Kuwait,28-05-2020,261438,44,215,261223,Eastern Mediterranean
Kyrgyzstan,28-05-2020,165038,2066,119,164919,Europe
Latvia,28-05-2020,404478,146,440,404038,Europe
Lebanon,28-05-2020,268175,702,872,267303,Eastern Mediterranean
Liberia,28-05-2020,88284,2126,561,87723,Africa
Liechtenstein,28-05-2020,32655,928,430,32225,Europe
Lithuania,28-05-2020,271671,2390,1146,270525,Europe
Luxembourg,28-05-2020,715,283,379,336,Europe
Madagascar,28-05-2020,94500,1746,1226,93274,Africa
Malaysia,28-05-2020,292448,1577,553,291895,Western Pacific
Maldives,28-05-2020,157972,1005,206,157766,South-East Asia
Malta,28-05-2020,51402,914,302,51100,Europe
Mauritania,28-05-2020,58931,1435,625,58306,Africa
Mauritius,28-05-2020,414318,652,1117,413201,Africa
Mexico,28-05-2020,392345,651,909,391436,Americas
Moldova,28-05-2020,171452,1499,978,170474,Europe
Monaco,28-05-2020,380024,1614,916,379108,Europe
Mongolia,28-05-2020,390236,653,417,389819,Western Pacific
Montenegro,28-05-2020,380973,141,402,380571,Europe
Morocco,28-05-2020,396772,266,466,396306,Eastern Mediterranean
Namibia,28-05-2020,304576,1872,1199,303377,Africa
Nepal,28-05-2020,152280,614,524,151756,South-East Asia
Netherlands,28-05-2020,70050,9,335,69715,Europe
Netherlands,28-05-2020,326590,537,1021,325569,Europe
Netherlands,28-05-2020,219928,227,734,219194,Europe
Netherlands,28-05-2020,309829,1019,588,309241,Europe
New Zealand,28-05-2020,369590,2068,1037,368553,Western Pacific
Nicaragua,28-05-2020,290527,1203,866,289661,Americas
Niger,28-05-2020,290088,849,265,289823,Africa
Nigeria,28-05-2020,261050,6,116,260934,Africa
North Macedonia,28-05-2020,392126,1151,1001,391125,Europe
Norway,28-05-2020,140760,800,401,140359,Europe
Oman,28-05-2020,267492,1005,440,267052,Eastern Mediterranean
Pakistan,28-05-2020,304203,2115,513,303690,Eastern Mediterranean
Panama,28-05-2020,340055,798,710,339345,Americas
Papua New Guinea,28-05-2020,188239,148,715,187524,Western Pacific
Paraguay,28-05-2020,180040,1245,385,179655,Americas
Peru,28-05-2020,152951,1686,1115,151836,Americas
Philippines,28-05-2020,245173,2384,11,245162,Western Pacific
Poland,28-05-2020,212019,2296,1161,210858,Europe
Portugal,28-05-2020,320827,1808,445,320382,Europe
Qatar,28-05-2020,320949,1797,407,320542,Eastern Mediterranean
Romania,28-05-2020,138632,1897,441,138191,Europe
Russia,28-05-2020,46478,846,337,46141,Europe
Rwanda,28-05-2020,437033,1569,0,437033,Africa
Saint Lucia,28-05-2020,228967,651,927,228040,Americas
Saint Vincent and the Grenadines,28-05-2020,209254,1775,999,208255,Americas
San Marino,28-05-2020,443465,1725,146,443319,Europe
Saudi Arabia,28-05-2020,168238,1162,530,167708,Eastern Mediterranean
Senegal,28-05-2020,265137,1820,836,264301,Africa
Serbia,28-05-2020,285336,561,926,284410,Europe
Seychelles,28-05-2020,204564,692,72,204492,Africa
Singapore,28-05-2020,206842,1512,157,206685,Western Pacific
Slovakia,28-05-2020,146357,2302,612,145745,Europe
Slovenia,28-05-2020,254639,649,1188,253451,Europe
Somalia,28-05-2020,59379,2315,64,59315,Eastern Mediterranean
South Africa,28-05-2020,130722,2029,622,130100,Africa
Spain,28-05-2020,343747,1277,732,343015,Europe
Sri Lanka,28-05-2020,265217,2078,1175,264042,South-East Asia
Sudan,28-05-2020,123938,2215,1202,122736,Eastern Mediterranean
Suriname,28-05-2020,385546,2360,832,384714,Americas
Sweden,28-05-2020,416682,843,990,415692,Europe
Switzerland,28-05-2020,58406,2172,951,57455,Europe
Taiwan*,28-05-2020,351171,1987,870,350301,Western Pacific
Tanzania,28-05-2020,143880,1931,896,142984,Africa
Thailand,28-05-2020,304958,1038,200,304758,South-East Asia
Togo,28-05-2020,77073,2183,895,76178,Africa
Trinidad and Tobago,28-05-2020,109460,1592,836,108624,Americas
Tunisia,28-05-2020,33578,558,539,33039,Eastern Mediterranean
Turkey,28-05-2020,167930,1912,1170,166760,Europe
Uganda,28-05-2020,168561,1313,855,167706,Africa
Ukraine,28-05-2020,62127,1881,561,61566,Europe
United Arab Emirates,28-05-2020,207948,1168,228,207720,Eastern Mediterranean
United Kingdom,28-05-2020,107047,2151,1024,106023,Europe
United Kingdom,28-05-2020,157346,2240,861,156485,Europe
United Kingdom,28-05-2020,101185,684,911,100274,Europe
United Kingdom,28-05-2020,238573,678,825,237748,Europe
United Kingdom,28-05-2020,93569,418,859,92710,Europe
United Kingdom,28-05-2020,216449,1340,697,215752,Europe
United Kingdom,28-05-2020,192895,950,1139,191756,Europe
Uruguay,28-05-2020,118117,976,1067,117050,Americas
US,28-05-2020,17389,1267,911,16478,Americas
Uzbekistan,28-05-2020,336619,499,398,336221,Europe
Venezuela,28-05-2020,115653,817,333,115320,Americas
Vietnam,28-05-2020,376319,870,733,375586,Western Pacific
Zambia,28-05-2020,47494,1561,266,47228,Africa
Zimbabwe,28-05-2020,326175,1159,212,325963,Africa
Dominica,28-05-2020,405944,1642,125,405819,Americas
Grenada,28-05-2020,285074,771,0,285074,Americas
Mozambique,28-05-2020,70834,1215,4,70830,Africa
Syria,28-05-2020,115474,1687,106,115368,Eastern Mediterranean
Timor-Leste,28-05-2020,152948,149,1159,151789,South-East Asia
Belize,28-05-2020,414531,1916,984,413547,Americas
Laos,28-05-2020,251892,2004,828,251064,Western Pacific
Libya,28-05-2020,67967,2001,780,67187,Eastern Mediterranean
West Bank and Gaza,28-05-2020,49157,1976,559,48598,Eastern Mediterranean
Guinea-Bissau,28-05-2020,49208,530,175,49033,Africa
Mali,28-05-2020,280632,1825,763,279869,Africa
Saint Kitts and Nevis,28-05-2020,178221,975,495,177726,Americas
Canada,28-05-2020,229369,85,759,228610,Americas
Canada,28-05-2020,214211,2383,104,214107,Americas
Kosovo,28-05-2020,355548,171,376,355172,Europe
Burma,28-05-2020,75521,217,129,75392,South-East Asia
United Kingdom,28-05-2020,94306,1079,197,94109,Europe
United Kingdom,28-05-2020,178723,2487,1024,177699,Europe
United Kingdom,28-05-2020,65368,2471,122,65246,Europe
Botswana,28-05-2020,360010,131,731,359279,Africa
Burundi,28-05-2020,241875,46,1041,240834,Africa
Sierra Leone,28-05-2020,276923,1022,556,276367,Africa
Malawi,28-05-2020,53163,2354,590,52573,Africa
United Kingdom,28-05-2020,118656,2456,1053,117603,Europe
France,28-05-2020,223347,533,676,222671,Europe
South Sudan,28-05-2020,360501,855,1237,359264,Africa
Western Sahara,28-05-2020,256686,2284,777,255909,Africa
Sao Tome and Principe,28-05-2020,14318,1850,83,14235,Africa
Yemen,28-05-2020,127395,1597,609,126786,Eastern Mediterranean
Comoros,28-05-2020,247906,2097,656,247250,Africa
Tajikistan,28-05-2020,17612,743,787,16825,Europe
Lesotho,28-05-2020,6865,1874,676,6189,Africa
Afghanistan,29-05-2020,419917,249,1097,418820,Eastern Mediterranean
Albania,29-05-2020,189690,786,360,189330,Europe
Algeria,29-05-2020,151545,22,792,150753,Africa
Andorra,29-05-2020,143515,385,62,143453,Europe
Angola,29-05-2020,322519,1929,1010,321509,Africa
Antigua and Barbuda,29-05-2020,385519,2064,1168,384351,Americas
Argentina,29-05-2020,97817,1726,160,97657,Americas
Armenia,29-05-2020,375500,2106,1038,374462,Europe
Australia,29-05-2020,76899,40,944,75955,Western Pacific
Australia,29-05-2020,90611,1528,574,90037,Western Pacific
Australia,29-05-2020,154408,1929,210,154198,Western Pacific
Australia,29-05-2020,35958,29,1170,34788,Western Pacific
Australia,29-05-2020,436616,1753,1045,435571,Western Pacific
Australia,29-05-2020,315222,1180,606,314616,Western Pacific
Australia,29-05-2020,256943,2079,497,256446,Western Pacific
Australia,29-05-2020,155126,2228,195,154931,Western Pacific
Austria,29-05-2020,300498,1816,424,300074,Europe
Azerbaijan,29-05-2020,111073,1780,1119,109954,Europe
Bahamas,29-05-2020,257065,2263,1173,255892,Americas
Bahrain,29-05-2020,415055,2183,982,414073,Eastern Mediterranean
Bangladesh,29-05-2020,303818,1166,1009,302809,South-East Asia
Barbados,29-05-2020,237576,1558,1149,236427,Americas
Belarus,29-05-2020,85388,2433,938,84450,Europe
Belgium,29-05-2020,305719,264,720,304999,Europe
Benin,29-05-2020,254779,2334,92,254687,Africa
Bhutan,29-05-2020,383849,1991,542,383307,South-East Asia
Bolivia,29-05-2020,291400,1960,1154,290246,Americas
Bosnia and Herzegovina,29-05-2020,65486,1591,1009,64477,Europe
Brazil,29-05-2020,140092,710,499,139593,Americas
Brunei,29-05-2020,297533,642,864,296669,Western Pacific
Bulgaria,29-05-2020,112615,269,750,111865,Europe
Burkina Faso,29-05-2020,401907,2234,1100,400807,Africa
Cabo Verde,29-05-2020,370325,1604,477,369848,Africa
Cambodia,29-05-2020,310236,406,551,309685,Western Pacific
Cameroon,29-05-2020,225359,841,1098,224261,Africa
Canada,29-05-2020,301832,835,877,300955,Americas
Canada,29-05-2020,13080,208,220,12860,Americas
Canada,29-05-2020,55939,990,990,54949,Americas
Canada,29-05-2020,136271,892,615,135656,Americas
Canada,29-05-2020,162030,995,363,161667,Americas
Canada,29-05-2020,274730,396,845,273885,Americas
Canada,29-05-2020,395926,1285,933,394993,Americas
Canada,29-05-2020,262893,36,415,262478,Americas
Canada,29-05-2020,274544,1470,630,273914,Americas
Canada,29-05-2020,439604,2427,631,438973,Americas
Central African Republic,29-05-2020,43042,2221,1112,41930,Africa
Chad,29-05-2020,323522,2082,456,323066,Africa
Chile,29-05-2020,230688,382,82,230606,Americas
China,29-05-2020,1897,882,1018,879,Western Pacific
China,29-05-2020,401972,1424,673,401299,Western Pacific
China,29-05-2020,247550,1873,22,247528,Western Pacific
China,29-05-2020,177717,1029,1194,176523,Western Pacific
China,29-05-2020,76365,58,1072,75293,Western Pacific
China,29-05-2020,59526,2344,302,59224,Western Pacific
China,29-05-2020,322592,1946,642,321950,Western Pacific
China,29-05-2020,317921,2201,649,317272,Western Pacific
China,29-05-2020,392375,1169,1141,391234,Western Pacific
China,29-05-2020,344572,2076,784,343788,Western Pacific
China,29-05-2020,317106,238,257,316849,Western Pacific
China,29-05-2020,79295,67,300,78995,Western Pacific
China,29-05-2020,30418,1343,561,29857,Western Pacific
China,29-05-2020,92924,1289,963,91961,Western Pacific
China,29-05-2020,196680,2197,620,196060,Western Pacific
China,29-05-2020,443624,2348,788,442836,Western Pacific
China,29-05-2020,416234,1181,1024,415210,Western Pacific
China,29-05-2020,357389,2268,748,356641,Western Pacific
China,29-05-2020,176611,36,170,176441,Western Pacific
China,29-05-2020,412517,1680,123,412394,Western Pacific
China,29-05-2020,195335,626,890,194445,Western Pacific
China,29-05-2020,439607,1219,96,439511,Western Pacific
China,29-05-2020,398968,133,263,398705,Western Pacific
China,29-05-2020,141119,636,1239,139880,Western Pacific
China,29-05-2020,55291,1337,807,54484,Western Pacific
China,29-05-2020,303912,843,886,303026,Western Pacific
China,29-05-2020,140375,2324,133,140242,Western Pacific
China,29-05-2020,406702,407,683,406019,Western Pacific
China,29-05-2020,303922,1893,1171,302751,Western Pacific
China,29-05-2020,141490,2188,9,141481,Western Pacific
China,29-05-2020,263135,163,631,262504,Western Pacific
China,29-05-2020,20353,2229,208,20145,Western Pacific
China,29-05-2020,97129,2186,340,96789,Western Pacific
Colombia,29-05-2020,27349,1087,900,26449,Americas
Congo (Brazzaville),29-05-2020,317509,2039,881,316628,Africa
Congo (Kinshasa),29-05-2020,317004,2434,298,316706,Africa
Costa Rica,29-05-2020,375523,808,673,374850,Americas
Cote d'Ivoire,29-05-2020,306707,1967,289,306418,Africa
Croatia,29-05-2020,18634,531,509,18125,Europe
Cuba,29-05-2020,197069,813,1081,195988,Americas
Cyprus,29-05-2020,222455,1682,1114,221341,Europe
Czechia,29-05-2020,335231,890,199,335032,Europe
Denmark,29-05-2020,230902,512,642,230260,Europe
Greenland,29-05-2020,94293,2064,1057,93236,Europe
Denmark,29-05-2020,87949,1248,1167,86782,Europe
Djibouti,29-05-2020,248240,246,917,247323,Eastern Mediterranean
Dominican Republic,29-05-2020,317851,1352,571,317280,Americas
Ecuador,29-05-2020,397101,2286,236,396865,Americas
Egypt,29-05-2020,173800,1141,655,173145,Eastern Mediterranean
El Salvador,29-05-2020,424031,2203,1002,423029,Americas
Equatorial Guinea,29-05-2020,193444,2108,339,193105,Africa
Eritrea,29-05-2020,193252,129,837,192415,Africa
Estonia,29-05-2020,119081,1448,666,118415,Europe
Eswatini,29-05-2020,207857,980,653,207204,Africa
Ethiopia,29-05-2020,245357,345,980,244377,Africa
Fiji,29-05-2020,413454,310,1114,412340,Western Pacific
Finland,29-05-2020,397335,1453,374,396961,Europe
France,29-05-2020,43777,757,382,43395,Europe
France,29-05-2020,382891,1841,155,382736,Europe
France,29-05-2020,334357,1372,204,334153,Europe
France,29-05-2020,18642,2091,430,18212,Europe
France,29-05-2020,250223,656,496,249727,Europe
France,29-05-2020,93701,2121,478,93223,Europe
France,29-05-2020,80094,1478,1151,78943,Europe
France,29-05-2020,75691,2174,1156,74535,Europe
France,29-05-2020,259175,2103,237,258938,Europe
France,29-05-2020,59200,879,1048,58152,Europe
Gabon,29-05-2020,341302,597,679,340623,Africa
Gambia,29-05-2020,368971,944,190,368781,Africa
Georgia,29-05-2020,370788,1490,705,370083,Europe
Germany,29-05-2020,98611,1214,1131,97480,Europe
Ghana,29-05-2020,390268,507,84,390184,Africa
Greece,29-05-2020,94232,1724,995,93237,Europe
Guatemala,29-05-2020,299570,1721,1078,298492,Americas
Guinea,29-05-2020,293679,800,1059,292620,Africa
Guyana,29-05-2020,217478,1576,301,217177,Americas
Haiti,29-05-2020,363458,1905,81,363377,Americas
Holy See,29-05-2020,126604,151,402,126202,Europe
Honduras,29-05-2020,405753,754,625,405128,Americas
Hungary,29-05-2020,297952,685,1164,296788,Europe
Iceland,29-05-2020,47087,1237,968,46119,Europe
India,29-05-2020,281586,2465,257,281329,South-East Asia
Indonesia,29-05-2020,344005,2368,524,343481,South-East Asia
Iran,29-05-2020,276176,1318,773,275403,Eastern Mediterranean
Iraq,29-05-2020,295274,1029,966,294308,Eastern Mediterranean
Ireland,29-05-2020,261643,1583,944,260699,Europe
Israel,29-05-2020,397031,2249,534,396497,Europe
Italy,29-05-2020,207342,1520,313,207029,Europe
Jamaica,29-05-2020,365599,2107,1156,364443,Americas
Japan,29-05-2020,113602,1840,852,112750,Western Pacific
Jordan,29-05-2020,286000,2290,1216,284784,Eastern Mediterranean
Kazakhstan,29-05-2020,263872,356,196,263676,Europe
Kenya,29-05-2020,366836,1675,412,366424,Africa
South Korea,29-05-2020,179490,116,404,179086,Western Pacific
Kuwait,29-05-2020,3017,2260,1221,1796,Eastern Mediterranean
Kyrgyzstan,29-05-2020,426043,451,919,425124,Europe
Latvia,29-05-2020,328872,1796,492,328380,Europe
Lebanon,29-05-2020,149687,174,709,148978,Eastern Mediterranean
Liberia,29-05-2020,157375,1622,1214,156161,Africa
Liechtenstein,29-05-2020,137490,1963,467,137023,Europe
Lithuania,29-05-2020,162713,881,794,161919,Europe
Luxembourg,29-05-2020,313933,1233,252,313681,Europe
Madagascar,29-05-2020,392034,1312,325,391709,Africa
Malaysia,29-05-2020,230305,362,218,230087,Western Pacific
Maldives,29-05-2020,103027,1406,326,102701,South-East Asia
Malta,29-05-2020,268642,2323,145,268497,Europe
Mauritania,29-05-2020,429411,1030,347,429064,Africa
Mauritius,29-05-2020,178882,2258,646,178236,Africa
Mexico,29-05-2020,167653,1952,466,167187,Americas
Moldova,29-05-2020,154956,1673,163,154793,Europe
Monaco,29-05-2020,71631,1850,1124,70507,Europe
Mongolia,29-05-2020,185812,1249,565,185247,Western Pacific
Montenegro,29-05-2020,176358,2324,362,175996,Europe
Morocco,29-05-2020,203762,2119,669,203093,Eastern Mediterranean
Namibia,29-05-2020,228664,293,1193,227471,Africa
Nepal,29-05-2020,288602,2129,887,287715,South-East Asia
Netherlands,29-05-2020,255599,318,445,255154,Europe
Netherlands,29-05-2020,410099,2409,66,410033,Europe
Netherlands,29-05-2020,46667,1776,150,46517,Europe
Netherlands,29-05-2020,425758,2368,1202,424556,Europe
New Zealand,29-05-2020,102737,730,612,102125,Western Pacific
Nicaragua,29-05-2020,344180,920,658,343522,Americas
Niger,29-05-2020,185430,1811,1070,184360,Africa
Nigeria,29-05-2020,144981,2138,100,144881,Africa
North Macedonia,29-05-2020,321479,19,1111,320368,Europe
Norway,29-05-2020,423708,800,521,423187,Europe
Oman,29-05-2020,251416,1289,1010,250406,Eastern Mediterranean
Pakistan,29-05-2020,328724,1616,1036,327688,Eastern Mediterranean
Panama,29-05-2020,367300,285,1018,366282,Americas
Papua New Guinea,29-05-2020,187326,1289,237,187089,Western Pacific
Paraguay,29-05-2020,418896,598,1086,417810,Americas
Peru,29-05-2020,317803,11,185,317618,Americas
Philippines,29-05-2020,305684,223,821,304863,Western Pacific
Poland,29-05-2020,71695,1562,1081,70614,Europe
Portugal,29-05-2020,288391,2285,487,287904,Europe
Qatar,29-05-2020,133000,470,794,132206,Eastern Mediterranean
Romania,29-05-2020,89959,68,910,89049,Europe
Russia,29-05-2020,411010,1987,589,410421,Europe
Rwanda,29-05-2020,209926,2458,160,209766,Africa
Saint Lucia,29-05-2020,219895,1671,1113,218782,Americas
Saint Vincent and the Grenadines,29-05-2020,321846,1925,92,321754,Americas
San Marino,29-05-2020,375816,751,321,375495,Europe
Saudi Arabia,29-05-2020,448837,1367,556,448281,Eastern Mediterranean
Senegal,29-05-2020,6711,559,573,6138,Africa
Serbia,29-05-2020,122448,1467,996,121452,Europe
Seychelles,29-05-2020,118215,1068,285,117930,Africa
Singapore,29-05-2020,157405,1306,118,157287,Western Pacific
Slovakia,29-05-2020,78356,1512,480,77876,Europe
Slovenia,29-05-2020,389555,956,1052,388503,Europe
Somalia,29-05-2020,333402,570,993,332409,Eastern Mediterranean
South Africa,29-05-2020,419919,1981,104,419815,Africa
Spain,29-05-2020,355537,1798,699,354838,Europe
Sri Lanka,29-05-2020,432927,1367,855,432072,South-East Asia
Sudan,29-05-2020,238064,633,305,237759,Eastern Mediterranean
Suriname,29-05-2020,152408,2167,1134,151274,Americas
Sweden,29-05-2020,49118,1849,365,48753,Europe
Switzerland,29-05-2020,278841,610,123,278718,Europe
Taiwan*,29-05-2020,196332,550,525,195807,Western Pacific
Tanzania,29-05-2020,181719,571,719,181000,Africa
Thailand,29-05-2020,245487,1370,125,245362,South-East Asia
Togo,29-05-2020,14634,718,550,14084,Africa
Trinidad and Tobago,29-05-2020,449402,374,434,448968,Americas
Tunisia,29-05-2020,77411,46,811,76600,Eastern Mediterranean
Turkey,29-05-2020,13259,911,99,13160,Europe
Uganda,29-05-2020,103877,643,753,103124,Africa
Ukraine,29-05-2020,206984,1425,536,206448,Europe
United Arab Emirates,29-05-2020,105260,931,900,104360,Eastern Mediterranean
United Kingdom,29-05-2020,434748,403,613,434135,Europe
United Kingdom,29-05-2020,212251,194,1185,211066,Europe
United Kingdom,29-05-2020,102288,1517,651,101637,Europe
United Kingdom,29-05-2020,121305,36,227,121078,Europe
United Kingdom,29-05-2020,184215,580,349,183866,Europe
United Kingdom,29-05-2020,178772,2244,507,178265,Europe
United Kingdom,29-05-2020,306789,1681,396,306393,Europe
Uruguay,29-05-2020,288716,732,485,288231,Americas
US,29-05-2020,406259,2233,304,405955,Americas
Uzbekistan,29-05-2020,90155,305,442,89713,Europe
Venezuela,29-05-2020,423675,949,561,423114,Americas
Vietnam,29-05-2020,54540,594,393,54147,Western Pacific
Zambia,29-05-2020,390018,671,883,389135,Africa
Zimbabwe,29-05-2020,236150,2232,174,235976,Africa
Dominica,29-05-2020,226270,1493,565,225705,Americas
Grenada,29-05-2020,160219,587,355,159864,Americas
Mozambique,29-05-2020,297945,461,258,297687,Africa
Syria,29-05-2020,271077,1700,724,270353,Eastern Mediterranean
Timor-Leste,29-05-2020,313044,1244,291,312753,South-East Asia
Belize,29-05-2020,2261,2438,1183,1078,Americas
Laos,29-05-2020,378459,1474,746,377713,Western Pacific
Libya,29-05-2020,106280,1295,53,106227,Eastern Mediterranean
West Bank and Gaza,29-05-2020,37879,418,983,36896,Eastern Mediterranean
Guinea-Bissau,29-05-2020,353781,1651,429,353352,Africa
Mali,29-05-2020,438923,532,1138,437785,Africa
Saint Kitts and Nevis,29-05-2020,213001,177,1067,211934,Americas
Canada,29-05-2020,24752,464,240,24512,Americas
Canada,29-05-2020,89684,1932,1003,88681,Americas
Kosovo,29-05-2020,134711,284,547,134164,Europe
Burma,29-05-2020,162922,1065,1088,161834,South-East Asia
United Kingdom,29-05-2020,350717,536,489,350228,Europe
United Kingdom,29-05-2020,161858,2283,464,161394,Europe
United Kingdom,29-05-2020,118272,1137,1034,117238,Europe
Botswana,29-05-2020,117965,2161,177,117788,Africa
Burundi,29-05-2020,50290,2080,12,50278,Africa
Sierra Leone,29-05-2020,387849,133,378,387471,Africa
Malawi,29-05-2020,140995,1376,844,140151,Africa
United Kingdom,29-05-2020,62963,1922,603,62360,Europe
France,29-05-2020,71717,216,979,70738,Europe
South Sudan,29-05-2020,83592,1892,1070,82522,Africa
Western Sahara,29-05-2020,310190,376,649,309541,Africa
Sao Tome and Principe,29-05-2020,388544,1955,609,387935,Africa
Yemen,29-05-2020,380864,885,1247,379617,Eastern Mediterranean
Comoros,29-05-2020,336991,18,313,336678,Africa
Tajikistan,29-05-2020,218107,1805,305,217802,Europe
Lesotho,29-05-2020,444054,184,290,443764,Africa
Afghanistan,30-05-2020,160010,86,667,159343,Eastern Mediterranean
Albania,30-05-2020,173522,1575,381,173141,Europe
Algeria,30-05-2020,238599,438,369,238230,Africa
Andorra,30-05-2020,221366,555,340,221026,Europe
Angola,30-05-2020,82229,1877,685,81544,Africa
Antigua and Barbuda,30-05-2020,301376,886,226,301150,Americas
Argentina,30-05-2020,266379,2172,333,266046,Americas
Armenia,30-05-2020,358492,1624,752,357740,Europe
Australia,30-05-2020,376390,2461,92,376298,Western Pacific
Australia,30-05-2020,298362,118,530,297832,Western Pacific
Australia,30-05-2020,270156,1832,1096,269060,Western Pacific
Australia,30-05-2020,229904,614,220,229684,Western Pacific
Australia,30-05-2020,306043,978,739,305304,Western Pacific
Australia,30-05-2020,84905,1808,1045,83860,Western Pacific
Australia,30-05-2020,252556,455,276,252280,Western Pacific
Australia,30-05-2020,162184,1533,526,161658,Western Pacific
Austria,30-05-2020,402259,798,229,402030,Europe
Azerbaijan,30-05-2020,194993,73,1178,193815,Europe
Bahamas,30-05-2020,188213,1178,819,187394,Americas
Bahrain,30-05-2020,230110,1518,990,229120,Eastern Mediterranean
Bangladesh,30-05-2020,317988,783,1067,316921,South-East Asia
Barbados,30-05-2020,342730,2105,276,342454,Americas
Belarus,30-05-2020,404101,2449,534,403567,Europe
Belgium,30-05-2020,178730,551,201,178529,Europe
Benin,30-05-2020,285629,2222,1099,284530,Africa
Bhutan,30-05-2020,293670,1683,274,293396,South-East Asia
Bolivia,30-05-2020,249369,1631,213,249156,Americas
Bosnia and Herzegovina,30-05-2020,412233,694,464,411769,Europe
Brazil,30-05-2020,266191,1817,25,266166,Americas
Brunei,30-05-2020,186146,2253,664,185482,Western Pacific
Bulgaria,30-05-2020,392914,861,958,391956,Europe
Burkina Faso,30-05-2020,284403,2437,1006,283397,Africa
Cabo Verde,30-05-2020,193368,2126,897,192471,Africa
Cambodia,30-05-2020,179211,446,1100,178111,Western Pacific
Cameroon,30-05-2020,240399,1030,649,239750,Africa
Canada,30-05-2020,211354,2143,1051,210303,Americas
Canada,30-05-2020,195763,2102,579,195184,Americas
Canada,30-05-2020,194368,1378,843,193525,Americas
Canada,30-05-2020,143358,1758,605,142753,Americas
Canada,30-05-2020,85603,402,1044,84559,Americas
Canada,30-05-2020,201205,716,702,200503,Americas
Canada,30-05-2020,17124,576,100,17024,Americas
Canada,30-05-2020,1474,2315,801,673,Americas
Canada,30-05-2020,8393,1629,64,8329,Americas
Canada,30-05-2020,21321,1913,532,20789,Americas
Central African Republic,30-05-2020,312559,1189,77,312482,Africa
Chad,30-05-2020,360112,1371,1045,359067,Africa
Chile,30-05-2020,59686,453,937,58749,Americas
China,30-05-2020,413223,2339,1160,412063,Western Pacific
China,30-05-2020,417872,2018,605,417267,Western Pacific
China,30-05-2020,56555,1523,16,56539,Western Pacific
China,30-05-2020,71020,29,1204,69816,Western Pacific
China,30-05-2020,360507,2284,470,360037,Western Pacific
China,30-05-2020,374640,847,814,373826,Western Pacific
China,30-05-2020,435602,1835,707,434895,Western Pacific
China,30-05-2020,155510,1917,514,154996,Western Pacific
China,30-05-2020,263125,817,61,263064,Western Pacific
China,30-05-2020,357934,749,872,357062,Western Pacific
China,30-05-2020,160483,1184,1186,159297,Western Pacific
China,30-05-2020,28767,630,1087,27680,Western Pacific
China,30-05-2020,251700,532,1081,250619,Western Pacific
China,30-05-2020,445955,1106,165,445790,Western Pacific
China,30-05-2020,20141,1994,926,19215,Western Pacific
China,30-05-2020,381332,1337,1012,380320,Western Pacific
China,30-05-2020,63837,541,534,63303,Western Pacific
China,30-05-2020,81083,1164,307,80776,Western Pacific
China,30-05-2020,373957,92,1211,372746,Western Pacific
China,30-05-2020,21100,1814,1020,20080,Western Pacific
China,30-05-2020,55071,1197,60,55011,Western Pacific
China,30-05-2020,260519,1742,283,260236,Western Pacific
China,30-05-2020,431048,1824,391,430657,Western Pacific
China,30-05-2020,56978,104,120,56858,Western Pacific
China,30-05-2020,132455,2228,1147,131308,Western Pacific
China,30-05-2020,248706,1591,553,248153,Western Pacific
China,30-05-2020,298277,1467,753,297524,Western Pacific
China,30-05-2020,329778,555,734,329044,Western Pacific
China,30-05-2020,251033,666,996,250037,Western Pacific
China,30-05-2020,191984,98,671,191313,Western Pacific
China,30-05-2020,27999,1222,330,27669,Western Pacific
China,30-05-2020,337559,2181,494,337065,Western Pacific
China,30-05-2020,182235,8,252,181983,Western Pacific
Colombia,30-05-2020,418224,439,315,417909,Americas
Congo (Brazzaville),30-05-2020,259661,1785,462,259199,Africa
Congo (Kinshasa),30-05-2020,245990,1449,229,245761,Africa
Costa Rica,30-05-2020,226382,606,1003,225379,Americas
Cote d'Ivoire,30-05-2020,335670,318,165,335505,Africa
Croatia,30-05-2020,274841,1406,169,274672,Europe
Cuba,30-05-2020,92283,897,306,91977,Americas
Cyprus,30-05-2020,293783,1045,830,292953,Europe
Czechia,30-05-2020,40996,887,372,40624,Europe
Denmark,30-05-2020,74083,1265,721,73362,Europe
Greenland,30-05-2020,93162,859,821,92341,Europe
Denmark,30-05-2020,447369,1324,440,446929,Europe
Djibouti,30-05-2020,329500,910,724,328776,Eastern Mediterranean
Dominican Republic,30-05-2020,223204,1561,948,222256,Americas
Ecuador,30-05-2020,183286,1098,608,182678,Americas
Egypt,30-05-2020,55773,591,1139,54634,Eastern Mediterranean
El Salvador,30-05-2020,193367,1470,175,193192,Americas
Equatorial Guinea,30-05-2020,302002,824,834,301168,Africa
Eritrea,30-05-2020,66616,7,62,66554,Africa
Estonia,30-05-2020,133528,2295,1116,132412,Europe
Eswatini,30-05-2020,132019,1798,4,132015,Africa
Ethiopia,30-05-2020,13167,1666,910,12257,Africa
Fiji,30-05-2020,345689,1284,737,344952,Western Pacific
Finland,30-05-2020,111794,1406,298,111496,Europe
France,30-05-2020,48574,300,1025,47549,Europe
France,30-05-2020,19069,652,787,18282,Europe
France,30-05-2020,417319,1378,673,416646,Europe
France,30-05-2020,139923,2251,475,139448,Europe
France,30-05-2020,352164,944,313,351851,Europe
France,30-05-2020,252865,262,1061,251804,Europe
France,30-05-2020,326663,2449,186,326477,Europe
France,30-05-2020,350822,244,779,350043,Europe
France,30-05-2020,294308,749,455,293853,Europe
France,30-05-2020,334741,9,644,334097,Europe
Gabon,30-05-2020,324417,653,638,323779,Africa
Gambia,30-05-2020,285413,634,998,284415,Africa
Georgia,30-05-2020,425432,1238,472,424960,Europe
Germany,30-05-2020,447769,2167,16,447753,Europe
Ghana,30-05-2020,298420,678,283,298137,Africa
Greece,30-05-2020,213214,190,248,212966,Europe
Guatemala,30-05-2020,29665,755,183,29482,Americas
Guinea,30-05-2020,115224,2136,1082,114142,Africa
Guyana,30-05-2020,193111,575,181,192930,Americas
Haiti,30-05-2020,297139,453,96,297043,Americas
Holy See,30-05-2020,50702,331,58,50644,Europe
Honduras,30-05-2020,178934,1136,483,178451,Americas
Hungary,30-05-2020,304417,1579,563,303854,Europe
Iceland,30-05-2020,226189,2396,439,225750,Europe
India,30-05-2020,218839,166,1096,217743,South-East Asia
Indonesia,30-05-2020,257718,497,978,256740,South-East Asia
Iran,30-05-2020,366457,938,447,366010,Eastern Mediterranean
Iraq,30-05-2020,211238,2443,528,210710,Eastern Mediterranean
Ireland,30-05-2020,122711,496,282,122429,Europe
Israel,30-05-2020,384272,429,346,383926,Europe
Italy,30-05-2020,136626,807,883,135743,Europe
Jamaica,30-05-2020,190616,1717,117,190499,Americas
Japan,30-05-2020,444007,505,781,443226,Western Pacific
Jordan,30-05-2020,214941,1310,403,214538,Eastern Mediterranean
Kazakhstan,30-05-2020,237991,1446,145,237846,Europe
Kenya,30-05-2020,343947,1741,1079,342868,Africa
South Korea,30-05-2020,438970,1074,285,438685,Western Pacific
Kuwait,30-05-2020,169613,235,785,168828,Eastern Mediterranean
Kyrgyzstan,30-05-2020,312964,1691,391,312573,Europe
Latvia,30-05-2020,374872,659,97,374775,Europe
Lebanon,30-05-2020,147158,242,60,147098,Eastern Mediterranean
Liberia,30-05-2020,410350,58,864,409486,Africa
Liechtenstein,30-05-2020,410344,1699,623,409721,Europe
Lithuania,30-05-2020,367560,944,649,366911,Europe
Luxembourg,30-05-2020,336260,1989,652,335608,Europe
Madagascar,30-05-2020,183828,376,614,183214,Africa
Malaysia,30-05-2020,122674,855,1142,121532,Western Pacific
Maldives,30-05-2020,147569,1122,171,147398,South-East Asia
Malta,30-05-2020,146901,1987,240,146661,Europe
Mauritania,30-05-2020,8750,971,339,8411,Africa
Mauritius,30-05-2020,444190,565,151,444039,Africa
Mexico,30-05-2020,434585,2138,1078,433507,Americas
Moldova,30-05-2020,439043,998,33,439010,Europe
Monaco,30-05-2020,391966,1256,1154,390812,Europe
Mongolia,30-05-2020,23393,750,418,22975,Western Pacific
Montenegro,30-05-2020,163120,1352,830,162290,Europe
Morocco,30-05-2020,229610,126,113,229497,Eastern Mediterranean
Namibia,30-05-2020,16979,1295,58,16921,Africa
Nepal,30-05-2020,168344,1426,642,167702,South-East Asia
Netherlands,30-05-2020,273624,519,383,273241,Europe
Netherlands,30-05-2020,224485,961,1146,223339,Europe
Netherlands,30-05-2020,297632,1351,875,296757,Europe
Netherlands,30-05-2020,233384,582,109,233275,Europe
New Zealand,30-05-2020,296366,2128,697,295669,Western Pacific
Nicaragua,30-05-2020,38986,2343,877,38109,Americas
Niger,30-05-2020,52119,1048,1170,50949,Africa
Nigeria,30-05-2020,229094,2274,669,228425,Africa
North Macedonia,30-05-2020,29153,2201,177,28976,Europe
Norway,30-05-2020,160368,1369,1073,159295,Europe
Oman,30-05-2020,42030,1948,364,41666,Eastern Mediterranean
Pakistan,30-05-2020,259404,1995,962,258442,Eastern Mediterranean
Panama,30-05-2020,323912,452,304,323608,Americas
Papua New Guinea,30-05-2020,388005,969,1192,386813,Western Pacific
Paraguay,30-05-2020,93365,512,284,93081,Americas
Peru,30-05-2020,169680,2160,1119,168561,Americas
Philippines,30-05-2020,14778,1688,873,13905,Western Pacific
Poland,30-05-2020,194848,333,1148,193700,Europe
Portugal,30-05-2020,187237,1842,482,186755,Europe
Qatar,30-05-2020,407864,1584,982,406882,Eastern Mediterranean
Romania,30-05-2020,426255,1632,532,425723,Europe
Russia,30-05-2020,106822,237,395,106427,Europe
Rwanda,30-05-2020,54961,1551,612,54349,Africa
Saint Lucia,30-05-2020,340053,1432,108,339945,Americas
Saint Vincent and the Grenadines,30-05-2020,21032,400,1023,20009,Americas
San Marino,30-05-2020,373157,807,28,373129,Europe
Saudi Arabia,30-05-2020,399023,781,245,398778,Eastern Mediterranean
Senegal,30-05-2020,340742,1361,941,339801,Africa
Serbia,30-05-2020,344663,2424,6,344657,Europe
Seychelles,30-05-2020,108211,1867,111,108100,Africa
Singapore,30-05-2020,406092,1764,432,405660,Western Pacific
Slovakia,30-05-2020,294408,1619,308,294100,Europe
Slovenia,30-05-2020,111768,1016,912,110856,Europe
Somalia,30-05-2020,50432,1274,145,50287,Eastern Mediterranean
South Africa,30-05-2020,376739,888,1002,375737,Africa
Spain,30-05-2020,53939,1300,664,53275,Europe
Sri Lanka,30-05-2020,24716,281,422,24294,South-East Asia
Sudan,30-05-2020,181719,1252,409,181310,Eastern Mediterranean
Suriname,30-05-2020,314227,1895,310,313917,Americas
Sweden,30-05-2020,10680,431,233,10447,Europe
Switzerland,30-05-2020,127861,1613,104,127757,Europe
Taiwan*,30-05-2020,232178,1598,679,231499,Western Pacific
Tanzania,30-05-2020,440279,1355,1068,439211,Africa
Thailand,30-05-2020,392247,1108,990,391257,South-East Asia
Togo,30-05-2020,56468,1380,1011,55457,Africa
Trinidad and Tobago,30-05-2020,175820,1182,419,175401,Americas
Tunisia,30-05-2020,238402,1346,1176,237226,Eastern Mediterranean
Turkey,30-05-2020,236948,490,735,236213,Europe
Uganda,30-05-2020,447361,2179,306,447055,Africa
Ukraine,30-05-2020,323814,2353,980,322834,Europe
United Arab Emirates,30-05-2020,180726,738,146,180580,Eastern Mediterranean
United Kingdom,30-05-2020,433875,2103,1165,432710,Europe
United Kingdom,30-05-2020,211690,251,800,210890,Europe
United Kingdom,30-05-2020,403330,2198,510,402820,Europe
United Kingdom,30-05-2020,261719,1572,809,260910,Europe
United Kingdom,30-05-2020,330607,2241,172,330435,Europe
United Kingdom,30-05-2020,63462,473,1082,62380,Europe
United Kingdom,30-05-2020,275331,260,1166,274165,Europe
Uruguay,30-05-2020,104062,455,1179,102883,Americas
US,30-05-2020,337679,734,561,337118,Americas
Uzbekistan,30-05-2020,11225,1632,664,10561,Europe
Venezuela,30-05-2020,125738,908,260,125478,Americas
Vietnam,30-05-2020,257608,2111,933,256675,Western Pacific
Zambia,30-05-2020,332263,877,45,332218,Africa
Zimbabwe,30-05-2020,42090,420,1136,40954,Africa
Dominica,30-05-2020,298475,357,331,298144,Americas
Grenada,30-05-2020,72211,1797,987,71224,Americas
Mozambique,30-05-2020,326976,599,929,326047,Africa
Syria,30-05-2020,216645,1537,522,216123,Eastern Mediterranean
Timor-Leste,30-05-2020,10492,328,796,9696,South-East Asia
Belize,30-05-2020,227578,795,876,226702,Americas
Laos,30-05-2020,338398,1670,113,338285,Western Pacific
Libya,30-05-2020,120274,576,44,120230,Eastern Mediterranean
West Bank and Gaza,30-05-2020,50876,2482,191,50685,Eastern Mediterranean
Guinea-Bissau,30-05-2020,392891,473,578,392313,Africa
Mali,30-05-2020,235918,1351,229,235689,Africa
Saint Kitts and Nevis,30-05-2020,296843,885,1104,295739,Americas
Canada,30-05-2020,417716,1729,921,416795,Americas
Canada,30-05-2020,237093,159,507,236586,Americas
Kosovo,30-05-2020,409562,2078,508,409054,Europe
Burma,30-05-2020,349313,757,49,349264,South-East Asia
United Kingdom,30-05-2020,345794,1186,382,345412,Europe
United Kingdom,30-05-2020,23340,171,324,23016,Europe
United Kingdom,30-05-2020,300492,594,977,299515,Europe
Botswana,30-05-2020,43013,1695,925,42088,Africa
Burundi,30-05-2020,360598,1980,144,360454,Africa
Sierra Leone,30-05-2020,190983,1908,869,190114,Africa
Malawi,30-05-2020,185073,468,429,184644,Africa
United Kingdom,30-05-2020,351585,656,1211,350374,Europe
France,30-05-2020,34915,1093,170,34745,Europe
South Sudan,30-05-2020,432169,1605,386,431783,Africa
Western Sahara,30-05-2020,376423,836,238,376185,Africa
Sao Tome and Principe,30-05-2020,63201,2427,207,62994,Africa
Yemen,30-05-2020,238891,404,514,238377,Eastern Mediterranean
Comoros,30-05-2020,70529,917,846,69683,Africa
Tajikistan,30-05-2020,148852,1484,34,148818,Europe
Lesotho,30-05-2020,166258,1924,529,165729,Africa
Afghanistan,31-05-2020,330579,730,761,329818,Eastern Mediterranean
Albania,31-05-2020,425400,817,1176,424224,Europe
Algeria,31-05-2020,11031,1310,744,10287,Africa
Andorra,31-05-2020,203531,987,295,203236,Europe
Angola,31-05-2020,42811,289,903,41908,Africa
Antigua and Barbuda,31-05-2020,97629,1618,764,96865,Americas
Argentina,31-05-2020,278505,772,815,277690,Americas
Armenia,31-05-2020,320980,366,410,320570,Europe
Australia,31-05-2020,86919,2142,527,86392,Western Pacific
Australia,31-05-2020,258377,1243,70,258307,Western Pacific
Australia,31-05-2020,215422,496,1059,214363,Western Pacific
Australia,31-05-2020,304307,1917,1036,303271,Western Pacific
Australia,31-05-2020,184083,2351,607,183476,Western Pacific
Australia,31-05-2020,431854,1993,1151,430703,Western Pacific
Australia,31-05-2020,188698,1159,854,187844,Western Pacific
Australia,31-05-2020,87300,315,259,87041,Western Pacific
Austria,31-05-2020,393072,1459,952,392120,Europe
Azerbaijan,31-05-2020,414438,1695,564,413874,Europe
Bahamas,31-05-2020,171917,194,18,171899,Americas
Bahrain,31-05-2020,445863,823,56,445807,Eastern Mediterranean
Bangladesh,31-05-2020,400741,625,837,399904,South-East Asia
Barbados,31-05-2020,375333,2409,262,375071,Americas
Belarus,31-05-2020,153846,1471,602,153244,Europe
Belgium,31-05-2020,361618,810,862,360756,Europe
Benin,31-05-2020,175779,1615,1172,174607,Africa
Bhutan,31-05-2020,24394,469,793,23601,South-East Asia
Bolivia,31-05-2020,281554,286,517,281037,Americas
Bosnia and Herzegovina,31-05-2020,250592,824,114,250478,Europe
Brazil,31-05-2020,1638,2376,186,1452,Americas
Brunei,31-05-2020,418022,251,557,417465,Western Pacific
Bulgaria,31-05-2020,169798,2169,220,169578,Europe
Burkina Faso,31-05-2020,127469,18,938,126531,Africa
Cabo Verde,31-05-2020,177305,477,6,177299,Africa
Cambodia,31-05-2020,62457,1636,679,61778,Western Pacific
Cameroon,31-05-2020,312164,1038,972,311192,Africa
Canada,31-05-2020,383222,588,723,382499,Americas
Canada,31-05-2020,171276,1868,116,171160,Americas
Canada,31-05-2020,93571,1241,710,92861,Americas
Canada,31-05-2020,78948,1813,484,78464,Americas
Canada,31-05-2020,417718,1870,999,416719,Americas
Canada,31-05-2020,103872,1016,516,103356,Americas
Canada,31-05-2020,331557,1981,118,331439,Americas
Canada,31-05-2020,118087,198,475,117612,Americas
Canada,31-05-2020,307001,104,1116,305885,Americas
Canada,31-05-2020,434007,56,400,433607,Americas
Central African Republic,31-05-2020,11573,255,801,10772,Africa
Chad,31-05-2020,187872,1325,434,187438,Africa
Chile,31-05-2020,257151,782,0,257151,Americas
China,31-05-2020,39754,1095,1070,38684,Western Pacific
China,31-05-2020,46987,1551,734,46253,Western Pacific
China,31-05-2020,212507,497,1064,211443,Western Pacific
China,31-05-2020,31031,455,1017,30014,Western Pacific
China,31-05-2020,215514,100,598,214916,Western Pacific
China,31-05-2020,122618,552,191,122427,Western Pacific
China,31-05-2020,41446,1743,572,40874,Western Pacific
China,31-05-2020,242985,119,663,242322,Western Pacific
China,31-05-2020,3479,59,68,3411,Western Pacific
China,31-05-2020,67499,494,97,67402,Western Pacific
China,31-05-2020,409659,1915,935,408724,Western Pacific
China,31-05-2020,242024,2146,559,241465,Western Pacific
China,31-05-2020,396101,1905,429,395672,Western Pacific
China,31-05-2020,7001,764,945,6056,Western Pacific
China,31-05-2020,186238,1521,930,185308,Western Pacific
China,31-05-2020,261169,1114,502,260667,Western Pacific
China,31-05-2020,64260,254,594,63666,Western Pacific
China,31-05-2020,115501,1798,1192,114309,Western Pacific
China,31-05-2020,351311,2339,884,350427,Western Pacific
China,31-05-2020,306026,1262,765,305261,Western Pacific
China,31-05-2020,213588,1135,1115,212473,Western Pacific
China,31-05-2020,378247,1793,1237,377010,Western Pacific
China,31-05-2020,230249,2323,536,229713,Western Pacific
China,31-05-2020,252169,634,495,251674,Western Pacific
China,31-05-2020,106869,1839,984,105885,Western Pacific
China,31-05-2020,63065,2303,835,62230,Western Pacific
China,31-05-2020,342064,1286,576,341488,Western Pacific
China,31-05-2020,350830,1439,265,350565,Western Pacific
China,31-05-2020,408283,415,905,407378,Western Pacific
China,31-05-2020,257571,1926,642,256929,Western Pacific
China,31-05-2020,433471,1320,374,433097,Western Pacific
China,31-05-2020,278141,125,679,277462,Western Pacific
China,31-05-2020,316716,216,2,316714,Western Pacific
Colombia,31-05-2020,420006,379,952,419054,Americas
Congo (Brazzaville),31-05-2020,61670,467,686,60984,Africa
Congo (Kinshasa),31-05-2020,303338,756,154,303184,Africa
Costa Rica,31-05-2020,398991,321,663,398328,Americas
Cote d'Ivoire,31-05-2020,295609,645,1003,294606,Africa
Croatia,31-05-2020,40812,73,897,39915,Europe
Cuba,31-05-2020,399915,828,112,399803,Americas
Cyprus,31-05-2020,72160,2339,736,71424,Europe
Czechia,31-05-2020,226831,181,692,226139,Europe
Denmark,31-05-2020,175184,249,150,175034,Europe
Greenland,31-05-2020,43482,1317,910,42572,Europe
Denmark,31-05-2020,201251,698,451,200800,Europe
Djibouti,31-05-2020,103512,1630,940,102572,Eastern Mediterranean
Dominican Republic,31-05-2020,118990,2148,1204,117786,Americas
Ecuador,31-05-2020,107885,1188,1089,106796,Americas
Egypt,31-05-2020,284190,2277,84,284106,Eastern Mediterranean
El Salvador,31-05-2020,74374,367,1084,73290,Americas
Equatorial Guinea,31-05-2020,123805,1960,1072,122733,Africa
Eritrea,31-05-2020,29117,1235,912,28205,Africa
Estonia,31-05-2020,362417,1213,913,361504,Europe
Eswatini,31-05-2020,126256,2144,1085,125171,Africa
Ethiopia,31-05-2020,330322,1183,601,329721,Africa
Fiji,31-05-2020,336567,2481,501,336066,Western Pacific
Finland,31-05-2020,4938,1777,635,4303,Europe
France,31-05-2020,266849,2134,1061,265788,Europe
France,31-05-2020,199013,2200,8,199005,Europe
France,31-05-2020,387702,1163,510,387192,Europe
France,31-05-2020,18502,1240,64,18438,Europe
France,31-05-2020,247031,311,420,246611,Europe
France,31-05-2020,414411,171,170,414241,Europe
France,31-05-2020,101949,226,894,101055,Europe
France,31-05-2020,93471,695,233,93238,Europe
France,31-05-2020,80535,383,148,80387,Europe
France,31-05-2020,42061,1697,370,41691,Europe
Gabon,31-05-2020,239018,2178,109,238909,Africa
Gambia,31-05-2020,152618,1536,505,152113,Africa
Georgia,31-05-2020,316,2374,371,-55,Europe
Germany,31-05-2020,219198,1178,853,218345,Europe
Ghana,31-05-2020,246610,1590,22,246588,Africa
Greece,31-05-2020,119841,172,363,119478,Europe
Guatemala,31-05-2020,268396,886,640,267756,Americas
Guinea,31-05-2020,50178,1222,772,49406,Africa
Guyana,31-05-2020,160479,1972,486,159993,Americas
Haiti,31-05-2020,272116,2304,956,271160,Americas
Holy See,31-05-2020,315899,2412,356,315543,Europe
Honduras,31-05-2020,220678,2399,348,220330,Americas
Hungary,31-05-2020,279537,1938,243,279294,Europe
Iceland,31-05-2020,129531,289,595,128936,Europe
India,31-05-2020,15580,1484,570,15010,South-East Asia
Indonesia,31-05-2020,106753,1164,601,106152,South-East Asia
Iran,31-05-2020,144298,781,455,143843,Eastern Mediterranean
Iraq,31-05-2020,36106,2450,1092,35014,Eastern Mediterranean
Ireland,31-05-2020,81509,1687,903,80606,Europe
Israel,31-05-2020,14516,2293,451,14065,Europe
Italy,31-05-2020,103951,768,1219,102732,Europe
Jamaica,31-05-2020,113211,55,97,113114,Americas
Japan,31-05-2020,211766,499,847,210919,Western Pacific
Jordan,31-05-2020,411942,1695,503,411439,Eastern Mediterranean
Kazakhstan,31-05-2020,325146,736,1092,324054,Europe
Kenya,31-05-2020,222018,1785,200,221818,Africa
South Korea,31-05-2020,42602,264,305,42297,Western Pacific
Kuwait,31-05-2020,297555,555,397,297158,Eastern Mediterranean
Kyrgyzstan,31-05-2020,412766,1380,1190,411576,Europe
Latvia,31-05-2020,402589,1115,251,402338,Europe
Lebanon,31-05-2020,435872,2036,1011,434861,Eastern Mediterranean
Liberia,31-05-2020,238211,1805,1193,237018,Africa
Liechtenstein,31-05-2020,253198,435,1001,252197,Europe
Lithuania,31-05-2020,124048,1931,1028,123020,Europe
Luxembourg,31-05-2020,171246,1939,52,171194,Europe
Madagascar,31-05-2020,206220,1027,225,205995,Africa
Malaysia,31-05-2020,157710,863,979,156731,Western Pacific
Maldives,31-05-2020,207512,2294,754,206758,South-East Asia
Malta,31-05-2020,384180,758,444,383736,Europe
Mauritania,31-05-2020,145988,2406,733,145255,Africa
Mauritius,31-05-2020,294813,29,541,294272,Africa
Mexico,31-05-2020,324660,1918,908,323752,Americas
Moldova,31-05-2020,55940,485,513,55427,Europe
Monaco,31-05-2020,29615,1430,528,29087,Europe
Mongolia,31-05-2020,434394,1647,511,433883,Western Pacific
Montenegro,31-05-2020,343574,1732,403,343171,Europe
Morocco,31-05-2020,74538,1915,325,74213,Eastern Mediterranean
Namibia,31-05-2020,274502,2206,1027,273475,Africa
Nepal,31-05-2020,132436,1209,480,131956,South-East Asia
Netherlands,31-05-2020,80859,1391,162,80697,Europe
Netherlands,31-05-2020,136563,1561,263,136300,Europe
Netherlands,31-05-2020,44064,1423,789,43275,Europe
Netherlands,31-05-2020,190245,282,948,189297,Europe
New Zealand,31-05-2020,92891,514,736,92155,Western Pacific
Nicaragua,31-05-2020,369042,1248,145,368897,Americas
Niger,31-05-2020,263585,541,833,262752,Africa
Nigeria,31-05-2020,383895,712,131,383764,Africa
North Macedonia,31-05-2020,149437,957,335,149102,Europe
Norway,31-05-2020,200280,169,1107,199173,Europe
Oman,31-05-2020,423340,186,64,423276,Eastern Mediterranean
Pakistan,31-05-2020,149430,1368,428,149002,Eastern Mediterranean
Panama,31-05-2020,432750,287,484,432266,Americas
Papua New Guinea,31-05-2020,83989,582,1177,82812,Western Pacific
Paraguay,31-05-2020,286064,2019,637,285427,Americas
Peru,31-05-2020,96732,186,299,96433,Americas
Philippines,31-05-2020,56741,1822,480,56261,Western Pacific
Poland,31-05-2020,380992,1072,57,380935,Europe
Portugal,31-05-2020,25030,247,180,24850,Europe
Qatar,31-05-2020,393006,1777,573,392433,Eastern Mediterranean
Romania,31-05-2020,12918,971,732,12186,Europe
Russia,31-05-2020,4298,1787,506,3792,Europe
Rwanda,31-05-2020,411957,482,750,411207,Africa
Saint Lucia,31-05-2020,226559,2164,1098,225461,Americas
Saint Vincent and the Grenadines,31-05-2020,439995,1182,117,439878,Americas
San Marino,31-05-2020,398320,955,106,398214,Europe
Saudi Arabia,31-05-2020,240484,1284,711,239773,Eastern Mediterranean
Senegal,31-05-2020,323502,1809,130,323372,Africa
Serbia,31-05-2020,101004,392,1088,99916,Europe
Seychelles,31-05-2020,10472,1533,591,9881,Africa
Singapore,31-05-2020,286175,2343,770,285405,Western Pacific
Slovakia,31-05-2020,204710,607,883,203827,Europe
Slovenia,31-05-2020,204119,1677,832,203287,Europe
Somalia,31-05-2020,333594,825,332,333262,Eastern Mediterranean
South Africa,31-05-2020,59131,1360,886,58245,Africa
Spain,31-05-2020,337312,360,86,337226,Europe
Sri Lanka,31-05-2020,359747,1589,369,359378,South-East Asia
Sudan,31-05-2020,214723,261,503,214220,Eastern Mediterranean
Suriname,31-05-2020,135507,843,739,134768,Americas
Sweden,31-05-2020,129697,1700,826,128871,Europe
Switzerland,31-05-2020,171573,2351,684,170889,Europe
Taiwan*,31-05-2020,435913,1609,974,434939,Western Pacific
Tanzania,31-05-2020,211996,1980,87,211909,Africa
Thailand,31-05-2020,306334,1575,1026,305308,South-East Asia
Togo,31-05-2020,94506,851,847,93659,Africa
Trinidad and Tobago,31-05-2020,258714,1616,123,258591,Americas
Tunisia,31-05-2020,56533,806,275,56258,Eastern Mediterranean
Turkey,31-05-2020,430531,285,824,429707,Europe
Uganda,31-05-2020,247519,947,1005,246514,Africa
Ukraine,31-05-2020,360125,364,1151,358974,Europe
United Arab Emirates,31-05-2020,399729,1525,176,399553,Eastern Mediterranean
United Kingdom,31-05-2020,265174,413,1166,264008,Europe
United Kingdom,31-05-2020,404770,869,404,404366,Europe
United Kingdom,31-05-2020,237498,1103,60,237438,Europe
United Kingdom,31-05-2020,364785,680,1130,363655,Europe
United Kingdom,31-05-2020,378628,1795,114,378514,Europe
United Kingdom,31-05-2020,289887,1566,195,289692,Europe
United Kingdom,31-05-2020,115919,239,129,115790,Europe
Uruguay,31-05-2020,166156,1178,641,165515,Americas
US,31-05-2020,212868,1670,657,212211,Americas
Uzbekistan,31-05-2020,140981,2358,188,140793,Europe
Venezuela,31-05-2020,280537,128,676,279861,Americas
Vietnam,31-05-2020,39942,1851,992,38950,Western Pacific
Zambia,31-05-2020,417364,315,598,416766,Africa
Zimbabwe,31-05-2020,64171,2018,1098,63073,Africa
Dominica,31-05-2020,13602,80,617,12985,Americas
Grenada,31-05-2020,125856,1811,1017,124839,Americas
Mozambique,31-05-2020,8288,1413,50,8238,Africa
Syria,31-05-2020,351073,718,1003,350070,Eastern Mediterranean
Timor-Leste,31-05-2020,288367,1030,631,287736,South-East Asia
Belize,31-05-2020,170315,1385,238,170077,Americas
Laos,31-05-2020,81016,542,896,80120,Western Pacific
Libya,31-05-2020,30572,1188,299,30273,Eastern Mediterranean
West Bank and Gaza,31-05-2020,147855,1282,502,147353,Eastern Mediterranean
Guinea-Bissau,31-05-2020,340627,655,1124,339503,Africa
Mali,31-05-2020,262456,1089,1186,261270,Africa
Saint Kitts and Nevis,31-05-2020,172008,524,659,171349,Americas
Canada,31-05-2020,204952,364,154,204798,Americas
Canada,31-05-2020,367959,1281,515,367444,Americas
Kosovo,31-05-2020,122933,917,132,122801,Europe
Burma,31-05-2020,372018,1583,566,371452,South-East Asia
United Kingdom,31-05-2020,335711,772,849,334862,Europe
United Kingdom,31-05-2020,381049,1262,462,380587,Europe
United Kingdom,31-05-2020,136596,1146,149,136447,Europe
Botswana,31-05-2020,262522,389,435,262087,Africa
Burundi,31-05-2020,324048,1549,627,323421,Africa
Sierra Leone,31-05-2020,97935,1215,564,97371,Africa
Malawi,31-05-2020,25442,1659,476,24966,Africa
United Kingdom,31-05-2020,50422,1034,229,50193,Europe
France,31-05-2020,437379,837,1017,436362,Europe
South Sudan,31-05-2020,33894,1916,844,33050,Africa
Western Sahara,31-05-2020,195688,2107,1090,194598,Africa
Sao Tome and Principe,31-05-2020,249792,628,1066,248726,Africa
Yemen,31-05-2020,448970,2292,507,448463,Eastern Mediterranean
Comoros,31-05-2020,47181,1632,1118,46063,Africa
Tajikistan,31-05-2020,381841,357,336,381505,Europe
Lesotho,31-05-2020,200742,2325,998,199744,Africa
Afghanistan,01-06-2020,395947,2466,271,395676,Eastern Mediterranean
Albania,01-06-2020,198451,442,1125,197326,Europe
Algeria,01-06-2020,79605,198,1097,78508,Africa
Andorra,01-06-2020,382417,79,10,382407,Europe
Angola,01-06-2020,2031,7,1093,938,Africa
Antigua and Barbuda,01-06-2020,304072,1710,718,303354,Americas
Argentina,01-06-2020,281293,1900,742,280551,Americas
Armenia,01-06-2020,347929,599,235,347694,Europe
Australia,01-06-2020,112985,1712,1206,111779,Western Pacific
Australia,01-06-2020,8756,458,576,8180,Western Pacific
Australia,01-06-2020,369537,1305,1238,368299,Western Pacific
Australia,01-06-2020,352751,1431,859,351892,Western Pacific
Australia,01-06-2020,372708,435,189,372519,Western Pacific
Australia,01-06-2020,307919,1053,318,307601,Western Pacific
Australia,01-06-2020,337822,78,698,337124,Western Pacific
Australia,01-06-2020,284045,2412,13,284032,Western Pacific
Austria,01-06-2020,267332,58,283,267049,Europe
Azerbaijan,01-06-2020,125919,1529,689,125230,Europe
Bahamas,01-06-2020,436430,194,177,436253,Americas
Bahrain,01-06-2020,250727,42,1068,249659,Eastern Mediterranean
Bangladesh,01-06-2020,368881,1981,1054,367827,South-East Asia
Barbados,01-06-2020,138560,2374,293,138267,Americas
Belarus,01-06-2020,440853,446,506,440347,Europe
Belgium,01-06-2020,251054,1145,542,250512,Europe
Benin,01-06-2020,376210,2351,60,376150,Africa
Bhutan,01-06-2020,21191,1286,223,20968,South-East Asia
Bolivia,01-06-2020,394831,357,364,394467,Americas
Bosnia and Herzegovina,01-06-2020,319381,781,177,319204,Europe
Brazil,01-06-2020,113470,928,1236,112234,Americas
Brunei,01-06-2020,94243,1181,613,93630,Western Pacific
Bulgaria,01-06-2020,9248,1886,921,8327,Europe
Burkina Faso,01-06-2020,413703,1967,681,413022,Africa
Cabo Verde,01-06-2020,380411,2315,165,380246,Africa
Cambodia,01-06-2020,339249,1059,422,338827,Western Pacific
Cameroon,01-06-2020,65871,1561,1195,64676,Africa
Canada,01-06-2020,246779,1211,830,245949,Americas
Canada,01-06-2020,137003,2464,565,136438,Americas
Canada,01-06-2020,419173,1859,385,418788,Americas
Canada,01-06-2020,41597,104,79,41518,Americas
Canada,01-06-2020,85690,1952,390,85300,Americas
Canada,01-06-2020,3712,1745,1008,2704,Americas
Canada,01-06-2020,219401,2206,278,219123,Americas
Canada,01-06-2020,259092,1706,741,258351,Americas
Canada,01-06-2020,257717,2034,10,257707,Americas
Canada,01-06-2020,227632,290,84,227548,Americas
Central African Republic,01-06-2020,439373,2062,275,439098,Africa
Chad,01-06-2020,440791,1810,1175,439616,Africa
Chile,01-06-2020,49873,1335,1155,48718,Americas
China,01-06-2020,250557,2072,1145,249412,Western Pacific
China,01-06-2020,419556,1409,361,419195,Western Pacific
China,01-06-2020,230844,802,283,230561,Western Pacific
China,01-06-2020,392167,355,1248,390919,Western Pacific
China,01-06-2020,313666,1383,936,312730,Western Pacific
China,01-06-2020,65082,441,166,64916,Western Pacific
China,01-06-2020,132045,528,1111,130934,Western Pacific
China,01-06-2020,239867,1024,755,239112,Western Pacific
China,01-06-2020,195746,33,107,195639,Western Pacific
China,01-06-2020,154692,1148,311,154381,Western Pacific
China,01-06-2020,137495,1494,1231,136264,Western Pacific
China,01-06-2020,159937,512,169,159768,Western Pacific
China,01-06-2020,58929,2175,809,58120,Western Pacific
China,01-06-2020,325333,358,365,324968,Western Pacific
China,01-06-2020,68407,2226,666,67741,Western Pacific
China,01-06-2020,286807,1023,457,286350,Western Pacific
China,01-06-2020,292634,2283,547,292087,Western Pacific
China,01-06-2020,63422,2384,740,62682,Western Pacific
China,01-06-2020,150108,902,813,149295,Western Pacific
China,01-06-2020,81580,621,234,81346,Western Pacific
China,01-06-2020,371507,22,821,370686,Western Pacific
China,01-06-2020,261944,603,406,261538,Western Pacific
China,01-06-2020,375543,1394,291,375252,Western Pacific
China,01-06-2020,84049,862,398,83651,Western Pacific
China,01-06-2020,178734,1798,65,178669,Western Pacific
China,01-06-2020,205417,851,888,204529,Western Pacific
China,01-06-2020,12321,1877,403,11918,Western Pacific
China,01-06-2020,91462,2000,1017,90445,Western Pacific
China,01-06-2020,282166,1660,1129,281037,Western Pacific
China,01-06-2020,118714,437,1043,117671,Western Pacific
China,01-06-2020,265922,323,630,265292,Western Pacific
China,01-06-2020,149642,982,157,149485,Western Pacific
China,01-06-2020,353169,1868,1198,351971,Western Pacific
Colombia,01-06-2020,285869,1115,1106,284763,Americas
Congo (Brazzaville),01-06-2020,11108,1494,430,10678,Africa
Congo (Kinshasa),01-06-2020,149874,1617,520,149354,Africa
Costa Rica,01-06-2020,151493,594,13,151480,Americas
Cote d'Ivoire,01-06-2020,220850,1597,185,220665,Africa
Croatia,01-06-2020,364202,1400,36,364166,Europe
Cuba,01-06-2020,67185,515,780,66405,Americas
Cyprus,01-06-2020,141324,1442,1051,140273,Europe
Czechia,01-06-2020,234475,1137,1199,233276,Europe
Denmark,01-06-2020,29554,1488,697,28857,Europe
Greenland,01-06-2020,53476,1309,366,53110,Europe
Denmark,01-06-2020,348937,287,977,347960,Europe
Djibouti,01-06-2020,421634,26,1244,420390,Eastern Mediterranean
Dominican Republic,01-06-2020,102165,1396,48,102117,Americas
Ecuador,01-06-2020,267585,1947,567,267018,Americas
Egypt,01-06-2020,424252,139,554,423698,Eastern Mediterranean
El Salvador,01-06-2020,10650,1013,281,10369,Americas
Equatorial Guinea,01-06-2020,2571,72,265,2306,Africa
Eritrea,01-06-2020,316417,2074,745,315672,Africa
Estonia,01-06-2020,167269,1901,3,167266,Europe
Eswatini,01-06-2020,120050,164,850,119200,Africa
Ethiopia,01-06-2020,315539,1317,251,315288,Africa
Fiji,01-06-2020,9406,1312,718,8688,Western Pacific
Finland,01-06-2020,306714,1852,736,305978,Europe
France,01-06-2020,170827,2211,830,169997,Europe
France,01-06-2020,120493,1231,266,120227,Europe
France,01-06-2020,202834,128,1084,201750,Europe
France,01-06-2020,133758,1018,163,133595,Europe
France,01-06-2020,3963,2403,1063,2900,Europe
France,01-06-2020,330594,678,415,330179,Europe
France,01-06-2020,256624,148,332,256292,Europe
France,01-06-2020,145570,1678,576,144994,Europe
France,01-06-2020,295047,2238,986,294061,Europe
France,01-06-2020,198475,416,408,198067,Europe
Gabon,01-06-2020,177743,2247,166,177577,Africa
Gambia,01-06-2020,43716,1221,1071,42645,Africa
Georgia,01-06-2020,107553,1465,282,107271,Europe
Germany,01-06-2020,9036,1255,1005,8031,Europe
Ghana,01-06-2020,245949,1297,384,245565,Africa
Greece,01-06-2020,189610,1981,10,189600,Europe
Guatemala,01-06-2020,40822,1492,336,40486,Americas
Guinea,01-06-2020,40311,1836,316,39995,Africa
Guyana,01-06-2020,194028,1235,91,193937,Americas
Haiti,01-06-2020,74409,1010,535,73874,Americas
Holy See,01-06-2020,327496,316,652,326844,Europe
Honduras,01-06-2020,145231,2428,357,144874,Americas
Hungary,01-06-2020,172216,1785,820,171396,Europe
Iceland,01-06-2020,447627,2130,308,447319,Europe
India,01-06-2020,377982,1410,1135,376847,South-East Asia
Indonesia,01-06-2020,185181,1151,1168,184013,South-East Asia
Iran,01-06-2020,378474,2059,1077,377397,Eastern Mediterranean
Iraq,01-06-2020,323600,22,24,323576,Eastern Mediterranean
Ireland,01-06-2020,405224,2485,1123,404101,Europe
Israel,01-06-2020,240606,839,101,240505,Europe
Italy,01-06-2020,134183,1292,1227,132956,Europe
Jamaica,01-06-2020,34079,2298,738,33341,Americas
Japan,01-06-2020,79467,1869,1222,78245,Western Pacific
Jordan,01-06-2020,424448,802,111,424337,Eastern Mediterranean
Kazakhstan,01-06-2020,74513,1995,737,73776,Europe
Kenya,01-06-2020,377697,2200,54,377643,Africa
South Korea,01-06-2020,43952,1611,865,43087,Western Pacific
Kuwait,01-06-2020,53033,442,761,52272,Eastern Mediterranean
Kyrgyzstan,01-06-2020,362805,1797,10,362795,Europe
Latvia,01-06-2020,359901,953,386,359515,Europe
Lebanon,01-06-2020,158384,1753,716,157668,Eastern Mediterranean
Liberia,01-06-2020,69838,1352,486,69352,Africa
Liechtenstein,01-06-2020,148780,795,1012,147768,Europe
Lithuania,01-06-2020,297482,1206,116,297366,Europe
Luxembourg,01-06-2020,310121,941,1152,308969,Europe
Madagascar,01-06-2020,297177,1686,726,296451,Africa
Malaysia,01-06-2020,391425,425,722,390703,Western Pacific
Maldives,01-06-2020,339763,1297,786,338977,South-East Asia
Malta,01-06-2020,58745,1782,247,58498,Europe
Mauritania,01-06-2020,129847,1636,1038,128809,Africa
Mauritius,01-06-2020,276354,734,383,275971,Africa
Mexico,01-06-2020,261131,896,60,261071,Americas
Moldova,01-06-2020,206727,1623,577,206150,Europe
Monaco,01-06-2020,38902,1725,1160,37742,Europe
Mongolia,01-06-2020,252518,2101,502,252016,Western Pacific
Montenegro,01-06-2020,278557,1140,414,278143,Europe
Morocco,01-06-2020,203122,1703,941,202181,Eastern Mediterranean
Namibia,01-06-2020,400513,2244,325,400188,Africa
Nepal,01-06-2020,233726,339,1136,232590,South-East Asia
Netherlands,01-06-2020,281960,1241,1037,280923,Europe
Netherlands,01-06-2020,144518,1639,1221,143297,Europe
Netherlands,01-06-2020,431727,1428,849,430878,Europe
Netherlands,01-06-2020,215191,1704,481,214710,Europe
New Zealand,01-06-2020,438729,2299,873,437856,Western Pacific
Nicaragua,01-06-2020,340796,1449,936,339860,Americas
Niger,01-06-2020,418939,439,471,418468,Africa
Nigeria,01-06-2020,24493,190,882,23611,Africa
North Macedonia,01-06-2020,440004,1675,1184,438820,Europe
Norway,01-06-2020,447283,2465,824,446459,Europe
Oman,01-06-2020,259980,666,1122,258858,Eastern Mediterranean
Pakistan,01-06-2020,153220,424,663,152557,Eastern Mediterranean
Panama,01-06-2020,132830,644,353,132477,Americas
Papua New Guinea,01-06-2020,3171,716,98,3073,Western Pacific
Paraguay,01-06-2020,169589,645,7,169582,Americas
Peru,01-06-2020,317238,1523,1002,316236,Americas
Philippines,01-06-2020,407328,2026,790,406538,Western Pacific
Poland,01-06-2020,427992,380,1142,426850,Europe
Portugal,01-06-2020,423662,571,1211,422451,Europe
Qatar,01-06-2020,22721,92,648,22073,Eastern Mediterranean
Romania,01-06-2020,194363,879,1188,193175,Europe
Russia,01-06-2020,157963,732,1040,156923,Europe
Rwanda,01-06-2020,125383,1690,569,124814,Africa
Saint Lucia,01-06-2020,367480,134,847,366633,Americas
Saint Vincent and the Grenadines,01-06-2020,365275,1780,383,364892,Americas
San Marino,01-06-2020,415275,552,160,415115,Europe
Saudi Arabia,01-06-2020,426607,1969,1250,425357,Eastern Mediterranean
Senegal,01-06-2020,161988,2099,588,161400,Africa
Serbia,01-06-2020,318688,789,910,317778,Europe
Seychelles,01-06-2020,324023,1262,419,323604,Africa
Singapore,01-06-2020,373963,1209,71,373892,Western Pacific
Slovakia,01-06-2020,12441,48,629,11812,Europe
Slovenia,01-06-2020,36034,1566,825,35209,Europe
Somalia,01-06-2020,408367,582,1014,407353,Eastern Mediterranean
South Africa,01-06-2020,429409,169,597,428812,Africa
Spain,01-06-2020,285127,2307,1221,283906,Europe
Sri Lanka,01-06-2020,134343,324,133,134210,South-East Asia
Sudan,01-06-2020,81473,2406,512,80961,Eastern Mediterranean
Suriname,01-06-2020,444274,1666,625,443649,Americas
Sweden,01-06-2020,344273,1713,254,344019,Europe
Switzerland,01-06-2020,403787,2355,220,403567,Europe
Taiwan*,01-06-2020,75782,1280,1039,74743,Western Pacific
Tanzania,01-06-2020,58016,1149,1010,57006,Africa
Thailand,01-06-2020,447027,2113,13,447014,South-East Asia
Togo,01-06-2020,266386,735,933,265453,Africa
Trinidad and Tobago,01-06-2020,346488,181,293,346195,Americas
Tunisia,01-06-2020,20473,2223,394,20079,Eastern Mediterranean
Turkey,01-06-2020,166960,1928,995,165965,Europe
Uganda,01-06-2020,142874,2424,613,142261,Africa
Ukraine,01-06-2020,388663,1203,481,388182,Europe
United Arab Emirates,01-06-2020,118133,1745,289,117844,Eastern Mediterranean
United Kingdom,01-06-2020,189862,716,401,189461,Europe
United Kingdom,01-06-2020,58878,1736,490,58388,Europe
United Kingdom,01-06-2020,68915,1216,34,68881,Europe
United Kingdom,01-06-2020,200286,2433,666,199620,Europe
United Kingdom,01-06-2020,219391,895,274,219117,Europe
United Kingdom,01-06-2020,416402,219,593,415809,Europe
United Kingdom,01-06-2020,188024,107,1163,186861,Europe
Uruguay,01-06-2020,285327,1091,62,285265,Americas
US,01-06-2020,119316,1078,533,118783,Americas
Uzbekistan,01-06-2020,299160,1099,524,298636,Europe
Venezuela,01-06-2020,90832,785,300,90532,Americas
Vietnam,01-06-2020,65802,1485,807,64995,Western Pacific
Zambia,01-06-2020,145342,1214,392,144950,Africa
Zimbabwe,01-06-2020,214983,1239,707,214276,Africa
Dominica,01-06-2020,244796,646,1048,243748,Americas
Grenada,01-06-2020,347712,484,911,346801,Americas
Mozambique,01-06-2020,387076,638,358,386718,Africa
Syria,01-06-2020,131765,1665,50,131715,Eastern Mediterranean
Timor-Leste,01-06-2020,392498,56,85,392413,South-East Asia
Belize,01-06-2020,79972,2176,548,79424,Americas
Laos,01-06-2020,393843,162,650,393193,Western Pacific
Libya,01-06-2020,339140,2418,23,339117,Eastern Mediterranean
West Bank and Gaza,01-06-2020,107313,1497,57,107256,Eastern Mediterranean
Guinea-Bissau,01-06-2020,302351,1489,1063,301288,Africa
Mali,01-06-2020,283258,254,357,282901,Africa
Saint Kitts and Nevis,01-06-2020,209799,2481,32,209767,Americas
Canada,01-06-2020,436423,501,866,435557,Americas
Canada,01-06-2020,187179,123,1244,185935,Americas
Kosovo,01-06-2020,240138,197,194,239944,Europe
Burma,01-06-2020,88675,151,103,88572,South-East Asia
United Kingdom,01-06-2020,67273,852,499,66774,Europe
United Kingdom,01-06-2020,238218,2304,219,237999,Europe
United Kingdom,01-06-2020,340312,2123,1186,339126,Europe
Botswana,01-06-2020,196708,1320,904,195804,Africa
Burundi,01-06-2020,292734,1591,642,292092,Africa
Sierra Leone,01-06-2020,38875,1377,1115,37760,Africa
Malawi,01-06-2020,32495,554,987,31508,Africa
United Kingdom,01-06-2020,429444,1245,449,428995,Europe
France,01-06-2020,90233,304,1138,89095,Europe
South Sudan,01-06-2020,364403,562,398,364005,Africa
Western Sahara,01-06-2020,221762,2187,333,221429,Africa
Sao Tome and Principe,01-06-2020,275655,75,1102,274553,Africa
Yemen,01-06-2020,193542,1825,287,193255,Eastern Mediterranean
Comoros,01-06-2020,285981,2364,536,285445,Africa
Tajikistan,01-06-2020,12108,2325,105,12003,Europe
Lesotho,01-06-2020,138645,239,60,138585,Africa
Afghanistan,02-06-2020,100807,2034,775,100032,Eastern Mediterranean
Albania,02-06-2020,58882,1617,316,58566,Europe
Algeria,02-06-2020,302590,738,1167,301423,Africa
Andorra,02-06-2020,289527,2111,1130,288397,Europe
Angola,02-06-2020,327691,981,526,327165,Africa
Antigua and Barbuda,02-06-2020,119961,1195,668,119293,Americas
Argentina,02-06-2020,169349,2465,32,169317,Americas
Armenia,02-06-2020,319664,1733,1007,318657,Europe
Australia,02-06-2020,223221,421,1146,222075,Western Pacific
Australia,02-06-2020,221513,2058,44,221469,Western Pacific
Australia,02-06-2020,102767,1852,1072,101695,Western Pacific
Australia,02-06-2020,165448,2455,221,165227,Western Pacific
Australia,02-06-2020,150396,1972,498,149898,Western Pacific
Australia,02-06-2020,377950,2076,16,377934,Western Pacific
Australia,02-06-2020,6222,70,733,5489,Western Pacific
Australia,02-06-2020,179742,2390,1020,178722,Western Pacific
Austria,02-06-2020,68369,479,142,68227,Europe
Azerbaijan,02-06-2020,315828,2234,306,315522,Europe
Bahamas,02-06-2020,80014,1382,582,79432,Americas
Bahrain,02-06-2020,181980,686,437,181543,Eastern Mediterranean
Bangladesh,02-06-2020,440258,174,623,439635,South-East Asia
Barbados,02-06-2020,82780,1314,222,82558,Americas
Belarus,02-06-2020,165822,1636,99,165723,Europe
Belgium,02-06-2020,365054,1346,328,364726,Europe
Benin,02-06-2020,385309,488,144,385165,Africa
Bhutan,02-06-2020,205987,878,809,205178,South-East Asia
Bolivia,02-06-2020,116158,1206,867,115291,Americas
Bosnia and Herzegovina,02-06-2020,177837,119,261,177576,Europe
Brazil,02-06-2020,154924,2272,266,154658,Americas
Brunei,02-06-2020,356093,860,632,355461,Western Pacific
Bulgaria,02-06-2020,384173,647,969,383204,Europe
Burkina Faso,02-06-2020,91760,2440,247,91513,Africa
Cabo Verde,02-06-2020,8045,2020,635,7410,Africa
Cambodia,02-06-2020,253456,1731,693,252763,Western Pacific
Cameroon,02-06-2020,146235,2015,1163,145072,Africa
Canada,02-06-2020,373285,2281,523,372762,Americas
Canada,02-06-2020,393540,1617,543,392997,Americas
Canada,02-06-2020,387476,391,485,386991,Americas
Canada,02-06-2020,396517,812,1236,395281,Americas
Canada,02-06-2020,410314,41,1053,409261,Americas
Canada,02-06-2020,142168,1180,1200,140968,Americas
Canada,02-06-2020,125008,463,1009,123999,Americas
Canada,02-06-2020,58270,2408,969,57301,Americas
Canada,02-06-2020,415864,952,1189,414675,Americas
Canada,02-06-2020,105906,1204,902,105004,Americas
Central African Republic,02-06-2020,417875,2392,546,417329,Africa
Chad,02-06-2020,135642,268,39,135603,Africa
Chile,02-06-2020,215698,2294,67,215631,Americas
China,02-06-2020,189194,1066,1234,187960,Western Pacific
China,02-06-2020,217975,382,61,217914,Western Pacific
China,02-06-2020,317584,2373,627,316957,Western Pacific
China,02-06-2020,174663,864,599,174064,Western Pacific
China,02-06-2020,402300,1306,791,401509,Western Pacific
China,02-06-2020,171093,907,1054,170039,Western Pacific
China,02-06-2020,201840,120,421,201419,Western Pacific
China,02-06-2020,14173,1047,1246,12927,Western Pacific
China,02-06-2020,277034,10,940,276094,Western Pacific
China,02-06-2020,316193,1876,633,315560,Western Pacific
China,02-06-2020,431671,997,440,431231,Western Pacific
China,02-06-2020,243510,445,740,242770,Western Pacific
China,02-06-2020,402772,583,899,401873,Western Pacific
China,02-06-2020,308973,1299,853,308120,Western Pacific
China,02-06-2020,10561,1222,960,9601,Western Pacific
China,02-06-2020,277411,2114,837,276574,Western Pacific
China,02-06-2020,229265,1478,468,228797,Western Pacific
China,02-06-2020,171914,1766,274,171640,Western Pacific
China,02-06-2020,147652,481,858,146794,Western Pacific
China,02-06-2020,321448,338,692,320756,Western Pacific
China,02-06-2020,179933,850,948,178985,Western Pacific
China,02-06-2020,76494,711,1164,75330,Western Pacific
China,02-06-2020,382182,2360,452,381730,Western Pacific
China,02-06-2020,1615,1993,219,1396,Western Pacific
China,02-06-2020,390783,1275,1058,389725,Western Pacific
China,02-06-2020,199827,314,1156,198671,Western Pacific
China,02-06-2020,418382,2213,99,418283,Western Pacific
China,02-06-2020,52407,926,485,51922,Western Pacific
China,02-06-2020,398771,2011,470,398301,Western Pacific
China,02-06-2020,381118,687,216,380902,Western Pacific
China,02-06-2020,391839,137,973,390866,Western Pacific
China,02-06-2020,319686,479,402,319284,Western Pacific
China,02-06-2020,314024,1280,7,314017,Western Pacific
Colombia,02-06-2020,408888,1923,118,408770,Americas
Congo (Brazzaville),02-06-2020,70518,432,1027,69491,Africa
Congo (Kinshasa),02-06-2020,73038,1803,175,72863,Africa
Costa Rica,02-06-2020,314080,706,794,313286,Americas
Cote d'Ivoire,02-06-2020,258651,1514,860,257791,Africa
Croatia,02-06-2020,158934,1184,733,158201,Europe
Cuba,02-06-2020,196176,2206,953,195223,Americas
Cyprus,02-06-2020,53904,641,365,53539,Europe
Czechia,02-06-2020,329741,2095,1246,328495,Europe
Denmark,02-06-2020,434935,470,1112,433823,Europe
Greenland,02-06-2020,270415,2493,343,270072,Europe
Denmark,02-06-2020,337126,1754,66,337060,Europe
Djibouti,02-06-2020,95297,1520,332,94965,Eastern Mediterranean
Dominican Republic,02-06-2020,114012,905,1071,112941,Americas
Ecuador,02-06-2020,237647,2147,585,237062,Americas
Egypt,02-06-2020,110324,1836,848,109476,Eastern Mediterranean
El Salvador,02-06-2020,275177,531,838,274339,Americas
Equatorial Guinea,02-06-2020,94817,536,412,94405,Africa
Eritrea,02-06-2020,447201,445,428,446773,Africa
Estonia,02-06-2020,223923,2342,1235,222688,Europe
Eswatini,02-06-2020,173052,557,169,172883,Africa
Ethiopia,02-06-2020,189471,1278,1036,188435,Africa
Fiji,02-06-2020,327276,2452,611,326665,Western Pacific
Finland,02-06-2020,438168,2060,31,438137,Europe
France,02-06-2020,195390,1250,1209,194181,Europe
France,02-06-2020,329358,243,362,328996,Europe
France,02-06-2020,144097,2015,378,143719,Europe
France,02-06-2020,321904,175,131,321773,Europe
France,02-06-2020,279770,1728,888,278882,Europe
France,02-06-2020,433674,2003,526,433148,Europe
France,02-06-2020,219066,902,835,218231,Europe
France,02-06-2020,383603,1758,751,382852,Europe
France,02-06-2020,376198,1707,93,376105,Europe
France,02-06-2020,156441,322,770,155671,Europe
Gabon,02-06-2020,93028,2197,296,92732,Africa
Gambia,02-06-2020,60852,1246,535,60317,Africa
Georgia,02-06-2020,202549,961,668,201881,Europe
Germany,02-06-2020,442270,181,485,441785,Europe
Ghana,02-06-2020,378694,1051,902,377792,Africa
Greece,02-06-2020,239516,298,997,238519,Europe
Guatemala,02-06-2020,30664,1737,511,30153,Americas
Guinea,02-06-2020,262156,1540,1007,261149,Africa
Guyana,02-06-2020,197689,930,1057,196632,Americas
Haiti,02-06-2020,221306,802,654,220652,Americas
Holy See,02-06-2020,371988,1946,766,371222,Europe
Honduras,02-06-2020,363163,119,733,362430,Americas
Hungary,02-06-2020,294685,974,110,294575,Europe
Iceland,02-06-2020,231277,2335,260,231017,Europe
India,02-06-2020,288648,1324,791,287857,South-East Asia
Indonesia,02-06-2020,227225,2186,1062,226163,South-East Asia
Iran,02-06-2020,64766,1866,825,63941,Eastern Mediterranean
Iraq,02-06-2020,394456,1124,106,394350,Eastern Mediterranean
Ireland,02-06-2020,282154,1144,260,281894,Europe
Israel,02-06-2020,41529,157,739,40790,Europe
Italy,02-06-2020,394671,942,693,393978,Europe
Jamaica,02-06-2020,6952,2217,113,6839,Americas
Japan,02-06-2020,66837,228,839,65998,Western Pacific
Jordan,02-06-2020,48663,597,310,48353,Eastern Mediterranean
Kazakhstan,02-06-2020,139875,1124,1199,138676,Europe
Kenya,02-06-2020,187803,1799,961,186842,Africa
South Korea,02-06-2020,380297,54,22,380275,Western Pacific
Kuwait,02-06-2020,210920,1550,734,210186,Eastern Mediterranean
Kyrgyzstan,02-06-2020,374874,1819,1091,373783,Europe
Latvia,02-06-2020,319948,2224,43,319905,Europe
Lebanon,02-06-2020,109936,1462,420,109516,Eastern Mediterranean
Liberia,02-06-2020,358124,53,1098,357026,Africa
Liechtenstein,02-06-2020,335627,48,888,334739,Europe
Lithuania,02-06-2020,285055,840,192,284863,Europe
Luxembourg,02-06-2020,288578,2115,436,288142,Europe
Madagascar,02-06-2020,131259,136,764,130495,Africa
Malaysia,02-06-2020,397611,594,423,397188,Western Pacific
Maldives,02-06-2020,347772,377,1204,346568,South-East Asia
Malta,02-06-2020,345298,1790,888,344410,Europe
Mauritania,02-06-2020,287717,842,1038,286679,Africa
Mauritius,02-06-2020,298237,327,392,297845,Africa
Mexico,02-06-2020,259056,2349,901,258155,Americas
Moldova,02-06-2020,438010,1922,476,437534,Europe
Monaco,02-06-2020,191708,1441,734,190974,Europe
Mongolia,02-06-2020,404949,200,640,404309,Western Pacific
Montenegro,02-06-2020,113761,85,426,113335,Europe
Morocco,02-06-2020,402763,970,808,401955,Eastern Mediterranean
Namibia,02-06-2020,61640,1631,1023,60617,Africa
Nepal,02-06-2020,121818,38,815,121003,South-East Asia
Netherlands,02-06-2020,202913,1864,1107,201806,Europe
Netherlands,02-06-2020,212173,680,746,211427,Europe
Netherlands,02-06-2020,268206,297,606,267600,Europe
Netherlands,02-06-2020,421081,2212,637,420444,Europe
New Zealand,02-06-2020,412010,329,1029,410981,Western Pacific
Nicaragua,02-06-2020,182998,1105,197,182801,Americas
Niger,02-06-2020,88484,1103,224,88260,Africa
Nigeria,02-06-2020,433354,2155,137,433217,Africa
North Macedonia,02-06-2020,368293,1224,190,368103,Europe
Norway,02-06-2020,438477,1203,919,437558,Europe
Oman,02-06-2020,233564,1101,1095,232469,Eastern Mediterranean
Pakistan,02-06-2020,44524,293,45,44479,Eastern Mediterranean
Panama,02-06-2020,161838,1570,1173,160665,Americas
Papua New Guinea,02-06-2020,153834,23,1235,152599,Western Pacific
Paraguay,02-06-2020,3007,2086,412,2595,Americas
Peru,02-06-2020,407738,185,415,407323,Americas
Philippines,02-06-2020,424103,1802,942,423161,Western Pacific
Poland,02-06-2020,363112,1893,1141,361971,Europe
Portugal,02-06-2020,392867,768,308,392559,Europe
Qatar,02-06-2020,85980,1393,839,85141,Eastern Mediterranean
Romania,02-06-2020,375898,1206,910,374988,Europe
Russia,02-06-2020,306679,1988,975,305704,Europe
Rwanda,02-06-2020,133358,55,802,132556,Africa
Saint Lucia,02-06-2020,249452,260,174,249278,Americas
Saint Vincent and the Grenadines,02-06-2020,39146,1154,37,39109,Americas
San Marino,02-06-2020,325643,786,64,325579,Europe
Saudi Arabia,02-06-2020,218792,1284,941,217851,Eastern Mediterranean
Senegal,02-06-2020,417361,1009,469,416892,Africa
Serbia,02-06-2020,252923,852,246,252677,Europe
Seychelles,02-06-2020,350164,466,1213,348951,Africa
Singapore,02-06-2020,67255,223,18,67237,Western Pacific
Slovakia,02-06-2020,111851,2129,1061,110790,Europe
Slovenia,02-06-2020,429372,1866,1224,428148,Europe
Somalia,02-06-2020,309580,1858,236,309344,Eastern Mediterranean
South Africa,02-06-2020,21629,31,708,20921,Africa
Spain,02-06-2020,232491,1071,1076,231415,Europe
Sri Lanka,02-06-2020,18516,2386,1082,17434,South-East Asia
Sudan,02-06-2020,89781,881,719,89062,Eastern Mediterranean
Suriname,02-06-2020,93500,4,956,92544,Americas
Sweden,02-06-2020,318698,2322,648,318050,Europe
Switzerland,02-06-2020,265416,2244,1156,264260,Europe
Taiwan*,02-06-2020,359500,292,581,358919,Western Pacific
Tanzania,02-06-2020,306478,474,502,305976,Africa
Thailand,02-06-2020,172385,1411,928,171457,South-East Asia
Togo,02-06-2020,192787,1229,169,192618,Africa
Trinidad and Tobago,02-06-2020,41855,1705,738,41117,Americas
Tunisia,02-06-2020,449314,2314,130,449184,Eastern Mediterranean
Turkey,02-06-2020,240208,1722,152,240056,Europe
Uganda,02-06-2020,139732,2279,310,139422,Africa
Ukraine,02-06-2020,437042,699,865,436177,Europe
United Arab Emirates,02-06-2020,249698,352,1002,248696,Eastern Mediterranean
United Kingdom,02-06-2020,358516,1019,462,358054,Europe
United Kingdom,02-06-2020,54984,154,561,54423,Europe
United Kingdom,02-06-2020,70765,2348,195,70570,Europe
United Kingdom,02-06-2020,293811,1116,362,293449,Europe
United Kingdom,02-06-2020,349896,1854,97,349799,Europe
United Kingdom,02-06-2020,332197,2239,1060,331137,Europe
United Kingdom,02-06-2020,28180,898,334,27846,Europe
Uruguay,02-06-2020,341507,1829,398,341109,Americas
US,02-06-2020,382571,1663,379,382192,Americas
Uzbekistan,02-06-2020,90445,1227,194,90251,Europe
Venezuela,02-06-2020,105328,685,314,105014,Americas
Vietnam,02-06-2020,96295,1040,773,95522,Western Pacific
Zambia,02-06-2020,346579,390,711,345868,Africa
Zimbabwe,02-06-2020,114718,2018,408,114310,Africa
Dominica,02-06-2020,331276,2002,132,331144,Americas
Grenada,02-06-2020,144980,1821,167,144813,Americas
Mozambique,02-06-2020,306532,1705,1018,305514,Africa
Syria,02-06-2020,80325,1075,691,79634,Eastern Mediterranean
Timor-Leste,02-06-2020,58089,1653,1039,57050,South-East Asia
Belize,02-06-2020,45356,305,1230,44126,Americas
Laos,02-06-2020,72481,247,151,72330,Western Pacific
Libya,02-06-2020,316519,641,319,316200,Eastern Mediterranean
West Bank and Gaza,02-06-2020,361990,2040,276,361714,Eastern Mediterranean
Guinea-Bissau,02-06-2020,442073,1644,720,441353,Africa
Mali,02-06-2020,170560,430,861,169699,Africa
Saint Kitts and Nevis,02-06-2020,90865,1134,8,90857,Americas
Canada,02-06-2020,184888,2484,203,184685,Americas
Canada,02-06-2020,90486,560,288,90198,Americas
Kosovo,02-06-2020,121229,897,20,121209,Europe
Burma,02-06-2020,90470,1996,234,90236,South-East Asia
United Kingdom,02-06-2020,397824,2006,23,397801,Europe
United Kingdom,02-06-2020,420164,73,1030,419134,Europe
United Kingdom,02-06-2020,7142,1440,444,6698,Europe
Botswana,02-06-2020,183765,1532,438,183327,Africa
Burundi,02-06-2020,383214,910,225,382989,Africa
Sierra Leone,02-06-2020,335936,857,766,335170,Africa
Malawi,02-06-2020,173739,1641,285,173454,Africa
United Kingdom,02-06-2020,247370,2168,624,246746,Europe
France,02-06-2020,427025,2262,130,426895,Europe
South Sudan,02-06-2020,91547,1751,843,90704,Africa
Western Sahara,02-06-2020,124312,1025,1141,123171,Africa
Sao Tome and Principe,02-06-2020,239250,387,784,238466,Africa
Yemen,02-06-2020,431501,1219,201,431300,Eastern Mediterranean
Comoros,02-06-2020,259358,498,41,259317,Africa
Tajikistan,02-06-2020,219333,178,940,218393,Europe
Lesotho,02-06-2020,375678,1624,394,375284,Africa
Afghanistan,03-06-2020,38180,1750,97,38083,Eastern Mediterranean
Albania,03-06-2020,329673,1206,755,328918,Europe
Algeria,03-06-2020,201752,2224,445,201307,Africa
Andorra,03-06-2020,145659,156,595,145064,Europe
Angola,03-06-2020,371982,1125,1235,370747,Africa
Antigua and Barbuda,03-06-2020,342296,1073,303,341993,Americas
Argentina,03-06-2020,70923,2146,244,70679,Americas
Armenia,03-06-2020,359119,691,999,358120,Europe
Australia,03-06-2020,280804,2010,339,280465,Western Pacific
Australia,03-06-2020,219184,1249,645,218539,Western Pacific
Australia,03-06-2020,351788,1219,76,351712,Western Pacific
Australia,03-06-2020,13564,1284,1172,12392,Western Pacific
Australia,03-06-2020,405969,2032,316,405653,Western Pacific
Australia,03-06-2020,378971,149,869,378102,Western Pacific
Australia,03-06-2020,270983,2326,162,270821,Western Pacific
Australia,03-06-2020,94894,206,357,94537,Western Pacific
Austria,03-06-2020,319663,308,564,319099,Europe
Azerbaijan,03-06-2020,74477,823,1201,73276,Europe
Bahamas,03-06-2020,19463,376,907,18556,Americas
Bahrain,03-06-2020,173248,2176,1,173247,Eastern Mediterranean
Bangladesh,03-06-2020,210810,245,1031,209779,South-East Asia
Barbados,03-06-2020,267982,153,901,267081,Americas
Belarus,03-06-2020,2280,2455,214,2066,Europe
Belgium,03-06-2020,345942,173,1206,344736,Europe
Benin,03-06-2020,217898,1342,1063,216835,Africa
Bhutan,03-06-2020,309173,1670,244,308929,South-East Asia
Bolivia,03-06-2020,355179,2463,837,354342,Americas
Bosnia and Herzegovina,03-06-2020,354083,1787,181,353902,Europe
Brazil,03-06-2020,146281,427,728,145553,Americas
Brunei,03-06-2020,175443,761,480,174963,Western Pacific
Bulgaria,03-06-2020,342756,2220,270,342486,Europe
Burkina Faso,03-06-2020,326667,1612,223,326444,Africa
Cabo Verde,03-06-2020,417387,358,757,416630,Africa
Cambodia,03-06-2020,130549,903,858,129691,Western Pacific
Cameroon,03-06-2020,26556,441,956,25600,Africa
Canada,03-06-2020,325430,1642,821,324609,Americas
Canada,03-06-2020,423516,1295,136,423380,Americas
Canada,03-06-2020,183546,1858,952,182594,Americas
Canada,03-06-2020,98283,781,208,98075,Americas
Canada,03-06-2020,207602,797,1141,206461,Americas
Canada,03-06-2020,75829,1195,194,75635,Americas
Canada,03-06-2020,332110,802,188,331922,Americas
Canada,03-06-2020,169486,1797,1213,168273,Americas
Canada,03-06-2020,437409,534,1032,436377,Americas
Canada,03-06-2020,211105,773,163,210942,Americas
Central African Republic,03-06-2020,118828,1464,162,118666,Africa
Chad,03-06-2020,46621,1196,155,46466,Africa
Chile,03-06-2020,203384,1527,1200,202184,Americas
China,03-06-2020,96753,1941,244,96509,Western Pacific
China,03-06-2020,122140,2381,355,121785,Western Pacific
China,03-06-2020,13181,759,400,12781,Western Pacific
China,03-06-2020,328385,1133,1114,327271,Western Pacific
China,03-06-2020,327241,155,884,326357,Western Pacific
China,03-06-2020,210220,2359,908,209312,Western Pacific
China,03-06-2020,305888,1838,58,305830,Western Pacific
China,03-06-2020,204512,2245,535,203977,Western Pacific
China,03-06-2020,118580,1293,344,118236,Western Pacific
China,03-06-2020,190170,220,505,189665,Western Pacific
China,03-06-2020,13392,2357,654,12738,Western Pacific
China,03-06-2020,34103,537,412,33691,Western Pacific
China,03-06-2020,426106,1331,722,425384,Western Pacific
China,03-06-2020,73015,1924,956,72059,Western Pacific
China,03-06-2020,99820,18,1185,98635,Western Pacific
China,03-06-2020,225449,1567,763,224686,Western Pacific
China,03-06-2020,27643,2462,448,27195,Western Pacific
China,03-06-2020,171840,928,252,171588,Western Pacific
China,03-06-2020,378259,1091,671,377588,Western Pacific
China,03-06-2020,431525,945,1002,430523,Western Pacific
China,03-06-2020,381055,1450,1183,379872,Western Pacific
China,03-06-2020,332691,2400,415,332276,Western Pacific
China,03-06-2020,23210,1135,739,22471,Western Pacific
China,03-06-2020,38401,733,1230,37171,Western Pacific
China,03-06-2020,306654,1654,1191,305463,Western Pacific
China,03-06-2020,183932,2178,361,183571,Western Pacific
China,03-06-2020,175416,1107,1153,174263,Western Pacific
China,03-06-2020,438918,1904,256,438662,Western Pacific
China,03-06-2020,240510,1765,464,240046,Western Pacific
China,03-06-2020,330600,229,1134,329466,Western Pacific
China,03-06-2020,273652,1332,1237,272415,Western Pacific
China,03-06-2020,339615,1362,1205,338410,Western Pacific
China,03-06-2020,279398,579,42,279356,Western Pacific
Colombia,03-06-2020,3128,553,580,2548,Americas
Congo (Brazzaville),03-06-2020,221502,656,526,220976,Africa
Congo (Kinshasa),03-06-2020,146655,2091,332,146323,Africa
Costa Rica,03-06-2020,364333,1127,1053,363280,Americas
Cote d'Ivoire,03-06-2020,312714,2191,91,312623,Africa
Croatia,03-06-2020,242078,301,160,241918,Europe
Cuba,03-06-2020,222420,1516,260,222160,Americas
Cyprus,03-06-2020,403106,1762,521,402585,Europe
Czechia,03-06-2020,348027,395,100,347927,Europe
Denmark,03-06-2020,321095,548,501,320594,Europe
Greenland,03-06-2020,126701,1917,927,125774,Europe
Denmark,03-06-2020,128226,1160,127,128099,Europe
Djibouti,03-06-2020,444709,709,1155,443554,Eastern Mediterranean
Dominican Republic,03-06-2020,54163,2157,547,53616,Americas
Ecuador,03-06-2020,206279,1547,287,205992,Americas
Egypt,03-06-2020,114744,667,304,114440,Eastern Mediterranean
El Salvador,03-06-2020,366002,2120,502,365500,Americas
Equatorial Guinea,03-06-2020,71782,915,516,71266,Africa
Eritrea,03-06-2020,247583,1278,1070,246513,Africa
Estonia,03-06-2020,190671,289,326,190345,Europe
Eswatini,03-06-2020,46375,1614,184,46191,Africa
Ethiopia,03-06-2020,220694,2149,952,219742,Africa
Fiji,03-06-2020,440679,2186,436,440243,Western Pacific
Finland,03-06-2020,235090,1814,357,234733,Europe
France,03-06-2020,129502,1461,607,128895,Europe
France,03-06-2020,78997,1227,363,78634,Europe
France,03-06-2020,265355,2254,1028,264327,Europe
France,03-06-2020,332225,1457,417,331808,Europe
France,03-06-2020,23381,1628,459,22922,Europe
France,03-06-2020,172911,2266,1077,171834,Europe
France,03-06-2020,51062,2274,539,50523,Europe
France,03-06-2020,21887,2117,825,21062,Europe
France,03-06-2020,56668,2489,479,56189,Europe
France,03-06-2020,209549,417,482,209067,Europe
Gabon,03-06-2020,406969,1322,150,406819,Africa
Gambia,03-06-2020,290274,745,521,289753,Africa
Georgia,03-06-2020,356219,220,550,355669,Europe
Germany,03-06-2020,400845,1664,518,400327,Europe
Ghana,03-06-2020,200364,2028,1234,199130,Africa
Greece,03-06-2020,244396,321,597,243799,Europe
Guatemala,03-06-2020,72710,265,572,72138,Americas
Guinea,03-06-2020,198634,190,404,198230,Africa
Guyana,03-06-2020,449211,2149,327,448884,Americas
Haiti,03-06-2020,330513,1318,423,330090,Americas
Holy See,03-06-2020,365285,2274,332,364953,Europe
Honduras,03-06-2020,182385,1622,937,181448,Americas
Hungary,03-06-2020,72432,1206,155,72277,Europe
Iceland,03-06-2020,348366,172,62,348304,Europe
India,03-06-2020,169254,1638,552,168702,South-East Asia
Indonesia,03-06-2020,423684,211,655,423029,South-East Asia
Iran,03-06-2020,111260,239,1074,110186,Eastern Mediterranean
Iraq,03-06-2020,367909,838,866,367043,Eastern Mediterranean
Ireland,03-06-2020,60862,1062,184,60678,Europe
Israel,03-06-2020,107165,842,360,106805,Europe
Italy,03-06-2020,54013,2217,1137,52876,Europe
Jamaica,03-06-2020,204460,317,539,203921,Americas
Japan,03-06-2020,198746,2258,867,197879,Western Pacific
Jordan,03-06-2020,243939,2280,785,243154,Eastern Mediterranean
Kazakhstan,03-06-2020,61909,1644,873,61036,Europe
Kenya,03-06-2020,417070,1824,1050,416020,Africa
South Korea,03-06-2020,295253,473,410,294843,Western Pacific
Kuwait,03-06-2020,263136,969,404,262732,Eastern Mediterranean
Kyrgyzstan,03-06-2020,46283,713,1065,45218,Europe
Latvia,03-06-2020,11214,411,823,10391,Europe
Lebanon,03-06-2020,424602,965,493,424109,Eastern Mediterranean
Liberia,03-06-2020,449714,1132,23,449691,Africa
Liechtenstein,03-06-2020,436244,2212,1151,435093,Europe
Lithuania,03-06-2020,89748,1793,468,89280,Europe
Luxembourg,03-06-2020,125108,1670,401,124707,Europe
Madagascar,03-06-2020,304602,2091,218,304384,Africa
Malaysia,03-06-2020,181363,2063,1040,180323,Western Pacific
Maldives,03-06-2020,99310,401,32,99278,South-East Asia
Malta,03-06-2020,272681,2499,1101,271580,Europe
Mauritania,03-06-2020,30266,1986,803,29463,Africa
Mauritius,03-06-2020,128610,200,124,128486,Africa
Mexico,03-06-2020,47354,1788,1172,46182,Americas
Moldova,03-06-2020,222527,665,574,221953,Europe
Monaco,03-06-2020,81320,492,878,80442,Europe
Mongolia,03-06-2020,239838,256,18,239820,Western Pacific
Montenegro,03-06-2020,53839,413,1043,52796,Europe
Morocco,03-06-2020,271474,2411,986,270488,Eastern Mediterranean
Namibia,03-06-2020,262716,231,611,262105,Africa
Nepal,03-06-2020,97592,2425,91,97501,South-East Asia
Netherlands,03-06-2020,106667,2050,1037,105630,Europe
Netherlands,03-06-2020,28016,116,977,27039,Europe
Netherlands,03-06-2020,147405,62,214,147191,Europe
Netherlands,03-06-2020,110142,1518,781,109361,Europe
New Zealand,03-06-2020,265970,1067,35,265935,Western Pacific
Nicaragua,03-06-2020,432831,2460,545,432286,Americas
Niger,03-06-2020,281899,1009,1115,280784,Africa
Nigeria,03-06-2020,379402,1279,274,379128,Africa
North Macedonia,03-06-2020,324336,1472,79,324257,Europe
Norway,03-06-2020,68402,140,557,67845,Europe
Oman,03-06-2020,344989,1397,917,344072,Eastern Mediterranean
Pakistan,03-06-2020,108274,769,463,107811,Eastern Mediterranean
Panama,03-06-2020,94548,1861,1071,93477,Americas
Papua New Guinea,03-06-2020,50336,1539,728,49608,Western Pacific
Paraguay,03-06-2020,247140,2155,528,246612,Americas
Peru,03-06-2020,271114,659,1059,270055,Americas
Philippines,03-06-2020,208375,1767,623,207752,Western Pacific
Poland,03-06-2020,109397,1806,1008,108389,Europe
Portugal,03-06-2020,447295,252,460,446835,Europe
Qatar,03-06-2020,221318,198,591,220727,Eastern Mediterranean
Romania,03-06-2020,417345,1752,88,417257,Europe
Russia,03-06-2020,166098,2255,258,165840,Europe
Rwanda,03-06-2020,137212,1446,1173,136039,Africa
Saint Lucia,03-06-2020,434311,709,684,433627,Americas
Saint Vincent and the Grenadines,03-06-2020,119855,1281,1098,118757,Americas
San Marino,03-06-2020,158819,1861,151,158668,Europe
Saudi Arabia,03-06-2020,422933,1692,683,422250,Eastern Mediterranean
Senegal,03-06-2020,263273,1654,828,262445,Africa
Serbia,03-06-2020,90587,662,146,90441,Europe
Seychelles,03-06-2020,36903,702,645,36258,Africa
Singapore,03-06-2020,59899,1754,443,59456,Western Pacific
Slovakia,03-06-2020,262042,104,666,261376,Europe
Slovenia,03-06-2020,11117,1584,212,10905,Europe
Somalia,03-06-2020,190518,166,92,190426,Eastern Mediterranean
South Africa,03-06-2020,309320,1684,830,308490,Africa
Spain,03-06-2020,259432,2367,188,259244,Europe
Sri Lanka,03-06-2020,22522,55,184,22338,South-East Asia
Sudan,03-06-2020,304760,2458,1015,303745,Eastern Mediterranean
Suriname,03-06-2020,357457,945,496,356961,Americas
Sweden,03-06-2020,282202,585,40,282162,Europe
Switzerland,03-06-2020,223621,1585,368,223253,Europe
Taiwan*,03-06-2020,187562,1773,872,186690,Western Pacific
Tanzania,03-06-2020,251121,471,1056,250065,Africa
Thailand,03-06-2020,183653,273,515,183138,South-East Asia
Togo,03-06-2020,237759,419,574,237185,Africa
Trinidad and Tobago,03-06-2020,65706,2062,201,65505,Americas
Tunisia,03-06-2020,201937,1432,1187,200750,Eastern Mediterranean
Turkey,03-06-2020,106817,2409,321,106496,Europe
Uganda,03-06-2020,290004,1963,477,289527,Africa
Ukraine,03-06-2020,7512,1624,440,7072,Europe
United Arab Emirates,03-06-2020,31411,133,337,31074,Eastern Mediterranean
United Kingdom,03-06-2020,18180,1097,224,17956,Europe
United Kingdom,03-06-2020,304583,1475,893,303690,Europe
United Kingdom,03-06-2020,166884,1298,960,165924,Europe
United Kingdom,03-06-2020,29096,1888,857,28239,Europe
United Kingdom,03-06-2020,238531,409,1140,237391,Europe
United Kingdom,03-06-2020,224277,1778,1126,223151,Europe
United Kingdom,03-06-2020,49683,779,248,49435,Europe
Uruguay,03-06-2020,208328,180,807,207521,Americas
US,03-06-2020,185801,717,193,185608,Americas
Uzbekistan,03-06-2020,410842,2412,511,410331,Europe
Venezuela,03-06-2020,382290,841,819,381471,Americas
Vietnam,03-06-2020,199601,1404,993,198608,Western Pacific
Zambia,03-06-2020,213435,822,816,212619,Africa
Zimbabwe,03-06-2020,220039,1356,408,219631,Africa
Dominica,03-06-2020,179869,378,495,179374,Americas
Grenada,03-06-2020,330757,1429,806,329951,Americas
Mozambique,03-06-2020,77094,859,964,76130,Africa
Syria,03-06-2020,409616,1757,67,409549,Eastern Mediterranean
Timor-Leste,03-06-2020,297822,2403,832,296990,South-East Asia
Belize,03-06-2020,200002,1971,884,199118,Americas
Laos,03-06-2020,389835,1432,336,389499,Western Pacific
Libya,03-06-2020,428127,2299,494,427633,Eastern Mediterranean
West Bank and Gaza,03-06-2020,184172,1776,1189,182983,Eastern Mediterranean
Guinea-Bissau,03-06-2020,420701,1931,361,420340,Africa
Mali,03-06-2020,32658,1608,1162,31496,Africa
Saint Kitts and Nevis,03-06-2020,276675,713,775,275900,Americas
Canada,03-06-2020,190941,719,1053,189888,Americas
Canada,03-06-2020,25545,760,624,24921,Americas
Kosovo,03-06-2020,321016,826,127,320889,Europe
Burma,03-06-2020,18783,856,429,18354,South-East Asia
United Kingdom,03-06-2020,363127,1097,259,362868,Europe
United Kingdom,03-06-2020,179456,192,58,179398,Europe
United Kingdom,03-06-2020,326558,290,683,325875,Europe
Botswana,03-06-2020,24114,435,933,23181,Africa
Burundi,03-06-2020,307923,2014,640,307283,Africa
Sierra Leone,03-06-2020,122410,2366,1025,121385,Africa
Malawi,03-06-2020,130740,1161,80,130660,Africa
United Kingdom,03-06-2020,291110,1216,947,290163,Europe
France,03-06-2020,209552,1366,950,208602,Europe
South Sudan,03-06-2020,315481,645,930,314551,Africa
Western Sahara,03-06-2020,332540,431,519,332021,Africa
Sao Tome and Principe,03-06-2020,125364,837,911,124453,Africa
Yemen,03-06-2020,67510,607,743,66767,Eastern Mediterranean
Comoros,03-06-2020,397708,2006,619,397089,Africa
Tajikistan,03-06-2020,141203,1973,514,140689,Europe
Lesotho,03-06-2020,18669,1265,822,17847,Africa
Afghanistan,04-06-2020,83890,182,265,83625,Eastern Mediterranean
Albania,04-06-2020,348458,787,669,347789,Europe
Algeria,04-06-2020,73530,695,308,73222,Africa
Andorra,04-06-2020,199902,980,1185,198717,Europe
Angola,04-06-2020,215200,877,251,214949,Africa
Antigua and Barbuda,04-06-2020,240884,605,674,240210,Americas
Argentina,04-06-2020,341845,803,491,341354,Americas
Armenia,04-06-2020,148863,999,107,148756,Europe
Australia,04-06-2020,135261,1084,546,134715,Western Pacific
Australia,04-06-2020,121497,605,896,120601,Western Pacific
Australia,04-06-2020,396678,1364,338,396340,Western Pacific
Australia,04-06-2020,355866,769,154,355712,Western Pacific
Australia,04-06-2020,310586,1963,453,310133,Western Pacific
Australia,04-06-2020,392806,1741,422,392384,Western Pacific
Australia,04-06-2020,417823,2214,857,416966,Western Pacific
Australia,04-06-2020,442171,2118,427,441744,Western Pacific
Austria,04-06-2020,110441,2371,268,110173,Europe
Azerbaijan,04-06-2020,53695,2271,835,52860,Europe
Bahamas,04-06-2020,53195,779,1051,52144,Americas
Bahrain,04-06-2020,157259,1360,588,156671,Eastern Mediterranean
Bangladesh,04-06-2020,121896,554,630,121266,South-East Asia
Barbados,04-06-2020,336978,1195,317,336661,Americas
Belarus,04-06-2020,111501,721,445,111056,Europe
Belgium,04-06-2020,39659,1351,1119,38540,Europe
Benin,04-06-2020,379083,1527,709,378374,Africa
Bhutan,04-06-2020,80494,582,239,80255,South-East Asia
Bolivia,04-06-2020,405464,789,860,404604,Americas
Bosnia and Herzegovina,04-06-2020,135708,1172,410,135298,Europe
Brazil,04-06-2020,142466,898,1010,141456,Americas
Brunei,04-06-2020,402650,523,282,402368,Western Pacific
Bulgaria,04-06-2020,36147,1583,491,35656,Europe
Burkina Faso,04-06-2020,16324,412,609,15715,Africa
Cabo Verde,04-06-2020,243526,768,682,242844,Africa
Cambodia,04-06-2020,11892,1214,233,11659,Western Pacific
Cameroon,04-06-2020,416880,1153,172,416708,Africa
Canada,04-06-2020,74874,1014,980,73894,Americas
Canada,04-06-2020,436521,2412,215,436306,Americas
Canada,04-06-2020,300103,387,52,300051,Americas
Canada,04-06-2020,383946,475,321,383625,Americas
Canada,04-06-2020,97943,2053,947,96996,Americas
Canada,04-06-2020,371368,756,597,370771,Americas
Canada,04-06-2020,431114,897,705,430409,Americas
Canada,04-06-2020,101989,1580,997,100992,Americas
Canada,04-06-2020,395202,1695,25,395177,Americas
Canada,04-06-2020,435641,837,1025,434616,Americas
Central African Republic,04-06-2020,3166,2147,597,2569,Africa
Chad,04-06-2020,244866,1945,39,244827,Africa
Chile,04-06-2020,410401,247,679,409722,Americas
China,04-06-2020,36739,766,1004,35735,Western Pacific
China,04-06-2020,39975,870,743,39232,Western Pacific
China,04-06-2020,45409,844,613,44796,Western Pacific
China,04-06-2020,125633,1255,322,125311,Western Pacific
China,04-06-2020,335914,615,632,335282,Western Pacific
China,04-06-2020,257778,1141,974,256804,Western Pacific
China,04-06-2020,7986,2439,199,7787,Western Pacific
China,04-06-2020,129715,1201,1181,128534,Western Pacific
China,04-06-2020,225407,746,995,224412,Western Pacific
China,04-06-2020,432963,1248,796,432167,Western Pacific
China,04-06-2020,298250,869,968,297282,Western Pacific
China,04-06-2020,237054,2199,804,236250,Western Pacific
China,04-06-2020,191884,536,1141,190743,Western Pacific
China,04-06-2020,60790,1074,168,60622,Western Pacific
China,04-06-2020,158496,1191,1177,157319,Western Pacific
China,04-06-2020,360799,1549,662,360137,Western Pacific
China,04-06-2020,169016,49,984,168032,Western Pacific
China,04-06-2020,379522,1482,906,378616,Western Pacific
China,04-06-2020,224718,2171,113,224605,Western Pacific
China,04-06-2020,242229,1664,58,242171,Western Pacific
China,04-06-2020,359113,1607,576,358537,Western Pacific
China,04-06-2020,8485,2349,367,8118,Western Pacific
China,04-06-2020,122713,2050,340,122373,Western Pacific
China,04-06-2020,213474,2235,118,213356,Western Pacific
China,04-06-2020,204965,1334,1233,203732,Western Pacific
China,04-06-2020,92423,313,279,92144,Western Pacific
China,04-06-2020,208290,681,595,207695,Western Pacific
China,04-06-2020,113201,1058,245,112956,Western Pacific
China,04-06-2020,173524,1665,786,172738,Western Pacific
China,04-06-2020,21463,1923,375,21088,Western Pacific
China,04-06-2020,147219,1191,884,146335,Western Pacific
China,04-06-2020,439530,1573,105,439425,Western Pacific
China,04-06-2020,1826,0,1210,616,Western Pacific
Colombia,04-06-2020,282639,759,862,281777,Americas
Congo (Brazzaville),04-06-2020,405788,1870,911,404877,Africa
Congo (Kinshasa),04-06-2020,327002,1296,310,326692,Africa
Costa Rica,04-06-2020,19586,1919,1082,18504,Americas
Cote d'Ivoire,04-06-2020,262073,2110,360,261713,Africa
Croatia,04-06-2020,223363,1459,1190,222173,Europe
Cuba,04-06-2020,13250,2290,249,13001,Americas
Cyprus,04-06-2020,352544,2403,825,351719,Europe
Czechia,04-06-2020,246319,396,1022,245297,Europe
Denmark,04-06-2020,162635,1602,1120,161515,Europe
Greenland,04-06-2020,128356,1791,471,127885,Europe
Denmark,04-06-2020,215547,2174,613,214934,Europe
Djibouti,04-06-2020,444293,848,567,443726,Eastern Mediterranean
Dominican Republic,04-06-2020,166152,864,850,165302,Americas
Ecuador,04-06-2020,305419,829,1081,304338,Americas
Egypt,04-06-2020,314156,2157,489,313667,Eastern Mediterranean
El Salvador,04-06-2020,337407,2486,288,337119,Americas
Equatorial Guinea,04-06-2020,344044,340,403,343641,Africa
Eritrea,04-06-2020,27812,1388,690,27122,Africa
Estonia,04-06-2020,89138,1956,580,88558,Europe
Eswatini,04-06-2020,141900,2488,932,140968,Africa
Ethiopia,04-06-2020,318284,238,322,317962,Africa
Fiji,04-06-2020,76421,2412,511,75910,Western Pacific
Finland,04-06-2020,61535,283,642,60893,Europe
France,04-06-2020,402298,1404,257,402041,Europe
France,04-06-2020,196768,148,1250,195518,Europe
France,04-06-2020,231588,651,961,230627,Europe
France,04-06-2020,227983,555,1011,226972,Europe
France,04-06-2020,219644,646,130,219514,Europe
France,04-06-2020,217955,452,302,217653,Europe
France,04-06-2020,243919,1933,719,243200,Europe
France,04-06-2020,53032,1474,211,52821,Europe
France,04-06-2020,433139,390,205,432934,Europe
France,04-06-2020,60328,1092,1019,59309,Europe
Gabon,04-06-2020,172710,2256,384,172326,Africa
Gambia,04-06-2020,392847,1435,312,392535,Africa
Georgia,04-06-2020,402365,1757,590,401775,Europe
Germany,04-06-2020,402813,1110,1212,401601,Europe
Ghana,04-06-2020,249414,1210,471,248943,Africa
Greece,04-06-2020,58324,1702,774,57550,Europe
Guatemala,04-06-2020,337154,263,557,336597,Americas
Guinea,04-06-2020,390005,2037,601,389404,Africa
Guyana,04-06-2020,278262,840,400,277862,Americas
Haiti,04-06-2020,355133,934,883,354250,Americas
Holy See,04-06-2020,150325,1375,637,149688,Europe
Honduras,04-06-2020,351081,2362,511,350570,Americas
Hungary,04-06-2020,266839,1626,101,266738,Europe
Iceland,04-06-2020,89771,601,895,88876,Europe
India,04-06-2020,252346,1167,1100,251246,South-East Asia
Indonesia,04-06-2020,59765,156,1008,58757,South-East Asia
Iran,04-06-2020,165429,822,15,165414,Eastern Mediterranean
Iraq,04-06-2020,172815,486,379,172436,Eastern Mediterranean
Ireland,04-06-2020,169812,64,739,169073,Europe
Israel,04-06-2020,24342,1586,451,23891,Europe
Italy,04-06-2020,119577,221,797,118780,Europe
Jamaica,04-06-2020,438207,1685,61,438146,Americas
Japan,04-06-2020,449915,2271,1121,448794,Western Pacific
Jordan,04-06-2020,109492,234,1028,108464,Eastern Mediterranean
Kazakhstan,04-06-2020,247913,1397,125,247788,Europe
Kenya,04-06-2020,407171,446,790,406381,Africa
South Korea,04-06-2020,98378,794,544,97834,Western Pacific
Kuwait,04-06-2020,376070,1311,614,375456,Eastern Mediterranean
Kyrgyzstan,04-06-2020,226303,1475,479,225824,Europe
Latvia,04-06-2020,369145,2166,882,368263,Europe
Lebanon,04-06-2020,145765,1211,614,145151,Eastern Mediterranean
Liberia,04-06-2020,45486,774,418,45068,Africa
Liechtenstein,04-06-2020,28793,2104,900,27893,Europe
Lithuania,04-06-2020,3121,1583,69,3052,Europe
Luxembourg,04-06-2020,278678,1056,544,278134,Europe
Madagascar,04-06-2020,39838,505,700,39138,Africa
Malaysia,04-06-2020,62155,1556,961,61194,Western Pacific
Maldives,04-06-2020,317525,1732,943,316582,South-East Asia
Malta,04-06-2020,18008,204,305,17703,Europe
Mauritania,04-06-2020,339561,707,156,339405,Africa
Mauritius,04-06-2020,39058,144,1082,37976,Africa
Mexico,04-06-2020,334754,2457,483,334271,Americas
Moldova,04-06-2020,414114,2190,832,413282,Europe
Monaco,04-06-2020,17124,1478,712,16412,Europe
Mongolia,04-06-2020,51580,964,698,50882,Western Pacific
Montenegro,04-06-2020,209668,1618,803,208865,Europe
Morocco,04-06-2020,65778,425,800,64978,Eastern Mediterranean
Namibia,04-06-2020,356102,1144,415,355687,Africa
Nepal,04-06-2020,181059,2321,979,180080,South-East Asia
Netherlands,04-06-2020,313088,1361,569,312519,Europe
Netherlands,04-06-2020,441287,663,932,440355,Europe
Netherlands,04-06-2020,69221,469,1083,68138,Europe
Netherlands,04-06-2020,31842,825,436,31406,Europe
New Zealand,04-06-2020,18921,351,266,18655,Western Pacific
Nicaragua,04-06-2020,411507,616,1045,410462,Americas
Niger,04-06-2020,368918,1103,120,368798,Africa
Nigeria,04-06-2020,144511,1228,1078,143433,Africa
North Macedonia,04-06-2020,250002,1991,1129,248873,Europe
Norway,04-06-2020,195899,867,1149,194750,Europe
Oman,04-06-2020,130727,1782,685,130042,Eastern Mediterranean
Pakistan,04-06-2020,64000,1092,479,63521,Eastern Mediterranean
Panama,04-06-2020,113005,1565,735,112270,Americas
Papua New Guinea,04-06-2020,113041,961,1209,111832,Western Pacific
Paraguay,04-06-2020,170981,2142,1024,169957,Americas
Peru,04-06-2020,57138,1702,1154,55984,Americas
Philippines,04-06-2020,156450,1122,350,156100,Western Pacific
Poland,04-06-2020,124053,307,1248,122805,Europe
Portugal,04-06-2020,208676,280,1064,207612,Europe
Qatar,04-06-2020,141133,1846,171,140962,Eastern Mediterranean
Romania,04-06-2020,379665,326,1032,378633,Europe
Russia,04-06-2020,58240,1720,292,57948,Europe
Rwanda,04-06-2020,303280,1978,258,303022,Africa
Saint Lucia,04-06-2020,182296,246,975,181321,Americas
Saint Vincent and the Grenadines,04-06-2020,323501,627,1092,322409,Americas
San Marino,04-06-2020,114108,432,392,113716,Europe
Saudi Arabia,04-06-2020,395554,1763,840,394714,Eastern Mediterranean
Senegal,04-06-2020,237838,460,788,237050,Africa
Serbia,04-06-2020,425993,1848,628,425365,Europe
Seychelles,04-06-2020,299965,758,498,299467,Africa
Singapore,04-06-2020,419266,870,895,418371,Western Pacific
Slovakia,04-06-2020,78787,1676,136,78651,Europe
Slovenia,04-06-2020,18472,2344,1025,17447,Europe
Somalia,04-06-2020,383116,1667,1099,382017,Eastern Mediterranean
South Africa,04-06-2020,44929,1609,48,44881,Africa
Spain,04-06-2020,96009,114,785,95224,Europe
Sri Lanka,04-06-2020,277193,1321,436,276757,South-East Asia
Sudan,04-06-2020,129527,2312,12,129515,Eastern Mediterranean
Suriname,04-06-2020,41419,2185,831,40588,Americas
Sweden,04-06-2020,418082,1177,152,417930,Europe
Switzerland,04-06-2020,33559,2218,494,33065,Europe
Taiwan*,04-06-2020,425095,79,364,424731,Western Pacific
Tanzania,04-06-2020,97268,149,194,97074,Africa
Thailand,04-06-2020,131093,2416,766,130327,South-East Asia
Togo,04-06-2020,288683,1168,431,288252,Africa
Trinidad and Tobago,04-06-2020,207305,194,615,206690,Americas
Tunisia,04-06-2020,297952,1450,747,297205,Eastern Mediterranean
Turkey,04-06-2020,254072,2329,319,253753,Europe
Uganda,04-06-2020,270065,1292,54,270011,Africa
Ukraine,04-06-2020,26285,541,788,25497,Europe
United Arab Emirates,04-06-2020,319770,2296,863,318907,Eastern Mediterranean
United Kingdom,04-06-2020,260803,87,1154,259649,Europe
United Kingdom,04-06-2020,232292,1525,297,231995,Europe
United Kingdom,04-06-2020,53115,164,287,52828,Europe
United Kingdom,04-06-2020,332498,1650,3,332495,Europe
United Kingdom,04-06-2020,132105,1865,1109,130996,Europe
United Kingdom,04-06-2020,112212,1789,170,112042,Europe
United Kingdom,04-06-2020,182487,2313,809,181678,Europe
Uruguay,04-06-2020,285855,1088,263,285592,Americas
US,04-06-2020,322785,1783,97,322688,Americas
Uzbekistan,04-06-2020,442282,847,226,442056,Europe
Venezuela,04-06-2020,187021,542,921,186100,Americas
Vietnam,04-06-2020,25478,1266,1016,24462,Western Pacific
Zambia,04-06-2020,4994,81,326,4668,Africa
Zimbabwe,04-06-2020,283714,1587,960,282754,Africa
Dominica,04-06-2020,101952,143,562,101390,Americas
Grenada,04-06-2020,209321,1764,525,208796,Americas
Mozambique,04-06-2020,432134,1312,1172,430962,Africa
Syria,04-06-2020,197221,2350,283,196938,Eastern Mediterranean
Timor-Leste,04-06-2020,166398,2004,271,166127,South-East Asia
Belize,04-06-2020,334051,727,583,333468,Americas
Laos,04-06-2020,301262,1564,120,301142,Western Pacific
Libya,04-06-2020,61785,2290,469,61316,Eastern Mediterranean
West Bank and Gaza,04-06-2020,115160,1340,713,114447,Eastern Mediterranean
Guinea-Bissau,04-06-2020,238384,1274,759,237625,Africa
Mali,04-06-2020,377934,750,1237,376697,Africa
Saint Kitts and Nevis,04-06-2020,303225,2122,1038,302187,Americas
Canada,04-06-2020,135504,2414,1031,134473,Americas
Canada,04-06-2020,206867,805,730,206137,Americas
Kosovo,04-06-2020,382721,672,1119,381602,Europe
Burma,04-06-2020,116725,2429,938,115787,South-East Asia
United Kingdom,04-06-2020,64470,1520,851,63619,Europe
United Kingdom,04-06-2020,120744,482,138,120606,Europe
United Kingdom,04-06-2020,111180,1932,728,110452,Europe
Botswana,04-06-2020,449485,774,474,449011,Africa
Burundi,04-06-2020,446779,1328,618,446161,Africa
Sierra Leone,04-06-2020,254306,207,609,253697,Africa
Malawi,04-06-2020,188902,1137,1208,187694,Africa
United Kingdom,04-06-2020,229798,36,1079,228719,Europe
France,04-06-2020,166280,1449,983,165297,Europe
South Sudan,04-06-2020,127542,1167,312,127230,Africa
Western Sahara,04-06-2020,176572,2379,838,175734,Africa
Sao Tome and Principe,04-06-2020,291965,2225,683,291282,Africa
Yemen,04-06-2020,447080,184,77,447003,Eastern Mediterranean
Comoros,04-06-2020,142960,645,884,142076,Africa
Tajikistan,04-06-2020,99406,1700,670,98736,Europe
Lesotho,04-06-2020,301605,684,897,300708,Africa
Afghanistan,05-06-2020,276333,584,1016,275317,Eastern Mediterranean
Albania,05-06-2020,192739,979,967,191772,Europe
Algeria,05-06-2020,128034,1585,927,127107,Africa
Andorra,05-06-2020,413710,338,1197,412513,Europe
Angola,05-06-2020,151291,2378,613,150678,Africa
Antigua and Barbuda,05-06-2020,414861,1334,929,413932,Americas
Argentina,05-06-2020,374749,881,788,373961,Americas
Armenia,05-06-2020,24409,96,1098,23311,Europe
Australia,05-06-2020,446478,1220,440,446038,Western Pacific
Australia,05-06-2020,138055,1522,765,137290,Western Pacific
Australia,05-06-2020,382848,691,790,382058,Western Pacific
Australia,05-06-2020,114865,51,979,113886,Western Pacific
Australia,05-06-2020,291512,993,318,291194,Western Pacific
Australia,05-06-2020,220839,763,126,220713,Western Pacific
Australia,05-06-2020,26647,544,769,25878,Western Pacific
Australia,05-06-2020,272537,2386,437,272100,Western Pacific
Austria,05-06-2020,298586,2238,1084,297502,Europe
Azerbaijan,05-06-2020,357684,1993,537,357147,Europe
Bahamas,05-06-2020,212031,131,188,211843,Americas
Bahrain,05-06-2020,175655,2431,1099,174556,Eastern Mediterranean
Bangladesh,05-06-2020,148656,2414,454,148202,South-East Asia
Barbados,05-06-2020,228561,1937,1196,227365,Americas
Belarus,05-06-2020,235335,425,139,235196,Europe
Belgium,05-06-2020,435754,1489,504,435250,Europe
Benin,05-06-2020,319172,1866,1097,318075,Africa
Bhutan,05-06-2020,395863,597,76,395787,South-East Asia
Bolivia,05-06-2020,212410,2412,269,212141,Americas
Bosnia and Herzegovina,05-06-2020,137628,33,972,136656,Europe
Brazil,05-06-2020,303146,752,285,302861,Americas
Brunei,05-06-2020,419175,550,508,418667,Western Pacific
Bulgaria,05-06-2020,278773,242,259,278514,Europe
Burkina Faso,05-06-2020,73317,1479,1148,72169,Africa
Cabo Verde,05-06-2020,47995,278,792,47203,Africa
Cambodia,05-06-2020,104490,2254,940,103550,Western Pacific
Cameroon,05-06-2020,212722,983,759,211963,Africa
Canada,05-06-2020,424383,1869,710,423673,Americas
Canada,05-06-2020,323932,196,1250,322682,Americas
Canada,05-06-2020,294132,1405,477,293655,Americas
Canada,05-06-2020,91699,2340,456,91243,Americas
Canada,05-06-2020,441224,713,836,440388,Americas
Canada,05-06-2020,192009,285,873,191136,Americas
Canada,05-06-2020,360165,239,500,359665,Americas
Canada,05-06-2020,271399,919,335,271064,Americas
Canada,05-06-2020,54005,1396,706,53299,Americas
Canada,05-06-2020,303182,854,410,302772,Americas
Central African Republic,05-06-2020,151137,1651,1094,150043,Africa
Chad,05-06-2020,236165,1403,1139,235026,Africa
Chile,05-06-2020,78662,1689,234,78428,Americas
China,05-06-2020,252559,8,618,251941,Western Pacific
China,05-06-2020,252915,2125,295,252620,Western Pacific
China,05-06-2020,21794,1304,80,21714,Western Pacific
China,05-06-2020,382133,304,1212,380921,Western Pacific
China,05-06-2020,403398,1653,1216,402182,Western Pacific
China,05-06-2020,62819,2496,271,62548,Western Pacific
China,05-06-2020,139178,1811,975,138203,Western Pacific
China,05-06-2020,439701,1095,1189,438512,Western Pacific
China,05-06-2020,105946,52,907,105039,Western Pacific
China,05-06-2020,28902,520,1231,27671,Western Pacific
China,05-06-2020,217576,654,1073,216503,Western Pacific
China,05-06-2020,326946,1925,436,326510,Western Pacific
China,05-06-2020,220547,1904,443,220104,Western Pacific
China,05-06-2020,308440,2151,1156,307284,Western Pacific
China,05-06-2020,224846,1196,283,224563,Western Pacific
China,05-06-2020,354176,124,164,354012,Western Pacific
China,05-06-2020,426826,870,367,426459,Western Pacific
China,05-06-2020,367711,2267,277,367434,Western Pacific
China,05-06-2020,415116,2186,1130,413986,Western Pacific
China,05-06-2020,421871,17,1240,420631,Western Pacific
China,05-06-2020,395840,1018,619,395221,Western Pacific
China,05-06-2020,112234,892,839,111395,Western Pacific
China,05-06-2020,209417,1992,1159,208258,Western Pacific
China,05-06-2020,244579,638,441,244138,Western Pacific
China,05-06-2020,315972,1869,547,315425,Western Pacific
China,05-06-2020,229446,1804,378,229068,Western Pacific
China,05-06-2020,13388,524,431,12957,Western Pacific
China,05-06-2020,436797,1247,915,435882,Western Pacific
China,05-06-2020,438377,2101,1114,437263,Western Pacific
China,05-06-2020,371520,2479,570,370950,Western Pacific
China,05-06-2020,302950,2239,646,302304,Western Pacific
China,05-06-2020,257614,142,409,257205,Western Pacific
China,05-06-2020,71712,1296,311,71401,Western Pacific
Colombia,05-06-2020,405666,1015,798,404868,Americas
Congo (Brazzaville),05-06-2020,427555,1322,450,427105,Africa
Congo (Kinshasa),05-06-2020,364820,644,461,364359,Africa
Costa Rica,05-06-2020,12659,1161,131,12528,Americas
Cote d'Ivoire,05-06-2020,7560,188,688,6872,Africa
Croatia,05-06-2020,267079,446,8,267071,Europe
Cuba,05-06-2020,21676,691,847,20829,Americas
Cyprus,05-06-2020,271350,1989,1032,270318,Europe
Czechia,05-06-2020,104193,1243,415,103778,Europe
Denmark,05-06-2020,376593,881,40,376553,Europe
Greenland,05-06-2020,115581,2074,88,115493,Europe
Denmark,05-06-2020,317436,2013,689,316747,Europe
Djibouti,05-06-2020,101630,2082,419,101211,Eastern Mediterranean
Dominican Republic,05-06-2020,186396,2244,888,185508,Americas
Ecuador,05-06-2020,152785,946,482,152303,Americas
Egypt,05-06-2020,421041,2310,1171,419870,Eastern Mediterranean
El Salvador,05-06-2020,106771,960,779,105992,Americas
Equatorial Guinea,05-06-2020,149673,917,238,149435,Africa
Eritrea,05-06-2020,284602,220,294,284308,Africa
Estonia,05-06-2020,373806,1687,386,373420,Europe
Eswatini,05-06-2020,22543,1238,112,22431,Africa
Ethiopia,05-06-2020,79207,1158,380,78827,Africa
Fiji,05-06-2020,291497,1149,965,290532,Western Pacific
Finland,05-06-2020,407381,1252,1206,406175,Europe
France,05-06-2020,8598,914,346,8252,Europe
France,05-06-2020,42978,266,165,42813,Europe
France,05-06-2020,191744,2465,36,191708,Europe
France,05-06-2020,379301,1168,961,378340,Europe
France,05-06-2020,252344,2390,998,251346,Europe
France,05-06-2020,9718,483,294,9424,Europe
France,05-06-2020,291152,1401,898,290254,Europe
France,05-06-2020,288792,2364,838,287954,Europe
France,05-06-2020,121141,1264,1097,120044,Europe
France,05-06-2020,212524,1616,680,211844,Europe
Gabon,05-06-2020,72099,146,681,71418,Africa
Gambia,05-06-2020,268752,725,1112,267640,Africa
Georgia,05-06-2020,347314,1073,39,347275,Europe
Germany,05-06-2020,269864,1391,434,269430,Europe
Ghana,05-06-2020,41650,1397,1232,40418,Africa
Greece,05-06-2020,328973,935,1231,327742,Europe
Guatemala,05-06-2020,19995,1162,321,19674,Americas
Guinea,05-06-2020,420986,2056,193,420793,Africa
Guyana,05-06-2020,89814,1497,929,88885,Americas
Haiti,05-06-2020,229733,2483,253,229480,Americas
Holy See,05-06-2020,100386,459,751,99635,Europe
Honduras,05-06-2020,243738,2229,872,242866,Americas
Hungary,05-06-2020,288744,985,696,288048,Europe
Iceland,05-06-2020,64432,1835,787,63645,Europe
India,05-06-2020,231791,169,1241,230550,South-East Asia
Indonesia,05-06-2020,52303,554,254,52049,South-East Asia
Iran,05-06-2020,259210,245,1249,257961,Eastern Mediterranean
Iraq,05-06-2020,365349,2100,394,364955,Eastern Mediterranean
Ireland,05-06-2020,384066,828,329,383737,Europe
Israel,05-06-2020,17199,569,956,16243,Europe
Italy,05-06-2020,96536,1257,1128,95408,Europe
Jamaica,05-06-2020,39028,1036,130,38898,Americas
Japan,05-06-2020,21674,2103,91,21583,Western Pacific
Jordan,05-06-2020,304906,2253,574,304332,Eastern Mediterranean
Kazakhstan,05-06-2020,360968,1637,101,360867,Europe
Kenya,05-06-2020,96832,657,1204,95628,Africa
South Korea,05-06-2020,199791,2481,153,199638,Western Pacific
Kuwait,05-06-2020,407492,2392,81,407411,Eastern Mediterranean
Kyrgyzstan,05-06-2020,189475,533,990,188485,Europe
Latvia,05-06-2020,156946,922,633,156313,Europe
Lebanon,05-06-2020,269378,611,1150,268228,Eastern Mediterranean
Liberia,05-06-2020,227380,1905,511,226869,Africa
Liechtenstein,05-06-2020,307861,1793,209,307652,Europe
Lithuania,05-06-2020,116327,1468,682,115645,Europe
Luxembourg,05-06-2020,411663,954,10,411653,Europe
Madagascar,05-06-2020,422953,2177,1170,421783,Africa
Malaysia,05-06-2020,427073,486,503,426570,Western Pacific
Maldives,05-06-2020,239425,994,199,239226,South-East Asia
Malta,05-06-2020,195052,888,632,194420,Europe
Mauritania,05-06-2020,406013,2461,128,405885,Africa
Mauritius,05-06-2020,278858,2143,334,278524,Africa
Mexico,05-06-2020,212093,1530,301,211792,Americas
Moldova,05-06-2020,379709,372,240,379469,Europe
Monaco,05-06-2020,190236,2413,772,189464,Europe
Mongolia,05-06-2020,222781,190,417,222364,Western Pacific
Montenegro,05-06-2020,168432,533,658,167774,Europe
Morocco,05-06-2020,390649,785,1224,389425,Eastern Mediterranean
Namibia,05-06-2020,351703,42,164,351539,Africa
Nepal,05-06-2020,357411,1552,1004,356407,South-East Asia
Netherlands,05-06-2020,116365,1696,1063,115302,Europe
Netherlands,05-06-2020,290302,535,104,290198,Europe
Netherlands,05-06-2020,173586,379,591,172995,Europe
Netherlands,05-06-2020,167770,1688,387,167383,Europe
New Zealand,05-06-2020,64185,2271,1244,62941,Western Pacific
Nicaragua,05-06-2020,133586,1454,37,133549,Americas
Niger,05-06-2020,300627,751,778,299849,Africa
Nigeria,05-06-2020,40408,2166,406,40002,Africa
North Macedonia,05-06-2020,444905,2193,619,444286,Europe
Norway,05-06-2020,350777,571,605,350172,Europe
Oman,05-06-2020,236724,295,908,235816,Eastern Mediterranean
Pakistan,05-06-2020,306673,585,354,306319,Eastern Mediterranean
Panama,05-06-2020,307963,1418,339,307624,Americas
Papua New Guinea,05-06-2020,297234,2435,689,296545,Western Pacific
Paraguay,05-06-2020,164696,742,161,164535,Americas
Peru,05-06-2020,408019,647,179,407840,Americas
Philippines,05-06-2020,6870,733,769,6101,Western Pacific
Poland,05-06-2020,140093,1380,1114,138979,Europe
Portugal,05-06-2020,318033,2445,882,317151,Europe
Qatar,05-06-2020,21557,2333,916,20641,Eastern Mediterranean
Romania,05-06-2020,439078,718,651,438427,Europe
Russia,05-06-2020,152148,432,666,151482,Europe
Rwanda,05-06-2020,443652,81,947,442705,Africa
Saint Lucia,05-06-2020,354682,1138,378,354304,Americas
Saint Vincent and the Grenadines,05-06-2020,358513,541,410,358103,Americas
San Marino,05-06-2020,311386,2313,648,310738,Europe
Saudi Arabia,05-06-2020,245586,1868,652,244934,Eastern Mediterranean
Senegal,05-06-2020,20069,34,19,20050,Africa
Serbia,05-06-2020,223096,1254,416,222680,Europe
Seychelles,05-06-2020,58962,2191,766,58196,Africa
Singapore,05-06-2020,338042,2375,204,337838,Western Pacific
Slovakia,05-06-2020,441948,788,604,441344,Europe
Slovenia,05-06-2020,416490,1751,823,415667,Europe
Somalia,05-06-2020,124548,443,232,124316,Eastern Mediterranean
South Africa,05-06-2020,362572,1847,770,361802,Africa
Spain,05-06-2020,442367,21,757,441610,Europe
Sri Lanka,05-06-2020,259506,563,427,259079,South-East Asia
Sudan,05-06-2020,308439,2295,1199,307240,Eastern Mediterranean
Suriname,05-06-2020,51169,76,293,50876,Americas
Sweden,05-06-2020,365087,80,967,364120,Europe
Switzerland,05-06-2020,135986,1729,893,135093,Europe
Taiwan*,05-06-2020,118838,1353,1240,117598,Western Pacific
Tanzania,05-06-2020,61809,640,754,61055,Africa
Thailand,05-06-2020,330539,1043,483,330056,South-East Asia
Togo,05-06-2020,123999,1001,858,123141,Africa
Trinidad and Tobago,05-06-2020,250018,101,17,250001,Americas
Tunisia,05-06-2020,129388,540,571,128817,Eastern Mediterranean
Turkey,05-06-2020,72404,1756,359,72045,Europe
Uganda,05-06-2020,275855,2249,882,274973,Africa
Ukraine,05-06-2020,358280,2268,533,357747,Europe
United Arab Emirates,05-06-2020,383746,1518,97,383649,Eastern Mediterranean
United Kingdom,05-06-2020,158837,1856,266,158571,Europe
United Kingdom,05-06-2020,447710,2190,349,447361,Europe
United Kingdom,05-06-2020,323273,224,165,323108,Europe
United Kingdom,05-06-2020,104651,1971,1068,103583,Europe
United Kingdom,05-06-2020,45640,32,800,44840,Europe
United Kingdom,05-06-2020,72943,1828,650,72293,Europe
United Kingdom,05-06-2020,212488,327,410,212078,Europe
Uruguay,05-06-2020,212654,2378,290,212364,Americas
US,05-06-2020,418340,755,525,417815,Americas
Uzbekistan,05-06-2020,88766,1658,141,88625,Europe
Venezuela,05-06-2020,288213,2135,376,287837,Americas
Vietnam,05-06-2020,405414,2020,51,405363,Western Pacific
Zambia,05-06-2020,359189,101,857,358332,Africa
Zimbabwe,05-06-2020,94320,1005,776,93544,Africa
Dominica,05-06-2020,418750,1623,1247,417503,Americas
Grenada,05-06-2020,123948,1063,1205,122743,Americas
Mozambique,05-06-2020,107335,1883,1175,106160,Africa
Syria,05-06-2020,255993,4,1146,254847,Eastern Mediterranean
Timor-Leste,05-06-2020,222179,1970,648,221531,South-East Asia
Belize,05-06-2020,406405,2132,1127,405278,Americas
Laos,05-06-2020,381096,2049,436,380660,Western Pacific
Libya,05-06-2020,378496,1997,188,378308,Eastern Mediterranean
West Bank and Gaza,05-06-2020,437720,2351,2,437718,Eastern Mediterranean
Guinea-Bissau,05-06-2020,16688,1615,990,15698,Africa
Mali,05-06-2020,77543,1125,198,77345,Africa
Saint Kitts and Nevis,05-06-2020,117895,2403,652,117243,Americas
Canada,05-06-2020,52367,1939,451,51916,Americas
Canada,05-06-2020,175170,390,1229,173941,Americas
Kosovo,05-06-2020,270627,1296,123,270504,Europe
Burma,05-06-2020,23109,1061,250,22859,South-East Asia
United Kingdom,05-06-2020,46520,2031,187,46333,Europe
United Kingdom,05-06-2020,99912,2179,394,99518,Europe
United Kingdom,05-06-2020,158274,462,250,158024,Europe
Botswana,05-06-2020,264539,424,1189,263350,Africa
Burundi,05-06-2020,25360,52,352,25008,Africa
Sierra Leone,05-06-2020,90793,741,1010,89783,Africa
Malawi,05-06-2020,47254,1104,1083,46171,Africa
United Kingdom,05-06-2020,208401,306,249,208152,Europe
France,05-06-2020,164533,2038,308,164225,Europe
South Sudan,05-06-2020,220156,1375,134,220022,Africa
Western Sahara,05-06-2020,51262,508,132,51130,Africa
Sao Tome and Principe,05-06-2020,429377,2168,491,428886,Africa
Yemen,05-06-2020,411585,712,1177,410408,Eastern Mediterranean
Comoros,05-06-2020,347006,2432,194,346812,Africa
Tajikistan,05-06-2020,249442,1631,462,248980,Europe
Lesotho,05-06-2020,222451,2049,121,222330,Africa
Afghanistan,06-06-2020,208043,441,209,207834,Eastern Mediterranean
Albania,06-06-2020,251025,1064,507,250518,Europe
Algeria,06-06-2020,36784,665,377,36407,Africa
Andorra,06-06-2020,209098,139,733,208365,Europe
Angola,06-06-2020,40099,1115,588,39511,Africa
Antigua and Barbuda,06-06-2020,292900,2073,164,292736,Americas
Argentina,06-06-2020,303509,173,1037,302472,Americas
Armenia,06-06-2020,332693,310,760,331933,Europe
Australia,06-06-2020,207303,806,173,207130,Western Pacific
Australia,06-06-2020,360432,1451,656,359776,Western Pacific
Australia,06-06-2020,208781,1120,882,207899,Western Pacific
Australia,06-06-2020,197297,528,55,197242,Western Pacific
Australia,06-06-2020,340878,2468,544,340334,Western Pacific
Australia,06-06-2020,229764,1264,20,229744,Western Pacific
Australia,06-06-2020,167601,1875,1221,166380,Western Pacific
Australia,06-06-2020,199419,1164,305,199114,Western Pacific
Austria,06-06-2020,395545,1626,691,394854,Europe
Azerbaijan,06-06-2020,315236,1657,156,315080,Europe
Bahamas,06-06-2020,172438,1965,374,172064,Americas
Bahrain,06-06-2020,111027,893,561,110466,Eastern Mediterranean
Bangladesh,06-06-2020,433244,516,905,432339,South-East Asia
Barbados,06-06-2020,258368,512,784,257584,Americas
Belarus,06-06-2020,162838,1072,918,161920,Europe
Belgium,06-06-2020,410460,260,500,409960,Europe
Benin,06-06-2020,193093,1898,535,192558,Africa
Bhutan,06-06-2020,353463,2300,999,352464,South-East Asia
Bolivia,06-06-2020,110646,1521,287,110359,Americas
Bosnia and Herzegovina,06-06-2020,35447,1102,1175,34272,Europe
Brazil,06-06-2020,124109,1576,216,123893,Americas
Brunei,06-06-2020,406233,1832,789,405444,Western Pacific
Bulgaria,06-06-2020,56131,2383,815,55316,Europe
Burkina Faso,06-06-2020,435545,1228,1025,434520,Africa
Cabo Verde,06-06-2020,198214,1361,564,197650,Africa
Cambodia,06-06-2020,302544,1133,586,301958,Western Pacific
Cameroon,06-06-2020,298575,1030,396,298179,Africa
Canada,06-06-2020,324589,920,602,323987,Americas
Canada,06-06-2020,131079,1788,767,130312,Americas
Canada,06-06-2020,414843,1873,415,414428,Americas
Canada,06-06-2020,159857,727,781,159076,Americas
Canada,06-06-2020,183426,2440,1196,182230,Americas
Canada,06-06-2020,340165,732,554,339611,Americas
Canada,06-06-2020,341066,1129,1055,340011,Americas
Canada,06-06-2020,57218,1976,296,56922,Americas
Canada,06-06-2020,274935,700,228,274707,Americas
Canada,06-06-2020,352912,1077,761,352151,Americas
Central African Republic,06-06-2020,153321,1663,1082,152239,Africa
Chad,06-06-2020,361721,1280,460,361261,Africa
Chile,06-06-2020,375308,1483,791,374517,Americas
China,06-06-2020,414962,1068,672,414290,Western Pacific
China,06-06-2020,378163,1724,1,378162,Western Pacific
China,06-06-2020,24849,2165,795,24054,Western Pacific
China,06-06-2020,60288,2219,977,59311,Western Pacific
China,06-06-2020,312837,1818,731,312106,Western Pacific
China,06-06-2020,391566,938,769,390797,Western Pacific
China,06-06-2020,397093,774,1233,395860,Western Pacific
China,06-06-2020,445791,609,418,445373,Western Pacific
China,06-06-2020,11620,2072,1118,10502,Western Pacific
China,06-06-2020,142440,415,530,141910,Western Pacific
China,06-06-2020,41644,681,1037,40607,Western Pacific
China,06-06-2020,243260,506,788,242472,Western Pacific
China,06-06-2020,271460,1422,736,270724,Western Pacific
China,06-06-2020,114363,1977,926,113437,Western Pacific
China,06-06-2020,136487,1314,746,135741,Western Pacific
China,06-06-2020,329218,1677,816,328402,Western Pacific
China,06-06-2020,434623,2399,752,433871,Western Pacific
China,06-06-2020,323316,1739,1052,322264,Western Pacific
China,06-06-2020,265341,444,393,264948,Western Pacific
China,06-06-2020,32569,1313,1051,31518,Western Pacific
China,06-06-2020,348615,2397,3,348612,Western Pacific
China,06-06-2020,82809,595,794,82015,Western Pacific
China,06-06-2020,29771,801,239,29532,Western Pacific
China,06-06-2020,187017,771,945,186072,Western Pacific
China,06-06-2020,418020,1788,982,417038,Western Pacific
China,06-06-2020,173323,1886,402,172921,Western Pacific
China,06-06-2020,226067,961,854,225213,Western Pacific
China,06-06-2020,166550,1438,375,166175,Western Pacific
China,06-06-2020,339323,1204,1031,338292,Western Pacific
China,06-06-2020,184434,648,536,183898,Western Pacific
China,06-06-2020,328878,910,205,328673,Western Pacific
China,06-06-2020,340915,1816,602,340313,Western Pacific
China,06-06-2020,413226,792,1053,412173,Western Pacific
Colombia,06-06-2020,184460,2454,160,184300,Americas
Congo (Brazzaville),06-06-2020,357026,2096,937,356089,Africa
Congo (Kinshasa),06-06-2020,100200,1606,949,99251,Africa
Costa Rica,06-06-2020,302533,2318,379,302154,Americas
Cote d'Ivoire,06-06-2020,437956,438,1201,436755,Africa
Croatia,06-06-2020,303926,485,109,303817,Europe
Cuba,06-06-2020,260949,470,693,260256,Americas
Cyprus,06-06-2020,122931,600,1,122930,Europe
Czechia,06-06-2020,246136,813,483,245653,Europe
Denmark,06-06-2020,353142,346,732,352410,Europe
Greenland,06-06-2020,120451,434,608,119843,Europe
Denmark,06-06-2020,131422,1123,87,131335,Europe
Djibouti,06-06-2020,100942,563,375,100567,Eastern Mediterranean
Dominican Republic,06-06-2020,80627,1782,1024,79603,Americas
Ecuador,06-06-2020,217934,453,197,217737,Americas
Egypt,06-06-2020,34536,129,361,34175,Eastern Mediterranean
El Salvador,06-06-2020,117830,1919,504,117326,Americas
Equatorial Guinea,06-06-2020,243861,1220,1067,242794,Africa
Eritrea,06-06-2020,141389,1085,267,141122,Africa
Estonia,06-06-2020,80619,2420,460,80159,Europe
Eswatini,06-06-2020,265755,2030,175,265580,Africa
Ethiopia,06-06-2020,22733,2217,401,22332,Africa
Fiji,06-06-2020,131529,1619,1057,130472,Western Pacific
Finland,06-06-2020,63271,686,289,62982,Europe
France,06-06-2020,134656,2150,739,133917,Europe
France,06-06-2020,42755,124,356,42399,Europe
France,06-06-2020,68872,1698,733,68139,Europe
France,06-06-2020,379078,491,1195,377883,Europe
France,06-06-2020,433260,2080,392,432868,Europe
France,06-06-2020,97196,1598,178,97018,Europe
France,06-06-2020,13231,1913,659,12572,Europe
France,06-06-2020,39464,1724,1008,38456,Europe
France,06-06-2020,165294,1607,227,165067,Europe
France,06-06-2020,115544,614,475,115069,Europe
Gabon,06-06-2020,7829,1250,826,7003,Africa
Gambia,06-06-2020,157544,163,965,156579,Africa
Georgia,06-06-2020,61452,2007,702,60750,Europe
Germany,06-06-2020,116179,2194,216,115963,Europe
Ghana,06-06-2020,129296,1435,1208,128088,Africa
Greece,06-06-2020,39471,1445,11,39460,Europe
Guatemala,06-06-2020,260160,1373,648,259512,Americas
Guinea,06-06-2020,162886,2061,272,162614,Africa
Guyana,06-06-2020,84321,275,864,83457,Americas
Haiti,06-06-2020,403638,1365,455,403183,Americas
Holy See,06-06-2020,392437,858,837,391600,Europe
Honduras,06-06-2020,35067,0,957,34110,Americas
Hungary,06-06-2020,173083,16,1201,171882,Europe
Iceland,06-06-2020,6247,2345,321,5926,Europe
India,06-06-2020,277613,1219,351,277262,South-East Asia
Indonesia,06-06-2020,182084,2414,212,181872,South-East Asia
Iran,06-06-2020,417263,1569,349,416914,Eastern Mediterranean
Iraq,06-06-2020,301985,1525,543,301442,Eastern Mediterranean
Ireland,06-06-2020,243871,853,711,243160,Europe
Israel,06-06-2020,340457,285,348,340109,Europe
Italy,06-06-2020,305582,2198,940,304642,Europe
Jamaica,06-06-2020,42427,44,852,41575,Americas
Japan,06-06-2020,154115,1659,508,153607,Western Pacific
Jordan,06-06-2020,241965,866,363,241602,Eastern Mediterranean
Kazakhstan,06-06-2020,341037,1784,1063,339974,Europe
Kenya,06-06-2020,273433,1465,1244,272189,Africa
South Korea,06-06-2020,11737,911,946,10791,Western Pacific
Kuwait,06-06-2020,390255,849,483,389772,Eastern Mediterranean
Kyrgyzstan,06-06-2020,192372,6,445,191927,Europe
Latvia,06-06-2020,165194,893,889,164305,Europe
Lebanon,06-06-2020,120188,1946,784,119404,Eastern Mediterranean
Liberia,06-06-2020,426151,561,576,425575,Africa
Liechtenstein,06-06-2020,279090,1207,855,278235,Europe
Lithuania,06-06-2020,374540,877,935,373605,Europe
Luxembourg,06-06-2020,288264,2470,774,287490,Europe
Madagascar,06-06-2020,243655,2282,1243,242412,Africa
Malaysia,06-06-2020,34138,1432,642,33496,Western Pacific
Maldives,06-06-2020,12169,1321,702,11467,South-East Asia
Malta,06-06-2020,174640,1753,623,174017,Europe
Mauritania,06-06-2020,118153,836,624,117529,Africa
Mauritius,06-06-2020,18331,1943,468,17863,Africa
Mexico,06-06-2020,249396,676,61,249335,Americas
Moldova,06-06-2020,255401,1231,808,254593,Europe
Monaco,06-06-2020,85041,1912,1063,83978,Europe
Mongolia,06-06-2020,302764,2020,199,302565,Western Pacific
Montenegro,06-06-2020,232375,2253,620,231755,Europe
Morocco,06-06-2020,334774,1630,391,334383,Eastern Mediterranean
Namibia,06-06-2020,237178,693,25,237153,Africa
Nepal,06-06-2020,373268,608,63,373205,South-East Asia
Netherlands,06-06-2020,273505,1325,363,273142,Europe
Netherlands,06-06-2020,343754,1758,951,342803,Europe
Netherlands,06-06-2020,153357,3,656,152701,Europe
Netherlands,06-06-2020,89753,433,963,88790,Europe
New Zealand,06-06-2020,257259,1943,316,256943,Western Pacific
Nicaragua,06-06-2020,197513,1340,1242,196271,Americas
Niger,06-06-2020,62461,1783,1188,61273,Africa
Nigeria,06-06-2020,221963,263,781,221182,Africa
North Macedonia,06-06-2020,102350,7,1072,101278,Europe
Norway,06-06-2020,71415,1851,410,71005,Europe
Oman,06-06-2020,161062,711,1079,159983,Eastern Mediterranean
Pakistan,06-06-2020,258286,919,390,257896,Eastern Mediterranean
Panama,06-06-2020,252411,1337,852,251559,Americas
Papua New Guinea,06-06-2020,397037,120,960,396077,Western Pacific
Paraguay,06-06-2020,66726,2130,705,66021,Americas
Peru,06-06-2020,139978,1921,785,139193,Americas
Philippines,06-06-2020,7341,2153,441,6900,Western Pacific
Poland,06-06-2020,5147,2102,1121,4026,Europe
Portugal,06-06-2020,335220,48,242,334978,Europe
Qatar,06-06-2020,185929,961,704,185225,Eastern Mediterranean
Romania,06-06-2020,389250,337,1061,388189,Europe
Russia,06-06-2020,348001,2450,908,347093,Europe
Rwanda,06-06-2020,280042,658,1125,278917,Africa
Saint Lucia,06-06-2020,76048,1355,989,75059,Americas
Saint Vincent and the Grenadines,06-06-2020,353785,472,668,353117,Americas
San Marino,06-06-2020,348674,1470,761,347913,Europe
Saudi Arabia,06-06-2020,199742,453,651,199091,Eastern Mediterranean
Senegal,06-06-2020,162508,2098,838,161670,Africa
Serbia,06-06-2020,358623,1047,463,358160,Europe
Seychelles,06-06-2020,109893,1972,550,109343,Africa
Singapore,06-06-2020,346668,1315,961,345707,Western Pacific
Slovakia,06-06-2020,26564,798,355,26209,Europe
Slovenia,06-06-2020,26578,1504,11,26567,Europe
Somalia,06-06-2020,381646,5,613,381033,Eastern Mediterranean
South Africa,06-06-2020,295480,477,348,295132,Africa
Spain,06-06-2020,432538,1071,530,432008,Europe
Sri Lanka,06-06-2020,219845,1400,308,219537,South-East Asia
Sudan,06-06-2020,51376,1893,460,50916,Eastern Mediterranean
Suriname,06-06-2020,48943,625,490,48453,Americas
Sweden,06-06-2020,425991,109,202,425789,Europe
Switzerland,06-06-2020,398089,1046,338,397751,Europe
Taiwan*,06-06-2020,20278,2034,74,20204,Western Pacific
Tanzania,06-06-2020,231431,1460,667,230764,Africa
Thailand,06-06-2020,294199,1439,1121,293078,South-East Asia
Togo,06-06-2020,374317,2351,74,374243,Africa
Trinidad and Tobago,06-06-2020,146900,62,353,146547,Americas
Tunisia,06-06-2020,224058,1548,592,223466,Eastern Mediterranean
Turkey,06-06-2020,148378,1507,476,147902,Europe
Uganda,06-06-2020,324595,707,271,324324,Africa
Ukraine,06-06-2020,4644,2436,1114,3530,Europe
United Arab Emirates,06-06-2020,134382,919,583,133799,Eastern Mediterranean
United Kingdom,06-06-2020,297725,951,233,297492,Europe
United Kingdom,06-06-2020,63838,644,959,62879,Europe
United Kingdom,06-06-2020,11968,341,245,11723,Europe
United Kingdom,06-06-2020,275169,1305,800,274369,Europe
United Kingdom,06-06-2020,156859,1237,673,156186,Europe
United Kingdom,06-06-2020,346717,2003,359,346358,Europe
United Kingdom,06-06-2020,274807,1448,428,274379,Europe
Uruguay,06-06-2020,40884,1239,772,40112,Americas
US,06-06-2020,381229,1076,872,380357,Americas
Uzbekistan,06-06-2020,158636,1883,1008,157628,Europe
Venezuela,06-06-2020,379876,1817,830,379046,Americas
Vietnam,06-06-2020,2979,1463,282,2697,Western Pacific
Zambia,06-06-2020,280168,748,537,279631,Africa
Zimbabwe,06-06-2020,116177,1730,1177,115000,Africa
Dominica,06-06-2020,310042,698,400,309642,Americas
Grenada,06-06-2020,59571,1548,743,58828,Americas
Mozambique,06-06-2020,410712,30,509,410203,Africa
Syria,06-06-2020,210164,702,1162,209002,Eastern Mediterranean
Timor-Leste,06-06-2020,10326,2078,685,9641,South-East Asia
Belize,06-06-2020,281180,1148,581,280599,Americas
Laos,06-06-2020,253747,1378,659,253088,Western Pacific
Libya,06-06-2020,245860,363,1159,244701,Eastern Mediterranean
West Bank and Gaza,06-06-2020,383926,771,755,383171,Eastern Mediterranean
Guinea-Bissau,06-06-2020,154318,1791,460,153858,Africa
Mali,06-06-2020,429726,881,814,428912,Africa
Saint Kitts and Nevis,06-06-2020,342086,2173,462,341624,Americas
Canada,06-06-2020,293077,937,932,292145,Americas
Canada,06-06-2020,242999,1537,1057,241942,Americas
Kosovo,06-06-2020,337492,1884,299,337193,Europe
Burma,06-06-2020,146414,825,1036,145378,South-East Asia
United Kingdom,06-06-2020,424810,152,83,424727,Europe
United Kingdom,06-06-2020,316215,995,784,315431,Europe
United Kingdom,06-06-2020,146552,1742,238,146314,Europe
Botswana,06-06-2020,446500,2485,1135,445365,Africa
Burundi,06-06-2020,30143,661,812,29331,Africa
Sierra Leone,06-06-2020,276918,1443,144,276774,Africa
Malawi,06-06-2020,229190,151,912,228278,Africa
United Kingdom,06-06-2020,298126,538,624,297502,Europe
France,06-06-2020,30364,2049,335,30029,Europe
South Sudan,06-06-2020,161760,1662,984,160776,Africa
Western Sahara,06-06-2020,138136,2044,522,137614,Africa
Sao Tome and Principe,06-06-2020,322931,599,223,322708,Africa
Yemen,06-06-2020,100207,2310,1129,99078,Eastern Mediterranean
Comoros,06-06-2020,354581,2111,365,354216,Africa
Tajikistan,06-06-2020,112962,2062,475,112487,Europe
Lesotho,06-06-2020,420886,1251,406,420480,Africa
Afghanistan,07-06-2020,20344,1142,416,19928,Eastern Mediterranean
Albania,07-06-2020,47247,1504,328,46919,Europe
Algeria,07-06-2020,377803,1386,190,377613,Africa
Andorra,07-06-2020,147209,819,1163,146046,Europe
Angola,07-06-2020,43600,64,10,43590,Africa
Antigua and Barbuda,07-06-2020,439742,968,882,438860,Americas
Argentina,07-06-2020,126385,2482,1204,125181,Americas
Armenia,07-06-2020,332996,2335,297,332699,Europe
Australia,07-06-2020,436996,1516,343,436653,Western Pacific
Australia,07-06-2020,366290,642,1003,365287,Western Pacific
Australia,07-06-2020,194895,188,1232,193663,Western Pacific
Australia,07-06-2020,351341,2059,148,351193,Western Pacific
Australia,07-06-2020,156382,1448,987,155395,Western Pacific
Australia,07-06-2020,68254,1788,542,67712,Western Pacific
Australia,07-06-2020,146929,1326,10,146919,Western Pacific
Australia,07-06-2020,262288,1551,857,261431,Western Pacific
Austria,07-06-2020,325345,269,845,324500,Europe
Azerbaijan,07-06-2020,363311,2379,944,362367,Europe
Bahamas,07-06-2020,63827,702,240,63587,Americas
Bahrain,07-06-2020,210537,2031,1118,209419,Eastern Mediterranean
Bangladesh,07-06-2020,144925,1408,973,143952,South-East Asia
Barbados,07-06-2020,110102,686,369,109733,Americas
Belarus,07-06-2020,210337,756,58,210279,Europe
Belgium,07-06-2020,224447,166,215,224232,Europe
Benin,07-06-2020,229746,610,607,229139,Africa
Bhutan,07-06-2020,370031,1583,749,369282,South-East Asia
Bolivia,07-06-2020,155716,1002,890,154826,Americas
Bosnia and Herzegovina,07-06-2020,268505,844,820,267685,Europe
Brazil,07-06-2020,133339,2086,1140,132199,Americas
Brunei,07-06-2020,200014,640,1139,198875,Western Pacific
Bulgaria,07-06-2020,179617,1801,777,178840,Europe
Burkina Faso,07-06-2020,288309,2342,1026,287283,Africa
Cabo Verde,07-06-2020,316310,1499,830,315480,Africa
Cambodia,07-06-2020,69966,1835,1095,68871,Western Pacific
Cameroon,07-06-2020,200987,785,871,200116,Africa
Canada,07-06-2020,58565,1218,580,57985,Americas
Canada,07-06-2020,164327,2332,575,163752,Americas
Canada,07-06-2020,2605,381,648,1957,Americas
Canada,07-06-2020,160500,274,581,159919,Americas
Canada,07-06-2020,65776,196,485,65291,Americas
Canada,07-06-2020,437645,2046,633,437012,Americas
Canada,07-06-2020,71165,2046,63,71102,Americas
Canada,07-06-2020,299050,162,785,298265,Americas
Canada,07-06-2020,146507,1367,1113,145394,Americas
Canada,07-06-2020,143248,886,1085,142163,Americas
Central African Republic,07-06-2020,130650,527,74,130576,Africa
Chad,07-06-2020,317587,2434,506,317081,Africa
Chile,07-06-2020,261722,1908,858,260864,Americas
China,07-06-2020,346721,2067,1093,345628,Western Pacific
China,07-06-2020,231147,858,66,231081,Western Pacific
China,07-06-2020,156195,675,346,155849,Western Pacific
China,07-06-2020,23787,237,353,23434,Western Pacific
China,07-06-2020,351667,1763,1026,350641,Western Pacific
China,07-06-2020,19820,286,515,19305,Western Pacific
China,07-06-2020,124183,1497,1080,123103,Western Pacific
China,07-06-2020,322237,2007,220,322017,Western Pacific
China,07-06-2020,59256,1669,859,58397,Western Pacific
China,07-06-2020,377422,590,119,377303,Western Pacific
China,07-06-2020,326436,1298,610,325826,Western Pacific
China,07-06-2020,110831,1425,601,110230,Western Pacific
China,07-06-2020,287202,2462,861,286341,Western Pacific
China,07-06-2020,165980,626,164,165816,Western Pacific
China,07-06-2020,93606,119,448,93158,Western Pacific
China,07-06-2020,399255,1404,573,398682,Western Pacific
China,07-06-2020,100905,1838,799,100106,Western Pacific
China,07-06-2020,169982,1317,503,169479,Western Pacific
China,07-06-2020,84574,857,198,84376,Western Pacific
China,07-06-2020,223740,1171,63,223677,Western Pacific
China,07-06-2020,47443,884,1060,46383,Western Pacific
China,07-06-2020,376855,609,1219,375636,Western Pacific
China,07-06-2020,231108,2045,922,230186,Western Pacific
China,07-06-2020,104230,937,1040,103190,Western Pacific
China,07-06-2020,284725,2487,926,283799,Western Pacific
China,07-06-2020,370347,557,515,369832,Western Pacific
China,07-06-2020,339520,2404,118,339402,Western Pacific
China,07-06-2020,207031,1336,168,206863,Western Pacific
China,07-06-2020,150648,395,573,150075,Western Pacific
China,07-06-2020,190078,1705,1124,188954,Western Pacific
China,07-06-2020,8166,1485,220,7946,Western Pacific
China,07-06-2020,257486,1066,692,256794,Western Pacific
China,07-06-2020,341053,1845,942,340111,Western Pacific
Colombia,07-06-2020,8597,982,903,7694,Americas
Congo (Brazzaville),07-06-2020,193737,76,514,193223,Africa
Congo (Kinshasa),07-06-2020,344971,2463,788,344183,Africa
Costa Rica,07-06-2020,75637,200,726,74911,Americas
Cote d'Ivoire,07-06-2020,323836,1782,740,323096,Africa
Croatia,07-06-2020,185829,260,769,185060,Europe
Cuba,07-06-2020,446095,492,1234,444861,Americas
Cyprus,07-06-2020,176433,694,153,176280,Europe
Czechia,07-06-2020,116790,1193,159,116631,Europe
Denmark,07-06-2020,204792,2115,250,204542,Europe
Greenland,07-06-2020,66276,80,604,65672,Europe
Denmark,07-06-2020,274139,1971,293,273846,Europe
Djibouti,07-06-2020,386034,472,877,385157,Eastern Mediterranean
Dominican Republic,07-06-2020,72640,1758,1167,71473,Americas
Ecuador,07-06-2020,398389,534,628,397761,Americas
Egypt,07-06-2020,248610,304,176,248434,Eastern Mediterranean
El Salvador,07-06-2020,144793,1066,306,144487,Americas
Equatorial Guinea,07-06-2020,34384,1808,123,34261,Africa
Eritrea,07-06-2020,164012,2392,1168,162844,Africa
Estonia,07-06-2020,29054,156,69,28985,Europe
Eswatini,07-06-2020,432015,1948,493,431522,Africa
Ethiopia,07-06-2020,381210,1009,644,380566,Africa
Fiji,07-06-2020,255139,1327,98,255041,Western Pacific
Finland,07-06-2020,13052,1578,437,12615,Europe
France,07-06-2020,319294,1663,767,318527,Europe
France,07-06-2020,32127,1424,176,31951,Europe
France,07-06-2020,327258,977,565,326693,Europe
France,07-06-2020,10030,1626,819,9211,Europe
France,07-06-2020,262412,2036,335,262077,Europe
France,07-06-2020,335507,1430,684,334823,Europe
France,07-06-2020,237593,207,918,236675,Europe
France,07-06-2020,300491,1648,1205,299286,Europe
France,07-06-2020,263909,2486,458,263451,Europe
France,07-06-2020,225532,2059,382,225150,Europe
Gabon,07-06-2020,51539,2289,1147,50392,Africa
Gambia,07-06-2020,323613,2318,160,323453,Africa
Georgia,07-06-2020,290780,2172,1177,289603,Europe
Germany,07-06-2020,327941,902,1037,326904,Europe
Ghana,07-06-2020,185650,1318,322,185328,Africa
Greece,07-06-2020,8395,1657,553,7842,Europe
Guatemala,07-06-2020,37788,1714,85,37703,Americas
Guinea,07-06-2020,91764,2117,866,90898,Africa
Guyana,07-06-2020,80778,1508,267,80511,Americas
Haiti,07-06-2020,236797,338,534,236263,Americas
Holy See,07-06-2020,134709,266,102,134607,Europe
Honduras,07-06-2020,35979,1478,510,35469,Americas
Hungary,07-06-2020,45669,519,153,45516,Europe
Iceland,07-06-2020,389696,1207,745,388951,Europe
India,07-06-2020,395905,432,900,395005,South-East Asia
Indonesia,07-06-2020,431279,438,907,430372,South-East Asia
Iran,07-06-2020,138339,2033,1159,137180,Eastern Mediterranean
Iraq,07-06-2020,362882,5,357,362525,Eastern Mediterranean
Ireland,07-06-2020,87156,996,197,86959,Europe
Israel,07-06-2020,254787,865,1073,253714,Europe
Italy,07-06-2020,444085,1219,894,443191,Europe
Jamaica,07-06-2020,36906,1686,664,36242,Americas
Japan,07-06-2020,142060,2327,785,141275,Western Pacific
Jordan,07-06-2020,112729,2314,1024,111705,Eastern Mediterranean
Kazakhstan,07-06-2020,171550,2405,617,170933,Europe
Kenya,07-06-2020,10280,608,152,10128,Africa
South Korea,07-06-2020,203225,754,292,202933,Western Pacific
Kuwait,07-06-2020,165194,1246,1119,164075,Eastern Mediterranean
Kyrgyzstan,07-06-2020,187676,1033,445,187231,Europe
Latvia,07-06-2020,217705,215,592,217113,Europe
Lebanon,07-06-2020,25906,2350,1095,24811,Eastern Mediterranean
Liberia,07-06-2020,52146,2331,131,52015,Africa
Liechtenstein,07-06-2020,279765,1680,408,279357,Europe
Lithuania,07-06-2020,91178,1391,506,90672,Europe
Luxembourg,07-06-2020,240570,742,160,240410,Europe
Madagascar,07-06-2020,414121,864,542,413579,Africa
Malaysia,07-06-2020,436428,472,637,435791,Western Pacific
Maldives,07-06-2020,83398,1972,1055,82343,South-East Asia
Malta,07-06-2020,246100,1400,1139,244961,Europe
Mauritania,07-06-2020,422410,1934,309,422101,Africa
Mauritius,07-06-2020,147057,509,328,146729,Africa
Mexico,07-06-2020,211235,1796,752,210483,Americas
Moldova,07-06-2020,220698,182,760,219938,Europe
Monaco,07-06-2020,20076,1449,681,19395,Europe
Mongolia,07-06-2020,63536,486,576,62960,Western Pacific
Montenegro,07-06-2020,228332,54,832,227500,Europe
Morocco,07-06-2020,150521,804,874,149647,Eastern Mediterranean
Namibia,07-06-2020,180604,1461,244,180360,Africa
Nepal,07-06-2020,286604,1041,1095,285509,South-East Asia
Netherlands,07-06-2020,179257,341,75,179182,Europe
Netherlands,07-06-2020,26320,1494,880,25440,Europe
Netherlands,07-06-2020,154593,2006,637,153956,Europe
Netherlands,07-06-2020,237399,1840,76,237323,Europe
New Zealand,07-06-2020,313612,2139,746,312866,Western Pacific
Nicaragua,07-06-2020,161220,524,1045,160175,Americas
Niger,07-06-2020,76651,1235,959,75692,Africa
Nigeria,07-06-2020,85750,1961,144,85606,Africa
North Macedonia,07-06-2020,344989,85,930,344059,Europe
Norway,07-06-2020,41550,608,988,40562,Europe
Oman,07-06-2020,117327,2384,68,117259,Eastern Mediterranean
Pakistan,07-06-2020,242702,1854,421,242281,Eastern Mediterranean
Panama,07-06-2020,21342,131,182,21160,Americas
Papua New Guinea,07-06-2020,45444,863,519,44925,Western Pacific
Paraguay,07-06-2020,193711,980,159,193552,Americas
Peru,07-06-2020,402401,1332,779,401622,Americas
Philippines,07-06-2020,199547,2211,831,198716,Western Pacific
Poland,07-06-2020,392475,639,671,391804,Europe
Portugal,07-06-2020,319554,335,452,319102,Europe
Qatar,07-06-2020,934,2149,52,882,Eastern Mediterranean
Romania,07-06-2020,132914,1824,905,132009,Europe
Russia,07-06-2020,347640,1262,80,347560,Europe
Rwanda,07-06-2020,41888,1261,1216,40672,Africa
Saint Lucia,07-06-2020,219468,1303,524,218944,Americas
Saint Vincent and the Grenadines,07-06-2020,48314,1550,839,47475,Americas
San Marino,07-06-2020,180599,1499,966,179633,Europe
Saudi Arabia,07-06-2020,116024,783,299,115725,Eastern Mediterranean
Senegal,07-06-2020,37753,1656,25,37728,Africa
Serbia,07-06-2020,381916,1891,486,381430,Europe
Seychelles,07-06-2020,118252,675,164,118088,Africa
Singapore,07-06-2020,366279,2467,657,365622,Western Pacific
Slovakia,07-06-2020,118237,1956,260,117977,Europe
Slovenia,07-06-2020,1549,1167,963,586,Europe
Somalia,07-06-2020,143061,1306,936,142125,Eastern Mediterranean
South Africa,07-06-2020,297327,1928,1119,296208,Africa
Spain,07-06-2020,405039,2373,786,404253,Europe
Sri Lanka,07-06-2020,77071,1347,430,76641,South-East Asia
Sudan,07-06-2020,148274,2090,779,147495,Eastern Mediterranean
Suriname,07-06-2020,226617,2303,840,225777,Americas
Sweden,07-06-2020,250479,170,1195,249284,Europe
Switzerland,07-06-2020,366121,330,472,365649,Europe
Taiwan*,07-06-2020,401095,2442,914,400181,Western Pacific
Tanzania,07-06-2020,116880,2382,575,116305,Africa
Thailand,07-06-2020,261449,2108,863,260586,South-East Asia
Togo,07-06-2020,281728,707,93,281635,Africa
Trinidad and Tobago,07-06-2020,153696,24,961,152735,Americas
Tunisia,07-06-2020,269636,552,701,268935,Eastern Mediterranean
Turkey,07-06-2020,440540,247,36,440504,Europe
Uganda,07-06-2020,205629,933,402,205227,Africa
Ukraine,07-06-2020,312764,928,967,311797,Europe
United Arab Emirates,07-06-2020,78967,1867,1074,77893,Eastern Mediterranean
United Kingdom,07-06-2020,329494,2094,169,329325,Europe
United Kingdom,07-06-2020,289364,51,925,288439,Europe
United Kingdom,07-06-2020,106355,1661,938,105417,Europe
United Kingdom,07-06-2020,415256,2026,49,415207,Europe
United Kingdom,07-06-2020,398027,1036,810,397217,Europe
United Kingdom,07-06-2020,230770,1471,839,229931,Europe
United Kingdom,07-06-2020,86703,1903,1234,85469,Europe
Uruguay,07-06-2020,176188,363,972,175216,Americas
US,07-06-2020,198010,1410,529,197481,Americas
Uzbekistan,07-06-2020,168166,2055,139,168027,Europe
Venezuela,07-06-2020,377980,488,90,377890,Americas
Vietnam,07-06-2020,50225,159,1115,49110,Western Pacific
Zambia,07-06-2020,264796,1671,1226,263570,Africa
Zimbabwe,07-06-2020,211939,788,959,210980,Africa
Dominica,07-06-2020,384731,1383,35,384696,Americas
Grenada,07-06-2020,246371,801,378,245993,Americas
Mozambique,07-06-2020,440099,567,65,440034,Africa
Syria,07-06-2020,66146,1786,941,65205,Eastern Mediterranean
Timor-Leste,07-06-2020,150807,1296,1130,149677,South-East Asia
Belize,07-06-2020,257335,1378,1002,256333,Americas
Laos,07-06-2020,369632,1817,167,369465,Western Pacific
Libya,07-06-2020,355225,1641,874,354351,Eastern Mediterranean
West Bank and Gaza,07-06-2020,427440,1380,440,427000,Eastern Mediterranean
Guinea-Bissau,07-06-2020,160947,1503,697,160250,Africa
Mali,07-06-2020,254226,2185,176,254050,Africa
Saint Kitts and Nevis,07-06-2020,160930,1700,700,160230,Americas
Canada,07-06-2020,133441,2168,1130,132311,Americas
Canada,07-06-2020,199374,1490,966,198408,Americas
Kosovo,07-06-2020,246588,813,1188,245400,Europe
Burma,07-06-2020,53008,37,1161,51847,South-East Asia
United Kingdom,07-06-2020,274904,748,1089,273815,Europe
United Kingdom,07-06-2020,231361,112,908,230453,Europe
United Kingdom,07-06-2020,102917,1407,874,102043,Europe
Botswana,07-06-2020,127160,388,136,127024,Africa
Burundi,07-06-2020,362619,1898,218,362401,Africa
Sierra Leone,07-06-2020,129444,1752,376,129068,Africa
Malawi,07-06-2020,282772,692,662,282110,Africa
United Kingdom,07-06-2020,433456,372,149,433307,Europe
France,07-06-2020,41554,1998,472,41082,Europe
South Sudan,07-06-2020,22637,158,1018,21619,Africa
Western Sahara,07-06-2020,267249,2441,517,266732,Africa
Sao Tome and Principe,07-06-2020,289089,824,84,289005,Africa
Yemen,07-06-2020,231643,1133,1083,230560,Eastern Mediterranean
Comoros,07-06-2020,140029,1727,487,139542,Africa
Tajikistan,07-06-2020,365012,904,833,364179,Europe
Lesotho,07-06-2020,211095,1475,1164,209931,Africa
Afghanistan,08-06-2020,423975,1143,827,423148,Eastern Mediterranean
Albania,08-06-2020,395180,1915,408,394772,Europe
Algeria,08-06-2020,237670,866,810,236860,Africa
Andorra,08-06-2020,201913,1641,851,201062,Europe
Angola,08-06-2020,256664,213,349,256315,Africa
Antigua and Barbuda,08-06-2020,275416,667,536,274880,Americas
Argentina,08-06-2020,39880,297,1219,38661,Americas
Armenia,08-06-2020,172289,1520,16,172273,Europe
Australia,08-06-2020,313706,2045,1191,312515,Western Pacific
Australia,08-06-2020,240189,1372,561,239628,Western Pacific
Australia,08-06-2020,282535,2206,227,282308,Western Pacific
Australia,08-06-2020,297536,1103,758,296778,Western Pacific
Australia,08-06-2020,176861,493,560,176301,Western Pacific
Australia,08-06-2020,114743,1133,872,113871,Western Pacific
Australia,08-06-2020,440479,1983,410,440069,Western Pacific
Australia,08-06-2020,329026,755,566,328460,Western Pacific
Austria,08-06-2020,298601,1613,403,298198,Europe
Azerbaijan,08-06-2020,274884,1073,535,274349,Europe
Bahamas,08-06-2020,299653,994,664,298989,Americas
Bahrain,08-06-2020,433144,2104,322,432822,Eastern Mediterranean
Bangladesh,08-06-2020,42858,976,461,42397,South-East Asia
Barbados,08-06-2020,98975,1879,607,98368,Americas
Belarus,08-06-2020,241327,1843,1204,240123,Europe
Belgium,08-06-2020,246662,778,405,246257,Europe
Benin,08-06-2020,189221,2232,132,189089,Africa
Bhutan,08-06-2020,44553,2035,1024,43529,South-East Asia
Bolivia,08-06-2020,348230,76,626,347604,Americas
Bosnia and Herzegovina,08-06-2020,419977,326,429,419548,Europe
Brazil,08-06-2020,105463,1536,234,105229,Americas
Brunei,08-06-2020,73634,2176,1061,72573,Western Pacific
Bulgaria,08-06-2020,61852,2155,827,61025,Europe
Burkina Faso,08-06-2020,288219,18,1165,287054,Africa
Cabo Verde,08-06-2020,388808,813,12,388796,Africa
Cambodia,08-06-2020,192456,1506,788,191668,Western Pacific
Cameroon,08-06-2020,166047,1966,1143,164904,Africa
Canada,08-06-2020,230551,2317,812,229739,Americas
Canada,08-06-2020,234508,1388,711,233797,Americas
Canada,08-06-2020,47424,1826,1027,46397,Americas
Canada,08-06-2020,356428,985,1004,355424,Americas
Canada,08-06-2020,384110,1839,1245,382865,Americas
Canada,08-06-2020,63085,1100,845,62240,Americas
Canada,08-06-2020,109734,1641,464,109270,Americas
Canada,08-06-2020,16276,1975,344,15932,Americas
Canada,08-06-2020,372645,2478,991,371654,Americas
Canada,08-06-2020,342430,1149,39,342391,Americas
Central African Republic,08-06-2020,265462,98,952,264510,Africa
Chad,08-06-2020,27775,947,332,27443,Africa
Chile,08-06-2020,291687,1008,594,291093,Americas
China,08-06-2020,407099,1541,1224,405875,Western Pacific
China,08-06-2020,346677,1336,639,346038,Western Pacific
China,08-06-2020,85789,2238,525,85264,Western Pacific
China,08-06-2020,118388,2006,337,118051,Western Pacific
China,08-06-2020,254908,1528,355,254553,Western Pacific
China,08-06-2020,329584,445,899,328685,Western Pacific
China,08-06-2020,294848,436,130,294718,Western Pacific
China,08-06-2020,366896,86,77,366819,Western Pacific
China,08-06-2020,105804,45,458,105346,Western Pacific
China,08-06-2020,133528,580,421,133107,Western Pacific
China,08-06-2020,412602,1165,808,411794,Western Pacific
China,08-06-2020,347522,522,1176,346346,Western Pacific
China,08-06-2020,358903,1567,1120,357783,Western Pacific
China,08-06-2020,147482,1991,637,146845,Western Pacific
China,08-06-2020,12699,1299,1135,11564,Western Pacific
China,08-06-2020,69370,273,786,68584,Western Pacific
China,08-06-2020,304351,551,1048,303303,Western Pacific
China,08-06-2020,122195,588,552,121643,Western Pacific
China,08-06-2020,27700,1540,479,27221,Western Pacific
China,08-06-2020,117504,1671,59,117445,Western Pacific
China,08-06-2020,405882,265,723,405159,Western Pacific
China,08-06-2020,379161,1562,682,378479,Western Pacific
China,08-06-2020,82141,619,433,81708,Western Pacific
China,08-06-2020,295682,59,563,295119,Western Pacific
China,08-06-2020,6130,2190,319,5811,Western Pacific
China,08-06-2020,316833,2442,751,316082,Western Pacific
China,08-06-2020,372159,939,163,371996,Western Pacific
China,08-06-2020,367276,728,213,367063,Western Pacific
China,08-06-2020,431776,1559,1176,430600,Western Pacific
China,08-06-2020,69810,1936,675,69135,Western Pacific
China,08-06-2020,297128,967,335,296793,Western Pacific
China,08-06-2020,203670,759,290,203380,Western Pacific
China,08-06-2020,167309,2433,1211,166098,Western Pacific
Colombia,08-06-2020,306875,474,932,305943,Americas
Congo (Brazzaville),08-06-2020,146897,334,364,146533,Africa
Congo (Kinshasa),08-06-2020,29318,198,1058,28260,Africa
Costa Rica,08-06-2020,217090,403,178,216912,Americas
Cote d'Ivoire,08-06-2020,78660,2318,209,78451,Africa
Croatia,08-06-2020,283689,1823,952,282737,Europe
Cuba,08-06-2020,327544,543,229,327315,Americas
Cyprus,08-06-2020,109841,781,946,108895,Europe
Czechia,08-06-2020,218946,2411,651,218295,Europe
Denmark,08-06-2020,163720,1457,1236,162484,Europe
Greenland,08-06-2020,72666,2285,1066,71600,Europe
Denmark,08-06-2020,366314,1507,601,365713,Europe
Djibouti,08-06-2020,276807,1147,760,276047,Eastern Mediterranean
Dominican Republic,08-06-2020,207838,1750,1188,206650,Americas
Ecuador,08-06-2020,2797,1964,338,2459,Americas
Egypt,08-06-2020,4291,1717,859,3432,Eastern Mediterranean
El Salvador,08-06-2020,265835,1365,499,265336,Americas
Equatorial Guinea,08-06-2020,21601,81,26,21575,Africa
Eritrea,08-06-2020,69738,1131,774,68964,Africa
Estonia,08-06-2020,321574,191,558,321016,Europe
Eswatini,08-06-2020,220063,2413,641,219422,Africa
Ethiopia,08-06-2020,355292,2370,55,355237,Africa
Fiji,08-06-2020,127268,1543,898,126370,Western Pacific
Finland,08-06-2020,5109,1889,316,4793,Europe
France,08-06-2020,81063,820,872,80191,Europe
France,08-06-2020,344183,339,575,343608,Europe
France,08-06-2020,11881,1962,604,11277,Europe
France,08-06-2020,119680,488,699,118981,Europe
France,08-06-2020,336680,1016,296,336384,Europe
France,08-06-2020,157955,1908,1210,156745,Europe
France,08-06-2020,422215,1473,229,421986,Europe
France,08-06-2020,264834,189,1247,263587,Europe
France,08-06-2020,72606,1316,210,72396,Europe
France,08-06-2020,397803,1512,1025,396778,Europe
Gabon,08-06-2020,304072,421,1058,303014,Africa
Gambia,08-06-2020,152650,754,312,152338,Africa
Georgia,08-06-2020,126837,911,214,126623,Europe
Germany,08-06-2020,227391,656,289,227102,Europe
Ghana,08-06-2020,9832,2474,128,9704,Africa
Greece,08-06-2020,193930,273,909,193021,Europe
Guatemala,08-06-2020,212621,2388,824,211797,Americas
Guinea,08-06-2020,191158,1228,38,191120,Africa
Guyana,08-06-2020,328129,2367,172,327957,Americas
Haiti,08-06-2020,111206,366,1039,110167,Americas
Holy See,08-06-2020,154582,1270,641,153941,Europe
Honduras,08-06-2020,158481,1030,873,157608,Americas
Hungary,08-06-2020,273989,1892,842,273147,Europe
Iceland,08-06-2020,410081,1231,183,409898,Europe
India,08-06-2020,431600,1748,414,431186,South-East Asia
Indonesia,08-06-2020,7909,616,788,7121,South-East Asia
Iran,08-06-2020,211040,1484,624,210416,Eastern Mediterranean
Iraq,08-06-2020,330402,205,465,329937,Eastern Mediterranean
Ireland,08-06-2020,129855,2188,696,129159,Europe
Israel,08-06-2020,40375,1189,802,39573,Europe
Italy,08-06-2020,405466,2238,23,405443,Europe
Jamaica,08-06-2020,288092,1185,845,287247,Americas
Japan,08-06-2020,39623,1804,978,38645,Western Pacific
Jordan,08-06-2020,355954,1800,176,355778,Eastern Mediterranean
Kazakhstan,08-06-2020,229289,1321,751,228538,Europe
Kenya,08-06-2020,424415,2116,491,423924,Africa
South Korea,08-06-2020,426351,1259,385,425966,Western Pacific
Kuwait,08-06-2020,408322,365,767,407555,Eastern Mediterranean
Kyrgyzstan,08-06-2020,203631,1381,904,202727,Europe
Latvia,08-06-2020,21977,1420,308,21669,Europe
Lebanon,08-06-2020,394702,1013,574,394128,Eastern Mediterranean
Liberia,08-06-2020,311725,1107,957,310768,Africa
Liechtenstein,08-06-2020,395230,801,479,394751,Europe
Lithuania,08-06-2020,309127,481,759,308368,Europe
Luxembourg,08-06-2020,420567,2365,155,420412,Europe
Madagascar,08-06-2020,375225,322,861,374364,Africa
Malaysia,08-06-2020,379555,2144,264,379291,Western Pacific
Maldives,08-06-2020,18065,1660,863,17202,South-East Asia
Malta,08-06-2020,113670,2435,1039,112631,Europe
Mauritania,08-06-2020,47903,1513,295,47608,Africa
Mauritius,08-06-2020,444350,1802,1076,443274,Africa
Mexico,08-06-2020,336522,1426,486,336036,Americas
Moldova,08-06-2020,159980,992,964,159016,Europe
Monaco,08-06-2020,297455,1053,500,296955,Europe
Mongolia,08-06-2020,66776,1374,865,65911,Western Pacific
Montenegro,08-06-2020,99942,70,1080,98862,Europe
Morocco,08-06-2020,39554,1845,879,38675,Eastern Mediterranean
Namibia,08-06-2020,107869,239,767,107102,Africa
Nepal,08-06-2020,408977,954,59,408918,South-East Asia
Netherlands,08-06-2020,273917,823,548,273369,Europe
Netherlands,08-06-2020,271161,1540,702,270459,Europe
Netherlands,08-06-2020,270393,1686,688,269705,Europe
Netherlands,08-06-2020,148140,755,714,147426,Europe
New Zealand,08-06-2020,27327,1939,47,27280,Western Pacific
Nicaragua,08-06-2020,427980,1087,197,427783,Americas
Niger,08-06-2020,256818,301,154,256664,Africa
Nigeria,08-06-2020,21189,311,824,20365,Africa
North Macedonia,08-06-2020,209834,1008,977,208857,Europe
Norway,08-06-2020,300429,662,974,299455,Europe
Oman,08-06-2020,373037,361,627,372410,Eastern Mediterranean
Pakistan,08-06-2020,234604,478,107,234497,Eastern Mediterranean
Panama,08-06-2020,275215,2212,1105,274110,Americas
Papua New Guinea,08-06-2020,72282,1816,597,71685,Western Pacific
Paraguay,08-06-2020,117702,172,435,117267,Americas
Peru,08-06-2020,211043,1831,824,210219,Americas
Philippines,08-06-2020,357757,1224,1061,356696,Western Pacific
Poland,08-06-2020,438162,704,195,437967,Europe
Portugal,08-06-2020,36700,126,488,36212,Europe
Qatar,08-06-2020,54279,1743,145,54134,Eastern Mediterranean
Romania,08-06-2020,243772,1850,561,243211,Europe
Russia,08-06-2020,282112,1969,547,281565,Europe
Rwanda,08-06-2020,346667,837,1030,345637,Africa
Saint Lucia,08-06-2020,434219,1798,657,433562,Americas
Saint Vincent and the Grenadines,08-06-2020,144403,1039,741,143662,Americas
San Marino,08-06-2020,364183,1886,958,363225,Europe
Saudi Arabia,08-06-2020,32443,1123,819,31624,Eastern Mediterranean
Senegal,08-06-2020,349194,961,481,348713,Africa
Serbia,08-06-2020,333295,462,132,333163,Europe
Seychelles,08-06-2020,7705,2190,291,7414,Africa
Singapore,08-06-2020,141431,2231,471,140960,Western Pacific
Slovakia,08-06-2020,404226,1401,99,404127,Europe
Slovenia,08-06-2020,342702,1658,1210,341492,Europe
Somalia,08-06-2020,186602,2102,1250,185352,Eastern Mediterranean
South Africa,08-06-2020,192263,2195,1168,191095,Africa
Spain,08-06-2020,427148,323,744,426404,Europe
Sri Lanka,08-06-2020,435012,2401,618,434394,South-East Asia
Sudan,08-06-2020,370111,1301,1129,368982,Eastern Mediterranean
Suriname,08-06-2020,95841,1505,1019,94822,Americas
Sweden,08-06-2020,219474,386,4,219470,Europe
Switzerland,08-06-2020,193639,1848,30,193609,Europe
Taiwan*,08-06-2020,90304,385,797,89507,Western Pacific
Tanzania,08-06-2020,396298,1103,655,395643,Africa
Thailand,08-06-2020,366988,1939,594,366394,South-East Asia
Togo,08-06-2020,74597,723,850,73747,Africa
Trinidad and Tobago,08-06-2020,93914,2365,813,93101,Americas
Tunisia,08-06-2020,71687,2028,939,70748,Eastern Mediterranean
Turkey,08-06-2020,369952,978,284,369668,Europe
Uganda,08-06-2020,398520,2197,819,397701,Africa
Ukraine,08-06-2020,137475,1921,469,137006,Europe
United Arab Emirates,08-06-2020,372325,751,582,371743,Eastern Mediterranean
United Kingdom,08-06-2020,172017,1469,340,171677,Europe
United Kingdom,08-06-2020,364613,398,849,363764,Europe
United Kingdom,08-06-2020,156378,1142,454,155924,Europe
United Kingdom,08-06-2020,317607,1270,242,317365,Europe
United Kingdom,08-06-2020,257050,2257,1153,255897,Europe
United Kingdom,08-06-2020,110708,460,1037,109671,Europe
United Kingdom,08-06-2020,254993,671,170,254823,Europe
Uruguay,08-06-2020,169497,409,396,169101,Americas
US,08-06-2020,234087,2474,988,233099,Americas
Uzbekistan,08-06-2020,14211,347,983,13228,Europe
Venezuela,08-06-2020,121758,1149,346,121412,Americas
Vietnam,08-06-2020,335723,2476,258,335465,Western Pacific
Zambia,08-06-2020,320561,1833,1007,319554,Africa
Zimbabwe,08-06-2020,208874,809,467,208407,Africa
Dominica,08-06-2020,241302,695,1011,240291,Americas
Grenada,08-06-2020,444999,2284,1081,443918,Americas
Mozambique,08-06-2020,228999,2479,167,228832,Africa
Syria,08-06-2020,179662,105,760,178902,Eastern Mediterranean
Timor-Leste,08-06-2020,9921,1908,346,9575,South-East Asia
Belize,08-06-2020,211267,1642,738,210529,Americas
Laos,08-06-2020,377619,358,935,376684,Western Pacific
Libya,08-06-2020,22890,1811,326,22564,Eastern Mediterranean
West Bank and Gaza,08-06-2020,233498,610,379,233119,Eastern Mediterranean
Guinea-Bissau,08-06-2020,305041,1257,903,304138,Africa
Mali,08-06-2020,33283,1990,712,32571,Africa
Saint Kitts and Nevis,08-06-2020,410901,1910,969,409932,Americas
Canada,08-06-2020,25581,123,1044,24537,Americas
Canada,08-06-2020,223624,2054,1062,222562,Americas
Kosovo,08-06-2020,124787,362,281,124506,Europe
Burma,08-06-2020,332360,1912,311,332049,South-East Asia
United Kingdom,08-06-2020,167710,326,266,167444,Europe
United Kingdom,08-06-2020,362705,1202,730,361975,Europe
United Kingdom,08-06-2020,223078,992,787,222291,Europe
Botswana,08-06-2020,89983,2149,270,89713,Africa
Burundi,08-06-2020,118597,2397,142,118455,Africa
Sierra Leone,08-06-2020,379817,823,1060,378757,Africa
Malawi,08-06-2020,397584,1897,304,397280,Africa
United Kingdom,08-06-2020,347753,924,487,347266,Europe
France,08-06-2020,270774,2364,401,270373,Europe
South Sudan,08-06-2020,242424,1194,1000,241424,Africa
Western Sahara,08-06-2020,390531,1182,868,389663,Africa
Sao Tome and Principe,08-06-2020,229233,76,864,228369,Africa
Yemen,08-06-2020,414985,189,825,414160,Eastern Mediterranean
Comoros,08-06-2020,171142,1634,558,170584,Africa
Tajikistan,08-06-2020,426575,191,1126,425449,Europe
Lesotho,08-06-2020,244729,110,1138,243591,Africa
Afghanistan,09-06-2020,383486,1492,209,383277,Eastern Mediterranean
Albania,09-06-2020,1934,1558,588,1346,Europe
Algeria,09-06-2020,276467,761,827,275640,Africa
Andorra,09-06-2020,210879,984,911,209968,Europe
Angola,09-06-2020,177804,862,541,177263,Africa
Antigua and Barbuda,09-06-2020,178117,121,1200,176917,Americas
Argentina,09-06-2020,383016,2035,741,382275,Americas
Armenia,09-06-2020,327991,782,942,327049,Europe
Australia,09-06-2020,77535,922,355,77180,Western Pacific
Australia,09-06-2020,48218,1221,806,47412,Western Pacific
Australia,09-06-2020,72289,1594,1046,71243,Western Pacific
Australia,09-06-2020,293759,1907,184,293575,Western Pacific
Australia,09-06-2020,32055,1555,256,31799,Western Pacific
Australia,09-06-2020,151647,557,336,151311,Western Pacific
Australia,09-06-2020,428240,1375,693,427547,Western Pacific
Australia,09-06-2020,76719,2252,118,76601,Western Pacific
Austria,09-06-2020,268903,1360,465,268438,Europe
Azerbaijan,09-06-2020,418747,1208,108,418639,Europe
Bahamas,09-06-2020,370637,846,21,370616,Americas
Bahrain,09-06-2020,219413,2408,770,218643,Eastern Mediterranean
Bangladesh,09-06-2020,406454,1330,218,406236,South-East Asia
Barbados,09-06-2020,319187,2351,1119,318068,Americas
Belarus,09-06-2020,2967,529,966,2001,Europe
Belgium,09-06-2020,384360,167,606,383754,Europe
Benin,09-06-2020,196284,2245,970,195314,Africa
Bhutan,09-06-2020,392181,994,522,391659,South-East Asia
Bolivia,09-06-2020,385985,771,1177,384808,Americas
Bosnia and Herzegovina,09-06-2020,82138,1827,1144,80994,Europe
Brazil,09-06-2020,327846,1738,193,327653,Americas
Brunei,09-06-2020,268008,2193,703,267305,Western Pacific
Bulgaria,09-06-2020,223185,398,935,222250,Europe
Burkina Faso,09-06-2020,257454,1794,866,256588,Africa
Cabo Verde,09-06-2020,22855,118,715,22140,Africa
Cambodia,09-06-2020,385480,1323,210,385270,Western Pacific
Cameroon,09-06-2020,170390,2000,838,169552,Africa
Canada,09-06-2020,71149,1939,970,70179,Americas
Canada,09-06-2020,315233,2034,464,314769,Americas
Canada,09-06-2020,123598,1945,952,122646,Americas
Canada,09-06-2020,379574,2252,90,379484,Americas
Canada,09-06-2020,414862,1742,182,414680,Americas
Canada,09-06-2020,35889,1253,892,34997,Americas
Canada,09-06-2020,206015,934,529,205486,Americas
Canada,09-06-2020,298015,2292,1021,296994,Americas
Canada,09-06-2020,17348,1391,17,17331,Americas
Canada,09-06-2020,162194,1099,21,162173,Americas
Central African Republic,09-06-2020,115196,345,957,114239,Africa
Chad,09-06-2020,419007,1836,213,418794,Africa
Chile,09-06-2020,214590,9,391,214199,Americas
China,09-06-2020,73932,344,660,73272,Western Pacific
China,09-06-2020,24517,680,319,24198,Western Pacific
China,09-06-2020,76396,590,462,75934,Western Pacific
China,09-06-2020,5182,836,233,4949,Western Pacific
China,09-06-2020,125405,1575,362,125043,Western Pacific
China,09-06-2020,30039,157,115,29924,Western Pacific
China,09-06-2020,290266,219,667,289599,Western Pacific
China,09-06-2020,114372,2343,857,113515,Western Pacific
China,09-06-2020,314692,1622,22,314670,Western Pacific
China,09-06-2020,367727,648,1162,366565,Western Pacific
China,09-06-2020,165386,1765,465,164921,Western Pacific
China,09-06-2020,23013,705,839,22174,Western Pacific
China,09-06-2020,419557,2050,621,418936,Western Pacific
China,09-06-2020,57113,193,639,56474,Western Pacific
China,09-06-2020,276755,1785,2,276753,Western Pacific
China,09-06-2020,244593,1017,1115,243478,Western Pacific
China,09-06-2020,167516,2477,23,167493,Western Pacific
China,09-06-2020,364956,846,711,364245,Western Pacific
China,09-06-2020,27572,1454,637,26935,Western Pacific
China,09-06-2020,48216,826,507,47709,Western Pacific
China,09-06-2020,114194,2115,805,113389,Western Pacific
China,09-06-2020,90434,1118,325,90109,Western Pacific
China,09-06-2020,305894,1699,828,305066,Western Pacific
China,09-06-2020,117770,2229,821,116949,Western Pacific
China,09-06-2020,303855,2083,554,303301,Western Pacific
China,09-06-2020,197572,313,492,197080,Western Pacific
China,09-06-2020,150960,1872,3,150957,Western Pacific
China,09-06-2020,267647,1223,220,267427,Western Pacific
China,09-06-2020,431718,2139,388,431330,Western Pacific
China,09-06-2020,76925,1841,424,76501,Western Pacific
China,09-06-2020,119274,2171,113,119161,Western Pacific
China,09-06-2020,101884,2060,709,101175,Western Pacific
China,09-06-2020,347250,1376,457,346793,Western Pacific
Colombia,09-06-2020,153256,34,181,153075,Americas
Congo (Brazzaville),09-06-2020,216764,783,843,215921,Africa
Congo (Kinshasa),09-06-2020,74761,1764,798,73963,Africa
Costa Rica,09-06-2020,405810,2054,80,405730,Americas
Cote d'Ivoire,09-06-2020,261384,230,339,261045,Africa
Croatia,09-06-2020,225801,2102,85,225716,Europe
Cuba,09-06-2020,51653,1130,957,50696,Americas
Cyprus,09-06-2020,351693,1951,1099,350594,Europe
Czechia,09-06-2020,168270,811,26,168244,Europe
Denmark,09-06-2020,307077,1056,205,306872,Europe
Greenland,09-06-2020,363011,982,380,362631,Europe
Denmark,09-06-2020,217202,70,756,216446,Europe
Djibouti,09-06-2020,202978,2357,988,201990,Eastern Mediterranean
Dominican Republic,09-06-2020,263198,2328,698,262500,Americas
Ecuador,09-06-2020,35125,1045,694,34431,Americas
Egypt,09-06-2020,100226,1631,1173,99053,Eastern Mediterranean
El Salvador,09-06-2020,247803,947,974,246829,Americas
Equatorial Guinea,09-06-2020,367739,1893,329,367410,Africa
Eritrea,09-06-2020,213068,2399,672,212396,Africa
Estonia,09-06-2020,410073,702,454,409619,Europe
Eswatini,09-06-2020,366176,1980,878,365298,Africa
Ethiopia,09-06-2020,229271,130,1225,228046,Africa
Fiji,09-06-2020,67540,25,711,66829,Western Pacific
Finland,09-06-2020,338687,1652,271,338416,Europe
France,09-06-2020,414597,564,397,414200,Europe
France,09-06-2020,356723,2263,630,356093,Europe
France,09-06-2020,47916,595,1062,46854,Europe
France,09-06-2020,379310,687,1043,378267,Europe
France,09-06-2020,76534,718,1201,75333,Europe
France,09-06-2020,29084,374,1005,28079,Europe
France,09-06-2020,12727,1343,872,11855,Europe
France,09-06-2020,267093,951,518,266575,Europe
France,09-06-2020,310802,2225,230,310572,Europe
France,09-06-2020,50371,525,1099,49272,Europe
Gabon,09-06-2020,40378,1589,1123,39255,Africa
Gambia,09-06-2020,430635,1942,568,430067,Africa
Georgia,09-06-2020,249269,1131,36,249233,Europe
Germany,09-06-2020,232746,811,690,232056,Europe
Ghana,09-06-2020,24812,1360,1067,23745,Africa
Greece,09-06-2020,16947,1377,802,16145,Europe
Guatemala,09-06-2020,104786,2002,133,104653,Americas
Guinea,09-06-2020,27579,1028,228,27351,Africa
Guyana,09-06-2020,125464,2496,572,124892,Americas
Haiti,09-06-2020,293785,1756,537,293248,Americas
Holy See,09-06-2020,160814,1413,964,159850,Europe
Honduras,09-06-2020,83062,233,209,82853,Americas
Hungary,09-06-2020,195352,1385,842,194510,Europe
Iceland,09-06-2020,84104,1617,915,83189,Europe
India,09-06-2020,285484,1098,251,285233,South-East Asia
Indonesia,09-06-2020,87458,1657,896,86562,South-East Asia
Iran,09-06-2020,16019,634,443,15576,Eastern Mediterranean
Iraq,09-06-2020,90876,2381,537,90339,Eastern Mediterranean
Ireland,09-06-2020,180643,605,363,180280,Europe
Israel,09-06-2020,183630,603,672,182958,Europe
Italy,09-06-2020,391790,1548,784,391006,Europe
Jamaica,09-06-2020,179624,1067,1059,178565,Americas
Japan,09-06-2020,284761,1487,502,284259,Western Pacific
Jordan,09-06-2020,116983,1850,22,116961,Eastern Mediterranean
Kazakhstan,09-06-2020,88268,2014,116,88152,Europe
Kenya,09-06-2020,244871,550,52,244819,Africa
South Korea,09-06-2020,158066,206,249,157817,Western Pacific
Kuwait,09-06-2020,407546,1187,256,407290,Eastern Mediterranean
Kyrgyzstan,09-06-2020,111276,43,905,110371,Europe
Latvia,09-06-2020,348100,2311,305,347795,Europe
Lebanon,09-06-2020,245710,403,1062,244648,Eastern Mediterranean
Liberia,09-06-2020,331038,1760,776,330262,Africa
Liechtenstein,09-06-2020,72997,156,582,72415,Europe
Lithuania,09-06-2020,393840,542,1052,392788,Europe
Luxembourg,09-06-2020,71608,1109,729,70879,Europe
Madagascar,09-06-2020,395370,1792,208,395162,Africa
Malaysia,09-06-2020,103594,1765,1220,102374,Western Pacific
Maldives,09-06-2020,90474,1776,415,90059,South-East Asia
Malta,09-06-2020,362624,1056,783,361841,Europe
Mauritania,09-06-2020,339799,1933,699,339100,Africa
Mauritius,09-06-2020,131087,1415,904,130183,Africa
Mexico,09-06-2020,436286,1573,629,435657,Americas
Moldova,09-06-2020,24736,1705,733,24003,Europe
Monaco,09-06-2020,72174,2304,34,72140,Europe
Mongolia,09-06-2020,107406,252,493,106913,Western Pacific
Montenegro,09-06-2020,158073,1049,642,157431,Europe
Morocco,09-06-2020,229724,2440,926,228798,Eastern Mediterranean
Namibia,09-06-2020,154489,424,462,154027,Africa
Nepal,09-06-2020,196670,1723,1035,195635,South-East Asia
Netherlands,09-06-2020,427176,2011,300,426876,Europe
Netherlands,09-06-2020,3480,1954,329,3151,Europe
Netherlands,09-06-2020,404995,1843,697,404298,Europe
Netherlands,09-06-2020,87549,803,1171,86378,Europe
New Zealand,09-06-2020,110063,1344,1153,108910,Western Pacific
Nicaragua,09-06-2020,105565,2464,1241,104324,Americas
Niger,09-06-2020,116662,805,249,116413,Africa
Nigeria,09-06-2020,82344,1623,610,81734,Africa
North Macedonia,09-06-2020,427947,2409,958,426989,Europe
Norway,09-06-2020,437707,634,335,437372,Europe
Oman,09-06-2020,269747,1683,3,269744,Eastern Mediterranean
Pakistan,09-06-2020,439270,1564,712,438558,Eastern Mediterranean
Panama,09-06-2020,114144,2138,665,113479,Americas
Papua New Guinea,09-06-2020,219302,2499,1009,218293,Western Pacific
Paraguay,09-06-2020,162391,708,1022,161369,Americas
Peru,09-06-2020,321506,1450,967,320539,Americas
Philippines,09-06-2020,213441,19,883,212558,Western Pacific
Poland,09-06-2020,414859,1113,784,414075,Europe
Portugal,09-06-2020,190541,48,1142,189399,Europe
Qatar,09-06-2020,127234,968,1023,126211,Eastern Mediterranean
Romania,09-06-2020,386902,2169,443,386459,Europe
Russia,09-06-2020,393997,1147,360,393637,Europe
Rwanda,09-06-2020,19792,1204,133,19659,Africa
Saint Lucia,09-06-2020,348237,1386,883,347354,Americas
Saint Vincent and the Grenadines,09-06-2020,433613,1768,63,433550,Americas
San Marino,09-06-2020,86396,2324,933,85463,Europe
Saudi Arabia,09-06-2020,403096,296,612,402484,Eastern Mediterranean
Senegal,09-06-2020,309944,1296,824,309120,Africa
Serbia,09-06-2020,184400,1034,961,183439,Europe
Seychelles,09-06-2020,141779,2237,989,140790,Africa
Singapore,09-06-2020,298196,1217,321,297875,Western Pacific
Slovakia,09-06-2020,34826,1363,1048,33778,Europe
Slovenia,09-06-2020,262471,348,877,261594,Europe
Somalia,09-06-2020,342041,2350,408,341633,Eastern Mediterranean
South Africa,09-06-2020,196619,568,439,196180,Africa
Spain,09-06-2020,248590,2379,531,248059,Europe
Sri Lanka,09-06-2020,370856,1945,1078,369778,South-East Asia
Sudan,09-06-2020,101044,16,313,100731,Eastern Mediterranean
Suriname,09-06-2020,447050,2136,866,446184,Americas
Sweden,09-06-2020,430109,1511,480,429629,Europe
Switzerland,09-06-2020,124898,242,1155,123743,Europe
Taiwan*,09-06-2020,42755,613,938,41817,Western Pacific
Tanzania,09-06-2020,155051,2012,1012,154039,Africa
Thailand,09-06-2020,277115,1078,1236,275879,South-East Asia
Togo,09-06-2020,397773,1202,122,397651,Africa
Trinidad and Tobago,09-06-2020,409784,2197,26,409758,Americas
Tunisia,09-06-2020,76934,3,686,76248,Eastern Mediterranean
Turkey,09-06-2020,220548,53,979,219569,Europe
Uganda,09-06-2020,273472,210,274,273198,Africa
Ukraine,09-06-2020,418565,667,418,418147,Europe
United Arab Emirates,09-06-2020,338497,579,60,338437,Eastern Mediterranean
United Kingdom,09-06-2020,298282,207,1102,297180,Europe
United Kingdom,09-06-2020,105214,1842,508,104706,Europe
United Kingdom,09-06-2020,11947,2094,397,11550,Europe
United Kingdom,09-06-2020,314429,1986,225,314204,Europe
United Kingdom,09-06-2020,21572,2492,690,20882,Europe
United Kingdom,09-06-2020,129633,252,445,129188,Europe
United Kingdom,09-06-2020,35760,826,567,35193,Europe
Uruguay,09-06-2020,354618,1140,894,353724,Americas
US,09-06-2020,294564,1799,996,293568,Americas
Uzbekistan,09-06-2020,327309,47,944,326365,Europe
Venezuela,09-06-2020,210066,627,326,209740,Americas
Vietnam,09-06-2020,102825,1351,254,102571,Western Pacific
Zambia,09-06-2020,233964,535,266,233698,Africa
Zimbabwe,09-06-2020,429906,1369,1039,428867,Africa
Dominica,09-06-2020,318742,729,664,318078,Americas
Grenada,09-06-2020,69827,1438,211,69616,Americas
Mozambique,09-06-2020,239557,766,1171,238386,Africa
Syria,09-06-2020,331000,2022,293,330707,Eastern Mediterranean
Timor-Leste,09-06-2020,198443,2399,254,198189,South-East Asia
Belize,09-06-2020,264447,766,1017,263430,Americas
Laos,09-06-2020,325802,1878,1049,324753,Western Pacific
Libya,09-06-2020,198264,996,373,197891,Eastern Mediterranean
West Bank and Gaza,09-06-2020,393371,1007,834,392537,Eastern Mediterranean
Guinea-Bissau,09-06-2020,436502,2357,563,435939,Africa
Mali,09-06-2020,300880,1879,886,299994,Africa
Saint Kitts and Nevis,09-06-2020,185857,2322,206,185651,Americas
Canada,09-06-2020,440014,464,1071,438943,Americas
Canada,09-06-2020,148875,1959,195,148680,Americas
Kosovo,09-06-2020,247397,1785,329,247068,Europe
Burma,09-06-2020,164358,62,47,164311,South-East Asia
United Kingdom,09-06-2020,134404,751,1050,133354,Europe
United Kingdom,09-06-2020,331629,2426,1165,330464,Europe
United Kingdom,09-06-2020,276123,524,250,275873,Europe
Botswana,09-06-2020,355671,2424,1212,354459,Africa
Burundi,09-06-2020,100823,1600,1233,99590,Africa
Sierra Leone,09-06-2020,277260,1138,225,277035,Africa
Malawi,09-06-2020,435234,1899,183,435051,Africa
United Kingdom,09-06-2020,89322,1103,442,88880,Europe
France,09-06-2020,349615,788,20,349595,Europe
South Sudan,09-06-2020,309902,2129,1149,308753,Africa
Western Sahara,09-06-2020,164442,2119,260,164182,Africa
Sao Tome and Principe,09-06-2020,287630,2310,218,287412,Africa
Yemen,09-06-2020,68726,2143,81,68645,Eastern Mediterranean
Comoros,09-06-2020,338443,157,140,338303,Africa
Tajikistan,09-06-2020,95871,1415,565,95306,Europe
Lesotho,09-06-2020,334260,938,492,333768,Africa
Afghanistan,10-06-2020,14097,2059,810,13287,Eastern Mediterranean
Albania,10-06-2020,236062,168,1022,235040,Europe
Algeria,10-06-2020,402556,649,907,401649,Africa
Andorra,10-06-2020,264853,869,443,264410,Europe
Angola,10-06-2020,132988,945,689,132299,Africa
Antigua and Barbuda,10-06-2020,147457,1603,191,147266,Americas
Argentina,10-06-2020,212683,1652,857,211826,Americas
Armenia,10-06-2020,8473,592,147,8326,Europe
Australia,10-06-2020,138717,2233,1111,137606,Western Pacific
Australia,10-06-2020,442207,2341,1089,441118,Western Pacific
Australia,10-06-2020,210065,1473,123,209942,Western Pacific
Australia,10-06-2020,155279,735,411,154868,Western Pacific
Australia,10-06-2020,270913,1205,61,270852,Western Pacific
Australia,10-06-2020,132906,1718,302,132604,Western Pacific
Australia,10-06-2020,255714,1094,5,255709,Western Pacific
Australia,10-06-2020,233644,1540,228,233416,Western Pacific
Austria,10-06-2020,271677,1026,262,271415,Europe
Azerbaijan,10-06-2020,304867,1547,1101,303766,Europe
Bahamas,10-06-2020,152763,1463,440,152323,Americas
Bahrain,10-06-2020,67721,1990,341,67380,Eastern Mediterranean
Bangladesh,10-06-2020,381127,490,187,380940,South-East Asia
Barbados,10-06-2020,74939,1515,790,74149,Americas
Belarus,10-06-2020,417302,53,244,417058,Europe
Belgium,10-06-2020,425361,2048,613,424748,Europe
Benin,10-06-2020,110025,136,290,109735,Africa
Bhutan,10-06-2020,154070,1820,674,153396,South-East Asia
Bolivia,10-06-2020,147232,1337,1015,146217,Americas
Bosnia and Herzegovina,10-06-2020,364065,97,212,363853,Europe
Brazil,10-06-2020,416410,2052,381,416029,Americas
Brunei,10-06-2020,378034,1056,726,377308,Western Pacific
Bulgaria,10-06-2020,67646,1131,1092,66554,Europe
Burkina Faso,10-06-2020,57987,12,163,57824,Africa
Cabo Verde,10-06-2020,249688,151,1145,248543,Africa
Cambodia,10-06-2020,407409,1770,387,407022,Western Pacific
Cameroon,10-06-2020,163280,1618,545,162735,Africa
Canada,10-06-2020,2372,1181,1155,1217,Americas
Canada,10-06-2020,254737,673,1025,253712,Americas
Canada,10-06-2020,141687,2016,995,140692,Americas
Canada,10-06-2020,63158,1575,374,62784,Americas
Canada,10-06-2020,205522,2255,1113,204409,Americas
Canada,10-06-2020,253874,1823,468,253406,Americas
Canada,10-06-2020,76987,369,1102,75885,Americas
Canada,10-06-2020,150465,163,435,150030,Americas
Canada,10-06-2020,30496,1000,543,29953,Americas
Canada,10-06-2020,392128,774,392,391736,Americas
Central African Republic,10-06-2020,304592,2293,1189,303403,Africa
Chad,10-06-2020,180197,565,1013,179184,Africa
Chile,10-06-2020,83848,716,1164,82684,Americas
China,10-06-2020,427046,2075,716,426330,Western Pacific
China,10-06-2020,168137,2242,963,167174,Western Pacific
China,10-06-2020,186777,2164,544,186233,Western Pacific
China,10-06-2020,58066,481,479,57587,Western Pacific
China,10-06-2020,416489,110,828,415661,Western Pacific
China,10-06-2020,71349,1568,255,71094,Western Pacific
China,10-06-2020,267937,1572,367,267570,Western Pacific
China,10-06-2020,360208,2259,646,359562,Western Pacific
China,10-06-2020,275797,1006,5,275792,Western Pacific
China,10-06-2020,347300,2121,897,346403,Western Pacific
China,10-06-2020,47375,1215,999,46376,Western Pacific
China,10-06-2020,439292,1971,1096,438196,Western Pacific
China,10-06-2020,23841,508,1024,22817,Western Pacific
China,10-06-2020,199756,1440,661,199095,Western Pacific
China,10-06-2020,121384,674,80,121304,Western Pacific
China,10-06-2020,391311,1195,917,390394,Western Pacific
China,10-06-2020,343485,171,1171,342314,Western Pacific
China,10-06-2020,63161,2099,601,62560,Western Pacific
China,10-06-2020,208578,2163,133,208445,Western Pacific
China,10-06-2020,275975,501,493,275482,Western Pacific
China,10-06-2020,97621,258,918,96703,Western Pacific
China,10-06-2020,211443,227,918,210525,Western Pacific
China,10-06-2020,153548,1566,1018,152530,Western Pacific
China,10-06-2020,321398,2341,503,320895,Western Pacific
China,10-06-2020,339718,2053,85,339633,Western Pacific
China,10-06-2020,200166,980,1169,198997,Western Pacific
China,10-06-2020,250311,862,1184,249127,Western Pacific
China,10-06-2020,147877,226,393,147484,Western Pacific
China,10-06-2020,326727,472,315,326412,Western Pacific
China,10-06-2020,409986,2055,557,409429,Western Pacific
China,10-06-2020,109907,1297,658,109249,Western Pacific
China,10-06-2020,208280,361,299,207981,Western Pacific
China,10-06-2020,48086,2303,919,47167,Western Pacific
Colombia,10-06-2020,360590,1531,1135,359455,Americas
Congo (Brazzaville),10-06-2020,329063,1676,1059,328004,Africa
Congo (Kinshasa),10-06-2020,45612,1976,776,44836,Africa
Costa Rica,10-06-2020,222968,2086,1049,221919,Americas
Cote d'Ivoire,10-06-2020,201507,2468,727,200780,Africa
Croatia,10-06-2020,327975,121,950,327025,Europe
Cuba,10-06-2020,444420,1353,217,444203,Americas
Cyprus,10-06-2020,281185,539,633,280552,Europe
Czechia,10-06-2020,67884,1376,1154,66730,Europe
Denmark,10-06-2020,255576,1332,793,254783,Europe
Greenland,10-06-2020,417559,1173,390,417169,Europe
Denmark,10-06-2020,137784,5,323,137461,Europe
Djibouti,10-06-2020,332175,1022,74,332101,Eastern Mediterranean
Dominican Republic,10-06-2020,127861,2030,449,127412,Americas
Ecuador,10-06-2020,259259,2494,469,258790,Americas
Egypt,10-06-2020,31454,201,376,31078,Eastern Mediterranean
El Salvador,10-06-2020,179892,2282,816,179076,Americas
Equatorial Guinea,10-06-2020,364444,1104,712,363732,Africa
Eritrea,10-06-2020,229,298,1043,-814,Africa
Estonia,10-06-2020,357407,1231,342,357065,Europe
Eswatini,10-06-2020,308765,1472,226,308539,Africa
Ethiopia,10-06-2020,156012,147,665,155347,Africa
Fiji,10-06-2020,105173,2312,815,104358,Western Pacific
Finland,10-06-2020,74709,1886,1046,73663,Europe
France,10-06-2020,362964,2134,117,362847,Europe
France,10-06-2020,125746,335,279,125467,Europe
France,10-06-2020,258678,1588,698,257980,Europe
France,10-06-2020,325250,2052,455,324795,Europe
France,10-06-2020,218501,2213,536,217965,Europe
France,10-06-2020,397507,321,1221,396286,Europe
France,10-06-2020,1535,673,629,906,Europe
France,10-06-2020,132221,2145,1143,131078,Europe
France,10-06-2020,217382,1395,916,216466,Europe
France,10-06-2020,34980,1617,653,34327,Europe
Gabon,10-06-2020,402916,1475,1086,401830,Africa
Gambia,10-06-2020,264312,609,1185,263127,Africa
Georgia,10-06-2020,125283,582,162,125121,Europe
Germany,10-06-2020,284667,622,399,284268,Europe
Ghana,10-06-2020,281720,442,576,281144,Africa
Greece,10-06-2020,163599,2196,122,163477,Europe
Guatemala,10-06-2020,169482,637,423,169059,Americas
Guinea,10-06-2020,419205,461,384,418821,Africa
Guyana,10-06-2020,224065,362,356,223709,Americas
Haiti,10-06-2020,396931,284,726,396205,Americas
Holy See,10-06-2020,335778,298,231,335547,Europe
Honduras,10-06-2020,321342,1828,1170,320172,Americas
Hungary,10-06-2020,234567,644,1200,233367,Europe
Iceland,10-06-2020,250653,625,1097,249556,Europe
India,10-06-2020,198415,329,7,198408,South-East Asia
Indonesia,10-06-2020,122272,524,509,121763,South-East Asia
Iran,10-06-2020,363010,2463,67,362943,Eastern Mediterranean
Iraq,10-06-2020,57059,288,607,56452,Eastern Mediterranean
Ireland,10-06-2020,318945,2205,573,318372,Europe
Israel,10-06-2020,399938,244,1028,398910,Europe
Italy,10-06-2020,12566,2044,852,11714,Europe
Jamaica,10-06-2020,239639,2108,823,238816,Americas
Japan,10-06-2020,146944,467,482,146462,Western Pacific
Jordan,10-06-2020,409321,621,669,408652,Eastern Mediterranean
Kazakhstan,10-06-2020,403491,154,236,403255,Europe
Kenya,10-06-2020,194560,2369,1221,193339,Africa
South Korea,10-06-2020,159306,1163,77,159229,Western Pacific
Kuwait,10-06-2020,151012,303,920,150092,Eastern Mediterranean
Kyrgyzstan,10-06-2020,207670,1589,559,207111,Europe
Latvia,10-06-2020,448977,556,996,447981,Europe
Lebanon,10-06-2020,22101,589,673,21428,Eastern Mediterranean
Liberia,10-06-2020,367525,637,338,367187,Africa
Liechtenstein,10-06-2020,40436,985,509,39927,Europe
Lithuania,10-06-2020,26589,2289,1216,25373,Europe
Luxembourg,10-06-2020,59157,318,620,58537,Europe
Madagascar,10-06-2020,176634,534,919,175715,Africa
Malaysia,10-06-2020,150968,1054,24,150944,Western Pacific
Maldives,10-06-2020,190441,2250,194,190247,South-East Asia
Malta,10-06-2020,101671,1695,860,100811,Europe
Mauritania,10-06-2020,8325,2453,1071,7254,Africa
Mauritius,10-06-2020,154144,1819,1003,153141,Africa
Mexico,10-06-2020,277466,2340,140,277326,Americas
Moldova,10-06-2020,54375,1482,1128,53247,Europe
Monaco,10-06-2020,377243,1671,934,376309,Europe
Mongolia,10-06-2020,213345,457,1172,212173,Western Pacific
Montenegro,10-06-2020,356106,196,625,355481,Europe
Morocco,10-06-2020,42766,536,569,42197,Eastern Mediterranean
Namibia,10-06-2020,211633,238,21,211612,Africa
Nepal,10-06-2020,109180,1325,736,108444,South-East Asia
Netherlands,10-06-2020,332132,458,419,331713,Europe
Netherlands,10-06-2020,2806,1436,949,1857,Europe
Netherlands,10-06-2020,170593,1543,1231,169362,Europe
Netherlands,10-06-2020,11341,1834,900,10441,Europe
New Zealand,10-06-2020,34620,2170,748,33872,Western Pacific
Nicaragua,10-06-2020,41634,2325,458,41176,Americas
Niger,10-06-2020,296504,380,713,295791,Africa
Nigeria,10-06-2020,267893,2219,1105,266788,Africa
North Macedonia,10-06-2020,249273,2451,183,249090,Europe
Norway,10-06-2020,308121,1391,644,307477,Europe
Oman,10-06-2020,176989,265,516,176473,Eastern Mediterranean
Pakistan,10-06-2020,436797,1627,983,435814,Eastern Mediterranean
Panama,10-06-2020,371812,340,1057,370755,Americas
Papua New Guinea,10-06-2020,59819,1833,462,59357,Western Pacific
Paraguay,10-06-2020,48382,879,489,47893,Americas
Peru,10-06-2020,348402,977,895,347507,Americas
Philippines,10-06-2020,45915,110,528,45387,Western Pacific
Poland,10-06-2020,171998,959,530,171468,Europe
Portugal,10-06-2020,227597,742,310,227287,Europe
Qatar,10-06-2020,335806,735,131,335675,Eastern Mediterranean
Romania,10-06-2020,409885,1181,90,409795,Europe
Russia,10-06-2020,216049,2341,876,215173,Europe
Rwanda,10-06-2020,404241,53,255,403986,Africa
Saint Lucia,10-06-2020,176370,1019,928,175442,Americas
Saint Vincent and the Grenadines,10-06-2020,45914,168,888,45026,Americas
San Marino,10-06-2020,30553,306,511,30042,Europe
Saudi Arabia,10-06-2020,417179,453,995,416184,Eastern Mediterranean
Senegal,10-06-2020,280321,1608,668,279653,Africa
Serbia,10-06-2020,108160,205,70,108090,Europe
Seychelles,10-06-2020,36491,1695,454,36037,Africa
Singapore,10-06-2020,95746,533,867,94879,Western Pacific
Slovakia,10-06-2020,244117,2456,47,244070,Europe
Slovenia,10-06-2020,359589,937,1156,358433,Europe
Somalia,10-06-2020,14572,848,60,14512,Eastern Mediterranean
South Africa,10-06-2020,172758,252,308,172450,Africa
Spain,10-06-2020,247288,1628,1223,246065,Europe
Sri Lanka,10-06-2020,240772,116,938,239834,South-East Asia
Sudan,10-06-2020,236539,847,1116,235423,Eastern Mediterranean
Suriname,10-06-2020,98135,1622,1184,96951,Americas
Sweden,10-06-2020,237131,279,952,236179,Europe
Switzerland,10-06-2020,18042,357,523,17519,Europe
Taiwan*,10-06-2020,71071,1739,1198,69873,Western Pacific
Tanzania,10-06-2020,131910,2322,336,131574,Africa
Thailand,10-06-2020,179287,1883,505,178782,South-East Asia
Togo,10-06-2020,17083,1036,891,16192,Africa
Trinidad and Tobago,10-06-2020,17811,2047,203,17608,Americas
Tunisia,10-06-2020,134630,1034,992,133638,Eastern Mediterranean
Turkey,10-06-2020,214389,1159,1226,213163,Europe
Uganda,10-06-2020,116469,1530,231,116238,Africa
Ukraine,10-06-2020,129559,2420,191,129368,Europe
United Arab Emirates,10-06-2020,162115,402,680,161435,Eastern Mediterranean
United Kingdom,10-06-2020,439816,1505,184,439632,Europe
United Kingdom,10-06-2020,125675,199,39,125636,Europe
United Kingdom,10-06-2020,71506,1133,204,71302,Europe
United Kingdom,10-06-2020,258341,2061,147,258194,Europe
United Kingdom,10-06-2020,399868,534,657,399211,Europe
United Kingdom,10-06-2020,122295,2289,951,121344,Europe
United Kingdom,10-06-2020,412217,765,796,411421,Europe
Uruguay,10-06-2020,234412,1429,1188,233224,Americas
US,10-06-2020,270925,1495,656,270269,Americas
Uzbekistan,10-06-2020,420614,1063,904,419710,Europe
Venezuela,10-06-2020,89397,756,1241,88156,Americas
Vietnam,10-06-2020,22066,522,96,21970,Western Pacific
Zambia,10-06-2020,367910,21,740,367170,Africa
Zimbabwe,10-06-2020,295548,2091,1128,294420,Africa
Dominica,10-06-2020,164258,456,222,164036,Americas
Grenada,10-06-2020,325634,1946,564,325070,Americas
Mozambique,10-06-2020,43843,2314,633,43210,Africa
Syria,10-06-2020,73104,2264,588,72516,Eastern Mediterranean
Timor-Leste,10-06-2020,168899,633,90,168809,South-East Asia
Belize,10-06-2020,368003,2484,893,367110,Americas
Laos,10-06-2020,101076,1322,197,100879,Western Pacific
Libya,10-06-2020,323409,835,310,323099,Eastern Mediterranean
West Bank and Gaza,10-06-2020,118372,621,56,118316,Eastern Mediterranean
Guinea-Bissau,10-06-2020,84236,452,10,84226,Africa
Mali,10-06-2020,16612,2157,84,16528,Africa
Saint Kitts and Nevis,10-06-2020,195583,228,386,195197,Americas
Canada,10-06-2020,191393,320,54,191339,Americas
Canada,10-06-2020,449849,814,1169,448680,Americas
Kosovo,10-06-2020,443660,183,536,443124,Europe
Burma,10-06-2020,371116,157,655,370461,South-East Asia
United Kingdom,10-06-2020,91557,1413,915,90642,Europe
United Kingdom,10-06-2020,243350,2485,495,242855,Europe
United Kingdom,10-06-2020,217323,2235,1230,216093,Europe
Botswana,10-06-2020,128259,2306,1072,127187,Africa
Burundi,10-06-2020,263680,1253,866,262814,Africa
Sierra Leone,10-06-2020,318203,1485,622,317581,Africa
Malawi,10-06-2020,369606,66,857,368749,Africa
United Kingdom,10-06-2020,437610,1644,218,437392,Europe
France,10-06-2020,35868,1380,400,35468,Europe
South Sudan,10-06-2020,210915,296,474,210441,Africa
Western Sahara,10-06-2020,10589,161,78,10511,Africa
Sao Tome and Principe,10-06-2020,301755,1783,126,301629,Africa
Yemen,10-06-2020,25490,367,594,24896,Eastern Mediterranean
Comoros,10-06-2020,368910,10,341,368569,Africa
Tajikistan,10-06-2020,191129,1919,1138,189991,Europe
Lesotho,10-06-2020,281279,183,100,281179,Africa
Afghanistan,11-06-2020,336015,865,543,335472,Eastern Mediterranean
Albania,11-06-2020,329189,746,1186,328003,Europe
Algeria,11-06-2020,91665,1894,678,90987,Africa
Andorra,11-06-2020,373407,842,81,373326,Europe
Angola,11-06-2020,118869,657,130,118739,Africa
Antigua and Barbuda,11-06-2020,442588,1631,182,442406,Americas
Argentina,11-06-2020,303391,1656,810,302581,Americas
Armenia,11-06-2020,159535,1659,1099,158436,Europe
Australia,11-06-2020,440081,108,967,439114,Western Pacific
Australia,11-06-2020,143521,1456,206,143315,Western Pacific
Australia,11-06-2020,8049,932,1100,6949,Western Pacific
Australia,11-06-2020,2972,2366,177,2795,Western Pacific
Australia,11-06-2020,123591,2085,137,123454,Western Pacific
Australia,11-06-2020,18878,1296,1081,17797,Western Pacific
Australia,11-06-2020,382559,2397,1178,381381,Western Pacific
Australia,11-06-2020,74615,2056,974,73641,Western Pacific
Austria,11-06-2020,408966,276,96,408870,Europe
Azerbaijan,11-06-2020,160208,410,578,159630,Europe
Bahamas,11-06-2020,250233,477,943,249290,Americas
Bahrain,11-06-2020,381549,2157,751,380798,Eastern Mediterranean
Bangladesh,11-06-2020,398161,309,724,397437,South-East Asia
Barbados,11-06-2020,445825,260,521,445304,Americas
Belarus,11-06-2020,315413,1768,1092,314321,Europe
Belgium,11-06-2020,43988,1024,291,43697,Europe
Benin,11-06-2020,262938,398,542,262396,Africa
Bhutan,11-06-2020,291130,159,901,290229,South-East Asia
Bolivia,11-06-2020,444683,2174,658,444025,Americas
Bosnia and Herzegovina,11-06-2020,435539,373,618,434921,Europe
Brazil,11-06-2020,64666,1968,926,63740,Americas
Brunei,11-06-2020,14223,1486,325,13898,Western Pacific
Bulgaria,11-06-2020,376306,771,296,376010,Europe
Burkina Faso,11-06-2020,115051,2379,159,114892,Africa
Cabo Verde,11-06-2020,258095,15,335,257760,Africa
Cambodia,11-06-2020,426890,393,6,426884,Western Pacific
Cameroon,11-06-2020,154678,2305,629,154049,Africa
Canada,11-06-2020,73347,2451,580,72767,Americas
Canada,11-06-2020,297860,549,396,297464,Americas
Canada,11-06-2020,102564,202,790,101774,Americas
Canada,11-06-2020,210890,2113,1009,209881,Americas
Canada,11-06-2020,162385,1308,994,161391,Americas
Canada,11-06-2020,15316,2333,1145,14171,Americas
Canada,11-06-2020,25439,1488,1034,24405,Americas
Canada,11-06-2020,265491,111,212,265279,Americas
Canada,11-06-2020,408220,508,318,407902,Americas
Canada,11-06-2020,442199,540,1000,441199,Americas
Central African Republic,11-06-2020,376781,130,658,376123,Africa
Chad,11-06-2020,309030,1196,531,308499,Africa
Chile,11-06-2020,107860,2102,320,107540,Americas
China,11-06-2020,229238,776,135,229103,Western Pacific
China,11-06-2020,409607,700,900,408707,Western Pacific
China,11-06-2020,239271,1821,244,239027,Western Pacific
China,11-06-2020,167071,13,395,166676,Western Pacific
China,11-06-2020,296295,506,39,296256,Western Pacific
China,11-06-2020,247496,969,864,246632,Western Pacific
China,11-06-2020,104019,1210,895,103124,Western Pacific
China,11-06-2020,123024,1099,219,122805,Western Pacific
China,11-06-2020,361,1218,1027,-666,Western Pacific
China,11-06-2020,286540,123,1237,285303,Western Pacific
China,11-06-2020,317656,894,1078,316578,Western Pacific
China,11-06-2020,434801,1256,1077,433724,Western Pacific
China,11-06-2020,253354,1957,145,253209,Western Pacific
China,11-06-2020,374827,594,707,374120,Western Pacific
China,11-06-2020,180044,922,678,179366,Western Pacific
China,11-06-2020,403519,1687,36,403483,Western Pacific
China,11-06-2020,392858,1996,1182,391676,Western Pacific
China,11-06-2020,339619,295,334,339285,Western Pacific
China,11-06-2020,182805,1466,260,182545,Western Pacific
China,11-06-2020,418659,310,1148,417511,Western Pacific
China,11-06-2020,306143,2456,1021,305122,Western Pacific
China,11-06-2020,439053,1864,34,439019,Western Pacific
China,11-06-2020,245933,2176,1022,244911,Western Pacific
China,11-06-2020,128792,652,844,127948,Western Pacific
China,11-06-2020,98666,1930,752,97914,Western Pacific
China,11-06-2020,315264,336,921,314343,Western Pacific
China,11-06-2020,147234,2472,1151,146083,Western Pacific
China,11-06-2020,124441,979,883,123558,Western Pacific
China,11-06-2020,151730,2403,1142,150588,Western Pacific
China,11-06-2020,181082,474,656,180426,Western Pacific
China,11-06-2020,334278,1048,1227,333051,Western Pacific
China,11-06-2020,275587,1585,1058,274529,Western Pacific
China,11-06-2020,32705,1282,1058,31647,Western Pacific
Colombia,11-06-2020,156291,1543,1213,155078,Americas
Congo (Brazzaville),11-06-2020,84455,408,954,83501,Africa
Congo (Kinshasa),11-06-2020,342591,2134,529,342062,Africa
Costa Rica,11-06-2020,193194,1878,45,193149,Americas
Cote d'Ivoire,11-06-2020,304793,1835,820,303973,Africa
Croatia,11-06-2020,38731,482,1050,37681,Europe
Cuba,11-06-2020,340929,647,719,340210,Americas
Cyprus,11-06-2020,192479,770,34,192445,Europe
Czechia,11-06-2020,211948,381,138,211810,Europe
Denmark,11-06-2020,375114,1301,190,374924,Europe
Greenland,11-06-2020,315293,577,318,314975,Europe
Denmark,11-06-2020,330169,1264,139,330030,Europe
Djibouti,11-06-2020,380710,409,492,380218,Eastern Mediterranean
Dominican Republic,11-06-2020,215741,1542,1018,214723,Americas
Ecuador,11-06-2020,388627,1319,540,388087,Americas
Egypt,11-06-2020,119253,1906,1173,118080,Eastern Mediterranean
El Salvador,11-06-2020,80858,701,458,80400,Americas
Equatorial Guinea,11-06-2020,189419,173,1016,188403,Africa
Eritrea,11-06-2020,67306,1945,378,66928,Africa
Estonia,11-06-2020,382160,553,176,381984,Europe
Eswatini,11-06-2020,204711,273,491,204220,Africa
Ethiopia,11-06-2020,8060,2204,810,7250,Africa
Fiji,11-06-2020,19159,656,112,19047,Western Pacific
Finland,11-06-2020,86621,1111,288,86333,Europe
France,11-06-2020,146138,1367,427,145711,Europe
France,11-06-2020,261318,1591,687,260631,Europe
France,11-06-2020,295641,1938,674,294967,Europe
France,11-06-2020,399272,1519,92,399180,Europe
France,11-06-2020,381354,383,653,380701,Europe
France,11-06-2020,260275,1859,1111,259164,Europe
France,11-06-2020,331314,2207,8,331306,Europe
France,11-06-2020,304752,1359,1131,303621,Europe
France,11-06-2020,216853,1009,350,216503,Europe
France,11-06-2020,415566,1457,1250,414316,Europe
Gabon,11-06-2020,358570,2420,711,357859,Africa
Gambia,11-06-2020,55002,769,611,54391,Africa
Georgia,11-06-2020,197530,2071,163,197367,Europe
Germany,11-06-2020,19113,436,533,18580,Europe
Ghana,11-06-2020,171410,1577,1023,170387,Africa
Greece,11-06-2020,314499,143,708,313791,Europe
Guatemala,11-06-2020,395312,1523,782,394530,Americas
Guinea,11-06-2020,27113,1482,753,26360,Africa
Guyana,11-06-2020,6085,654,404,5681,Americas
Haiti,11-06-2020,432323,402,128,432195,Americas
Holy See,11-06-2020,62619,1372,11,62608,Europe
Honduras,11-06-2020,117466,1946,124,117342,Americas
Hungary,11-06-2020,167798,2253,975,166823,Europe
Iceland,11-06-2020,327306,2399,946,326360,Europe
India,11-06-2020,46956,1683,709,46247,South-East Asia
Indonesia,11-06-2020,110371,735,115,110256,South-East Asia
Iran,11-06-2020,98160,1644,201,97959,Eastern Mediterranean
Iraq,11-06-2020,66161,2355,444,65717,Eastern Mediterranean
Ireland,11-06-2020,198588,908,630,197958,Europe
Israel,11-06-2020,72375,1463,758,71617,Europe
Italy,11-06-2020,284160,2265,208,283952,Europe
Jamaica,11-06-2020,328845,163,64,328781,Americas
Japan,11-06-2020,323130,457,1164,321966,Western Pacific
Jordan,11-06-2020,142775,1159,702,142073,Eastern Mediterranean
Kazakhstan,11-06-2020,424756,953,303,424453,Europe
Kenya,11-06-2020,284630,809,1222,283408,Africa
South Korea,11-06-2020,396075,1347,686,395389,Western Pacific
Kuwait,11-06-2020,290712,459,792,289920,Eastern Mediterranean
Kyrgyzstan,11-06-2020,440264,202,381,439883,Europe
Latvia,11-06-2020,195117,2030,1191,193926,Europe
Lebanon,11-06-2020,419731,1494,810,418921,Eastern Mediterranean
Liberia,11-06-2020,261424,500,1200,260224,Africa
Liechtenstein,11-06-2020,324101,1390,1024,323077,Europe
Lithuania,11-06-2020,443152,718,1224,441928,Europe
Luxembourg,11-06-2020,399822,1895,847,398975,Europe
Madagascar,11-06-2020,138647,783,579,138068,Africa
Malaysia,11-06-2020,437511,1653,25,437486,Western Pacific
Maldives,11-06-2020,61621,1437,1118,60503,South-East Asia
Malta,11-06-2020,333173,2155,488,332685,Europe
Mauritania,11-06-2020,139206,74,1044,138162,Africa
Mauritius,11-06-2020,400556,671,1014,399542,Africa
Mexico,11-06-2020,375257,1707,538,374719,Americas
Moldova,11-06-2020,140573,2204,318,140255,Europe
Monaco,11-06-2020,177751,2342,15,177736,Europe
Mongolia,11-06-2020,319698,594,595,319103,Western Pacific
Montenegro,11-06-2020,289083,432,556,288527,Europe
Morocco,11-06-2020,63663,849,1006,62657,Eastern Mediterranean
Namibia,11-06-2020,33224,2087,928,32296,Africa
Nepal,11-06-2020,155511,117,1100,154411,South-East Asia
Netherlands,11-06-2020,11731,348,756,10975,Europe
Netherlands,11-06-2020,117277,2069,1175,116102,Europe
Netherlands,11-06-2020,365166,1227,47,365119,Europe
Netherlands,11-06-2020,322496,1437,219,322277,Europe
New Zealand,11-06-2020,316516,2230,1207,315309,Western Pacific
Nicaragua,11-06-2020,360977,2470,833,360144,Americas
Niger,11-06-2020,260131,1362,896,259235,Africa
Nigeria,11-06-2020,60360,168,349,60011,Africa
North Macedonia,11-06-2020,209304,1850,1221,208083,Europe
Norway,11-06-2020,148906,1435,190,148716,Europe
Oman,11-06-2020,358875,2303,231,358644,Eastern Mediterranean
Pakistan,11-06-2020,74206,556,641,73565,Eastern Mediterranean
Panama,11-06-2020,373226,723,76,373150,Americas
Papua New Guinea,11-06-2020,324379,404,793,323586,Western Pacific
Paraguay,11-06-2020,430434,786,665,429769,Americas
Peru,11-06-2020,124297,1265,1165,123132,Americas
Philippines,11-06-2020,255549,2152,343,255206,Western Pacific
Poland,11-06-2020,347668,152,447,347221,Europe
Portugal,11-06-2020,375248,366,1125,374123,Europe
Qatar,11-06-2020,169026,1808,164,168862,Eastern Mediterranean
Romania,11-06-2020,26534,1858,190,26344,Europe
Russia,11-06-2020,284065,856,163,283902,Europe
Rwanda,11-06-2020,285881,718,892,284989,Africa
Saint Lucia,11-06-2020,119215,101,90,119125,Americas
Saint Vincent and the Grenadines,11-06-2020,426946,1519,1016,425930,Americas
San Marino,11-06-2020,240172,1398,1157,239015,Europe
Saudi Arabia,11-06-2020,388132,2423,913,387219,Eastern Mediterranean
Senegal,11-06-2020,360503,1101,553,359950,Africa
Serbia,11-06-2020,402333,654,1125,401208,Europe
Seychelles,11-06-2020,370308,306,418,369890,Africa
Singapore,11-06-2020,407750,1623,259,407491,Western Pacific
Slovakia,11-06-2020,280147,1426,1109,279038,Europe
Slovenia,11-06-2020,257940,1772,1127,256813,Europe
Somalia,11-06-2020,142268,1580,489,141779,Eastern Mediterranean
South Africa,11-06-2020,115741,1349,419,115322,Africa
Spain,11-06-2020,339342,2092,351,338991,Europe
Sri Lanka,11-06-2020,240671,2210,87,240584,South-East Asia
Sudan,11-06-2020,122506,393,466,122040,Eastern Mediterranean
Suriname,11-06-2020,73230,1877,29,73201,Americas
Sweden,11-06-2020,397181,1841,435,396746,Europe
Switzerland,11-06-2020,144152,2437,819,143333,Europe
Taiwan*,11-06-2020,389740,339,1080,388660,Western Pacific
Tanzania,11-06-2020,78850,1315,603,78247,Africa
Thailand,11-06-2020,31677,462,512,31165,South-East Asia
Togo,11-06-2020,166280,1673,978,165302,Africa
Trinidad and Tobago,11-06-2020,443697,944,854,442843,Americas
Tunisia,11-06-2020,334930,2130,993,333937,Eastern Mediterranean
Turkey,11-06-2020,222358,13,1005,221353,Europe
Uganda,11-06-2020,130787,600,685,130102,Africa
Ukraine,11-06-2020,185126,1506,335,184791,Europe
United Arab Emirates,11-06-2020,120682,629,1048,119634,Eastern Mediterranean
United Kingdom,11-06-2020,10919,813,295,10624,Europe
United Kingdom,11-06-2020,396199,919,1206,394993,Europe
United Kingdom,11-06-2020,245415,59,547,244868,Europe
United Kingdom,11-06-2020,19700,833,309,19391,Europe
United Kingdom,11-06-2020,168868,1350,368,168500,Europe
United Kingdom,11-06-2020,288533,785,168,288365,Europe
United Kingdom,11-06-2020,447005,736,612,446393,Europe
Uruguay,11-06-2020,395781,2361,1110,394671,Americas
US,11-06-2020,330027,1346,812,329215,Americas
Uzbekistan,11-06-2020,109867,2046,127,109740,Europe
Venezuela,11-06-2020,73795,1269,995,72800,Americas
Vietnam,11-06-2020,416765,734,372,416393,Western Pacific
Zambia,11-06-2020,61293,1461,923,60370,Africa
Zimbabwe,11-06-2020,402246,2430,607,401639,Africa
Dominica,11-06-2020,231043,1917,1058,229985,Americas
Grenada,11-06-2020,66641,2100,551,66090,Americas
Mozambique,11-06-2020,297303,2053,852,296451,Africa
Syria,11-06-2020,28334,419,327,28007,Eastern Mediterranean
Timor-Leste,11-06-2020,358502,2253,748,357754,South-East Asia
Belize,11-06-2020,363985,1768,401,363584,Americas
Laos,11-06-2020,358858,2283,450,358408,Western Pacific
Libya,11-06-2020,114718,1509,1227,113491,Eastern Mediterranean
West Bank and Gaza,11-06-2020,199130,140,512,198618,Eastern Mediterranean
Guinea-Bissau,11-06-2020,16521,755,567,15954,Africa
Mali,11-06-2020,403375,222,859,402516,Africa
Saint Kitts and Nevis,11-06-2020,168749,1813,870,167879,Americas
Canada,11-06-2020,128499,866,232,128267,Americas
Canada,11-06-2020,385142,2106,32,385110,Americas
Kosovo,11-06-2020,91994,2476,861,91133,Europe
Burma,11-06-2020,340991,818,567,340424,South-East Asia
United Kingdom,11-06-2020,266078,2046,950,265128,Europe
United Kingdom,11-06-2020,67068,868,160,66908,Europe
United Kingdom,11-06-2020,289331,1909,127,289204,Europe
Botswana,11-06-2020,160063,1168,1033,159030,Africa
Burundi,11-06-2020,138010,2143,308,137702,Africa
Sierra Leone,11-06-2020,95246,727,1133,94113,Africa
Malawi,11-06-2020,309388,1365,261,309127,Africa
United Kingdom,11-06-2020,241563,1561,1021,240542,Europe
France,11-06-2020,378366,10,196,378170,Europe
South Sudan,11-06-2020,113753,2092,359,113394,Africa
Western Sahara,11-06-2020,267821,1776,933,266888,Africa
Sao Tome and Principe,11-06-2020,291942,628,553,291389,Africa
Yemen,11-06-2020,338799,1191,701,338098,Eastern Mediterranean
Comoros,11-06-2020,309043,418,395,308648,Africa
Tajikistan,11-06-2020,79640,2399,44,79596,Europe
Lesotho,11-06-2020,241851,2444,30,241821,Africa
Afghanistan,12-06-2020,269048,1084,84,268964,Eastern Mediterranean
Albania,12-06-2020,370917,912,627,370290,Europe
Algeria,12-06-2020,202849,2331,1203,201646,Africa
Andorra,12-06-2020,348527,1530,1017,347510,Europe
Angola,12-06-2020,31533,1067,292,31241,Africa
Antigua and Barbuda,12-06-2020,296628,1792,502,296126,Americas
Argentina,12-06-2020,370509,737,1210,369299,Americas
Armenia,12-06-2020,12886,1692,163,12723,Europe
Australia,12-06-2020,335412,2041,1035,334377,Western Pacific
Australia,12-06-2020,338783,1897,368,338415,Western Pacific
Australia,12-06-2020,433268,1604,647,432621,Western Pacific
Australia,12-06-2020,273283,1887,649,272634,Western Pacific
Australia,12-06-2020,435771,425,159,435612,Western Pacific
Australia,12-06-2020,362507,690,177,362330,Western Pacific
Australia,12-06-2020,444850,278,369,444481,Western Pacific
Australia,12-06-2020,337461,2190,59,337402,Western Pacific
Austria,12-06-2020,28232,2192,1243,26989,Europe
Azerbaijan,12-06-2020,174376,154,433,173943,Europe
Bahamas,12-06-2020,243340,787,852,242488,Americas
Bahrain,12-06-2020,352224,390,94,352130,Eastern Mediterranean
Bangladesh,12-06-2020,446323,2412,641,445682,South-East Asia
Barbados,12-06-2020,427836,2100,567,427269,Americas
Belarus,12-06-2020,402793,1857,551,402242,Europe
Belgium,12-06-2020,282150,1384,1154,280996,Europe
Benin,12-06-2020,28716,816,990,27726,Africa
Bhutan,12-06-2020,236814,2168,414,236400,South-East Asia
Bolivia,12-06-2020,160461,1258,68,160393,Americas
Bosnia and Herzegovina,12-06-2020,135183,931,115,135068,Europe
Brazil,12-06-2020,145728,814,382,145346,Americas
Brunei,12-06-2020,175288,1169,741,174547,Western Pacific
Bulgaria,12-06-2020,212737,139,721,212016,Europe
Burkina Faso,12-06-2020,378323,1747,298,378025,Africa
Cabo Verde,12-06-2020,290650,349,1147,289503,Africa
Cambodia,12-06-2020,104497,2299,877,103620,Western Pacific
Cameroon,12-06-2020,439993,1498,678,439315,Africa
Canada,12-06-2020,106624,1917,820,105804,Americas
Canada,12-06-2020,81737,1769,406,81331,Americas
Canada,12-06-2020,341281,427,408,340873,Americas
Canada,12-06-2020,364084,416,765,363319,Americas
Canada,12-06-2020,164324,1977,430,163894,Americas
Canada,12-06-2020,128172,2077,888,127284,Americas
Canada,12-06-2020,219237,2216,1117,218120,Americas
Canada,12-06-2020,372026,392,540,371486,Americas
Canada,12-06-2020,214274,1308,40,214234,Americas
Canada,12-06-2020,442786,2017,166,442620,Americas
Central African Republic,12-06-2020,431483,2037,184,431299,Africa
Chad,12-06-2020,251227,1804,374,250853,Africa
Chile,12-06-2020,268777,1760,162,268615,Americas
China,12-06-2020,64666,676,216,64450,Western Pacific
China,12-06-2020,285610,451,333,285277,Western Pacific
China,12-06-2020,79269,982,1207,78062,Western Pacific
China,12-06-2020,246182,1621,437,245745,Western Pacific
China,12-06-2020,404291,828,667,403624,Western Pacific
China,12-06-2020,77023,2020,1046,75977,Western Pacific
China,12-06-2020,6110,1005,897,5213,Western Pacific
China,12-06-2020,133824,2278,782,133042,Western Pacific
China,12-06-2020,299318,1093,325,298993,Western Pacific
China,12-06-2020,255371,2175,1146,254225,Western Pacific
China,12-06-2020,357552,1754,582,356970,Western Pacific
China,12-06-2020,14298,1061,622,13676,Western Pacific
China,12-06-2020,294461,648,1156,293305,Western Pacific
China,12-06-2020,338969,2308,37,338932,Western Pacific
China,12-06-2020,403453,709,371,403082,Western Pacific
China,12-06-2020,317362,1369,5,317357,Western Pacific
China,12-06-2020,58328,1172,1179,57149,Western Pacific
China,12-06-2020,445856,2391,170,445686,Western Pacific
China,12-06-2020,50101,246,1222,48879,Western Pacific
China,12-06-2020,167815,2387,145,167670,Western Pacific
China,12-06-2020,254149,1835,850,253299,Western Pacific
China,12-06-2020,222375,1996,639,221736,Western Pacific
China,12-06-2020,320846,1063,906,319940,Western Pacific
China,12-06-2020,14978,481,337,14641,Western Pacific
China,12-06-2020,381117,1685,825,380292,Western Pacific
China,12-06-2020,426559,347,402,426157,Western Pacific
China,12-06-2020,95985,2292,73,95912,Western Pacific
China,12-06-2020,444185,1914,28,444157,Western Pacific
China,12-06-2020,53065,2047,1175,51890,Western Pacific
China,12-06-2020,89854,2263,182,89672,Western Pacific
China,12-06-2020,308569,111,952,307617,Western Pacific
China,12-06-2020,262777,432,304,262473,Western Pacific
China,12-06-2020,163586,1222,1186,162400,Western Pacific
Colombia,12-06-2020,403776,1501,837,402939,Americas
Congo (Brazzaville),12-06-2020,271016,1049,828,270188,Africa
Congo (Kinshasa),12-06-2020,441380,903,446,440934,Africa
Costa Rica,12-06-2020,192069,722,699,191370,Americas
Cote d'Ivoire,12-06-2020,352971,1112,1059,351912,Africa
Croatia,12-06-2020,132086,2074,222,131864,Europe
Cuba,12-06-2020,421538,164,597,420941,Americas
Cyprus,12-06-2020,383596,1121,1123,382473,Europe
Czechia,12-06-2020,120414,504,882,119532,Europe
Denmark,12-06-2020,84860,965,344,84516,Europe
Greenland,12-06-2020,157047,1450,515,156532,Europe
Denmark,12-06-2020,161656,1227,978,160678,Europe
Djibouti,12-06-2020,442309,2349,303,442006,Eastern Mediterranean
Dominican Republic,12-06-2020,405657,2144,300,405357,Americas
Ecuador,12-06-2020,423432,248,1017,422415,Americas
Egypt,12-06-2020,180356,541,870,179486,Eastern Mediterranean
El Salvador,12-06-2020,213095,1942,777,212318,Americas
Equatorial Guinea,12-06-2020,293940,1036,1099,292841,Africa
Eritrea,12-06-2020,409421,1023,421,409000,Africa
Estonia,12-06-2020,411726,1885,1001,410725,Europe
Eswatini,12-06-2020,22938,2020,130,22808,Africa
Ethiopia,12-06-2020,4221,1867,970,3251,Africa
Fiji,12-06-2020,446031,637,1002,445029,Western Pacific
Finland,12-06-2020,99752,1090,524,99228,Europe
France,12-06-2020,417573,1175,427,417146,Europe
France,12-06-2020,149290,493,9,149281,Europe
France,12-06-2020,74618,2205,191,74427,Europe
France,12-06-2020,41173,1564,549,40624,Europe
France,12-06-2020,97098,1057,666,96432,Europe
France,12-06-2020,272922,1512,30,272892,Europe
France,12-06-2020,164822,673,1095,163727,Europe
France,12-06-2020,318066,1166,314,317752,Europe
France,12-06-2020,383623,226,199,383424,Europe
France,12-06-2020,403229,2256,666,402563,Europe
Gabon,12-06-2020,91516,2024,383,91133,Africa
Gambia,12-06-2020,13494,161,580,12914,Africa
Georgia,12-06-2020,337574,508,765,336809,Europe
Germany,12-06-2020,132863,265,869,131994,Europe
Ghana,12-06-2020,282108,2234,1169,280939,Africa
Greece,12-06-2020,440874,68,436,440438,Europe
Guatemala,12-06-2020,266672,665,788,265884,Americas
Guinea,12-06-2020,119605,1748,686,118919,Africa
Guyana,12-06-2020,137936,1262,1111,136825,Americas
Haiti,12-06-2020,322879,794,715,322164,Americas
Holy See,12-06-2020,372051,782,1144,370907,Europe
Honduras,12-06-2020,233877,279,1068,232809,Americas
Hungary,12-06-2020,308796,1733,479,308317,Europe
Iceland,12-06-2020,339209,762,634,338575,Europe
India,12-06-2020,181212,501,760,180452,South-East Asia
Indonesia,12-06-2020,22137,1435,165,21972,South-East Asia
Iran,12-06-2020,13706,1514,858,12848,Eastern Mediterranean
Iraq,12-06-2020,385534,1270,699,384835,Eastern Mediterranean
Ireland,12-06-2020,407246,1522,400,406846,Europe
Israel,12-06-2020,202656,475,1002,201654,Europe
Italy,12-06-2020,312975,1220,812,312163,Europe
Jamaica,12-06-2020,58229,1215,1198,57031,Americas
Japan,12-06-2020,99667,25,458,99209,Western Pacific
Jordan,12-06-2020,66696,1037,289,66407,Eastern Mediterranean
Kazakhstan,12-06-2020,126986,1585,248,126738,Europe
Kenya,12-06-2020,235074,794,438,234636,Africa
South Korea,12-06-2020,93686,193,163,93523,Western Pacific
Kuwait,12-06-2020,288615,651,64,288551,Eastern Mediterranean
Kyrgyzstan,12-06-2020,239496,471,1225,238271,Europe
Latvia,12-06-2020,310767,1810,789,309978,Europe
Lebanon,12-06-2020,332160,1800,1062,331098,Eastern Mediterranean
Liberia,12-06-2020,114040,1842,1039,113001,Africa
Liechtenstein,12-06-2020,60833,2038,878,59955,Europe
Lithuania,12-06-2020,297505,2394,80,297425,Europe
Luxembourg,12-06-2020,309652,1925,597,309055,Europe
Madagascar,12-06-2020,23447,2095,290,23157,Africa
Malaysia,12-06-2020,281102,285,289,280813,Western Pacific
Maldives,12-06-2020,206173,950,1008,205165,South-East Asia
Malta,12-06-2020,173270,1460,10,173260,Europe
Mauritania,12-06-2020,9502,1785,558,8944,Africa
Mauritius,12-06-2020,435979,395,661,435318,Africa
Mexico,12-06-2020,440543,116,807,439736,Americas
Moldova,12-06-2020,269694,1915,515,269179,Europe
Monaco,12-06-2020,181542,4,1200,180342,Europe
Mongolia,12-06-2020,333722,244,687,333035,Western Pacific
Montenegro,12-06-2020,242731,1996,129,242602,Europe
Morocco,12-06-2020,252332,187,397,251935,Eastern Mediterranean
Namibia,12-06-2020,53356,1995,861,52495,Africa
Nepal,12-06-2020,94950,625,1096,93854,South-East Asia
Netherlands,12-06-2020,222797,784,249,222548,Europe
Netherlands,12-06-2020,299026,346,165,298861,Europe
Netherlands,12-06-2020,250258,788,1179,249079,Europe
Netherlands,12-06-2020,244317,408,489,243828,Europe
New Zealand,12-06-2020,316627,2251,824,315803,Western Pacific
Nicaragua,12-06-2020,405842,1217,864,404978,Americas
Niger,12-06-2020,68729,51,913,67816,Africa
Nigeria,12-06-2020,379472,1719,395,379077,Africa
North Macedonia,12-06-2020,120777,1800,938,119839,Europe
Norway,12-06-2020,358770,2168,451,358319,Europe
Oman,12-06-2020,73641,1747,922,72719,Eastern Mediterranean
Pakistan,12-06-2020,403794,2295,867,402927,Eastern Mediterranean
Panama,12-06-2020,46256,1598,773,45483,Americas
Papua New Guinea,12-06-2020,65958,396,711,65247,Western Pacific
Paraguay,12-06-2020,122901,443,403,122498,Americas
Peru,12-06-2020,310508,730,360,310148,Americas
Philippines,12-06-2020,324321,1656,61,324260,Western Pacific
Poland,12-06-2020,133548,312,61,133487,Europe
Portugal,12-06-2020,162354,12,630,161724,Europe
Qatar,12-06-2020,305,981,998,-693,Eastern Mediterranean
Romania,12-06-2020,154688,2018,926,153762,Europe
Russia,12-06-2020,176000,1970,12,175988,Europe
Rwanda,12-06-2020,72004,67,614,71390,Africa
Saint Lucia,12-06-2020,64708,2139,1219,63489,Americas
Saint Vincent and the Grenadines,12-06-2020,72041,1617,380,71661,Americas
San Marino,12-06-2020,356021,122,1220,354801,Europe
Saudi Arabia,12-06-2020,414266,344,1116,413150,Eastern Mediterranean
Senegal,12-06-2020,315714,1184,290,315424,Africa
Serbia,12-06-2020,329848,2280,377,329471,Europe
Seychelles,12-06-2020,353753,2195,990,352763,Africa
Singapore,12-06-2020,157328,1464,124,157204,Western Pacific
Slovakia,12-06-2020,165514,1753,4,165510,Europe
Slovenia,12-06-2020,9055,2179,624,8431,Europe
Somalia,12-06-2020,406131,1149,4,406127,Eastern Mediterranean
South Africa,12-06-2020,21422,1407,819,20603,Africa
Spain,12-06-2020,190344,361,413,189931,Europe
Sri Lanka,12-06-2020,18627,693,414,18213,South-East Asia
Sudan,12-06-2020,245592,1783,1076,244516,Eastern Mediterranean
Suriname,12-06-2020,194239,303,564,193675,Americas
Sweden,12-06-2020,263945,2344,150,263795,Europe
Switzerland,12-06-2020,37899,2222,583,37316,Europe
Taiwan*,12-06-2020,136454,397,929,135525,Western Pacific
Tanzania,12-06-2020,79038,2308,593,78445,Africa
Thailand,12-06-2020,317421,1146,367,317054,South-East Asia
Togo,12-06-2020,260648,296,232,260416,Africa
Trinidad and Tobago,12-06-2020,276028,1576,1017,275011,Americas
Tunisia,12-06-2020,317375,2496,810,316565,Eastern Mediterranean
Turkey,12-06-2020,352510,1587,1179,351331,Europe
Uganda,12-06-2020,278054,563,987,277067,Africa
Ukraine,12-06-2020,328218,2083,375,327843,Europe
United Arab Emirates,12-06-2020,66973,639,279,66694,Eastern Mediterranean
United Kingdom,12-06-2020,251937,1031,450,251487,Europe
United Kingdom,12-06-2020,223819,2045,282,223537,Europe
United Kingdom,12-06-2020,336237,2275,468,335769,Europe
United Kingdom,12-06-2020,58599,1027,942,57657,Europe
United Kingdom,12-06-2020,260014,1641,1132,258882,Europe
United Kingdom,12-06-2020,438913,1049,182,438731,Europe
United Kingdom,12-06-2020,164254,2392,343,163911,Europe
Uruguay,12-06-2020,25099,1928,740,24359,Americas
US,12-06-2020,184849,1147,226,184623,Americas
Uzbekistan,12-06-2020,222562,60,1177,221385,Europe
Venezuela,12-06-2020,216803,1101,193,216610,Americas
Vietnam,12-06-2020,407620,2337,884,406736,Western Pacific
Zambia,12-06-2020,369557,630,934,368623,Africa
Zimbabwe,12-06-2020,354021,409,625,353396,Africa
Dominica,12-06-2020,44297,1082,626,43671,Americas
Grenada,12-06-2020,186906,1171,77,186829,Americas
Mozambique,12-06-2020,28327,1532,551,27776,Africa
Syria,12-06-2020,388762,1133,708,388054,Eastern Mediterranean
Timor-Leste,12-06-2020,220327,952,1138,219189,South-East Asia
Belize,12-06-2020,139417,1210,112,139305,Americas
Laos,12-06-2020,410497,844,187,410310,Western Pacific
Libya,12-06-2020,390099,2200,896,389203,Eastern Mediterranean
West Bank and Gaza,12-06-2020,66599,931,1035,65564,Eastern Mediterranean
Guinea-Bissau,12-06-2020,48575,2222,1181,47394,Africa
Mali,12-06-2020,63659,1394,622,63037,Africa
Saint Kitts and Nevis,12-06-2020,362647,2073,1032,361615,Americas
Canada,12-06-2020,170239,1371,199,170040,Americas
Canada,12-06-2020,43006,1946,694,42312,Americas
Kosovo,12-06-2020,257603,1726,1137,256466,Europe
Burma,12-06-2020,116892,1847,1063,115829,South-East Asia
United Kingdom,12-06-2020,219077,852,632,218445,Europe
United Kingdom,12-06-2020,139608,1886,784,138824,Europe
United Kingdom,12-06-2020,10033,311,836,9197,Europe
Botswana,12-06-2020,108268,1008,741,107527,Africa
Burundi,12-06-2020,104759,1195,230,104529,Africa
Sierra Leone,12-06-2020,319718,2343,8,319710,Africa
Malawi,12-06-2020,368639,1111,643,367996,Africa
United Kingdom,12-06-2020,346254,765,94,346160,Europe
France,12-06-2020,404590,846,939,403651,Europe
South Sudan,12-06-2020,430513,570,1139,429374,Africa
Western Sahara,12-06-2020,103456,985,340,103116,Africa
Sao Tome and Principe,12-06-2020,298648,28,776,297872,Africa
Yemen,12-06-2020,182990,1740,189,182801,Eastern Mediterranean
Comoros,12-06-2020,261076,504,311,260765,Africa
Tajikistan,12-06-2020,58515,2419,1064,57451,Europe
Lesotho,12-06-2020,131777,657,378,131399,Africa
Afghanistan,13-06-2020,427306,1517,493,426813,Eastern Mediterranean
Albania,13-06-2020,237734,2301,138,237596,Europe
Algeria,13-06-2020,282447,1773,26,282421,Africa
Andorra,13-06-2020,377302,2329,969,376333,Europe
Angola,13-06-2020,311561,1310,819,310742,Africa
Antigua and Barbuda,13-06-2020,197020,2222,499,196521,Americas
Argentina,13-06-2020,235818,1841,686,235132,Americas
Armenia,13-06-2020,414174,1823,91,414083,Europe
Australia,13-06-2020,70439,99,643,69796,Western Pacific
Australia,13-06-2020,73387,1866,429,72958,Western Pacific
Australia,13-06-2020,50620,2403,174,50446,Western Pacific
Australia,13-06-2020,422752,2070,65,422687,Western Pacific
Australia,13-06-2020,255240,471,838,254402,Western Pacific
Australia,13-06-2020,282016,1505,692,281324,Western Pacific
Australia,13-06-2020,399648,1181,424,399224,Western Pacific
Australia,13-06-2020,382347,760,391,381956,Western Pacific
Austria,13-06-2020,28421,1550,733,27688,Europe
Azerbaijan,13-06-2020,20351,566,958,19393,Europe
Bahamas,13-06-2020,125051,703,1232,123819,Americas
Bahrain,13-06-2020,293683,1349,565,293118,Eastern Mediterranean
Bangladesh,13-06-2020,341385,686,1065,340320,South-East Asia
Barbados,13-06-2020,288579,562,689,287890,Americas
Belarus,13-06-2020,175174,616,595,174579,Europe
Belgium,13-06-2020,331624,449,529,331095,Europe
Benin,13-06-2020,216769,82,647,216122,Africa
Bhutan,13-06-2020,295530,1367,787,294743,South-East Asia
Bolivia,13-06-2020,333701,1068,1224,332477,Americas
Bosnia and Herzegovina,13-06-2020,169739,496,1029,168710,Europe
Brazil,13-06-2020,115346,1105,312,115034,Americas
Brunei,13-06-2020,348001,398,538,347463,Western Pacific
Bulgaria,13-06-2020,17602,495,35,17567,Europe
Burkina Faso,13-06-2020,293879,341,240,293639,Africa
Cabo Verde,13-06-2020,364727,1303,1074,363653,Africa
Cambodia,13-06-2020,103210,1434,288,102922,Western Pacific
Cameroon,13-06-2020,401516,268,1153,400363,Africa
Canada,13-06-2020,287862,1959,16,287846,Americas
Canada,13-06-2020,233385,1749,761,232624,Americas
Canada,13-06-2020,15520,1551,407,15113,Americas
Canada,13-06-2020,419251,1256,940,418311,Americas
Canada,13-06-2020,145308,1372,671,144637,Americas
Canada,13-06-2020,427916,1174,442,427474,Americas
Canada,13-06-2020,20043,2422,44,19999,Americas
Canada,13-06-2020,282221,1407,355,281866,Americas
Canada,13-06-2020,114962,2415,1107,113855,Americas
Canada,13-06-2020,288525,155,883,287642,Americas
Central African Republic,13-06-2020,249019,450,239,248780,Africa
Chad,13-06-2020,23863,169,246,23617,Africa
Chile,13-06-2020,105235,2339,731,104504,Americas
China,13-06-2020,314155,1649,209,313946,Western Pacific
China,13-06-2020,240198,314,429,239769,Western Pacific
China,13-06-2020,377270,931,989,376281,Western Pacific
China,13-06-2020,140897,1103,1224,139673,Western Pacific
China,13-06-2020,404338,2375,618,403720,Western Pacific
China,13-06-2020,266597,2389,84,266513,Western Pacific
China,13-06-2020,73938,2142,49,73889,Western Pacific
China,13-06-2020,396139,2156,1126,395013,Western Pacific
China,13-06-2020,224307,1077,1204,223103,Western Pacific
China,13-06-2020,127952,205,200,127752,Western Pacific
China,13-06-2020,407191,1171,984,406207,Western Pacific
China,13-06-2020,92769,1925,413,92356,Western Pacific
China,13-06-2020,94812,1844,766,94046,Western Pacific
China,13-06-2020,255004,2337,784,254220,Western Pacific
China,13-06-2020,187318,954,1108,186210,Western Pacific
China,13-06-2020,371862,750,599,371263,Western Pacific
China,13-06-2020,219582,2447,510,219072,Western Pacific
China,13-06-2020,205970,948,1097,204873,Western Pacific
China,13-06-2020,283033,1113,187,282846,Western Pacific
China,13-06-2020,327684,1098,889,326795,Western Pacific
China,13-06-2020,166342,1939,1221,165121,Western Pacific
China,13-06-2020,339319,107,635,338684,Western Pacific
China,13-06-2020,265661,391,492,265169,Western Pacific
China,13-06-2020,307840,1334,897,306943,Western Pacific
China,13-06-2020,44564,1844,308,44256,Western Pacific
China,13-06-2020,116130,1516,586,115544,Western Pacific
China,13-06-2020,406827,869,1040,405787,Western Pacific
China,13-06-2020,330765,984,500,330265,Western Pacific
China,13-06-2020,177100,898,928,176172,Western Pacific
China,13-06-2020,294596,129,490,294106,Western Pacific
China,13-06-2020,166617,1338,689,165928,Western Pacific
China,13-06-2020,243198,366,754,242444,Western Pacific
China,13-06-2020,79632,276,1202,78430,Western Pacific
Colombia,13-06-2020,182525,203,36,182489,Americas
Congo (Brazzaville),13-06-2020,351473,2350,116,351357,Africa
Congo (Kinshasa),13-06-2020,314853,1838,824,314029,Africa
Costa Rica,13-06-2020,423864,1385,394,423470,Americas
Cote d'Ivoire,13-06-2020,284367,184,49,284318,Africa
Croatia,13-06-2020,400935,1027,20,400915,Europe
Cuba,13-06-2020,438072,986,703,437369,Americas
Cyprus,13-06-2020,380832,1661,821,380011,Europe
Czechia,13-06-2020,347637,2179,618,347019,Europe
Denmark,13-06-2020,373953,2483,457,373496,Europe
Greenland,13-06-2020,236189,403,904,235285,Europe
Denmark,13-06-2020,329133,665,833,328300,Europe
Djibouti,13-06-2020,447858,1791,373,447485,Eastern Mediterranean
Dominican Republic,13-06-2020,330789,1498,986,329803,Americas
Ecuador,13-06-2020,381173,2258,885,380288,Americas
Egypt,13-06-2020,298976,378,630,298346,Eastern Mediterranean
El Salvador,13-06-2020,10050,1508,1094,8956,Americas
Equatorial Guinea,13-06-2020,387990,743,21,387969,Africa
Eritrea,13-06-2020,171703,1782,712,170991,Africa
Estonia,13-06-2020,280247,805,40,280207,Europe
Eswatini,13-06-2020,376753,2274,833,375920,Africa
Ethiopia,13-06-2020,60748,2011,1116,59632,Africa
Fiji,13-06-2020,206095,1669,500,205595,Western Pacific
Finland,13-06-2020,247940,1496,76,247864,Europe
France,13-06-2020,377193,1534,861,376332,Europe
France,13-06-2020,180095,296,314,179781,Europe
France,13-06-2020,12984,715,687,12297,Europe
France,13-06-2020,424298,1902,736,423562,Europe
France,13-06-2020,61527,628,140,61387,Europe
France,13-06-2020,284925,790,433,284492,Europe
France,13-06-2020,185692,1030,352,185340,Europe
France,13-06-2020,129461,1017,898,128563,Europe
France,13-06-2020,359307,2491,30,359277,Europe
France,13-06-2020,324349,528,684,323665,Europe
Gabon,13-06-2020,132662,1899,755,131907,Africa
Gambia,13-06-2020,310714,1383,181,310533,Africa
Georgia,13-06-2020,574,170,61,513,Europe
Germany,13-06-2020,260398,434,1170,259228,Europe
Ghana,13-06-2020,48844,742,426,48418,Africa
Greece,13-06-2020,110717,1678,380,110337,Europe
Guatemala,13-06-2020,298936,72,778,298158,Americas
Guinea,13-06-2020,303540,659,746,302794,Africa
Guyana,13-06-2020,41299,1201,887,40412,Americas
Haiti,13-06-2020,315788,478,425,315363,Americas
Holy See,13-06-2020,210588,326,38,210550,Europe
Honduras,13-06-2020,185259,701,1122,184137,Americas
Hungary,13-06-2020,51243,1242,150,51093,Europe
Iceland,13-06-2020,299768,1189,181,299587,Europe
India,13-06-2020,114401,1358,155,114246,South-East Asia
Indonesia,13-06-2020,174304,1542,1049,173255,South-East Asia
Iran,13-06-2020,379831,1250,667,379164,Eastern Mediterranean
Iraq,13-06-2020,225408,2402,471,224937,Eastern Mediterranean
Ireland,13-06-2020,177897,95,512,177385,Europe
Israel,13-06-2020,92982,2195,150,92832,Europe
Italy,13-06-2020,319684,1362,725,318959,Europe
Jamaica,13-06-2020,184209,208,701,183508,Americas
Japan,13-06-2020,137629,2458,215,137414,Western Pacific
Jordan,13-06-2020,443009,1232,91,442918,Eastern Mediterranean
Kazakhstan,13-06-2020,429973,1901,326,429647,Europe
Kenya,13-06-2020,427881,1756,554,427327,Africa
South Korea,13-06-2020,43520,1808,336,43184,Western Pacific
Kuwait,13-06-2020,283355,1838,467,282888,Eastern Mediterranean
Kyrgyzstan,13-06-2020,201547,9,1237,200310,Europe
Latvia,13-06-2020,396483,2407,1223,395260,Europe
Lebanon,13-06-2020,382854,1993,1014,381840,Eastern Mediterranean
Liberia,13-06-2020,437775,1982,823,436952,Africa
Liechtenstein,13-06-2020,242094,702,731,241363,Europe
Lithuania,13-06-2020,221163,854,371,220792,Europe
Luxembourg,13-06-2020,235886,199,942,234944,Europe
Madagascar,13-06-2020,311407,2203,749,310658,Africa
Malaysia,13-06-2020,188555,1984,467,188088,Western Pacific
Maldives,13-06-2020,335364,2488,744,334620,South-East Asia
Malta,13-06-2020,394968,1447,417,394551,Europe
Mauritania,13-06-2020,9894,2274,319,9575,Africa
Mauritius,13-06-2020,340665,662,1024,339641,Africa
Mexico,13-06-2020,158575,2398,1047,157528,Americas
Moldova,13-06-2020,146699,835,1110,145589,Europe
Monaco,13-06-2020,245746,2481,105,245641,Europe
Mongolia,13-06-2020,179065,1904,936,178129,Western Pacific
Montenegro,13-06-2020,361756,2367,983,360773,Europe
Morocco,13-06-2020,318268,1405,880,317388,Eastern Mediterranean
Namibia,13-06-2020,447131,53,622,446509,Africa
Nepal,13-06-2020,83608,568,875,82733,South-East Asia
Netherlands,13-06-2020,198714,664,505,198209,Europe
Netherlands,13-06-2020,99188,1406,1106,98082,Europe
Netherlands,13-06-2020,228969,431,442,228527,Europe
Netherlands,13-06-2020,384398,1451,195,384203,Europe
New Zealand,13-06-2020,347315,2254,978,346337,Western Pacific
Nicaragua,13-06-2020,318795,212,1083,317712,Americas
Niger,13-06-2020,336127,2060,3,336124,Africa
Nigeria,13-06-2020,428058,1727,281,427777,Africa
North Macedonia,13-06-2020,54819,2162,1188,53631,Europe
Norway,13-06-2020,363438,1563,275,363163,Europe
Oman,13-06-2020,120420,488,591,119829,Eastern Mediterranean
Pakistan,13-06-2020,195024,817,821,194203,Eastern Mediterranean
Panama,13-06-2020,52373,1322,1214,51159,Americas
Papua New Guinea,13-06-2020,200071,1493,62,200009,Western Pacific
Paraguay,13-06-2020,372351,959,137,372214,Americas
Peru,13-06-2020,51576,2295,390,51186,Americas
Philippines,13-06-2020,6229,407,707,5522,Western Pacific
Poland,13-06-2020,163677,1290,250,163427,Europe
Portugal,13-06-2020,222434,1195,399,222035,Europe
Qatar,13-06-2020,298819,2242,691,298128,Eastern Mediterranean
Romania,13-06-2020,101969,518,303,101666,Europe
Russia,13-06-2020,355009,2083,1179,353830,Europe
Rwanda,13-06-2020,39970,1540,1114,38856,Africa
Saint Lucia,13-06-2020,393174,1683,745,392429,Americas
Saint Vincent and the Grenadines,13-06-2020,101227,2123,464,100763,Americas
San Marino,13-06-2020,329365,305,185,329180,Europe
Saudi Arabia,13-06-2020,426963,1893,107,426856,Eastern Mediterranean
Senegal,13-06-2020,156841,621,510,156331,Africa
Serbia,13-06-2020,23167,1220,950,22217,Europe
Seychelles,13-06-2020,166303,1805,86,166217,Africa
Singapore,13-06-2020,446021,656,920,445101,Western Pacific
Slovakia,13-06-2020,339838,1588,367,339471,Europe
Slovenia,13-06-2020,21260,712,866,20394,Europe
Somalia,13-06-2020,213278,516,619,212659,Eastern Mediterranean
South Africa,13-06-2020,23414,1742,1170,22244,Africa
Spain,13-06-2020,401511,1673,890,400621,Europe
Sri Lanka,13-06-2020,374401,1739,420,373981,South-East Asia
Sudan,13-06-2020,352036,693,818,351218,Eastern Mediterranean
Suriname,13-06-2020,206199,1970,852,205347,Americas
Sweden,13-06-2020,396936,1093,1098,395838,Europe
Switzerland,13-06-2020,38833,1503,796,38037,Europe
Taiwan*,13-06-2020,174594,64,51,174543,Western Pacific
Tanzania,13-06-2020,440981,1650,389,440592,Africa
Thailand,13-06-2020,296642,1758,46,296596,South-East Asia
Togo,13-06-2020,439690,1393,818,438872,Africa
Trinidad and Tobago,13-06-2020,45231,620,715,44516,Americas
Tunisia,13-06-2020,409079,0,1066,408013,Eastern Mediterranean
Turkey,13-06-2020,6730,1343,654,6076,Europe
Uganda,13-06-2020,190016,734,679,189337,Africa
Ukraine,13-06-2020,218617,1431,913,217704,Europe
United Arab Emirates,13-06-2020,181889,613,34,181855,Eastern Mediterranean
United Kingdom,13-06-2020,131582,857,1045,130537,Europe
United Kingdom,13-06-2020,264333,1687,1080,263253,Europe
United Kingdom,13-06-2020,111264,1275,1050,110214,Europe
United Kingdom,13-06-2020,171948,80,418,171530,Europe
United Kingdom,13-06-2020,344438,1157,1186,343252,Europe
United Kingdom,13-06-2020,325149,821,1186,323963,Europe
United Kingdom,13-06-2020,416491,851,770,415721,Europe
Uruguay,13-06-2020,250986,728,821,250165,Americas
US,13-06-2020,302114,2021,10,302104,Americas
Uzbekistan,13-06-2020,90426,230,143,90283,Europe
Venezuela,13-06-2020,248327,1277,588,247739,Americas
Vietnam,13-06-2020,208877,2167,578,208299,Western Pacific
Zambia,13-06-2020,70504,345,845,69659,Africa
Zimbabwe,13-06-2020,104791,1893,730,104061,Africa
Dominica,13-06-2020,231606,1389,102,231504,Americas
Grenada,13-06-2020,221175,2155,615,220560,Americas
Mozambique,13-06-2020,233462,1084,450,233012,Africa
Syria,13-06-2020,372972,2156,95,372877,Eastern Mediterranean
Timor-Leste,13-06-2020,381102,349,109,380993,South-East Asia
Belize,13-06-2020,350600,2000,448,350152,Americas
Laos,13-06-2020,19967,883,1229,18738,Western Pacific
Libya,13-06-2020,19487,1075,221,19266,Eastern Mediterranean
West Bank and Gaza,13-06-2020,278234,578,202,278032,Eastern Mediterranean
Guinea-Bissau,13-06-2020,186728,561,34,186694,Africa
Mali,13-06-2020,432965,1428,342,432623,Africa
Saint Kitts and Nevis,13-06-2020,278722,1814,1074,277648,Americas
Canada,13-06-2020,20529,1607,523,20006,Americas
Canada,13-06-2020,257226,1938,17,257209,Americas
Kosovo,13-06-2020,64533,508,201,64332,Europe
Burma,13-06-2020,269557,2194,254,269303,South-East Asia
United Kingdom,13-06-2020,186364,1782,157,186207,Europe
United Kingdom,13-06-2020,369975,63,597,369378,Europe
United Kingdom,13-06-2020,220281,507,905,219376,Europe
Botswana,13-06-2020,3416,1547,57,3359,Africa
Burundi,13-06-2020,263165,2236,503,262662,Africa
Sierra Leone,13-06-2020,207362,821,702,206660,Africa
Malawi,13-06-2020,386252,148,434,385818,Africa
United Kingdom,13-06-2020,408767,186,816,407951,Europe
France,13-06-2020,361342,570,469,360873,Europe
South Sudan,13-06-2020,80827,77,563,80264,Africa
Western Sahara,13-06-2020,445894,111,888,445006,Africa
Sao Tome and Principe,13-06-2020,432689,1986,547,432142,Africa
Yemen,13-06-2020,74216,2003,102,74114,Eastern Mediterranean
Comoros,13-06-2020,167166,636,478,166688,Africa
Tajikistan,13-06-2020,415599,244,599,415000,Europe
Lesotho,13-06-2020,86144,789,1200,84944,Africa
Afghanistan,14-06-2020,212942,2287,1031,211911,Eastern Mediterranean
Albania,14-06-2020,73622,661,771,72851,Europe
Algeria,14-06-2020,144323,155,87,144236,Africa
Andorra,14-06-2020,292161,390,69,292092,Europe
Angola,14-06-2020,310000,1808,530,309470,Africa
Antigua and Barbuda,14-06-2020,22048,1887,575,21473,Americas
Argentina,14-06-2020,388838,657,933,387905,Americas
Armenia,14-06-2020,417752,1045,804,416948,Europe
Australia,14-06-2020,367580,1147,605,366975,Western Pacific
Australia,14-06-2020,257801,1941,247,257554,Western Pacific
Australia,14-06-2020,444236,35,75,444161,Western Pacific
Australia,14-06-2020,165416,779,944,164472,Western Pacific
Australia,14-06-2020,120359,2107,10,120349,Western Pacific
Australia,14-06-2020,371507,545,142,371365,Western Pacific
Australia,14-06-2020,220345,1141,1001,219344,Western Pacific
Australia,14-06-2020,164967,1540,918,164049,Western Pacific
Austria,14-06-2020,67362,232,1021,66341,Europe
Azerbaijan,14-06-2020,145791,949,501,145290,Europe
Bahamas,14-06-2020,148841,2013,376,148465,Americas
Bahrain,14-06-2020,170204,1784,949,169255,Eastern Mediterranean
Bangladesh,14-06-2020,394757,823,337,394420,South-East Asia
Barbados,14-06-2020,357486,1085,430,357056,Americas
Belarus,14-06-2020,89486,964,865,88621,Europe
Belgium,14-06-2020,329337,2158,12,329325,Europe
Benin,14-06-2020,44468,1037,620,43848,Africa
Bhutan,14-06-2020,339166,497,967,338199,South-East Asia
Bolivia,14-06-2020,53282,1034,683,52599,Americas
Bosnia and Herzegovina,14-06-2020,75026,2032,556,74470,Europe
Brazil,14-06-2020,388507,2327,682,387825,Americas
Brunei,14-06-2020,270574,2037,991,269583,Western Pacific
Bulgaria,14-06-2020,287932,2171,180,287752,Europe
Burkina Faso,14-06-2020,335549,82,1052,334497,Africa
Cabo Verde,14-06-2020,45838,686,846,44992,Africa
Cambodia,14-06-2020,28333,2104,886,27447,Western Pacific
Cameroon,14-06-2020,280286,112,1243,279043,Africa
Canada,14-06-2020,326441,1429,1063,325378,Americas
Canada,14-06-2020,312144,770,774,311370,Americas
Canada,14-06-2020,152728,220,797,151931,Americas
Canada,14-06-2020,405712,1547,1104,404608,Americas
Canada,14-06-2020,305653,1345,597,305056,Americas
Canada,14-06-2020,298326,1318,608,297718,Americas
Canada,14-06-2020,136063,358,1243,134820,Americas
Canada,14-06-2020,258310,899,391,257919,Americas
Canada,14-06-2020,85845,1937,1219,84626,Americas
Canada,14-06-2020,161744,380,361,161383,Americas
Central African Republic,14-06-2020,117102,378,284,116818,Africa
Chad,14-06-2020,51864,1913,774,51090,Africa
Chile,14-06-2020,382518,1033,446,382072,Americas
China,14-06-2020,278975,1320,46,278929,Western Pacific
China,14-06-2020,81655,2160,232,81423,Western Pacific
China,14-06-2020,9656,1043,978,8678,Western Pacific
China,14-06-2020,132358,740,250,132108,Western Pacific
China,14-06-2020,303655,1411,766,302889,Western Pacific
China,14-06-2020,407917,735,1174,406743,Western Pacific
China,14-06-2020,165147,343,736,164411,Western Pacific
China,14-06-2020,141468,1162,951,140517,Western Pacific
China,14-06-2020,386322,315,381,385941,Western Pacific
China,14-06-2020,46604,2322,1198,45406,Western Pacific
China,14-06-2020,145179,364,409,144770,Western Pacific
China,14-06-2020,373945,629,960,372985,Western Pacific
China,14-06-2020,169733,2184,241,169492,Western Pacific
China,14-06-2020,421044,1651,1159,419885,Western Pacific
China,14-06-2020,95545,716,961,94584,Western Pacific
China,14-06-2020,338579,17,751,337828,Western Pacific
China,14-06-2020,161971,1759,233,161738,Western Pacific
China,14-06-2020,379676,380,357,379319,Western Pacific
China,14-06-2020,137383,1375,188,137195,Western Pacific
China,14-06-2020,225842,1351,652,225190,Western Pacific
China,14-06-2020,124910,1786,1196,123714,Western Pacific
China,14-06-2020,393974,553,353,393621,Western Pacific
China,14-06-2020,49596,565,222,49374,Western Pacific
China,14-06-2020,154400,1168,1015,153385,Western Pacific
China,14-06-2020,427596,1952,1041,426555,Western Pacific
China,14-06-2020,22108,2485,625,21483,Western Pacific
China,14-06-2020,287516,1532,1119,286397,Western Pacific
China,14-06-2020,156549,230,605,155944,Western Pacific
China,14-06-2020,430294,159,704,429590,Western Pacific
China,14-06-2020,177552,1235,369,177183,Western Pacific
China,14-06-2020,291282,1371,789,290493,Western Pacific
China,14-06-2020,367845,1092,1217,366628,Western Pacific
China,14-06-2020,92855,2096,596,92259,Western Pacific
Colombia,14-06-2020,414894,212,563,414331,Americas
Congo (Brazzaville),14-06-2020,69582,2078,704,68878,Africa
Congo (Kinshasa),14-06-2020,247307,2120,456,246851,Africa
Costa Rica,14-06-2020,137697,164,190,137507,Americas
Cote d'Ivoire,14-06-2020,198319,312,510,197809,Africa
Croatia,14-06-2020,383977,889,467,383510,Europe
Cuba,14-06-2020,160761,1663,705,160056,Americas
Cyprus,14-06-2020,263571,1634,914,262657,Europe
Czechia,14-06-2020,214622,1625,111,214511,Europe
Denmark,14-06-2020,58239,1200,435,57804,Europe
Greenland,14-06-2020,252551,718,485,252066,Europe
Denmark,14-06-2020,432645,1363,931,431714,Europe
Djibouti,14-06-2020,158278,1550,763,157515,Eastern Mediterranean
Dominican Republic,14-06-2020,358702,1354,375,358327,Americas
Ecuador,14-06-2020,334480,389,1120,333360,Americas
Egypt,14-06-2020,341466,1095,432,341034,Eastern Mediterranean
El Salvador,14-06-2020,418571,1748,663,417908,Americas
Equatorial Guinea,14-06-2020,115120,1631,552,114568,Africa
Eritrea,14-06-2020,114497,1846,670,113827,Africa
Estonia,14-06-2020,206571,461,351,206220,Europe
Eswatini,14-06-2020,334575,2392,204,334371,Africa
Ethiopia,14-06-2020,353947,447,459,353488,Africa
Fiji,14-06-2020,230825,1437,76,230749,Western Pacific
Finland,14-06-2020,240042,2072,297,239745,Europe
France,14-06-2020,340683,1578,621,340062,Europe
France,14-06-2020,197007,380,552,196455,Europe
France,14-06-2020,53026,2113,952,52074,Europe
France,14-06-2020,167111,2150,1152,165959,Europe
France,14-06-2020,228622,986,473,228149,Europe
France,14-06-2020,396842,930,619,396223,Europe
France,14-06-2020,362831,2412,55,362776,Europe
France,14-06-2020,320421,546,380,320041,Europe
France,14-06-2020,276000,2316,1119,274881,Europe
France,14-06-2020,270224,1066,1126,269098,Europe
Gabon,14-06-2020,209264,1361,876,208388,Africa
Gambia,14-06-2020,188703,2321,127,188576,Africa
Georgia,14-06-2020,390043,232,526,389517,Europe
Germany,14-06-2020,297157,262,589,296568,Europe
Ghana,14-06-2020,55550,629,214,55336,Africa
Greece,14-06-2020,434072,1426,765,433307,Europe
Guatemala,14-06-2020,171911,235,601,171310,Americas
Guinea,14-06-2020,439333,1973,578,438755,Africa
Guyana,14-06-2020,142541,2006,565,141976,Americas
Haiti,14-06-2020,41108,1272,1037,40071,Americas
Holy See,14-06-2020,437909,1690,74,437835,Europe
Honduras,14-06-2020,307460,741,841,306619,Americas
Hungary,14-06-2020,346527,2414,542,345985,Europe
Iceland,14-06-2020,271423,1173,806,270617,Europe
India,14-06-2020,337788,556,1047,336741,South-East Asia
Indonesia,14-06-2020,410809,1427,1201,409608,South-East Asia
Iran,14-06-2020,360211,1121,1079,359132,Eastern Mediterranean
Iraq,14-06-2020,84296,2262,385,83911,Eastern Mediterranean
Ireland,14-06-2020,18848,2160,448,18400,Europe
Israel,14-06-2020,421021,731,12,421009,Europe
Italy,14-06-2020,444163,270,439,443724,Europe
Jamaica,14-06-2020,205059,2003,1060,203999,Americas
Japan,14-06-2020,211287,89,538,210749,Western Pacific
Jordan,14-06-2020,121972,2232,603,121369,Eastern Mediterranean
Kazakhstan,14-06-2020,28217,1457,756,27461,Europe
Kenya,14-06-2020,41582,647,214,41368,Africa
South Korea,14-06-2020,116196,1049,613,115583,Western Pacific
Kuwait,14-06-2020,319532,1189,167,319365,Eastern Mediterranean
Kyrgyzstan,14-06-2020,15501,887,673,14828,Europe
Latvia,14-06-2020,82263,1569,479,81784,Europe
Lebanon,14-06-2020,435370,1995,583,434787,Eastern Mediterranean
Liberia,14-06-2020,431316,2004,404,430912,Africa
Liechtenstein,14-06-2020,266129,797,1200,264929,Europe
Lithuania,14-06-2020,31362,1755,588,30774,Europe
Luxembourg,14-06-2020,134905,2358,327,134578,Europe
Madagascar,14-06-2020,447729,799,307,447422,Africa
Malaysia,14-06-2020,286337,2442,570,285767,Western Pacific
Maldives,14-06-2020,86862,1067,569,86293,South-East Asia
Malta,14-06-2020,186624,1445,1008,185616,Europe
Mauritania,14-06-2020,355545,204,635,354910,Africa
Mauritius,14-06-2020,335395,2186,900,334495,Africa
Mexico,14-06-2020,295909,511,817,295092,Americas
Moldova,14-06-2020,63763,1254,381,63382,Europe
Monaco,14-06-2020,169406,1200,200,169206,Europe
Mongolia,14-06-2020,262012,782,669,261343,Western Pacific
Montenegro,14-06-2020,36142,653,895,35247,Europe
Morocco,14-06-2020,83935,696,783,83152,Eastern Mediterranean
Namibia,14-06-2020,23412,1323,882,22530,Africa
Nepal,14-06-2020,322215,2389,808,321407,South-East Asia
Netherlands,14-06-2020,416683,2204,1095,415588,Europe
Netherlands,14-06-2020,24199,2020,989,23210,Europe
Netherlands,14-06-2020,264684,1345,475,264209,Europe
Netherlands,14-06-2020,391556,2145,485,391071,Europe
New Zealand,14-06-2020,53114,1007,1153,51961,Western Pacific
Nicaragua,14-06-2020,253973,494,437,253536,Americas
Niger,14-06-2020,172527,82,576,171951,Africa
Nigeria,14-06-2020,148492,484,1046,147446,Africa
North Macedonia,14-06-2020,17598,1409,744,16854,Europe
Norway,14-06-2020,267024,1977,128,266896,Europe
Oman,14-06-2020,97134,985,1069,96065,Eastern Mediterranean
Pakistan,14-06-2020,68977,173,646,68331,Eastern Mediterranean
Panama,14-06-2020,322519,1713,365,322154,Americas
Papua New Guinea,14-06-2020,247236,766,162,247074,Western Pacific
Paraguay,14-06-2020,376375,1516,428,375947,Americas
Peru,14-06-2020,55131,2218,1235,53896,Americas
Philippines,14-06-2020,415598,2138,975,414623,Western Pacific
Poland,14-06-2020,248650,1596,1137,247513,Europe
Portugal,14-06-2020,271405,2314,837,270568,Europe
Qatar,14-06-2020,449266,519,5,449261,Eastern Mediterranean
Romania,14-06-2020,300187,360,728,299459,Europe
Russia,14-06-2020,97135,2233,453,96682,Europe
Rwanda,14-06-2020,324676,365,465,324211,Africa
Saint Lucia,14-06-2020,194548,714,1248,193300,Americas
Saint Vincent and the Grenadines,14-06-2020,388647,91,286,388361,Americas
San Marino,14-06-2020,139576,2465,971,138605,Europe
Saudi Arabia,14-06-2020,177155,240,736,176419,Eastern Mediterranean
Senegal,14-06-2020,338736,1789,983,337753,Africa
Serbia,14-06-2020,57410,964,842,56568,Europe
Seychelles,14-06-2020,326293,546,303,325990,Africa
Singapore,14-06-2020,435092,1470,1001,434091,Western Pacific
Slovakia,14-06-2020,368894,27,882,368012,Europe
Slovenia,14-06-2020,180061,343,594,179467,Europe
Somalia,14-06-2020,448342,1288,75,448267,Eastern Mediterranean
South Africa,14-06-2020,312933,1111,1155,311778,Africa
Spain,14-06-2020,421425,1115,1094,420331,Europe
Sri Lanka,14-06-2020,132943,1650,679,132264,South-East Asia
Sudan,14-06-2020,244675,1536,1122,243553,Eastern Mediterranean
Suriname,14-06-2020,306128,1939,806,305322,Americas
Sweden,14-06-2020,69183,624,891,68292,Europe
Switzerland,14-06-2020,245857,252,505,245352,Europe
Taiwan*,14-06-2020,299965,1199,929,299036,Western Pacific
Tanzania,14-06-2020,178329,396,168,178161,Africa
Thailand,14-06-2020,367768,489,1061,366707,South-East Asia
Togo,14-06-2020,242838,2084,936,241902,Africa
Trinidad and Tobago,14-06-2020,377898,2472,347,377551,Americas
Tunisia,14-06-2020,234742,2,354,234388,Eastern Mediterranean
Turkey,14-06-2020,94905,1696,105,94800,Europe
Uganda,14-06-2020,170677,2336,575,170102,Africa
Ukraine,14-06-2020,80101,834,120,79981,Europe
United Arab Emirates,14-06-2020,148866,1762,28,148838,Eastern Mediterranean
United Kingdom,14-06-2020,256459,1325,466,255993,Europe
United Kingdom,14-06-2020,323419,743,482,322937,Europe
United Kingdom,14-06-2020,208684,1707,232,208452,Europe
United Kingdom,14-06-2020,54269,25,797,53472,Europe
United Kingdom,14-06-2020,40130,192,840,39290,Europe
United Kingdom,14-06-2020,96013,1733,757,95256,Europe
United Kingdom,14-06-2020,287627,2332,678,286949,Europe
Uruguay,14-06-2020,182494,1537,125,182369,Americas
US,14-06-2020,110516,1965,595,109921,Americas
Uzbekistan,14-06-2020,20167,798,1167,19000,Europe
Venezuela,14-06-2020,227012,1248,810,226202,Americas
Vietnam,14-06-2020,134092,2055,100,133992,Western Pacific
Zambia,14-06-2020,188079,1021,79,188000,Africa
Zimbabwe,14-06-2020,396204,2121,753,395451,Africa
Dominica,14-06-2020,429010,338,38,428972,Americas
Grenada,14-06-2020,64836,286,111,64725,Americas
Mozambique,14-06-2020,46473,1016,972,45501,Africa
Syria,14-06-2020,33053,1335,303,32750,Eastern Mediterranean
Timor-Leste,14-06-2020,11887,1424,221,11666,South-East Asia
Belize,14-06-2020,352212,669,445,351767,Americas
Laos,14-06-2020,433117,654,113,433004,Western Pacific
Libya,14-06-2020,226845,182,115,226730,Eastern Mediterranean
West Bank and Gaza,14-06-2020,278447,1175,641,277806,Eastern Mediterranean
Guinea-Bissau,14-06-2020,144560,1510,1010,143550,Africa
Mali,14-06-2020,336797,1533,59,336738,Africa
Saint Kitts and Nevis,14-06-2020,261998,2290,569,261429,Americas
Canada,14-06-2020,245345,1412,907,244438,Americas
Canada,14-06-2020,153129,1438,302,152827,Americas
Kosovo,14-06-2020,156953,533,1183,155770,Europe
Burma,14-06-2020,321952,1399,545,321407,South-East Asia
United Kingdom,14-06-2020,22784,2042,851,21933,Europe
United Kingdom,14-06-2020,318356,2441,1014,317342,Europe
United Kingdom,14-06-2020,132052,837,222,131830,Europe
Botswana,14-06-2020,124312,947,421,123891,Africa
Burundi,14-06-2020,408504,2321,70,408434,Africa
Sierra Leone,14-06-2020,332537,142,613,331924,Africa
Malawi,14-06-2020,256270,152,530,255740,Africa
United Kingdom,14-06-2020,446553,979,1146,445407,Europe
France,14-06-2020,25923,1795,758,25165,Europe
South Sudan,14-06-2020,258171,112,866,257305,Africa
Western Sahara,14-06-2020,55176,385,583,54593,Africa
Sao Tome and Principe,14-06-2020,99179,1968,481,98698,Africa
Yemen,14-06-2020,229341,950,1194,228147,Eastern Mediterranean
Comoros,14-06-2020,193873,430,52,193821,Africa
Tajikistan,14-06-2020,360992,1818,739,360253,Europe
Lesotho,14-06-2020,200952,1209,719,200233,Africa
Afghanistan,15-06-2020,160896,767,466,160430,Eastern Mediterranean
Albania,15-06-2020,167124,1063,701,166423,Europe
Algeria,15-06-2020,118404,2216,195,118209,Africa
Andorra,15-06-2020,438728,1034,694,438034,Europe
Angola,15-06-2020,100464,734,1063,99401,Africa
Antigua and Barbuda,15-06-2020,261263,65,1002,260261,Americas
Argentina,15-06-2020,435075,2282,175,434900,Americas
Armenia,15-06-2020,409629,156,11,409618,Europe
Australia,15-06-2020,170784,257,1030,169754,Western Pacific
Australia,15-06-2020,330393,225,514,329879,Western Pacific
Australia,15-06-2020,234163,1520,502,233661,Western Pacific
Australia,15-06-2020,78386,23,1004,77382,Western Pacific
Australia,15-06-2020,190859,934,74,190785,Western Pacific
Australia,15-06-2020,316879,1527,190,316689,Western Pacific
Australia,15-06-2020,435441,966,1161,434280,Western Pacific
Australia,15-06-2020,199186,2213,67,199119,Western Pacific
Austria,15-06-2020,435154,397,57,435097,Europe
Azerbaijan,15-06-2020,305325,2429,1218,304107,Europe
Bahamas,15-06-2020,329011,402,398,328613,Americas
Bahrain,15-06-2020,314134,960,886,313248,Eastern Mediterranean
Bangladesh,15-06-2020,396604,2456,676,395928,South-East Asia
Barbados,15-06-2020,285310,45,192,285118,Americas
Belarus,15-06-2020,384609,1381,1240,383369,Europe
Belgium,15-06-2020,290281,1350,124,290157,Europe
Benin,15-06-2020,12493,926,411,12082,Africa
Bhutan,15-06-2020,21607,188,742,20865,South-East Asia
Bolivia,15-06-2020,37190,845,1088,36102,Americas
Bosnia and Herzegovina,15-06-2020,223331,1383,663,222668,Europe
Brazil,15-06-2020,325512,1770,436,325076,Americas
Brunei,15-06-2020,43111,710,158,42953,Western Pacific
Bulgaria,15-06-2020,277169,2455,689,276480,Europe
Burkina Faso,15-06-2020,251219,1597,351,250868,Africa
Cabo Verde,15-06-2020,370716,919,633,370083,Africa
Cambodia,15-06-2020,211477,2110,1023,210454,Western Pacific
Cameroon,15-06-2020,385841,562,174,385667,Africa
Canada,15-06-2020,175383,598,615,174768,Americas
Canada,15-06-2020,434114,1159,832,433282,Americas
Canada,15-06-2020,392854,1314,1227,391627,Americas
Canada,15-06-2020,72921,218,423,72498,Americas
Canada,15-06-2020,158456,299,254,158202,Americas
Canada,15-06-2020,147466,1613,1174,146292,Americas
Canada,15-06-2020,42642,2147,323,42319,Americas
Canada,15-06-2020,408856,321,558,408298,Americas
Canada,15-06-2020,168671,1197,51,168620,Americas
Canada,15-06-2020,444781,2252,534,444247,Americas
Central African Republic,15-06-2020,348336,71,593,347743,Africa
Chad,15-06-2020,267819,1284,815,267004,Africa
Chile,15-06-2020,230063,1925,1174,228889,Americas
China,15-06-2020,8131,2077,1228,6903,Western Pacific
China,15-06-2020,241941,2230,1139,240802,Western Pacific
China,15-06-2020,230793,1900,69,230724,Western Pacific
China,15-06-2020,87536,188,1175,86361,Western Pacific
China,15-06-2020,368619,1700,164,368455,Western Pacific
China,15-06-2020,309679,957,567,309112,Western Pacific
China,15-06-2020,316110,1930,1114,314996,Western Pacific
China,15-06-2020,278205,1875,573,277632,Western Pacific
China,15-06-2020,154674,979,50,154624,Western Pacific
China,15-06-2020,109261,563,1144,108117,Western Pacific
China,15-06-2020,5761,1739,143,5618,Western Pacific
China,15-06-2020,255283,804,771,254512,Western Pacific
China,15-06-2020,103237,200,1118,102119,Western Pacific
China,15-06-2020,129813,1788,88,129725,Western Pacific
China,15-06-2020,402198,227,621,401577,Western Pacific
China,15-06-2020,70511,264,1068,69443,Western Pacific
China,15-06-2020,449033,680,1200,447833,Western Pacific
China,15-06-2020,273637,360,675,272962,Western Pacific
China,15-06-2020,211637,1534,689,210948,Western Pacific
China,15-06-2020,254461,1280,511,253950,Western Pacific
China,15-06-2020,382446,2238,1037,381409,Western Pacific
China,15-06-2020,94883,2423,1120,93763,Western Pacific
China,15-06-2020,49330,834,111,49219,Western Pacific
China,15-06-2020,50899,173,1029,49870,Western Pacific
China,15-06-2020,238332,2499,356,237976,Western Pacific
China,15-06-2020,406237,804,51,406186,Western Pacific
China,15-06-2020,292202,37,918,291284,Western Pacific
China,15-06-2020,331923,1082,454,331469,Western Pacific
China,15-06-2020,24720,737,1116,23604,Western Pacific
China,15-06-2020,46275,1859,298,45977,Western Pacific
China,15-06-2020,216724,314,1225,215499,Western Pacific
China,15-06-2020,148450,2170,1124,147326,Western Pacific
China,15-06-2020,20311,2123,435,19876,Western Pacific
Colombia,15-06-2020,399866,1868,825,399041,Americas
Congo (Brazzaville),15-06-2020,267312,1865,1099,266213,Africa
Congo (Kinshasa),15-06-2020,394771,2172,90,394681,Africa
Costa Rica,15-06-2020,431353,49,912,430441,Americas
Cote d'Ivoire,15-06-2020,322733,2331,5,322728,Africa
Croatia,15-06-2020,31464,2120,325,31139,Europe
Cuba,15-06-2020,317023,2162,491,316532,Americas
Cyprus,15-06-2020,144894,228,444,144450,Europe
Czechia,15-06-2020,322598,557,137,322461,Europe
Denmark,15-06-2020,303850,734,308,303542,Europe
Greenland,15-06-2020,189490,1101,1110,188380,Europe
Denmark,15-06-2020,166233,1160,33,166200,Europe
Djibouti,15-06-2020,393591,995,71,393520,Eastern Mediterranean
Dominican Republic,15-06-2020,341143,998,461,340682,Americas
Ecuador,15-06-2020,346091,325,916,345175,Americas
Egypt,15-06-2020,122089,967,805,121284,Eastern Mediterranean
El Salvador,15-06-2020,304975,824,896,304079,Americas
Equatorial Guinea,15-06-2020,375280,1688,1017,374263,Africa
Eritrea,15-06-2020,187534,1730,11,187523,Africa
Estonia,15-06-2020,93210,2267,1042,92168,Europe
Eswatini,15-06-2020,9069,270,970,8099,Africa
Ethiopia,15-06-2020,349806,2044,1079,348727,Africa
Fiji,15-06-2020,19253,1730,395,18858,Western Pacific
Finland,15-06-2020,52701,1110,765,51936,Europe
France,15-06-2020,131067,87,631,130436,Europe
France,15-06-2020,364471,1385,1069,363402,Europe
France,15-06-2020,95011,47,568,94443,Europe
France,15-06-2020,359472,975,200,359272,Europe
France,15-06-2020,259559,1744,965,258594,Europe
France,15-06-2020,185924,462,541,185383,Europe
France,15-06-2020,432524,874,1162,431362,Europe
France,15-06-2020,358370,83,66,358304,Europe
France,15-06-2020,384099,1606,53,384046,Europe
France,15-06-2020,260953,2312,164,260789,Europe
Gabon,15-06-2020,346799,1795,537,346262,Africa
Gambia,15-06-2020,355286,769,1166,354120,Africa
Georgia,15-06-2020,370604,2284,664,369940,Europe
Germany,15-06-2020,209062,2397,367,208695,Europe
Ghana,15-06-2020,412427,1810,1104,411323,Africa
Greece,15-06-2020,189989,1994,760,189229,Europe
Guatemala,15-06-2020,376981,822,848,376133,Americas
Guinea,15-06-2020,175930,40,741,175189,Africa
Guyana,15-06-2020,387601,1110,1198,386403,Americas
Haiti,15-06-2020,213710,1668,673,213037,Americas
Holy See,15-06-2020,279487,1035,47,279440,Europe
Honduras,15-06-2020,394310,864,585,393725,Americas
Hungary,15-06-2020,400232,1555,290,399942,Europe
Iceland,15-06-2020,274478,2139,1092,273386,Europe
India,15-06-2020,132194,1440,1105,131089,South-East Asia
Indonesia,15-06-2020,151303,527,218,151085,South-East Asia
Iran,15-06-2020,340045,544,1153,338892,Eastern Mediterranean
Iraq,15-06-2020,407903,2326,881,407022,Eastern Mediterranean
Ireland,15-06-2020,238837,1259,442,238395,Europe
Israel,15-06-2020,394520,350,532,393988,Europe
Italy,15-06-2020,310443,1892,518,309925,Europe
Jamaica,15-06-2020,132688,355,766,131922,Americas
Japan,15-06-2020,267341,493,1043,266298,Western Pacific
Jordan,15-06-2020,221831,2329,560,221271,Eastern Mediterranean
Kazakhstan,15-06-2020,342690,1434,58,342632,Europe
Kenya,15-06-2020,136854,501,270,136584,Africa
South Korea,15-06-2020,356560,754,352,356208,Western Pacific
Kuwait,15-06-2020,402769,1492,1198,401571,Eastern Mediterranean
Kyrgyzstan,15-06-2020,116290,2233,579,115711,Europe
Latvia,15-06-2020,159129,1120,1159,157970,Europe
Lebanon,15-06-2020,218446,2012,1223,217223,Eastern Mediterranean
Liberia,15-06-2020,340532,1307,1232,339300,Africa
Liechtenstein,15-06-2020,338435,396,899,337536,Europe
Lithuania,15-06-2020,33649,1303,610,33039,Europe
Luxembourg,15-06-2020,198802,1921,584,198218,Europe
Madagascar,15-06-2020,338533,1937,1034,337499,Africa
Malaysia,15-06-2020,15732,2153,172,15560,Western Pacific
Maldives,15-06-2020,82235,1823,95,82140,South-East Asia
Malta,15-06-2020,282228,220,301,281927,Europe
Mauritania,15-06-2020,434525,45,1201,433324,Africa
Mauritius,15-06-2020,419413,63,454,418959,Africa
Mexico,15-06-2020,196534,544,162,196372,Americas
Moldova,15-06-2020,233891,1431,897,232994,Europe
Monaco,15-06-2020,18861,2324,785,18076,Europe
Mongolia,15-06-2020,380138,1663,310,379828,Western Pacific
Montenegro,15-06-2020,226726,809,733,225993,Europe
Morocco,15-06-2020,114056,78,534,113522,Eastern Mediterranean
Namibia,15-06-2020,228447,552,75,228372,Africa
Nepal,15-06-2020,381810,1342,1187,380623,South-East Asia
Netherlands,15-06-2020,180184,1701,452,179732,Europe
Netherlands,15-06-2020,17293,203,362,16931,Europe
Netherlands,15-06-2020,265886,2316,93,265793,Europe
Netherlands,15-06-2020,449308,965,834,448474,Europe
New Zealand,15-06-2020,233310,330,519,232791,Western Pacific
Nicaragua,15-06-2020,318115,1623,798,317317,Americas
Niger,15-06-2020,234355,2154,954,233401,Africa
Nigeria,15-06-2020,350584,1638,48,350536,Africa
North Macedonia,15-06-2020,263908,966,940,262968,Europe
Norway,15-06-2020,78545,1000,306,78239,Europe
Oman,15-06-2020,15411,1337,594,14817,Eastern Mediterranean
Pakistan,15-06-2020,197691,931,968,196723,Eastern Mediterranean
Panama,15-06-2020,223418,1742,580,222838,Americas
Papua New Guinea,15-06-2020,212875,1536,402,212473,Western Pacific
Paraguay,15-06-2020,401035,1129,435,400600,Americas
Peru,15-06-2020,61517,605,1087,60430,Americas
Philippines,15-06-2020,6128,1613,1028,5100,Western Pacific
Poland,15-06-2020,409196,1135,718,408478,Europe
Portugal,15-06-2020,363635,2008,299,363336,Europe
Qatar,15-06-2020,231052,1681,85,230967,Eastern Mediterranean
Romania,15-06-2020,419676,2303,835,418841,Europe
Russia,15-06-2020,222580,926,178,222402,Europe
Rwanda,15-06-2020,354056,1350,922,353134,Africa
Saint Lucia,15-06-2020,171114,789,1140,169974,Americas
Saint Vincent and the Grenadines,15-06-2020,130081,50,458,129623,Americas
San Marino,15-06-2020,134753,1020,740,134013,Europe
Saudi Arabia,15-06-2020,372836,2097,464,372372,Eastern Mediterranean
Senegal,15-06-2020,164501,2278,61,164440,Africa
Serbia,15-06-2020,201774,2234,930,200844,Europe
Seychelles,15-06-2020,366858,1971,113,366745,Africa
Singapore,15-06-2020,447081,2191,563,446518,Western Pacific
Slovakia,15-06-2020,44972,726,1085,43887,Europe
Slovenia,15-06-2020,336022,2155,659,335363,Europe
Somalia,15-06-2020,337676,1674,1172,336504,Eastern Mediterranean
South Africa,15-06-2020,62779,1108,777,62002,Africa
Spain,15-06-2020,6556,159,523,6033,Europe
Sri Lanka,15-06-2020,190884,406,1,190883,South-East Asia
Sudan,15-06-2020,3062,247,214,2848,Eastern Mediterranean
Suriname,15-06-2020,17371,885,1051,16320,Americas
Sweden,15-06-2020,283731,222,601,283130,Europe
Switzerland,15-06-2020,226657,1737,14,226643,Europe
Taiwan*,15-06-2020,361313,2414,1103,360210,Western Pacific
Tanzania,15-06-2020,309760,1365,1107,308653,Africa
Thailand,15-06-2020,4510,396,292,4218,South-East Asia
Togo,15-06-2020,249174,478,319,248855,Africa
Trinidad and Tobago,15-06-2020,139626,2011,971,138655,Americas
Tunisia,15-06-2020,230216,529,250,229966,Eastern Mediterranean
Turkey,15-06-2020,420210,2428,76,420134,Europe
Uganda,15-06-2020,28863,215,242,28621,Africa
Ukraine,15-06-2020,64959,1295,431,64528,Europe
United Arab Emirates,15-06-2020,249521,2314,538,248983,Eastern Mediterranean
United Kingdom,15-06-2020,177831,2380,507,177324,Europe
United Kingdom,15-06-2020,212511,393,257,212254,Europe
United Kingdom,15-06-2020,121879,2235,1092,120787,Europe
United Kingdom,15-06-2020,331684,2312,746,330938,Europe
United Kingdom,15-06-2020,9350,244,187,9163,Europe
United Kingdom,15-06-2020,389375,883,874,388501,Europe
United Kingdom,15-06-2020,14532,734,62,14470,Europe
Uruguay,15-06-2020,355659,1988,575,355084,Americas
US,15-06-2020,46621,926,668,45953,Americas
Uzbekistan,15-06-2020,170487,2078,719,169768,Europe
Venezuela,15-06-2020,183209,1902,15,183194,Americas
Vietnam,15-06-2020,84267,813,1046,83221,Western Pacific
Zambia,15-06-2020,166535,883,1117,165418,Africa
Zimbabwe,15-06-2020,224126,1375,751,223375,Africa
Dominica,15-06-2020,407205,675,512,406693,Americas
Grenada,15-06-2020,274046,1353,391,273655,Americas
Mozambique,15-06-2020,217344,656,1249,216095,Africa
Syria,15-06-2020,401632,148,972,400660,Eastern Mediterranean
Timor-Leste,15-06-2020,268644,53,1117,267527,South-East Asia
Belize,15-06-2020,421602,2349,614,420988,Americas
Laos,15-06-2020,81233,2360,931,80302,Western Pacific
Libya,15-06-2020,352232,1967,408,351824,Eastern Mediterranean
West Bank and Gaza,15-06-2020,61954,1892,807,61147,Eastern Mediterranean
Guinea-Bissau,15-06-2020,361974,1422,982,360992,Africa
Mali,15-06-2020,79853,1746,628,79225,Africa
Saint Kitts and Nevis,15-06-2020,426542,1573,1078,425464,Americas
Canada,15-06-2020,201593,1218,1031,200562,Americas
Canada,15-06-2020,445245,2126,709,444536,Americas
Kosovo,15-06-2020,314404,1993,831,313573,Europe
Burma,15-06-2020,58243,353,992,57251,South-East Asia
United Kingdom,15-06-2020,75049,1583,250,74799,Europe
United Kingdom,15-06-2020,402062,484,1066,400996,Europe
United Kingdom,15-06-2020,115637,2136,1238,114399,Europe
Botswana,15-06-2020,403344,1756,774,402570,Africa
Burundi,15-06-2020,157194,253,794,156400,Africa
Sierra Leone,15-06-2020,387497,2071,72,387425,Africa
Malawi,15-06-2020,232809,1427,1056,231753,Africa
United Kingdom,15-06-2020,386675,1497,966,385709,Europe
France,15-06-2020,264181,1468,891,263290,Europe
South Sudan,15-06-2020,320115,819,468,319647,Africa
Western Sahara,15-06-2020,399834,1453,1245,398589,Africa
Sao Tome and Principe,15-06-2020,343982,225,249,343733,Africa
Yemen,15-06-2020,169928,161,904,169024,Eastern Mediterranean
Comoros,15-06-2020,38650,982,1013,37637,Africa
Tajikistan,15-06-2020,6825,2063,607,6218,Europe
Lesotho,15-06-2020,185272,2450,280,184992,Africa
Afghanistan,16-06-2020,142600,99,12,142588,Eastern Mediterranean
Albania,16-06-2020,225762,2241,102,225660,Europe
Algeria,16-06-2020,158257,1727,1028,157229,Africa
Andorra,16-06-2020,396082,10,404,395678,Europe
Angola,16-06-2020,346279,2020,1042,345237,Africa
Antigua and Barbuda,16-06-2020,394212,316,31,394181,Americas
Argentina,16-06-2020,376061,1896,1235,374826,Americas
Armenia,16-06-2020,68733,300,301,68432,Europe
Australia,16-06-2020,445246,985,666,444580,Western Pacific
Australia,16-06-2020,138112,1102,1138,136974,Western Pacific
Australia,16-06-2020,410236,762,727,409509,Western Pacific
Australia,16-06-2020,324585,1368,988,323597,Western Pacific
Australia,16-06-2020,422423,992,1058,421365,Western Pacific
Australia,16-06-2020,325085,858,632,324453,Western Pacific
Australia,16-06-2020,369602,1243,230,369372,Western Pacific
Australia,16-06-2020,216233,2046,395,215838,Western Pacific
Austria,16-06-2020,226280,1367,573,225707,Europe
Azerbaijan,16-06-2020,221604,2336,537,221067,Europe
Bahamas,16-06-2020,410968,2097,418,410550,Americas
Bahrain,16-06-2020,160344,1136,329,160015,Eastern Mediterranean
Bangladesh,16-06-2020,360328,2020,791,359537,South-East Asia
Barbados,16-06-2020,218642,780,405,218237,Americas
Belarus,16-06-2020,944,675,282,662,Europe
Belgium,16-06-2020,398286,1030,919,397367,Europe
Benin,16-06-2020,328194,376,1154,327040,Africa
Bhutan,16-06-2020,446646,1330,1127,445519,South-East Asia
Bolivia,16-06-2020,410464,697,810,409654,Americas
Bosnia and Herzegovina,16-06-2020,81278,1997,283,80995,Europe
Brazil,16-06-2020,434178,1826,337,433841,Americas
Brunei,16-06-2020,140210,927,37,140173,Western Pacific
Bulgaria,16-06-2020,427618,2411,87,427531,Europe
Burkina Faso,16-06-2020,426767,70,682,426085,Africa
Cabo Verde,16-06-2020,347547,1579,152,347395,Africa
Cambodia,16-06-2020,212595,991,333,212262,Western Pacific
Cameroon,16-06-2020,448076,1483,488,447588,Africa
Canada,16-06-2020,14072,2356,956,13116,Americas
Canada,16-06-2020,21646,1113,309,21337,Americas
Canada,16-06-2020,164243,935,1012,163231,Americas
Canada,16-06-2020,11572,846,503,11069,Americas
Canada,16-06-2020,239570,1382,665,238905,Americas
Canada,16-06-2020,343738,1034,648,343090,Americas
Canada,16-06-2020,139285,1523,328,138957,Americas
Canada,16-06-2020,141836,690,671,141165,Americas
Canada,16-06-2020,83745,1393,1239,82506,Americas
Canada,16-06-2020,132159,1933,222,131937,Americas
Central African Republic,16-06-2020,156247,2014,63,156184,Africa
Chad,16-06-2020,344359,165,810,343549,Africa
Chile,16-06-2020,290092,874,330,289762,Americas
China,16-06-2020,426516,1131,964,425552,Western Pacific
China,16-06-2020,161476,174,1113,160363,Western Pacific
China,16-06-2020,249600,2407,661,248939,Western Pacific
China,16-06-2020,60543,2275,296,60247,Western Pacific
China,16-06-2020,237579,1973,910,236669,Western Pacific
China,16-06-2020,365612,1868,367,365245,Western Pacific
China,16-06-2020,374730,547,956,373774,Western Pacific
China,16-06-2020,258026,1152,925,257101,Western Pacific
China,16-06-2020,135281,1202,666,134615,Western Pacific
China,16-06-2020,130337,1227,873,129464,Western Pacific
China,16-06-2020,3545,1054,1073,2472,Western Pacific
China,16-06-2020,280173,106,575,279598,Western Pacific
China,16-06-2020,393623,1286,657,392966,Western Pacific
China,16-06-2020,69050,405,141,68909,Western Pacific
China,16-06-2020,382484,2031,1028,381456,Western Pacific
China,16-06-2020,39244,1781,1086,38158,Western Pacific
China,16-06-2020,364654,1538,571,364083,Western Pacific
China,16-06-2020,347586,1808,73,347513,Western Pacific
China,16-06-2020,332623,989,836,331787,Western Pacific
China,16-06-2020,143948,863,88,143860,Western Pacific
China,16-06-2020,315440,32,498,314942,Western Pacific
China,16-06-2020,11765,1823,1005,10760,Western Pacific
China,16-06-2020,369828,1881,820,369008,Western Pacific
China,16-06-2020,336526,2329,514,336012,Western Pacific
China,16-06-2020,293524,1486,976,292548,Western Pacific
China,16-06-2020,397461,506,202,397259,Western Pacific
China,16-06-2020,301083,898,152,300931,Western Pacific
China,16-06-2020,16255,1729,97,16158,Western Pacific
China,16-06-2020,389234,678,491,388743,Western Pacific
China,16-06-2020,184581,282,1153,183428,Western Pacific
China,16-06-2020,223648,824,410,223238,Western Pacific
China,16-06-2020,364745,1875,161,364584,Western Pacific
China,16-06-2020,229177,2037,662,228515,Western Pacific
Colombia,16-06-2020,238332,14,771,237561,Americas
Congo (Brazzaville),16-06-2020,179364,1746,797,178567,Africa
Congo (Kinshasa),16-06-2020,422478,2398,411,422067,Africa
Costa Rica,16-06-2020,353314,2276,379,352935,Americas
Cote d'Ivoire,16-06-2020,448417,2104,387,448030,Africa
Croatia,16-06-2020,431512,678,1241,430271,Europe
Cuba,16-06-2020,301522,2086,478,301044,Americas
Cyprus,16-06-2020,332381,2239,935,331446,Europe
Czechia,16-06-2020,155470,603,915,154555,Europe
Denmark,16-06-2020,85611,1517,1081,84530,Europe
Greenland,16-06-2020,91754,1843,264,91490,Europe
Denmark,16-06-2020,413714,2419,1163,412551,Europe
Djibouti,16-06-2020,234474,86,358,234116,Eastern Mediterranean
Dominican Republic,16-06-2020,138212,1848,706,137506,Americas
Ecuador,16-06-2020,252619,1254,1033,251586,Americas
Egypt,16-06-2020,4247,841,1099,3148,Eastern Mediterranean
El Salvador,16-06-2020,235516,1325,1035,234481,Americas
Equatorial Guinea,16-06-2020,409976,30,85,409891,Africa
Eritrea,16-06-2020,338584,2457,509,338075,Africa
Estonia,16-06-2020,90008,2044,702,89306,Europe
Eswatini,16-06-2020,414410,844,435,413975,Africa
Ethiopia,16-06-2020,231339,549,999,230340,Africa
Fiji,16-06-2020,413379,2035,601,412778,Western Pacific
Finland,16-06-2020,85608,166,30,85578,Europe
France,16-06-2020,72590,929,226,72364,Europe
France,16-06-2020,86170,1485,539,85631,Europe
France,16-06-2020,403967,2465,923,403044,Europe
France,16-06-2020,182600,197,778,181822,Europe
France,16-06-2020,303460,2027,693,302767,Europe
France,16-06-2020,382186,417,269,381917,Europe
France,16-06-2020,243104,538,271,242833,Europe
France,16-06-2020,94226,552,1039,93187,Europe
France,16-06-2020,438474,1770,652,437822,Europe
France,16-06-2020,5251,1894,1208,4043,Europe
Gabon,16-06-2020,426837,204,848,425989,Africa
Gambia,16-06-2020,5314,271,217,5097,Africa
Georgia,16-06-2020,344918,1397,219,344699,Europe
Germany,16-06-2020,125582,28,1030,124552,Europe
Ghana,16-06-2020,375346,916,703,374643,Africa
Greece,16-06-2020,402123,9,981,401142,Europe
Guatemala,16-06-2020,11747,165,696,11051,Americas
Guinea,16-06-2020,60387,40,1237,59150,Africa
Guyana,16-06-2020,11201,1114,664,10537,Americas
Haiti,16-06-2020,112600,1349,176,112424,Americas
Holy See,16-06-2020,103464,1584,325,103139,Europe
Honduras,16-06-2020,175993,235,62,175931,Americas
Hungary,16-06-2020,224555,583,204,224351,Europe
Iceland,16-06-2020,219351,2399,680,218671,Europe
India,16-06-2020,56804,2411,653,56151,South-East Asia
Indonesia,16-06-2020,129613,603,716,128897,South-East Asia
Iran,16-06-2020,382904,1221,743,382161,Eastern Mediterranean
Iraq,16-06-2020,212660,669,403,212257,Eastern Mediterranean
Ireland,16-06-2020,179865,1292,443,179422,Europe
Israel,16-06-2020,274932,106,204,274728,Europe
Italy,16-06-2020,148461,1491,222,148239,Europe
Jamaica,16-06-2020,115838,162,1125,114713,Americas
Japan,16-06-2020,318685,2137,243,318442,Western Pacific
Jordan,16-06-2020,323668,1437,405,323263,Eastern Mediterranean
Kazakhstan,16-06-2020,72672,1877,519,72153,Europe
Kenya,16-06-2020,399117,2262,145,398972,Africa
South Korea,16-06-2020,162212,2185,240,161972,Western Pacific
Kuwait,16-06-2020,42319,427,425,41894,Eastern Mediterranean
Kyrgyzstan,16-06-2020,57057,1823,170,56887,Europe
Latvia,16-06-2020,207695,886,97,207598,Europe
Lebanon,16-06-2020,400059,543,1004,399055,Eastern Mediterranean
Liberia,16-06-2020,274033,2075,110,273923,Africa
Liechtenstein,16-06-2020,239892,2332,239,239653,Europe
Lithuania,16-06-2020,287623,405,1171,286452,Europe
Luxembourg,16-06-2020,133575,2129,1117,132458,Europe
Madagascar,16-06-2020,404174,509,743,403431,Africa
Malaysia,16-06-2020,294039,954,167,293872,Western Pacific
Maldives,16-06-2020,144178,919,694,143484,South-East Asia
Malta,16-06-2020,190947,2025,461,190486,Europe
Mauritania,16-06-2020,232375,1122,16,232359,Africa
Mauritius,16-06-2020,213220,2095,59,213161,Africa
Mexico,16-06-2020,92794,1679,732,92062,Americas
Moldova,16-06-2020,403888,2477,577,403311,Europe
Monaco,16-06-2020,318371,1734,30,318341,Europe
Mongolia,16-06-2020,116601,2245,1046,115555,Western Pacific
Montenegro,16-06-2020,270196,1029,1060,269136,Europe
Morocco,16-06-2020,194678,897,810,193868,Eastern Mediterranean
Namibia,16-06-2020,144024,934,518,143506,Africa
Nepal,16-06-2020,10267,240,100,10167,South-East Asia
Netherlands,16-06-2020,331093,74,975,330118,Europe
Netherlands,16-06-2020,307334,899,660,306674,Europe
Netherlands,16-06-2020,174473,710,851,173622,Europe
Netherlands,16-06-2020,385297,1292,508,384789,Europe
New Zealand,16-06-2020,389202,2460,493,388709,Western Pacific
Nicaragua,16-06-2020,308283,1908,831,307452,Americas
Niger,16-06-2020,433555,220,246,433309,Africa
Nigeria,16-06-2020,203840,1019,501,203339,Africa
North Macedonia,16-06-2020,321310,1293,178,321132,Europe
Norway,16-06-2020,400528,2050,487,400041,Europe
Oman,16-06-2020,283196,171,381,282815,Eastern Mediterranean
Pakistan,16-06-2020,180286,2399,450,179836,Eastern Mediterranean
Panama,16-06-2020,160162,1983,1011,159151,Americas
Papua New Guinea,16-06-2020,94413,2100,605,93808,Western Pacific
Paraguay,16-06-2020,182256,572,275,181981,Americas
Peru,16-06-2020,434566,997,871,433695,Americas
Philippines,16-06-2020,137751,2276,11,137740,Western Pacific
Poland,16-06-2020,79907,700,464,79443,Europe
Portugal,16-06-2020,178152,1170,464,177688,Europe
Qatar,16-06-2020,32052,229,541,31511,Eastern Mediterranean
Romania,16-06-2020,36788,1857,695,36093,Europe
Russia,16-06-2020,314202,2233,857,313345,Europe
Rwanda,16-06-2020,179063,586,539,178524,Africa
Saint Lucia,16-06-2020,320232,581,687,319545,Americas
Saint Vincent and the Grenadines,16-06-2020,26421,1347,825,25596,Americas
San Marino,16-06-2020,291637,2321,1039,290598,Europe
Saudi Arabia,16-06-2020,15051,664,1161,13890,Eastern Mediterranean
Senegal,16-06-2020,426630,1058,457,426173,Africa
Serbia,16-06-2020,32700,338,580,32120,Europe
Seychelles,16-06-2020,398594,897,86,398508,Africa
Singapore,16-06-2020,426238,2273,269,425969,Western Pacific
Slovakia,16-06-2020,252748,490,103,252645,Europe
Slovenia,16-06-2020,283091,181,535,282556,Europe
Somalia,16-06-2020,176228,877,25,176203,Eastern Mediterranean
South Africa,16-06-2020,132960,149,469,132491,Africa
Spain,16-06-2020,318655,1549,183,318472,Europe
Sri Lanka,16-06-2020,225771,1352,439,225332,South-East Asia
Sudan,16-06-2020,108429,2025,532,107897,Eastern Mediterranean
Suriname,16-06-2020,207039,2297,1147,205892,Americas
Sweden,16-06-2020,33228,501,414,32814,Europe
Switzerland,16-06-2020,57729,203,1135,56594,Europe
Taiwan*,16-06-2020,128163,947,274,127889,Western Pacific
Tanzania,16-06-2020,312325,1187,684,311641,Africa
Thailand,16-06-2020,299581,2209,747,298834,South-East Asia
Togo,16-06-2020,337004,1151,1135,335869,Africa
Trinidad and Tobago,16-06-2020,21483,1083,312,21171,Americas
Tunisia,16-06-2020,196436,2182,120,196316,Eastern Mediterranean
Turkey,16-06-2020,421217,1340,364,420853,Europe
Uganda,16-06-2020,295532,1519,115,295417,Africa
Ukraine,16-06-2020,145757,2377,325,145432,Europe
United Arab Emirates,16-06-2020,44662,168,938,43724,Eastern Mediterranean
United Kingdom,16-06-2020,449905,2244,1197,448708,Europe
United Kingdom,16-06-2020,116101,638,639,115462,Europe
United Kingdom,16-06-2020,440710,2344,83,440627,Europe
United Kingdom,16-06-2020,434703,2313,399,434304,Europe
United Kingdom,16-06-2020,203311,2107,471,202840,Europe
United Kingdom,16-06-2020,192977,1769,1231,191746,Europe
United Kingdom,16-06-2020,258247,29,69,258178,Europe
Uruguay,16-06-2020,210052,1580,665,209387,Americas
US,16-06-2020,264876,1611,1144,263732,Americas
Uzbekistan,16-06-2020,433654,1430,3,433651,Europe
Venezuela,16-06-2020,117060,1603,1138,115922,Americas
Vietnam,16-06-2020,357778,1061,1040,356738,Western Pacific
Zambia,16-06-2020,209602,2463,944,208658,Africa
Zimbabwe,16-06-2020,112033,605,1104,110929,Africa
Dominica,16-06-2020,108058,2092,459,107599,Americas
Grenada,16-06-2020,55537,2259,57,55480,Americas
Mozambique,16-06-2020,166045,1163,577,165468,Africa
Syria,16-06-2020,64412,498,312,64100,Eastern Mediterranean
Timor-Leste,16-06-2020,261081,1315,0,261081,South-East Asia
Belize,16-06-2020,329847,1797,1119,328728,Americas
Laos,16-06-2020,158805,1079,1089,157716,Western Pacific
Libya,16-06-2020,223425,1304,397,223028,Eastern Mediterranean
West Bank and Gaza,16-06-2020,210059,1899,510,209549,Eastern Mediterranean
Guinea-Bissau,16-06-2020,77701,46,828,76873,Africa
Mali,16-06-2020,9487,1989,470,9017,Africa
Saint Kitts and Nevis,16-06-2020,18069,760,542,17527,Americas
Canada,16-06-2020,370468,857,774,369694,Americas
Canada,16-06-2020,390345,460,509,389836,Americas
Kosovo,16-06-2020,149375,2099,822,148553,Europe
Burma,16-06-2020,96209,2102,242,95967,South-East Asia
United Kingdom,16-06-2020,86989,2150,269,86720,Europe
United Kingdom,16-06-2020,327678,278,966,326712,Europe
United Kingdom,16-06-2020,123504,1790,333,123171,Europe
Botswana,16-06-2020,201324,1807,1224,200100,Africa
Burundi,16-06-2020,199819,104,1013,198806,Africa
Sierra Leone,16-06-2020,335857,2035,759,335098,Africa
Malawi,16-06-2020,384522,688,754,383768,Africa
United Kingdom,16-06-2020,115528,1439,905,114623,Europe
France,16-06-2020,354346,2395,554,353792,Europe
South Sudan,16-06-2020,393538,2412,284,393254,Africa
Western Sahara,16-06-2020,349031,1150,616,348415,Africa
Sao Tome and Principe,16-06-2020,1962,1032,126,1836,Africa
Yemen,16-06-2020,90669,2250,130,90539,Eastern Mediterranean
Comoros,16-06-2020,444701,896,276,444425,Africa
Tajikistan,16-06-2020,412825,2280,1213,411612,Europe
Lesotho,16-06-2020,288576,324,350,288226,Africa
Afghanistan,17-06-2020,367273,1096,711,366562,Eastern Mediterranean
Albania,17-06-2020,106464,523,6,106458,Europe
Algeria,17-06-2020,348711,1976,863,347848,Africa
Andorra,17-06-2020,414177,973,101,414076,Europe
Angola,17-06-2020,377012,2457,724,376288,Africa
Antigua and Barbuda,17-06-2020,165292,1129,418,164874,Americas
Argentina,17-06-2020,414764,135,105,414659,Americas
Armenia,17-06-2020,307040,2132,988,306052,Europe
Australia,17-06-2020,7291,1376,582,6709,Western Pacific
Australia,17-06-2020,20337,2053,23,20314,Western Pacific
Australia,17-06-2020,147856,2154,279,147577,Western Pacific
Australia,17-06-2020,384575,2495,873,383702,Western Pacific
Australia,17-06-2020,236920,1403,147,236773,Western Pacific
Australia,17-06-2020,438563,422,504,438059,Western Pacific
Australia,17-06-2020,239440,770,374,239066,Western Pacific
Australia,17-06-2020,139272,421,336,138936,Western Pacific
Austria,17-06-2020,39906,470,932,38974,Europe
Azerbaijan,17-06-2020,26867,1276,55,26812,Europe
Bahamas,17-06-2020,124259,1253,1032,123227,Americas
Bahrain,17-06-2020,60398,1165,583,59815,Eastern Mediterranean
Bangladesh,17-06-2020,289211,2393,409,288802,South-East Asia
Barbados,17-06-2020,348299,1204,925,347374,Americas
Belarus,17-06-2020,170447,1627,625,169822,Europe
Belgium,17-06-2020,369720,1918,885,368835,Europe
Benin,17-06-2020,135693,1726,139,135554,Africa
Bhutan,17-06-2020,174042,2193,1122,172920,South-East Asia
Bolivia,17-06-2020,63895,1299,310,63585,Americas
Bosnia and Herzegovina,17-06-2020,100729,854,1020,99709,Europe
Brazil,17-06-2020,136194,679,428,135766,Americas
Brunei,17-06-2020,318716,14,963,317753,Western Pacific
Bulgaria,17-06-2020,160204,2483,784,159420,Europe
Burkina Faso,17-06-2020,86412,2483,241,86171,Africa
Cabo Verde,17-06-2020,187762,1448,953,186809,Africa
Cambodia,17-06-2020,92078,1319,23,92055,Western Pacific
Cameroon,17-06-2020,379026,957,43,378983,Africa
Canada,17-06-2020,107518,2486,222,107296,Americas
Canada,17-06-2020,340119,1286,1171,338948,Americas
Canada,17-06-2020,122650,2262,222,122428,Americas
Canada,17-06-2020,329504,70,356,329148,Americas
Canada,17-06-2020,381717,1906,995,380722,Americas
Canada,17-06-2020,352413,2251,516,351897,Americas
Canada,17-06-2020,411867,1781,74,411793,Americas
Canada,17-06-2020,111691,2463,35,111656,Americas
Canada,17-06-2020,12854,394,243,12611,Americas
Canada,17-06-2020,441854,221,1070,440784,Americas
Central African Republic,17-06-2020,37764,2088,1128,36636,Africa
Chad,17-06-2020,82496,858,744,81752,Africa
Chile,17-06-2020,204953,264,651,204302,Americas
China,17-06-2020,205466,52,841,204625,Western Pacific
China,17-06-2020,105599,2353,537,105062,Western Pacific
China,17-06-2020,70433,1516,558,69875,Western Pacific
China,17-06-2020,199985,1262,791,199194,Western Pacific
China,17-06-2020,448597,2037,186,448411,Western Pacific
China,17-06-2020,357853,958,813,357040,Western Pacific
China,17-06-2020,310106,165,333,309773,Western Pacific
China,17-06-2020,157795,1930,839,156956,Western Pacific
China,17-06-2020,327602,242,681,326921,Western Pacific
China,17-06-2020,6098,1479,209,5889,Western Pacific
China,17-06-2020,65814,1099,810,65004,Western Pacific
China,17-06-2020,138781,2374,55,138726,Western Pacific
China,17-06-2020,165645,657,271,165374,Western Pacific
China,17-06-2020,3265,1575,1002,2263,Western Pacific
China,17-06-2020,161530,2468,1117,160413,Western Pacific
China,17-06-2020,6785,417,46,6739,Western Pacific
China,17-06-2020,228892,452,746,228146,Western Pacific
China,17-06-2020,235999,758,136,235863,Western Pacific
China,17-06-2020,215108,812,501,214607,Western Pacific
China,17-06-2020,252952,2004,757,252195,Western Pacific
China,17-06-2020,31137,472,1195,29942,Western Pacific
China,17-06-2020,434340,306,850,433490,Western Pacific
China,17-06-2020,254196,994,1239,252957,Western Pacific
China,17-06-2020,305839,620,435,305404,Western Pacific
China,17-06-2020,96592,1207,317,96275,Western Pacific
China,17-06-2020,428056,1186,1025,427031,Western Pacific
China,17-06-2020,245688,177,789,244899,Western Pacific
China,17-06-2020,38671,772,706,37965,Western Pacific
China,17-06-2020,145971,433,574,145397,Western Pacific
China,17-06-2020,147823,984,329,147494,Western Pacific
China,17-06-2020,395801,763,1075,394726,Western Pacific
China,17-06-2020,362110,1712,1121,360989,Western Pacific
China,17-06-2020,248145,354,618,247527,Western Pacific
Colombia,17-06-2020,245272,860,407,244865,Americas
Congo (Brazzaville),17-06-2020,62668,859,946,61722,Africa
Congo (Kinshasa),17-06-2020,123457,1364,206,123251,Africa
Costa Rica,17-06-2020,410873,1578,952,409921,Americas
Cote d'Ivoire,17-06-2020,130374,747,1243,129131,Africa
Croatia,17-06-2020,239543,1108,1063,238480,Europe
Cuba,17-06-2020,11531,856,254,11277,Americas
Cyprus,17-06-2020,19920,1421,80,19840,Europe
Czechia,17-06-2020,409693,2272,619,409074,Europe
Denmark,17-06-2020,309496,2237,616,308880,Europe
Greenland,17-06-2020,190481,140,850,189631,Europe
Denmark,17-06-2020,52921,1099,152,52769,Europe
Djibouti,17-06-2020,436948,2189,601,436347,Eastern Mediterranean
Dominican Republic,17-06-2020,50876,120,700,50176,Americas
Ecuador,17-06-2020,159242,362,686,158556,Americas
Egypt,17-06-2020,163259,85,383,162876,Eastern Mediterranean
El Salvador,17-06-2020,328670,442,1011,327659,Americas
Equatorial Guinea,17-06-2020,410601,307,622,409979,Africa
Eritrea,17-06-2020,112649,834,1244,111405,Africa
Estonia,17-06-2020,211362,2250,744,210618,Europe
Eswatini,17-06-2020,215629,1785,178,215451,Africa
Ethiopia,17-06-2020,398065,764,464,397601,Africa
Fiji,17-06-2020,152218,1967,778,151440,Western Pacific
Finland,17-06-2020,17575,2072,314,17261,Europe
France,17-06-2020,75727,1940,985,74742,Europe
France,17-06-2020,224841,1675,103,224738,Europe
France,17-06-2020,69848,1195,841,69007,Europe
France,17-06-2020,422499,2325,703,421796,Europe
France,17-06-2020,9281,2348,234,9047,Europe
France,17-06-2020,32251,1575,1043,31208,Europe
France,17-06-2020,211457,1338,131,211326,Europe
France,17-06-2020,336546,1464,35,336511,Europe
France,17-06-2020,204927,177,612,204315,Europe
France,17-06-2020,250148,889,934,249214,Europe
Gabon,17-06-2020,165669,2410,1172,164497,Africa
Gambia,17-06-2020,253378,1095,1208,252170,Africa
Georgia,17-06-2020,241862,979,683,241179,Europe
Germany,17-06-2020,425067,1414,650,424417,Europe
Ghana,17-06-2020,315281,1219,858,314423,Africa
Greece,17-06-2020,232243,28,485,231758,Europe
Guatemala,17-06-2020,252742,1678,1029,251713,Americas
Guinea,17-06-2020,274071,956,1194,272877,Africa
Guyana,17-06-2020,5718,320,129,5589,Americas
Haiti,17-06-2020,73618,939,78,73540,Americas
Holy See,17-06-2020,223264,884,860,222404,Europe
Honduras,17-06-2020,340026,1776,84,339942,Americas
Hungary,17-06-2020,399623,2325,1095,398528,Europe
Iceland,17-06-2020,348083,2255,59,348024,Europe
India,17-06-2020,76887,66,571,76316,South-East Asia
Indonesia,17-06-2020,97158,2323,294,96864,South-East Asia
Iran,17-06-2020,137815,99,919,136896,Eastern Mediterranean
Iraq,17-06-2020,99095,1693,666,98429,Eastern Mediterranean
Ireland,17-06-2020,89223,1914,186,89037,Europe
Israel,17-06-2020,217488,2315,1126,216362,Europe
Italy,17-06-2020,390271,1175,1233,389038,Europe
Jamaica,17-06-2020,228932,2320,324,228608,Americas
Japan,17-06-2020,373740,1897,410,373330,Western Pacific
Jordan,17-06-2020,36493,265,277,36216,Eastern Mediterranean
Kazakhstan,17-06-2020,354269,237,427,353842,Europe
Kenya,17-06-2020,114185,1919,192,113993,Africa
South Korea,17-06-2020,355840,1333,327,355513,Western Pacific
Kuwait,17-06-2020,408727,537,592,408135,Eastern Mediterranean
Kyrgyzstan,17-06-2020,49473,2095,620,48853,Europe
Latvia,17-06-2020,204428,834,315,204113,Europe
Lebanon,17-06-2020,446092,138,1118,444974,Eastern Mediterranean
Liberia,17-06-2020,261964,869,510,261454,Africa
Liechtenstein,17-06-2020,84314,1076,1005,83309,Europe
Lithuania,17-06-2020,226249,1589,349,225900,Europe
Luxembourg,17-06-2020,71577,74,870,70707,Europe
Madagascar,17-06-2020,274626,2124,361,274265,Africa
Malaysia,17-06-2020,351748,2362,1029,350719,Western Pacific
Maldives,17-06-2020,264959,1357,784,264175,South-East Asia
Malta,17-06-2020,108315,1910,1067,107248,Europe
Mauritania,17-06-2020,174343,911,21,174322,Africa
Mauritius,17-06-2020,131280,1418,513,130767,Africa
Mexico,17-06-2020,163250,507,510,162740,Americas
Moldova,17-06-2020,103471,2082,739,102732,Europe
Monaco,17-06-2020,375277,2279,1054,374223,Europe
Mongolia,17-06-2020,402387,1095,636,401751,Western Pacific
Montenegro,17-06-2020,189268,1137,878,188390,Europe
Morocco,17-06-2020,381017,706,315,380702,Eastern Mediterranean
Namibia,17-06-2020,263130,1715,1014,262116,Africa
Nepal,17-06-2020,99985,335,1222,98763,South-East Asia
Netherlands,17-06-2020,228303,1074,355,227948,Europe
Netherlands,17-06-2020,214287,2190,124,214163,Europe
Netherlands,17-06-2020,62642,1858,165,62477,Europe
Netherlands,17-06-2020,81987,243,148,81839,Europe
New Zealand,17-06-2020,45410,320,468,44942,Western Pacific
Nicaragua,17-06-2020,438067,1039,1106,436961,Americas
Niger,17-06-2020,59725,143,641,59084,Africa
Nigeria,17-06-2020,293704,2099,1182,292522,Africa
North Macedonia,17-06-2020,360342,246,179,360163,Europe
Norway,17-06-2020,437502,1700,670,436832,Europe
Oman,17-06-2020,190961,1947,653,190308,Eastern Mediterranean
Pakistan,17-06-2020,197471,1085,553,196918,Eastern Mediterranean
Panama,17-06-2020,67071,1169,205,66866,Americas
Papua New Guinea,17-06-2020,128540,507,295,128245,Western Pacific
Paraguay,17-06-2020,188692,2177,1181,187511,Americas
Peru,17-06-2020,418554,272,329,418225,Americas
Philippines,17-06-2020,423122,2152,1070,422052,Western Pacific
Poland,17-06-2020,414225,799,803,413422,Europe
Portugal,17-06-2020,330623,2110,349,330274,Europe
Qatar,17-06-2020,233999,1360,1089,232910,Eastern Mediterranean
Romania,17-06-2020,145017,2158,858,144159,Europe
Russia,17-06-2020,190052,2485,318,189734,Europe
Rwanda,17-06-2020,434278,290,1050,433228,Africa
Saint Lucia,17-06-2020,287413,527,828,286585,Americas
Saint Vincent and the Grenadines,17-06-2020,106037,2196,1145,104892,Americas
San Marino,17-06-2020,427858,922,453,427405,Europe
Saudi Arabia,17-06-2020,237267,1523,949,236318,Eastern Mediterranean
Senegal,17-06-2020,8058,1407,273,7785,Africa
Serbia,17-06-2020,415495,2346,753,414742,Europe
Seychelles,17-06-2020,402093,2122,1095,400998,Africa
Singapore,17-06-2020,320964,1649,218,320746,Western Pacific
Slovakia,17-06-2020,78452,8,766,77686,Europe
Slovenia,17-06-2020,230992,1026,163,230829,Europe
Somalia,17-06-2020,409396,2047,959,408437,Eastern Mediterranean
South Africa,17-06-2020,275597,2407,489,275108,Africa
Spain,17-06-2020,62516,2288,1013,61503,Europe
Sri Lanka,17-06-2020,27906,1573,1243,26663,South-East Asia
Sudan,17-06-2020,430647,1877,612,430035,Eastern Mediterranean
Suriname,17-06-2020,324620,1165,1226,323394,Americas
Sweden,17-06-2020,186939,2178,547,186392,Europe
Switzerland,17-06-2020,261529,1548,793,260736,Europe
Taiwan*,17-06-2020,157687,74,961,156726,Western Pacific
Tanzania,17-06-2020,334866,1557,782,334084,Africa
Thailand,17-06-2020,170677,2191,871,169806,South-East Asia
Togo,17-06-2020,277764,1818,161,277603,Africa
Trinidad and Tobago,17-06-2020,285595,99,532,285063,Americas
Tunisia,17-06-2020,204901,2053,945,203956,Eastern Mediterranean
Turkey,17-06-2020,372085,404,1038,371047,Europe
Uganda,17-06-2020,283517,1230,22,283495,Africa
Ukraine,17-06-2020,204445,459,932,203513,Europe
United Arab Emirates,17-06-2020,319111,844,1197,317914,Eastern Mediterranean
United Kingdom,17-06-2020,355061,1862,1216,353845,Europe
United Kingdom,17-06-2020,447559,754,308,447251,Europe
United Kingdom,17-06-2020,222364,1509,627,221737,Europe
United Kingdom,17-06-2020,360788,1686,0,360788,Europe
United Kingdom,17-06-2020,357704,2434,370,357334,Europe
United Kingdom,17-06-2020,243472,1852,334,243138,Europe
United Kingdom,17-06-2020,136287,40,1213,135074,Europe
Uruguay,17-06-2020,7049,1314,1000,6049,Americas
US,17-06-2020,371741,151,1247,370494,Americas
Uzbekistan,17-06-2020,50692,1553,357,50335,Europe
Venezuela,17-06-2020,97753,2145,239,97514,Americas
Vietnam,17-06-2020,150521,2178,294,150227,Western Pacific
Zambia,17-06-2020,130512,834,717,129795,Africa
Zimbabwe,17-06-2020,415453,2495,1088,414365,Africa
Dominica,17-06-2020,294138,2367,116,294022,Americas
Grenada,17-06-2020,394280,194,1236,393044,Americas
Mozambique,17-06-2020,19679,803,158,19521,Africa
Syria,17-06-2020,199931,642,852,199079,Eastern Mediterranean
Timor-Leste,17-06-2020,372330,1243,697,371633,South-East Asia
Belize,17-06-2020,16335,614,277,16058,Americas
Laos,17-06-2020,232199,913,187,232012,Western Pacific
Libya,17-06-2020,377685,1512,45,377640,Eastern Mediterranean
West Bank and Gaza,17-06-2020,66172,1845,1039,65133,Eastern Mediterranean
Guinea-Bissau,17-06-2020,313255,1156,432,312823,Africa
Mali,17-06-2020,194666,1574,103,194563,Africa
Saint Kitts and Nevis,17-06-2020,427581,846,405,427176,Americas
Canada,17-06-2020,129194,2297,656,128538,Americas
Canada,17-06-2020,227857,1720,334,227523,Americas
Kosovo,17-06-2020,363118,1510,291,362827,Europe
Burma,17-06-2020,222620,2206,497,222123,South-East Asia
United Kingdom,17-06-2020,250768,2219,1189,249579,Europe
United Kingdom,17-06-2020,299379,1066,173,299206,Europe
United Kingdom,17-06-2020,198576,458,232,198344,Europe
Botswana,17-06-2020,427192,1003,1202,425990,Africa
Burundi,17-06-2020,402320,1768,727,401593,Africa
Sierra Leone,17-06-2020,123341,64,322,123019,Africa
Malawi,17-06-2020,115939,2262,98,115841,Africa
United Kingdom,17-06-2020,394484,2116,748,393736,Europe
France,17-06-2020,175020,2247,53,174967,Europe
South Sudan,17-06-2020,405837,1624,430,405407,Africa
Western Sahara,17-06-2020,316546,2291,484,316062,Africa
Sao Tome and Principe,17-06-2020,273428,1433,1065,272363,Africa
Yemen,17-06-2020,332098,498,902,331196,Eastern Mediterranean
Comoros,17-06-2020,105993,786,430,105563,Africa
Tajikistan,17-06-2020,22816,366,361,22455,Europe
Lesotho,17-06-2020,188330,1598,1221,187109,Africa
Afghanistan,18-06-2020,92702,1603,382,92320,Eastern Mediterranean
Albania,18-06-2020,152650,1628,1246,151404,Europe
Algeria,18-06-2020,238012,2133,82,237930,Africa
Andorra,18-06-2020,193351,2474,253,193098,Europe
Angola,18-06-2020,147727,253,366,147361,Africa
Antigua and Barbuda,18-06-2020,440331,767,370,439961,Americas
Argentina,18-06-2020,272403,1245,614,271789,Americas
Armenia,18-06-2020,5584,638,462,5122,Europe
Australia,18-06-2020,193823,2200,546,193277,Western Pacific
Australia,18-06-2020,375588,564,1086,374502,Western Pacific
Australia,18-06-2020,425307,1057,314,424993,Western Pacific
Australia,18-06-2020,424592,1008,1066,423526,Western Pacific
Australia,18-06-2020,56186,543,1228,54958,Western Pacific
Australia,18-06-2020,439190,2021,633,438557,Western Pacific
Australia,18-06-2020,12485,2202,173,12312,Western Pacific
Australia,18-06-2020,416428,767,421,416007,Western Pacific
Austria,18-06-2020,393025,1892,774,392251,Europe
Azerbaijan,18-06-2020,114860,1624,1163,113697,Europe
Bahamas,18-06-2020,339290,250,1211,338079,Americas
Bahrain,18-06-2020,53468,1684,237,53231,Eastern Mediterranean
Bangladesh,18-06-2020,107048,1058,75,106973,South-East Asia
Barbados,18-06-2020,62352,2283,580,61772,Americas
Belarus,18-06-2020,123528,1688,67,123461,Europe
Belgium,18-06-2020,385288,1936,613,384675,Europe
Benin,18-06-2020,356373,1065,484,355889,Africa
Bhutan,18-06-2020,63442,1108,18,63424,South-East Asia
Bolivia,18-06-2020,365906,1083,522,365384,Americas
Bosnia and Herzegovina,18-06-2020,412883,2176,1026,411857,Europe
Brazil,18-06-2020,139003,297,851,138152,Americas
Brunei,18-06-2020,364995,1553,238,364757,Western Pacific
Bulgaria,18-06-2020,180202,1380,349,179853,Europe
Burkina Faso,18-06-2020,198370,2384,118,198252,Africa
Cabo Verde,18-06-2020,147698,351,780,146918,Africa
Cambodia,18-06-2020,332841,392,177,332664,Western Pacific
Cameroon,18-06-2020,146995,1981,295,146700,Africa
Canada,18-06-2020,76306,676,263,76043,Americas
Canada,18-06-2020,269376,2159,390,268986,Americas
Canada,18-06-2020,300604,600,294,300310,Americas
Canada,18-06-2020,168900,339,711,168189,Americas
Canada,18-06-2020,214872,1506,247,214625,Americas
Canada,18-06-2020,234821,2252,1052,233769,Americas
Canada,18-06-2020,394503,918,28,394475,Americas
Canada,18-06-2020,197236,161,1027,196209,Americas
Canada,18-06-2020,36663,2327,908,35755,Americas
Canada,18-06-2020,419799,724,845,418954,Americas
Central African Republic,18-06-2020,212907,326,711,212196,Africa
Chad,18-06-2020,271890,29,890,271000,Africa
Chile,18-06-2020,314496,868,49,314447,Americas
China,18-06-2020,352640,847,993,351647,Western Pacific
China,18-06-2020,80165,1709,205,79960,Western Pacific
China,18-06-2020,393326,596,827,392499,Western Pacific
China,18-06-2020,189926,2290,662,189264,Western Pacific
China,18-06-2020,421379,783,709,420670,Western Pacific
China,18-06-2020,416950,1511,273,416677,Western Pacific
China,18-06-2020,145113,790,885,144228,Western Pacific
China,18-06-2020,380908,2329,792,380116,Western Pacific
China,18-06-2020,134617,2053,970,133647,Western Pacific
China,18-06-2020,68354,934,688,67666,Western Pacific
China,18-06-2020,92928,1465,664,92264,Western Pacific
China,18-06-2020,314754,2252,1161,313593,Western Pacific
China,18-06-2020,246026,506,1041,244985,Western Pacific
China,18-06-2020,148416,2351,1109,147307,Western Pacific
China,18-06-2020,181505,1036,1206,180299,Western Pacific
China,18-06-2020,315828,2426,560,315268,Western Pacific
China,18-06-2020,111038,1931,380,110658,Western Pacific
China,18-06-2020,305025,2431,45,304980,Western Pacific
China,18-06-2020,82169,654,1105,81064,Western Pacific
China,18-06-2020,21446,1767,1024,20422,Western Pacific
China,18-06-2020,237510,71,1156,236354,Western Pacific
China,18-06-2020,140338,1652,442,139896,Western Pacific
China,18-06-2020,141077,1191,822,140255,Western Pacific
China,18-06-2020,123410,1930,178,123232,Western Pacific
China,18-06-2020,272015,401,644,271371,Western Pacific
China,18-06-2020,362852,2041,708,362144,Western Pacific
China,18-06-2020,140525,190,896,139629,Western Pacific
China,18-06-2020,312159,1099,586,311573,Western Pacific
China,18-06-2020,128923,975,775,128148,Western Pacific
China,18-06-2020,321406,131,976,320430,Western Pacific
China,18-06-2020,408362,1148,643,407719,Western Pacific
China,18-06-2020,313407,1555,62,313345,Western Pacific
China,18-06-2020,255899,599,1000,254899,Western Pacific
Colombia,18-06-2020,359234,1467,607,358627,Americas
Congo (Brazzaville),18-06-2020,24774,1110,113,24661,Africa
Congo (Kinshasa),18-06-2020,64291,2049,829,63462,Africa
Costa Rica,18-06-2020,87196,1101,850,86346,Americas
Cote d'Ivoire,18-06-2020,352731,2238,327,352404,Africa
Croatia,18-06-2020,447383,1986,903,446480,Europe
Cuba,18-06-2020,82441,1037,971,81470,Americas
Cyprus,18-06-2020,404326,1484,214,404112,Europe
Czechia,18-06-2020,142207,51,405,141802,Europe
Denmark,18-06-2020,412070,1776,708,411362,Europe
Greenland,18-06-2020,205119,872,1057,204062,Europe
Denmark,18-06-2020,22827,937,1132,21695,Europe
Djibouti,18-06-2020,208659,557,56,208603,Eastern Mediterranean
Dominican Republic,18-06-2020,59884,1658,189,59695,Americas
Ecuador,18-06-2020,73453,1661,30,73423,Americas
Egypt,18-06-2020,164522,1828,774,163748,Eastern Mediterranean
El Salvador,18-06-2020,136630,613,160,136470,Americas
Equatorial Guinea,18-06-2020,329258,668,729,328529,Africa
Eritrea,18-06-2020,290060,2013,12,290048,Africa
Estonia,18-06-2020,369372,1137,139,369233,Europe
Eswatini,18-06-2020,58574,2069,141,58433,Africa
Ethiopia,18-06-2020,282622,1481,966,281656,Africa
Fiji,18-06-2020,363165,35,343,362822,Western Pacific
Finland,18-06-2020,343545,577,1231,342314,Europe
France,18-06-2020,231161,1565,1025,230136,Europe
France,18-06-2020,53870,789,901,52969,Europe
France,18-06-2020,382724,2102,71,382653,Europe
France,18-06-2020,124839,1083,1159,123680,Europe
France,18-06-2020,217166,389,1180,215986,Europe
France,18-06-2020,407139,976,244,406895,Europe
France,18-06-2020,97672,393,63,97609,Europe
France,18-06-2020,201373,409,1138,200235,Europe
France,18-06-2020,365174,2153,220,364954,Europe
France,18-06-2020,119258,1293,1128,118130,Europe
Gabon,18-06-2020,266924,2014,575,266349,Africa
Gambia,18-06-2020,92150,1154,1181,90969,Africa
Georgia,18-06-2020,106131,199,998,105133,Europe
Germany,18-06-2020,138570,1180,67,138503,Europe
Ghana,18-06-2020,77761,2212,50,77711,Africa
Greece,18-06-2020,441825,1410,479,441346,Europe
Guatemala,18-06-2020,41883,615,915,40968,Americas
Guinea,18-06-2020,249492,939,306,249186,Africa
Guyana,18-06-2020,100249,750,378,99871,Americas
Haiti,18-06-2020,101550,2040,616,100934,Americas
Holy See,18-06-2020,77497,1296,450,77047,Europe
Honduras,18-06-2020,243107,686,222,242885,Americas
Hungary,18-06-2020,379579,1971,905,378674,Europe
Iceland,18-06-2020,307108,670,466,306642,Europe
India,18-06-2020,440228,614,87,440141,South-East Asia
Indonesia,18-06-2020,432199,1018,135,432064,South-East Asia
Iran,18-06-2020,45161,2212,454,44707,Eastern Mediterranean
Iraq,18-06-2020,49557,2082,350,49207,Eastern Mediterranean
Ireland,18-06-2020,385121,962,307,384814,Europe
Israel,18-06-2020,78356,1167,928,77428,Europe
Italy,18-06-2020,242077,1894,258,241819,Europe
Jamaica,18-06-2020,419243,792,677,418566,Americas
Japan,18-06-2020,423620,171,46,423574,Western Pacific
Jordan,18-06-2020,211187,1558,421,210766,Eastern Mediterranean
Kazakhstan,18-06-2020,44580,723,592,43988,Europe
Kenya,18-06-2020,332252,1549,673,331579,Africa
South Korea,18-06-2020,9362,426,793,8569,Western Pacific
Kuwait,18-06-2020,269941,604,1208,268733,Eastern Mediterranean
Kyrgyzstan,18-06-2020,259806,192,610,259196,Europe
Latvia,18-06-2020,387023,1387,186,386837,Europe
Lebanon,18-06-2020,328653,1319,912,327741,Eastern Mediterranean
Liberia,18-06-2020,434404,2187,838,433566,Africa
Liechtenstein,18-06-2020,439494,1058,840,438654,Europe
Lithuania,18-06-2020,26208,2226,1049,25159,Europe
Luxembourg,18-06-2020,40994,2030,376,40618,Europe
Madagascar,18-06-2020,429444,1734,1086,428358,Africa
Malaysia,18-06-2020,65325,1990,824,64501,Western Pacific
Maldives,18-06-2020,14139,1181,1140,12999,South-East Asia
Malta,18-06-2020,394589,1563,488,394101,Europe
Mauritania,18-06-2020,423602,2241,252,423350,Africa
Mauritius,18-06-2020,380563,1767,1238,379325,Africa
Mexico,18-06-2020,414197,2111,454,413743,Americas
Moldova,18-06-2020,323419,1854,345,323074,Europe
Monaco,18-06-2020,180842,2439,538,180304,Europe
Mongolia,18-06-2020,86528,930,182,86346,Western Pacific
Montenegro,18-06-2020,69642,1546,863,68779,Europe
Morocco,18-06-2020,138114,803,423,137691,Eastern Mediterranean
Namibia,18-06-2020,223765,1733,262,223503,Africa
Nepal,18-06-2020,387379,2124,6,387373,South-East Asia
Netherlands,18-06-2020,282018,2064,374,281644,Europe
Netherlands,18-06-2020,38294,906,353,37941,Europe
Netherlands,18-06-2020,294416,1839,758,293658,Europe
Netherlands,18-06-2020,441932,1356,477,441455,Europe
New Zealand,18-06-2020,270315,1915,177,270138,Western Pacific
Nicaragua,18-06-2020,333033,1979,830,332203,Americas
Niger,18-06-2020,123834,1660,1237,122597,Africa
Nigeria,18-06-2020,121522,591,583,120939,Africa
North Macedonia,18-06-2020,407429,2284,944,406485,Europe
Norway,18-06-2020,265743,1826,195,265548,Europe
Oman,18-06-2020,165625,1096,718,164907,Eastern Mediterranean
Pakistan,18-06-2020,112902,1200,228,112674,Eastern Mediterranean
Panama,18-06-2020,197889,752,1007,196882,Americas
Papua New Guinea,18-06-2020,333331,2104,825,332506,Western Pacific
Paraguay,18-06-2020,421405,1440,1134,420271,Americas
Peru,18-06-2020,331685,1304,982,330703,Americas
Philippines,18-06-2020,261469,782,75,261394,Western Pacific
Poland,18-06-2020,221024,2492,472,220552,Europe
Portugal,18-06-2020,75677,386,566,75111,Europe
Qatar,18-06-2020,96509,1594,744,95765,Eastern Mediterranean
Romania,18-06-2020,39702,1095,52,39650,Europe
Russia,18-06-2020,165733,2293,1108,164625,Europe
Rwanda,18-06-2020,35600,1431,220,35380,Africa
Saint Lucia,18-06-2020,232366,1589,377,231989,Americas
Saint Vincent and the Grenadines,18-06-2020,303930,936,843,303087,Americas
San Marino,18-06-2020,218089,826,996,217093,Europe
Saudi Arabia,18-06-2020,448657,1369,871,447786,Eastern Mediterranean
Senegal,18-06-2020,395584,1066,129,395455,Africa
Serbia,18-06-2020,369440,231,873,368567,Europe
Seychelles,18-06-2020,247535,2489,88,247447,Africa
Singapore,18-06-2020,116854,1363,287,116567,Western Pacific
Slovakia,18-06-2020,412535,255,799,411736,Europe
Slovenia,18-06-2020,263515,184,971,262544,Europe
Somalia,18-06-2020,97616,1945,231,97385,Eastern Mediterranean
South Africa,18-06-2020,359422,1911,807,358615,Africa
Spain,18-06-2020,269947,602,57,269890,Europe
Sri Lanka,18-06-2020,336990,2331,598,336392,South-East Asia
Sudan,18-06-2020,228990,815,1032,227958,Eastern Mediterranean
Suriname,18-06-2020,244004,377,1117,242887,Americas
Sweden,18-06-2020,372573,119,137,372436,Europe
Switzerland,18-06-2020,296282,85,1207,295075,Europe
Taiwan*,18-06-2020,22211,310,1216,20995,Western Pacific
Tanzania,18-06-2020,276539,1497,163,276376,Africa
Thailand,18-06-2020,338529,1895,11,338518,South-East Asia
Togo,18-06-2020,208838,544,685,208153,Africa
Trinidad and Tobago,18-06-2020,212370,1696,830,211540,Americas
Tunisia,18-06-2020,391627,1501,1190,390437,Eastern Mediterranean
Turkey,18-06-2020,418835,1840,936,417899,Europe
Uganda,18-06-2020,307881,2090,223,307658,Africa
Ukraine,18-06-2020,60329,59,1064,59265,Europe
United Arab Emirates,18-06-2020,104924,1596,641,104283,Eastern Mediterranean
United Kingdom,18-06-2020,90612,2429,342,90270,Europe
United Kingdom,18-06-2020,421837,585,401,421436,Europe
United Kingdom,18-06-2020,331425,1133,594,330831,Europe
United Kingdom,18-06-2020,448025,1888,492,447533,Europe
United Kingdom,18-06-2020,16233,2001,367,15866,Europe
United Kingdom,18-06-2020,91425,150,307,91118,Europe
United Kingdom,18-06-2020,355261,339,901,354360,Europe
Uruguay,18-06-2020,262290,539,61,262229,Americas
US,18-06-2020,379942,154,722,379220,Americas
Uzbekistan,18-06-2020,198285,2075,279,198006,Europe
Venezuela,18-06-2020,425941,959,816,425125,Americas
Vietnam,18-06-2020,228198,1345,969,227229,Western Pacific
Zambia,18-06-2020,240946,2327,360,240586,Africa
Zimbabwe,18-06-2020,335439,1222,44,335395,Africa
Dominica,18-06-2020,429786,1204,959,428827,Americas
Grenada,18-06-2020,216356,1497,305,216051,Americas
Mozambique,18-06-2020,72739,1767,215,72524,Africa
Syria,18-06-2020,172880,308,1002,171878,Eastern Mediterranean
Timor-Leste,18-06-2020,332739,471,872,331867,South-East Asia
Belize,18-06-2020,50513,897,454,50059,Americas
Laos,18-06-2020,337004,606,967,336037,Western Pacific
Libya,18-06-2020,332060,1578,941,331119,Eastern Mediterranean
West Bank and Gaza,18-06-2020,447368,1976,263,447105,Eastern Mediterranean
Guinea-Bissau,18-06-2020,58042,1753,46,57996,Africa
Mali,18-06-2020,66214,598,205,66009,Africa
Saint Kitts and Nevis,18-06-2020,244714,614,1030,243684,Americas
Canada,18-06-2020,446817,228,881,445936,Americas
Canada,18-06-2020,284201,1606,496,283705,Americas
Kosovo,18-06-2020,436079,724,408,435671,Europe
Burma,18-06-2020,373346,1710,576,372770,South-East Asia
United Kingdom,18-06-2020,107259,634,1060,106199,Europe
United Kingdom,18-06-2020,94381,1338,576,93805,Europe
United Kingdom,18-06-2020,270115,846,494,269621,Europe
Botswana,18-06-2020,133967,1734,806,133161,Africa
Burundi,18-06-2020,293041,1581,960,292081,Africa
Sierra Leone,18-06-2020,376521,655,1041,375480,Africa
Malawi,18-06-2020,148053,797,182,147871,Africa
United Kingdom,18-06-2020,117265,2073,617,116648,Europe
France,18-06-2020,294666,1639,276,294390,Europe
South Sudan,18-06-2020,139623,225,222,139401,Africa
Western Sahara,18-06-2020,187238,2079,1206,186032,Africa
Sao Tome and Principe,18-06-2020,447443,1290,326,447117,Africa
Yemen,18-06-2020,390663,2275,845,389818,Eastern Mediterranean
Comoros,18-06-2020,371982,449,481,371501,Africa
Tajikistan,18-06-2020,326163,2217,620,325543,Europe
Lesotho,18-06-2020,341483,1987,110,341373,Africa
Afghanistan,19-06-2020,37872,46,475,37397,Eastern Mediterranean
Albania,19-06-2020,34241,824,498,33743,Europe
Algeria,19-06-2020,117565,1550,940,116625,Africa
Andorra,19-06-2020,365513,1678,41,365472,Europe
Angola,19-06-2020,321070,830,17,321053,Africa
Antigua and Barbuda,19-06-2020,218576,1487,64,218512,Americas
Argentina,19-06-2020,131524,451,661,130863,Americas
Armenia,19-06-2020,178597,2402,729,177868,Europe
Australia,19-06-2020,93383,2216,474,92909,Western Pacific
Australia,19-06-2020,154240,515,835,153405,Western Pacific
Australia,19-06-2020,149748,1667,788,148960,Western Pacific
Australia,19-06-2020,422445,1229,661,421784,Western Pacific
Australia,19-06-2020,428806,1117,254,428552,Western Pacific
Australia,19-06-2020,398251,2065,729,397522,Western Pacific
Australia,19-06-2020,242239,669,1128,241111,Western Pacific
Australia,19-06-2020,217936,2329,10,217926,Western Pacific
Austria,19-06-2020,238875,152,850,238025,Europe
Azerbaijan,19-06-2020,347440,2367,124,347316,Europe
Bahamas,19-06-2020,226554,1718,1098,225456,Americas
Bahrain,19-06-2020,367994,672,693,367301,Eastern Mediterranean
Bangladesh,19-06-2020,367729,1391,104,367625,South-East Asia
Barbados,19-06-2020,245515,933,1093,244422,Americas
Belarus,19-06-2020,167820,207,142,167678,Europe
Belgium,19-06-2020,367141,1926,271,366870,Europe
Benin,19-06-2020,432031,2118,419,431612,Africa
Bhutan,19-06-2020,7022,2098,501,6521,South-East Asia
Bolivia,19-06-2020,282637,2478,364,282273,Americas
Bosnia and Herzegovina,19-06-2020,226072,340,651,225421,Europe
Brazil,19-06-2020,234599,217,163,234436,Americas
Brunei,19-06-2020,266450,1058,317,266133,Western Pacific
Bulgaria,19-06-2020,359148,2344,38,359110,Europe
Burkina Faso,19-06-2020,120066,2491,328,119738,Africa
Cabo Verde,19-06-2020,339250,989,1155,338095,Africa
Cambodia,19-06-2020,10963,476,518,10445,Western Pacific
Cameroon,19-06-2020,432320,2180,883,431437,Africa
Canada,19-06-2020,332825,1566,300,332525,Americas
Canada,19-06-2020,389142,2318,29,389113,Americas
Canada,19-06-2020,388893,1968,927,387966,Americas
Canada,19-06-2020,78161,2178,302,77859,Americas
Canada,19-06-2020,291932,1310,1029,290903,Americas
Canada,19-06-2020,52398,2081,326,52072,Americas
Canada,19-06-2020,203292,337,846,202446,Americas
Canada,19-06-2020,353625,159,512,353113,Americas
Canada,19-06-2020,106651,1865,421,106230,Americas
Canada,19-06-2020,330086,2058,609,329477,Americas
Central African Republic,19-06-2020,174828,1136,850,173978,Africa
Chad,19-06-2020,364801,1980,943,363858,Africa
Chile,19-06-2020,375538,1733,925,374613,Americas
China,19-06-2020,9642,982,504,9138,Western Pacific
China,19-06-2020,327976,55,1161,326815,Western Pacific
China,19-06-2020,254774,1608,410,254364,Western Pacific
China,19-06-2020,337100,2413,139,336961,Western Pacific
China,19-06-2020,261179,1613,1020,260159,Western Pacific
China,19-06-2020,202604,119,646,201958,Western Pacific
China,19-06-2020,261279,1341,1104,260175,Western Pacific
China,19-06-2020,258065,1992,804,257261,Western Pacific
China,19-06-2020,6324,78,97,6227,Western Pacific
China,19-06-2020,422576,288,686,421890,Western Pacific
China,19-06-2020,17243,543,262,16981,Western Pacific
China,19-06-2020,32651,1474,455,32196,Western Pacific
China,19-06-2020,248900,1209,581,248319,Western Pacific
China,19-06-2020,352170,512,916,351254,Western Pacific
China,19-06-2020,96985,1903,865,96120,Western Pacific
China,19-06-2020,331251,395,128,331123,Western Pacific
China,19-06-2020,102524,1114,369,102155,Western Pacific
China,19-06-2020,383614,1681,388,383226,Western Pacific
China,19-06-2020,244525,609,951,243574,Western Pacific
China,19-06-2020,248642,37,604,248038,Western Pacific
China,19-06-2020,281976,1098,736,281240,Western Pacific
China,19-06-2020,415951,1243,848,415103,Western Pacific
China,19-06-2020,427272,1054,256,427016,Western Pacific
China,19-06-2020,267617,958,89,267528,Western Pacific
China,19-06-2020,186825,1281,968,185857,Western Pacific
China,19-06-2020,352628,466,495,352133,Western Pacific
China,19-06-2020,191640,1440,405,191235,Western Pacific
China,19-06-2020,340452,2347,154,340298,Western Pacific
China,19-06-2020,38429,1984,66,38363,Western Pacific
China,19-06-2020,101085,386,99,100986,Western Pacific
China,19-06-2020,412647,902,926,411721,Western Pacific
China,19-06-2020,321595,1221,1037,320558,Western Pacific
China,19-06-2020,441077,1345,180,440897,Western Pacific
Colombia,19-06-2020,395295,1310,1038,394257,Americas
Congo (Brazzaville),19-06-2020,278261,1328,532,277729,Africa
Congo (Kinshasa),19-06-2020,26905,1644,546,26359,Africa
Costa Rica,19-06-2020,415636,359,1052,414584,Americas
Cote d'Ivoire,19-06-2020,158723,2344,524,158199,Africa
Croatia,19-06-2020,374360,2215,405,373955,Europe
Cuba,19-06-2020,319701,941,125,319576,Americas
Cyprus,19-06-2020,224411,771,900,223511,Europe
Czechia,19-06-2020,261984,3,587,261397,Europe
Denmark,19-06-2020,197457,280,1215,196242,Europe
Greenland,19-06-2020,35645,1261,749,34896,Europe
Denmark,19-06-2020,310957,2112,646,310311,Europe
Djibouti,19-06-2020,291190,2370,264,290926,Eastern Mediterranean
Dominican Republic,19-06-2020,79853,609,1219,78634,Americas
Ecuador,19-06-2020,114075,969,1230,112845,Americas
Egypt,19-06-2020,299032,324,280,298752,Eastern Mediterranean
El Salvador,19-06-2020,163990,2134,761,163229,Americas
Equatorial Guinea,19-06-2020,131861,1836,1065,130796,Africa
Eritrea,19-06-2020,45533,92,730,44803,Africa
Estonia,19-06-2020,275057,461,641,274416,Europe
Eswatini,19-06-2020,372076,1389,38,372038,Africa
Ethiopia,19-06-2020,40842,324,1023,39819,Africa
Fiji,19-06-2020,296869,2283,768,296101,Western Pacific
Finland,19-06-2020,381023,424,1173,379850,Europe
France,19-06-2020,300605,355,1250,299355,Europe
France,19-06-2020,194901,2168,1228,193673,Europe
France,19-06-2020,245060,1627,902,244158,Europe
France,19-06-2020,413516,1202,396,413120,Europe
France,19-06-2020,46486,2374,1120,45366,Europe
France,19-06-2020,213289,2276,1005,212284,Europe
France,19-06-2020,97433,2433,264,97169,Europe
France,19-06-2020,97508,2424,11,97497,Europe
France,19-06-2020,302517,323,551,301966,Europe
France,19-06-2020,12682,949,543,12139,Europe
Gabon,19-06-2020,27080,152,963,26117,Africa
Gambia,19-06-2020,143416,782,588,142828,Africa
Georgia,19-06-2020,257013,1028,962,256051,Europe
Germany,19-06-2020,406329,1845,1026,405303,Europe
Ghana,19-06-2020,287337,2496,1093,286244,Africa
Greece,19-06-2020,130171,1512,1068,129103,Europe
Guatemala,19-06-2020,244307,126,398,243909,Americas
Guinea,19-06-2020,45685,398,4,45681,Africa
Guyana,19-06-2020,394627,1310,599,394028,Americas
Haiti,19-06-2020,244126,1020,208,243918,Americas
Holy See,19-06-2020,381959,1424,65,381894,Europe
Honduras,19-06-2020,366127,1262,1229,364898,Americas
Hungary,19-06-2020,369219,182,947,368272,Europe
Iceland,19-06-2020,104885,2434,1008,103877,Europe
India,19-06-2020,411004,1341,1192,409812,South-East Asia
Indonesia,19-06-2020,109879,313,942,108937,South-East Asia
Iran,19-06-2020,321553,1433,448,321105,Eastern Mediterranean
Iraq,19-06-2020,93941,131,269,93672,Eastern Mediterranean
Ireland,19-06-2020,384262,1112,1043,383219,Europe
Israel,19-06-2020,243837,1246,134,243703,Europe
Italy,19-06-2020,337606,995,1000,336606,Europe
Jamaica,19-06-2020,78627,1848,708,77919,Americas
Japan,19-06-2020,359509,734,380,359129,Western Pacific
Jordan,19-06-2020,223522,208,184,223338,Eastern Mediterranean
Kazakhstan,19-06-2020,291828,693,498,291330,Europe
Kenya,19-06-2020,157347,2459,1095,156252,Africa
South Korea,19-06-2020,80823,41,243,80580,Western Pacific
Kuwait,19-06-2020,105283,890,886,104397,Eastern Mediterranean
Kyrgyzstan,19-06-2020,145483,50,863,144620,Europe
Latvia,19-06-2020,108956,2272,517,108439,Europe
Lebanon,19-06-2020,429587,1799,1040,428547,Eastern Mediterranean
Liberia,19-06-2020,379445,910,1045,378400,Africa
Liechtenstein,19-06-2020,301698,2180,894,300804,Europe
Lithuania,19-06-2020,78065,458,1096,76969,Europe
Luxembourg,19-06-2020,396025,2451,896,395129,Europe
Madagascar,19-06-2020,51962,1772,746,51216,Africa
Malaysia,19-06-2020,445809,792,71,445738,Western Pacific
Maldives,19-06-2020,245683,248,55,245628,South-East Asia
Malta,19-06-2020,170791,1229,810,169981,Europe
Mauritania,19-06-2020,3636,2214,364,3272,Africa
Mauritius,19-06-2020,135740,13,888,134852,Africa
Mexico,19-06-2020,125799,520,753,125046,Americas
Moldova,19-06-2020,207342,429,158,207184,Europe
Monaco,19-06-2020,31126,2384,230,30896,Europe
Mongolia,19-06-2020,310857,225,890,309967,Western Pacific
Montenegro,19-06-2020,195726,1195,966,194760,Europe
Morocco,19-06-2020,377654,1291,14,377640,Eastern Mediterranean
Namibia,19-06-2020,255490,2431,496,254994,Africa
Nepal,19-06-2020,217839,738,431,217408,South-East Asia
Netherlands,19-06-2020,13117,963,913,12204,Europe
Netherlands,19-06-2020,365395,738,415,364980,Europe
Netherlands,19-06-2020,219790,2012,872,218918,Europe
Netherlands,19-06-2020,299742,174,380,299362,Europe
New Zealand,19-06-2020,104447,1674,311,104136,Western Pacific
Nicaragua,19-06-2020,242559,157,1183,241376,Americas
Niger,19-06-2020,384638,830,654,383984,Africa
Nigeria,19-06-2020,22659,2210,575,22084,Africa
North Macedonia,19-06-2020,380350,891,524,379826,Europe
Norway,19-06-2020,151911,979,679,151232,Europe
Oman,19-06-2020,439633,247,717,438916,Eastern Mediterranean
Pakistan,19-06-2020,323303,2142,329,322974,Eastern Mediterranean
Panama,19-06-2020,101007,2152,972,100035,Americas
Papua New Guinea,19-06-2020,229997,2348,1120,228877,Western Pacific
Paraguay,19-06-2020,254046,271,653,253393,Americas
Peru,19-06-2020,377195,2048,969,376226,Americas
Philippines,19-06-2020,265056,386,1115,263941,Western Pacific
Poland,19-06-2020,427615,2312,924,426691,Europe
Portugal,19-06-2020,83212,2440,241,82971,Europe
Qatar,19-06-2020,410039,1485,1030,409009,Eastern Mediterranean
Romania,19-06-2020,282436,1162,788,281648,Europe
Russia,19-06-2020,307269,2441,182,307087,Europe
Rwanda,19-06-2020,31852,147,1237,30615,Africa
Saint Lucia,19-06-2020,448132,1909,1209,446923,Americas
Saint Vincent and the Grenadines,19-06-2020,32433,1258,264,32169,Americas
San Marino,19-06-2020,185758,1258,841,184917,Europe
Saudi Arabia,19-06-2020,348343,1459,686,347657,Eastern Mediterranean
Senegal,19-06-2020,282321,587,1083,281238,Africa
Serbia,19-06-2020,436925,777,944,435981,Europe
Seychelles,19-06-2020,134793,166,648,134145,Africa
Singapore,19-06-2020,228246,1779,1011,227235,Western Pacific
Slovakia,19-06-2020,374212,2254,1031,373181,Europe
Slovenia,19-06-2020,221154,1760,897,220257,Europe
Somalia,19-06-2020,98318,1244,1199,97119,Eastern Mediterranean
South Africa,19-06-2020,3529,403,692,2837,Africa
Spain,19-06-2020,19538,1132,412,19126,Europe
Sri Lanka,19-06-2020,122029,2413,85,121944,South-East Asia
Sudan,19-06-2020,391559,1587,864,390695,Eastern Mediterranean
Suriname,19-06-2020,263820,934,1145,262675,Americas
Sweden,19-06-2020,161164,937,350,160814,Europe
Switzerland,19-06-2020,2903,1951,210,2693,Europe
Taiwan*,19-06-2020,43033,1735,1216,41817,Western Pacific
Tanzania,19-06-2020,1665,917,142,1523,Africa
Thailand,19-06-2020,361974,416,616,361358,South-East Asia
Togo,19-06-2020,190472,2467,377,190095,Africa
Trinidad and Tobago,19-06-2020,240928,165,165,240763,Americas
Tunisia,19-06-2020,261023,2487,423,260600,Eastern Mediterranean
Turkey,19-06-2020,296876,485,602,296274,Europe
Uganda,19-06-2020,2366,558,771,1595,Africa
Ukraine,19-06-2020,49314,1056,769,48545,Europe
United Arab Emirates,19-06-2020,231048,2287,810,230238,Eastern Mediterranean
United Kingdom,19-06-2020,314034,1579,535,313499,Europe
United Kingdom,19-06-2020,56502,532,995,55507,Europe
United Kingdom,19-06-2020,81591,1600,562,81029,Europe
United Kingdom,19-06-2020,371933,1433,797,371136,Europe
United Kingdom,19-06-2020,18796,1955,865,17931,Europe
United Kingdom,19-06-2020,166548,1199,38,166510,Europe
United Kingdom,19-06-2020,327518,694,308,327210,Europe
Uruguay,19-06-2020,427390,171,664,426726,Americas
US,19-06-2020,352499,2254,583,351916,Americas
Uzbekistan,19-06-2020,140017,224,359,139658,Europe
Venezuela,19-06-2020,80746,136,712,80034,Americas
Vietnam,19-06-2020,390954,197,484,390470,Western Pacific
Zambia,19-06-2020,16677,1647,687,15990,Africa
Zimbabwe,19-06-2020,128909,1151,74,128835,Africa
Dominica,19-06-2020,8765,1793,796,7969,Americas
Grenada,19-06-2020,401900,1019,378,401522,Americas
Mozambique,19-06-2020,448950,1639,786,448164,Africa
Syria,19-06-2020,405362,1410,1210,404152,Eastern Mediterranean
Timor-Leste,19-06-2020,339631,1146,1203,338428,South-East Asia
Belize,19-06-2020,358101,2442,531,357570,Americas
Laos,19-06-2020,302712,2488,85,302627,Western Pacific
Libya,19-06-2020,148759,518,66,148693,Eastern Mediterranean
West Bank and Gaza,19-06-2020,79600,1444,466,79134,Eastern Mediterranean
Guinea-Bissau,19-06-2020,75054,1641,1210,73844,Africa
Mali,19-06-2020,54118,257,1186,52932,Africa
Saint Kitts and Nevis,19-06-2020,113176,1770,405,112771,Americas
Canada,19-06-2020,102651,1758,1169,101482,Americas
Canada,19-06-2020,199304,1595,481,198823,Americas
Kosovo,19-06-2020,309355,472,1136,308219,Europe
Burma,19-06-2020,111983,1090,615,111368,South-East Asia
United Kingdom,19-06-2020,115211,1506,713,114498,Europe
United Kingdom,19-06-2020,12927,311,221,12706,Europe
United Kingdom,19-06-2020,374402,249,132,374270,Europe
Botswana,19-06-2020,233453,1293,719,232734,Africa
Burundi,19-06-2020,125323,930,839,124484,Africa
Sierra Leone,19-06-2020,418691,1148,298,418393,Africa
Malawi,19-06-2020,395771,925,318,395453,Africa
United Kingdom,19-06-2020,285175,1064,539,284636,Europe
France,19-06-2020,75957,640,860,75097,Europe
South Sudan,19-06-2020,370760,685,885,369875,Africa
Western Sahara,19-06-2020,81953,2254,866,81087,Africa
Sao Tome and Principe,19-06-2020,96122,1395,430,95692,Africa
Yemen,19-06-2020,285843,201,803,285040,Eastern Mediterranean
Comoros,19-06-2020,257756,599,377,257379,Africa
Tajikistan,19-06-2020,414319,2255,867,413452,Europe
Lesotho,19-06-2020,208259,1233,1047,207212,Africa
Afghanistan,20-06-2020,246659,138,1248,245411,Eastern Mediterranean
Albania,20-06-2020,439524,2080,1105,438419,Europe
Algeria,20-06-2020,351028,1326,439,350589,Africa
Andorra,20-06-2020,83582,244,752,82830,Europe
Angola,20-06-2020,165019,1945,825,164194,Africa
Antigua and Barbuda,20-06-2020,39302,2180,1239,38063,Americas
Argentina,20-06-2020,209606,748,950,208656,Americas
Armenia,20-06-2020,222160,1749,929,221231,Europe
Australia,20-06-2020,34705,2220,420,34285,Western Pacific
Australia,20-06-2020,7547,355,923,6624,Western Pacific
Australia,20-06-2020,67439,831,1171,66268,Western Pacific
Australia,20-06-2020,71502,2499,582,70920,Western Pacific
Australia,20-06-2020,25989,757,1110,24879,Western Pacific
Australia,20-06-2020,246438,1265,722,245716,Western Pacific
Australia,20-06-2020,248238,218,1191,247047,Western Pacific
Australia,20-06-2020,175099,1586,416,174683,Western Pacific
Austria,20-06-2020,317750,1190,694,317056,Europe
Azerbaijan,20-06-2020,407411,1170,859,406552,Europe
Bahamas,20-06-2020,138491,565,601,137890,Americas
Bahrain,20-06-2020,15379,771,893,14486,Eastern Mediterranean
Bangladesh,20-06-2020,288699,355,1007,287692,South-East Asia
Barbados,20-06-2020,259227,1113,564,258663,Americas
Belarus,20-06-2020,236593,908,538,236055,Europe
Belgium,20-06-2020,39676,504,684,38992,Europe
Benin,20-06-2020,343592,1432,974,342618,Africa
Bhutan,20-06-2020,135531,2044,814,134717,South-East Asia
Bolivia,20-06-2020,287727,2103,869,286858,Americas
Bosnia and Herzegovina,20-06-2020,368346,1843,822,367524,Europe
Brazil,20-06-2020,237012,2459,546,236466,Americas
Brunei,20-06-2020,221045,978,1169,219876,Western Pacific
Bulgaria,20-06-2020,410464,1974,1097,409367,Europe
Burkina Faso,20-06-2020,192319,91,545,191774,Africa
Cabo Verde,20-06-2020,433640,1069,163,433477,Africa
Cambodia,20-06-2020,189991,840,353,189638,Western Pacific
Cameroon,20-06-2020,52994,1476,823,52171,Africa
Canada,20-06-2020,155962,665,793,155169,Americas
Canada,20-06-2020,65313,1029,621,64692,Americas
Canada,20-06-2020,22154,1783,1203,20951,Americas
Canada,20-06-2020,69592,981,724,68868,Americas
Canada,20-06-2020,251120,677,1179,249941,Americas
Canada,20-06-2020,233053,1084,1228,231825,Americas
Canada,20-06-2020,140705,1500,767,139938,Americas
Canada,20-06-2020,74677,1494,568,74109,Americas
Canada,20-06-2020,220956,354,1132,219824,Americas
Canada,20-06-2020,71502,1897,991,70511,Americas
Central African Republic,20-06-2020,105153,867,769,104384,Africa
Chad,20-06-2020,104647,1421,322,104325,Africa
Chile,20-06-2020,239845,523,159,239686,Americas
China,20-06-2020,111024,1765,294,110730,Western Pacific
China,20-06-2020,368125,943,784,367341,Western Pacific
China,20-06-2020,35314,590,644,34670,Western Pacific
China,20-06-2020,62076,1888,974,61102,Western Pacific
China,20-06-2020,357703,1998,364,357339,Western Pacific
China,20-06-2020,317350,2089,610,316740,Western Pacific
China,20-06-2020,430520,2457,1138,429382,Western Pacific
China,20-06-2020,326008,88,1005,325003,Western Pacific
China,20-06-2020,411874,488,74,411800,Western Pacific
China,20-06-2020,101093,2178,644,100449,Western Pacific
China,20-06-2020,144573,2060,1033,143540,Western Pacific
China,20-06-2020,122471,490,440,122031,Western Pacific
China,20-06-2020,4935,188,935,4000,Western Pacific
China,20-06-2020,238358,228,239,238119,Western Pacific
China,20-06-2020,124230,1703,110,124120,Western Pacific
China,20-06-2020,61225,631,483,60742,Western Pacific
China,20-06-2020,198374,379,391,197983,Western Pacific
China,20-06-2020,160322,2277,453,159869,Western Pacific
China,20-06-2020,176813,479,345,176468,Western Pacific
China,20-06-2020,41657,105,541,41116,Western Pacific
China,20-06-2020,310561,2000,1250,309311,Western Pacific
China,20-06-2020,301356,887,1069,300287,Western Pacific
China,20-06-2020,416886,2311,596,416290,Western Pacific
China,20-06-2020,66298,2376,712,65586,Western Pacific
China,20-06-2020,333298,612,386,332912,Western Pacific
China,20-06-2020,407996,790,577,407419,Western Pacific
China,20-06-2020,337628,229,1131,336497,Western Pacific
China,20-06-2020,433907,2091,24,433883,Western Pacific
China,20-06-2020,229589,2138,271,229318,Western Pacific
China,20-06-2020,84148,1457,963,83185,Western Pacific
China,20-06-2020,70226,398,864,69362,Western Pacific
China,20-06-2020,442874,1675,347,442527,Western Pacific
China,20-06-2020,39594,647,956,38638,Western Pacific
Colombia,20-06-2020,177590,1857,1230,176360,Americas
Congo (Brazzaville),20-06-2020,144322,1000,984,143338,Africa
Congo (Kinshasa),20-06-2020,89576,1315,970,88606,Africa
Costa Rica,20-06-2020,195664,1116,1,195663,Americas
Cote d'Ivoire,20-06-2020,206119,1916,1078,205041,Africa
Croatia,20-06-2020,322434,402,1098,321336,Europe
Cuba,20-06-2020,258585,2190,937,257648,Americas
Cyprus,20-06-2020,219248,294,630,218618,Europe
Czechia,20-06-2020,446606,1736,460,446146,Europe
Denmark,20-06-2020,234448,434,1174,233274,Europe
Greenland,20-06-2020,423932,1704,882,423050,Europe
Denmark,20-06-2020,336598,46,350,336248,Europe
Djibouti,20-06-2020,413363,1230,179,413184,Eastern Mediterranean
Dominican Republic,20-06-2020,70130,1921,1212,68918,Americas
Ecuador,20-06-2020,1381,1776,384,997,Americas
Egypt,20-06-2020,140046,2054,384,139662,Eastern Mediterranean
El Salvador,20-06-2020,312956,676,701,312255,Americas
Equatorial Guinea,20-06-2020,121628,1863,461,121167,Africa
Eritrea,20-06-2020,396279,2176,1136,395143,Africa
Estonia,20-06-2020,296815,268,487,296328,Europe
Eswatini,20-06-2020,406885,453,1145,405740,Africa
Ethiopia,20-06-2020,165736,78,249,165487,Africa
Fiji,20-06-2020,128509,1338,365,128144,Western Pacific
Finland,20-06-2020,431271,1390,413,430858,Europe
France,20-06-2020,293019,883,773,292246,Europe
France,20-06-2020,232399,1155,811,231588,Europe
France,20-06-2020,215445,1372,197,215248,Europe
France,20-06-2020,412394,2288,30,412364,Europe
France,20-06-2020,447950,1043,1016,446934,Europe
France,20-06-2020,186615,1505,1132,185483,Europe
France,20-06-2020,308506,572,1117,307389,Europe
France,20-06-2020,83492,688,1067,82425,Europe
France,20-06-2020,6269,2122,144,6125,Europe
France,20-06-2020,18591,2443,659,17932,Europe
Gabon,20-06-2020,127775,292,469,127306,Africa
Gambia,20-06-2020,11544,2427,506,11038,Africa
Georgia,20-06-2020,40643,1825,490,40153,Europe
Germany,20-06-2020,42927,432,728,42199,Europe
Ghana,20-06-2020,278722,355,1126,277596,Africa
Greece,20-06-2020,120075,1343,346,119729,Europe
Guatemala,20-06-2020,127862,488,695,127167,Americas
Guinea,20-06-2020,332504,1450,1086,331418,Africa
Guyana,20-06-2020,381795,2450,1099,380696,Americas
Haiti,20-06-2020,126777,1690,852,125925,Americas
Holy See,20-06-2020,18634,1093,36,18598,Europe
Honduras,20-06-2020,15568,424,567,15001,Americas
Hungary,20-06-2020,338412,35,273,338139,Europe
Iceland,20-06-2020,155720,1938,77,155643,Europe
India,20-06-2020,81858,1474,670,81188,South-East Asia
Indonesia,20-06-2020,382056,1242,94,381962,South-East Asia
Iran,20-06-2020,125965,1710,644,125321,Eastern Mediterranean
Iraq,20-06-2020,298519,512,618,297901,Eastern Mediterranean
Ireland,20-06-2020,103871,1375,1150,102721,Europe
Israel,20-06-2020,149196,1396,35,149161,Europe
Italy,20-06-2020,259685,510,845,258840,Europe
Jamaica,20-06-2020,273148,1321,1250,271898,Americas
Japan,20-06-2020,373604,398,165,373439,Western Pacific
Jordan,20-06-2020,193600,1888,1246,192354,Eastern Mediterranean
Kazakhstan,20-06-2020,6339,239,1216,5123,Europe
Kenya,20-06-2020,9418,981,1108,8310,Africa
South Korea,20-06-2020,337979,40,846,337133,Western Pacific
Kuwait,20-06-2020,203919,2106,849,203070,Eastern Mediterranean
Kyrgyzstan,20-06-2020,339465,1224,726,338739,Europe
Latvia,20-06-2020,323904,1289,984,322920,Europe
Lebanon,20-06-2020,222263,1333,976,221287,Eastern Mediterranean
Liberia,20-06-2020,260814,932,958,259856,Africa
Liechtenstein,20-06-2020,415479,1283,894,414585,Europe
Lithuania,20-06-2020,377000,1871,651,376349,Europe
Luxembourg,20-06-2020,99726,902,928,98798,Europe
Madagascar,20-06-2020,41899,2452,1206,40693,Africa
Malaysia,20-06-2020,164834,1876,309,164525,Western Pacific
Maldives,20-06-2020,210302,1474,106,210196,South-East Asia
Malta,20-06-2020,173394,2203,1243,172151,Europe
Mauritania,20-06-2020,102700,265,514,102186,Africa
Mauritius,20-06-2020,6827,2460,831,5996,Africa
Mexico,20-06-2020,66338,1357,63,66275,Americas
Moldova,20-06-2020,106038,1795,1203,104835,Europe
Monaco,20-06-2020,4155,599,167,3988,Europe
Mongolia,20-06-2020,27991,455,131,27860,Western Pacific
Montenegro,20-06-2020,231476,2146,406,231070,Europe
Morocco,20-06-2020,90920,1608,119,90801,Eastern Mediterranean
Namibia,20-06-2020,191636,2032,1197,190439,Africa
Nepal,20-06-2020,270955,1177,342,270613,South-East Asia
Netherlands,20-06-2020,169980,1823,1093,168887,Europe
Netherlands,20-06-2020,262034,2136,100,261934,Europe
Netherlands,20-06-2020,390234,2422,775,389459,Europe
Netherlands,20-06-2020,199233,2068,513,198720,Europe
New Zealand,20-06-2020,234610,1353,161,234449,Western Pacific
Nicaragua,20-06-2020,279682,334,269,279413,Americas
Niger,20-06-2020,335497,773,788,334709,Africa
Nigeria,20-06-2020,394134,360,1020,393114,Africa
North Macedonia,20-06-2020,354634,716,1232,353402,Europe
Norway,20-06-2020,210364,1727,333,210031,Europe
Oman,20-06-2020,69039,1476,778,68261,Eastern Mediterranean
Pakistan,20-06-2020,400201,78,805,399396,Eastern Mediterranean
Panama,20-06-2020,436576,2229,326,436250,Americas
Papua New Guinea,20-06-2020,200002,1316,1198,198804,Western Pacific
Paraguay,20-06-2020,12459,1197,220,12239,Americas
Peru,20-06-2020,100716,471,542,100174,Americas
Philippines,20-06-2020,266121,1149,881,265240,Western Pacific
Poland,20-06-2020,299409,100,1227,298182,Europe
Portugal,20-06-2020,321161,1616,1231,319930,Europe
Qatar,20-06-2020,265869,1147,766,265103,Eastern Mediterranean
Romania,20-06-2020,4691,2153,1028,3663,Europe
Russia,20-06-2020,45184,1659,1226,43958,Europe
Rwanda,20-06-2020,276880,454,1104,275776,Africa
Saint Lucia,20-06-2020,136168,614,170,135998,Americas
Saint Vincent and the Grenadines,20-06-2020,77976,423,102,77874,Americas
San Marino,20-06-2020,199318,1878,723,198595,Europe
Saudi Arabia,20-06-2020,323791,991,759,323032,Eastern Mediterranean
Senegal,20-06-2020,329042,157,395,328647,Africa
Serbia,20-06-2020,151313,1091,153,151160,Europe
Seychelles,20-06-2020,273500,710,1113,272387,Africa
Singapore,20-06-2020,100195,718,1236,98959,Western Pacific
Slovakia,20-06-2020,211854,845,666,211188,Europe
Slovenia,20-06-2020,105397,405,393,105004,Europe
Somalia,20-06-2020,374908,1658,711,374197,Eastern Mediterranean
South Africa,20-06-2020,105120,837,817,104303,Africa
Spain,20-06-2020,426402,1284,100,426302,Europe
Sri Lanka,20-06-2020,177376,1532,67,177309,South-East Asia
Sudan,20-06-2020,314251,470,1140,313111,Eastern Mediterranean
Suriname,20-06-2020,403566,1422,1054,402512,Americas
Sweden,20-06-2020,50397,839,626,49771,Europe
Switzerland,20-06-2020,256018,555,258,255760,Europe
Taiwan*,20-06-2020,304495,1359,792,303703,Western Pacific
Tanzania,20-06-2020,156850,2060,1114,155736,Africa
Thailand,20-06-2020,257519,965,1058,256461,South-East Asia
Togo,20-06-2020,106400,1986,242,106158,Africa
Trinidad and Tobago,20-06-2020,77830,1176,751,77079,Americas
Tunisia,20-06-2020,330392,2439,686,329706,Eastern Mediterranean
Turkey,20-06-2020,366818,1550,358,366460,Europe
Uganda,20-06-2020,253459,457,929,252530,Africa
Ukraine,20-06-2020,384935,2230,634,384301,Europe
United Arab Emirates,20-06-2020,197787,2241,1114,196673,Eastern Mediterranean
United Kingdom,20-06-2020,153855,1650,1013,152842,Europe
United Kingdom,20-06-2020,290918,1151,1027,289891,Europe
United Kingdom,20-06-2020,149007,1399,171,148836,Europe
United Kingdom,20-06-2020,440934,767,315,440619,Europe
United Kingdom,20-06-2020,41170,617,1020,40150,Europe
United Kingdom,20-06-2020,114559,778,751,113808,Europe
United Kingdom,20-06-2020,320581,791,930,319651,Europe
Uruguay,20-06-2020,25036,590,1098,23938,Americas
US,20-06-2020,287344,1010,174,287170,Americas
Uzbekistan,20-06-2020,168808,2446,815,167993,Europe
Venezuela,20-06-2020,273102,959,1248,271854,Americas
Vietnam,20-06-2020,197573,2397,1073,196500,Western Pacific
Zambia,20-06-2020,87356,112,368,86988,Africa
Zimbabwe,20-06-2020,280909,264,383,280526,Africa
Dominica,20-06-2020,184544,213,276,184268,Americas
Grenada,20-06-2020,96916,795,940,95976,Americas
Mozambique,20-06-2020,122919,2470,536,122383,Africa
Syria,20-06-2020,230039,1192,575,229464,Eastern Mediterranean
Timor-Leste,20-06-2020,98559,2278,740,97819,South-East Asia
Belize,20-06-2020,355085,332,557,354528,Americas
Laos,20-06-2020,129046,1461,887,128159,Western Pacific
Libya,20-06-2020,430859,280,609,430250,Eastern Mediterranean
West Bank and Gaza,20-06-2020,204603,709,186,204417,Eastern Mediterranean
Guinea-Bissau,20-06-2020,265814,1817,572,265242,Africa
Mali,20-06-2020,349566,890,900,348666,Africa
Saint Kitts and Nevis,20-06-2020,29706,1001,540,29166,Americas
Canada,20-06-2020,326255,275,1020,325235,Americas
Canada,20-06-2020,320071,2230,13,320058,Americas
Kosovo,20-06-2020,53781,1259,541,53240,Europe
Burma,20-06-2020,445703,2463,381,445322,South-East Asia
United Kingdom,20-06-2020,117896,1980,171,117725,Europe
United Kingdom,20-06-2020,299165,1633,687,298478,Europe
United Kingdom,20-06-2020,200563,2339,315,200248,Europe
Botswana,20-06-2020,377270,591,680,376590,Africa
Burundi,20-06-2020,380677,328,898,379779,Africa
Sierra Leone,20-06-2020,99933,391,382,99551,Africa
Malawi,20-06-2020,161471,499,757,160714,Africa
United Kingdom,20-06-2020,179450,1631,642,178808,Europe
France,20-06-2020,414701,1718,1084,413617,Europe
South Sudan,20-06-2020,2714,1735,438,2276,Africa
Western Sahara,20-06-2020,130251,626,993,129258,Africa
Sao Tome and Principe,20-06-2020,359829,333,124,359705,Africa
Yemen,20-06-2020,173073,2150,1191,171882,Eastern Mediterranean
Comoros,20-06-2020,414999,2265,1031,413968,Africa
Tajikistan,20-06-2020,345974,1179,815,345159,Europe
Lesotho,20-06-2020,127163,1304,728,126435,Africa
Afghanistan,21-06-2020,140391,1183,920,139471,Eastern Mediterranean
Albania,21-06-2020,355735,1225,940,354795,Europe
Algeria,21-06-2020,124153,2013,513,123640,Africa
Andorra,21-06-2020,402785,1323,724,402061,Europe
Angola,21-06-2020,203083,1566,855,202228,Africa
Antigua and Barbuda,21-06-2020,126735,1904,382,126353,Americas
Argentina,21-06-2020,95532,149,821,94711,Americas
Armenia,21-06-2020,41985,2450,1250,40735,Europe
Australia,21-06-2020,399663,1501,737,398926,Western Pacific
Australia,21-06-2020,34317,1347,1248,33069,Western Pacific
Australia,21-06-2020,242902,1846,788,242114,Western Pacific
Australia,21-06-2020,235415,679,792,234623,Western Pacific
Australia,21-06-2020,14275,258,708,13567,Western Pacific
Australia,21-06-2020,357104,1294,19,357085,Western Pacific
Australia,21-06-2020,289794,801,933,288861,Western Pacific
Australia,21-06-2020,421774,570,168,421606,Western Pacific
Austria,21-06-2020,155912,2362,1100,154812,Europe
Azerbaijan,21-06-2020,13626,2136,652,12974,Europe
Bahamas,21-06-2020,349919,271,217,349702,Americas
Bahrain,21-06-2020,98154,131,123,98031,Eastern Mediterranean
Bangladesh,21-06-2020,372546,971,1023,371523,South-East Asia
Barbados,21-06-2020,188640,2089,869,187771,Americas
Belarus,21-06-2020,221098,1444,960,220138,Europe
Belgium,21-06-2020,27738,1934,577,27161,Europe
Benin,21-06-2020,162451,2244,934,161517,Africa
Bhutan,21-06-2020,410140,2238,565,409575,South-East Asia
Bolivia,21-06-2020,138494,1223,1039,137455,Americas
Bosnia and Herzegovina,21-06-2020,5757,640,924,4833,Europe
Brazil,21-06-2020,328137,1149,829,327308,Americas
Brunei,21-06-2020,424172,1540,73,424099,Western Pacific
Bulgaria,21-06-2020,112287,672,127,112160,Europe
Burkina Faso,21-06-2020,432273,10,41,432232,Africa
Cabo Verde,21-06-2020,403168,2242,643,402525,Africa
Cambodia,21-06-2020,360626,617,942,359684,Western Pacific
Cameroon,21-06-2020,147030,150,62,146968,Africa
Canada,21-06-2020,83486,1971,449,83037,Americas
Canada,21-06-2020,68670,2332,338,68332,Americas
Canada,21-06-2020,77501,834,704,76797,Americas
Canada,21-06-2020,354037,1175,118,353919,Americas
Canada,21-06-2020,178390,2418,235,178155,Americas
Canada,21-06-2020,31697,1129,213,31484,Americas
Canada,21-06-2020,213137,1944,217,212920,Americas
Canada,21-06-2020,392610,1553,180,392430,Americas
Canada,21-06-2020,367256,836,733,366523,Americas
Canada,21-06-2020,419833,2154,413,419420,Americas
Central African Republic,21-06-2020,237249,2064,922,236327,Africa
Chad,21-06-2020,316328,1234,669,315659,Africa
Chile,21-06-2020,155030,796,678,154352,Americas
China,21-06-2020,73350,253,207,73143,Western Pacific
China,21-06-2020,252016,1453,829,251187,Western Pacific
China,21-06-2020,135386,260,488,134898,Western Pacific
China,21-06-2020,65815,1574,635,65180,Western Pacific
China,21-06-2020,403664,1883,297,403367,Western Pacific
China,21-06-2020,101910,2457,619,101291,Western Pacific
China,21-06-2020,354138,1752,1188,352950,Western Pacific
China,21-06-2020,330602,123,151,330451,Western Pacific
China,21-06-2020,237019,15,550,236469,Western Pacific
China,21-06-2020,102563,9,888,101675,Western Pacific
China,21-06-2020,218967,31,210,218757,Western Pacific
China,21-06-2020,236144,2188,714,235430,Western Pacific
China,21-06-2020,265783,108,144,265639,Western Pacific
China,21-06-2020,86548,2044,372,86176,Western Pacific
China,21-06-2020,10414,1519,643,9771,Western Pacific
China,21-06-2020,313932,438,1239,312693,Western Pacific
China,21-06-2020,24075,1139,410,23665,Western Pacific
China,21-06-2020,191322,1404,474,190848,Western Pacific
China,21-06-2020,359711,1804,572,359139,Western Pacific
China,21-06-2020,282250,1640,12,282238,Western Pacific
China,21-06-2020,449144,2290,512,448632,Western Pacific
China,21-06-2020,278585,295,664,277921,Western Pacific
China,21-06-2020,210788,1819,1215,209573,Western Pacific
China,21-06-2020,432514,1327,114,432400,Western Pacific
China,21-06-2020,177796,2164,728,177068,Western Pacific
China,21-06-2020,165126,1464,379,164747,Western Pacific
China,21-06-2020,333864,608,659,333205,Western Pacific
China,21-06-2020,412369,1405,1218,411151,Western Pacific
China,21-06-2020,288732,1152,856,287876,Western Pacific
China,21-06-2020,340562,2379,1068,339494,Western Pacific
China,21-06-2020,23171,375,433,22738,Western Pacific
China,21-06-2020,11357,1322,1041,10316,Western Pacific
China,21-06-2020,146884,1401,252,146632,Western Pacific
Colombia,21-06-2020,92832,914,416,92416,Americas
Congo (Brazzaville),21-06-2020,185529,973,339,185190,Africa
Congo (Kinshasa),21-06-2020,377903,1408,667,377236,Africa
Costa Rica,21-06-2020,185822,750,62,185760,Americas
Cote d'Ivoire,21-06-2020,7675,1991,979,6696,Africa
Croatia,21-06-2020,28658,168,190,28468,Europe
Cuba,21-06-2020,121806,499,595,121211,Americas
Cyprus,21-06-2020,268005,1734,263,267742,Europe
Czechia,21-06-2020,208667,833,1115,207552,Europe
Denmark,21-06-2020,221267,1008,324,220943,Europe
Greenland,21-06-2020,405350,1781,517,404833,Europe
Denmark,21-06-2020,375382,772,435,374947,Europe
Djibouti,21-06-2020,205379,2310,452,204927,Eastern Mediterranean
Dominican Republic,21-06-2020,74563,2017,837,73726,Americas
Ecuador,21-06-2020,352622,1903,187,352435,Americas
Egypt,21-06-2020,102491,681,581,101910,Eastern Mediterranean
El Salvador,21-06-2020,74188,2094,866,73322,Americas
Equatorial Guinea,21-06-2020,164381,1672,888,163493,Africa
Eritrea,21-06-2020,215759,2175,949,214810,Africa
Estonia,21-06-2020,329183,1443,529,328654,Europe
Eswatini,21-06-2020,314617,299,507,314110,Africa
Ethiopia,21-06-2020,192686,1079,536,192150,Africa
Fiji,21-06-2020,445159,1254,509,444650,Western Pacific
Finland,21-06-2020,201225,1015,883,200342,Europe
France,21-06-2020,109619,2339,1100,108519,Europe
France,21-06-2020,3610,659,122,3488,Europe
France,21-06-2020,163021,1287,476,162545,Europe
France,21-06-2020,264660,1490,1130,263530,Europe
France,21-06-2020,400101,821,1016,399085,Europe
France,21-06-2020,403696,1282,533,403163,Europe
France,21-06-2020,144760,120,1115,143645,Europe
France,21-06-2020,322904,825,122,322782,Europe
France,21-06-2020,216592,2337,1052,215540,Europe
France,21-06-2020,32544,980,1010,31534,Europe
Gabon,21-06-2020,146679,2082,1208,145471,Africa
Gambia,21-06-2020,19972,1433,1148,18824,Africa
Georgia,21-06-2020,364496,2024,160,364336,Europe
Germany,21-06-2020,203391,1674,1151,202240,Europe
Ghana,21-06-2020,141362,336,1172,140190,Africa
Greece,21-06-2020,27044,1583,429,26615,Europe
Guatemala,21-06-2020,375398,464,59,375339,Americas
Guinea,21-06-2020,102495,284,51,102444,Africa
Guyana,21-06-2020,245905,2045,914,244991,Americas
Haiti,21-06-2020,159970,544,709,159261,Americas
Holy See,21-06-2020,116974,320,354,116620,Europe
Honduras,21-06-2020,74088,1381,49,74039,Americas
Hungary,21-06-2020,116669,863,91,116578,Europe
Iceland,21-06-2020,294410,417,590,293820,Europe
India,21-06-2020,259982,352,298,259684,South-East Asia
Indonesia,21-06-2020,67392,1332,655,66737,South-East Asia
Iran,21-06-2020,120512,1897,352,120160,Eastern Mediterranean
Iraq,21-06-2020,443139,952,655,442484,Eastern Mediterranean
Ireland,21-06-2020,302630,246,153,302477,Europe
Israel,21-06-2020,209959,2317,795,209164,Europe
Italy,21-06-2020,237423,215,281,237142,Europe
Jamaica,21-06-2020,39234,920,518,38716,Americas
Japan,21-06-2020,150946,281,258,150688,Western Pacific
Jordan,21-06-2020,112062,1996,804,111258,Eastern Mediterranean
Kazakhstan,21-06-2020,329648,2433,326,329322,Europe
Kenya,21-06-2020,97532,481,655,96877,Africa
South Korea,21-06-2020,441219,1655,987,440232,Western Pacific
Kuwait,21-06-2020,135074,2205,269,134805,Eastern Mediterranean
Kyrgyzstan,21-06-2020,133036,846,1124,131912,Europe
Latvia,21-06-2020,434262,45,376,433886,Europe
Lebanon,21-06-2020,369361,1031,782,368579,Eastern Mediterranean
Liberia,21-06-2020,303010,777,237,302773,Africa
Liechtenstein,21-06-2020,155619,2496,521,155098,Europe
Lithuania,21-06-2020,440570,2299,554,440016,Europe
Luxembourg,21-06-2020,96171,529,639,95532,Europe
Madagascar,21-06-2020,288259,2013,263,287996,Africa
Malaysia,21-06-2020,207750,1041,1228,206522,Western Pacific
Maldives,21-06-2020,169484,2310,1053,168431,South-East Asia
Malta,21-06-2020,256080,1990,795,255285,Europe
Mauritania,21-06-2020,166449,1199,501,165948,Africa
Mauritius,21-06-2020,74643,1518,948,73695,Africa
Mexico,21-06-2020,125511,1955,651,124860,Americas
Moldova,21-06-2020,192915,837,1239,191676,Europe
Monaco,21-06-2020,368819,1074,159,368660,Europe
Mongolia,21-06-2020,102742,2319,336,102406,Western Pacific
Montenegro,21-06-2020,68894,1954,981,67913,Europe
Morocco,21-06-2020,101890,85,838,101052,Eastern Mediterranean
Namibia,21-06-2020,387244,2389,1185,386059,Africa
Nepal,21-06-2020,117150,624,240,116910,South-East Asia
Netherlands,21-06-2020,296865,390,224,296641,Europe
Netherlands,21-06-2020,114120,294,150,113970,Europe
Netherlands,21-06-2020,442138,218,675,441463,Europe
Netherlands,21-06-2020,394877,2346,51,394826,Europe
New Zealand,21-06-2020,308167,1252,1232,306935,Western Pacific
Nicaragua,21-06-2020,274957,2388,292,274665,Americas
Niger,21-06-2020,277385,1637,96,277289,Africa
Nigeria,21-06-2020,128044,1862,62,127982,Africa
North Macedonia,21-06-2020,172950,1855,78,172872,Europe
Norway,21-06-2020,363995,423,571,363424,Europe
Oman,21-06-2020,208811,617,492,208319,Eastern Mediterranean
Pakistan,21-06-2020,72117,1893,1061,71056,Eastern Mediterranean
Panama,21-06-2020,50576,106,741,49835,Americas
Papua New Guinea,21-06-2020,54582,1729,485,54097,Western Pacific
Paraguay,21-06-2020,118440,1346,287,118153,Americas
Peru,21-06-2020,181328,1182,1133,180195,Americas
Philippines,21-06-2020,122066,93,543,121523,Western Pacific
Poland,21-06-2020,225456,1881,438,225018,Europe
Portugal,21-06-2020,233504,2356,524,232980,Europe
Qatar,21-06-2020,35381,383,1123,34258,Eastern Mediterranean
Romania,21-06-2020,31013,244,286,30727,Europe
Russia,21-06-2020,45025,1365,623,44402,Europe
Rwanda,21-06-2020,117939,651,736,117203,Africa
Saint Lucia,21-06-2020,381739,1542,675,381064,Americas
Saint Vincent and the Grenadines,21-06-2020,381720,1550,684,381036,Americas
San Marino,21-06-2020,204483,2227,424,204059,Europe
Saudi Arabia,21-06-2020,97147,1745,1182,95965,Eastern Mediterranean
Senegal,21-06-2020,443237,1950,252,442985,Africa
Serbia,21-06-2020,78447,779,765,77682,Europe
Seychelles,21-06-2020,408834,1628,978,407856,Africa
Singapore,21-06-2020,166586,235,256,166330,Western Pacific
Slovakia,21-06-2020,181456,1719,918,180538,Europe
Slovenia,21-06-2020,314645,1699,1177,313468,Europe
Somalia,21-06-2020,279796,1602,525,279271,Eastern Mediterranean
South Africa,21-06-2020,63249,591,0,63249,Africa
Spain,21-06-2020,80817,461,578,80239,Europe
Sri Lanka,21-06-2020,97717,111,712,97005,South-East Asia
Sudan,21-06-2020,226477,1678,330,226147,Eastern Mediterranean
Suriname,21-06-2020,375246,2254,1145,374101,Americas
Sweden,21-06-2020,128257,1981,744,127513,Europe
Switzerland,21-06-2020,338788,109,439,338349,Europe
Taiwan*,21-06-2020,113821,1969,396,113425,Western Pacific
Tanzania,21-06-2020,411824,2388,414,411410,Africa
Thailand,21-06-2020,161335,212,43,161292,South-East Asia
Togo,21-06-2020,53130,833,632,52498,Africa
Trinidad and Tobago,21-06-2020,92971,1023,778,92193,Americas
Tunisia,21-06-2020,220355,2264,371,219984,Eastern Mediterranean
Turkey,21-06-2020,445717,1485,288,445429,Europe
Uganda,21-06-2020,268500,2284,37,268463,Africa
Ukraine,21-06-2020,104837,1724,932,103905,Europe
United Arab Emirates,21-06-2020,291036,2177,938,290098,Eastern Mediterranean
United Kingdom,21-06-2020,105465,1151,789,104676,Europe
United Kingdom,21-06-2020,149450,975,935,148515,Europe
United Kingdom,21-06-2020,356483,1373,1110,355373,Europe
United Kingdom,21-06-2020,32797,1514,416,32381,Europe
United Kingdom,21-06-2020,22600,1422,980,21620,Europe
United Kingdom,21-06-2020,237044,1157,275,236769,Europe
United Kingdom,21-06-2020,161356,2265,361,160995,Europe
Uruguay,21-06-2020,400078,1806,551,399527,Americas
US,21-06-2020,252981,1537,644,252337,Americas
Uzbekistan,21-06-2020,323677,889,862,322815,Europe
Venezuela,21-06-2020,325628,798,381,325247,Americas
Vietnam,21-06-2020,339917,198,313,339604,Western Pacific
Zambia,21-06-2020,166659,2171,408,166251,Africa
Zimbabwe,21-06-2020,375956,647,997,374959,Africa
Dominica,21-06-2020,358572,706,1069,357503,Americas
Grenada,21-06-2020,342721,1088,67,342654,Americas
Mozambique,21-06-2020,236583,1747,163,236420,Africa
Syria,21-06-2020,68986,2401,466,68520,Eastern Mediterranean
Timor-Leste,21-06-2020,196643,1568,722,195921,South-East Asia
Belize,21-06-2020,204023,250,412,203611,Americas
Laos,21-06-2020,142862,2031,320,142542,Western Pacific
Libya,21-06-2020,350500,624,627,349873,Eastern Mediterranean
West Bank and Gaza,21-06-2020,51,1902,993,-942,Eastern Mediterranean
Guinea-Bissau,21-06-2020,197444,1065,675,196769,Africa
Mali,21-06-2020,104886,360,1143,103743,Africa
Saint Kitts and Nevis,21-06-2020,202863,1787,1094,201769,Americas
Canada,21-06-2020,275564,524,94,275470,Americas
Canada,21-06-2020,222017,1885,1085,220932,Americas
Kosovo,21-06-2020,57730,1593,1107,56623,Europe
Burma,21-06-2020,327502,433,114,327388,South-East Asia
United Kingdom,21-06-2020,176598,521,118,176480,Europe
United Kingdom,21-06-2020,447064,396,651,446413,Europe
United Kingdom,21-06-2020,104523,1738,433,104090,Europe
Botswana,21-06-2020,12233,468,228,12005,Africa
Burundi,21-06-2020,221849,298,203,221646,Africa
Sierra Leone,21-06-2020,366994,2319,720,366274,Africa
Malawi,21-06-2020,364464,128,400,364064,Africa
United Kingdom,21-06-2020,220925,1135,996,219929,Europe
France,21-06-2020,54226,1001,443,53783,Europe
South Sudan,21-06-2020,19504,2366,199,19305,Africa
Western Sahara,21-06-2020,284451,89,591,283860,Africa
Sao Tome and Principe,21-06-2020,24522,776,628,23894,Africa
Yemen,21-06-2020,449459,1203,49,449410,Eastern Mediterranean
Comoros,21-06-2020,23535,2056,1157,22378,Africa
Tajikistan,21-06-2020,143504,2215,143,143361,Europe
Lesotho,21-06-2020,389965,1718,878,389087,Africa
Afghanistan,22-06-2020,327741,1148,382,327359,Eastern Mediterranean
Albania,22-06-2020,341922,1949,496,341426,Europe
Algeria,22-06-2020,260595,2048,310,260285,Africa
Andorra,22-06-2020,303181,2446,1165,302016,Europe
Angola,22-06-2020,356744,2032,384,356360,Africa
Antigua and Barbuda,22-06-2020,34650,28,852,33798,Americas
Argentina,22-06-2020,118486,367,675,117811,Americas
Armenia,22-06-2020,352331,110,1195,351136,Europe
Australia,22-06-2020,11612,478,586,11026,Western Pacific
Australia,22-06-2020,323469,336,773,322696,Western Pacific
Australia,22-06-2020,446967,1188,1149,445818,Western Pacific
Australia,22-06-2020,129009,1236,161,128848,Western Pacific
Australia,22-06-2020,382905,2113,470,382435,Western Pacific
Australia,22-06-2020,67281,1080,553,66728,Western Pacific
Australia,22-06-2020,298261,408,543,297718,Western Pacific
Australia,22-06-2020,204989,70,636,204353,Western Pacific
Austria,22-06-2020,291028,2203,866,290162,Europe
Azerbaijan,22-06-2020,416393,324,783,415610,Europe
Bahamas,22-06-2020,324199,1677,867,323332,Americas
Bahrain,22-06-2020,205381,1989,905,204476,Eastern Mediterranean
Bangladesh,22-06-2020,227447,2229,498,226949,South-East Asia
Barbados,22-06-2020,311329,1650,356,310973,Americas
Belarus,22-06-2020,133886,460,26,133860,Europe
Belgium,22-06-2020,446989,119,370,446619,Europe
Benin,22-06-2020,98367,408,1004,97363,Africa
Bhutan,22-06-2020,353076,573,1222,351854,South-East Asia
Bolivia,22-06-2020,292444,1118,359,292085,Americas
Bosnia and Herzegovina,22-06-2020,316845,768,647,316198,Europe
Brazil,22-06-2020,164099,1738,950,163149,Americas
Brunei,22-06-2020,286390,1607,1224,285166,Western Pacific
Bulgaria,22-06-2020,309751,576,331,309420,Europe
Burkina Faso,22-06-2020,248259,823,778,247481,Africa
Cabo Verde,22-06-2020,413843,991,954,412889,Africa
Cambodia,22-06-2020,14944,2426,82,14862,Western Pacific
Cameroon,22-06-2020,65969,78,128,65841,Africa
Canada,22-06-2020,52946,412,292,52654,Americas
Canada,22-06-2020,331443,284,946,330497,Americas
Canada,22-06-2020,349407,1402,245,349162,Americas
Canada,22-06-2020,198110,504,109,198001,Americas
Canada,22-06-2020,225586,1191,1198,224388,Americas
Canada,22-06-2020,354440,1437,499,353941,Americas
Canada,22-06-2020,9518,738,397,9121,Americas
Canada,22-06-2020,420534,820,1194,419340,Americas
Canada,22-06-2020,260006,1826,657,259349,Americas
Canada,22-06-2020,142063,956,345,141718,Americas
Central African Republic,22-06-2020,303840,1272,190,303650,Africa
Chad,22-06-2020,332447,2205,551,331896,Africa
Chile,22-06-2020,255739,361,1194,254545,Americas
China,22-06-2020,246108,866,395,245713,Western Pacific
China,22-06-2020,188668,1006,518,188150,Western Pacific
China,22-06-2020,193666,228,346,193320,Western Pacific
China,22-06-2020,158182,724,378,157804,Western Pacific
China,22-06-2020,218315,192,1123,217192,Western Pacific
China,22-06-2020,368988,408,130,368858,Western Pacific
China,22-06-2020,295873,2379,576,295297,Western Pacific
China,22-06-2020,324811,931,855,323956,Western Pacific
China,22-06-2020,92676,263,1197,91479,Western Pacific
China,22-06-2020,136421,706,1082,135339,Western Pacific
China,22-06-2020,371715,1826,726,370989,Western Pacific
China,22-06-2020,275818,1434,600,275218,Western Pacific
China,22-06-2020,167530,148,473,167057,Western Pacific
China,22-06-2020,317391,871,538,316853,Western Pacific
China,22-06-2020,78681,1379,188,78493,Western Pacific
China,22-06-2020,173394,31,513,172881,Western Pacific
China,22-06-2020,195660,1283,190,195470,Western Pacific
China,22-06-2020,350568,91,987,349581,Western Pacific
China,22-06-2020,303419,1005,1214,302205,Western Pacific
China,22-06-2020,120873,2114,1213,119660,Western Pacific
China,22-06-2020,187323,514,679,186644,Western Pacific
China,22-06-2020,101313,611,520,100793,Western Pacific
China,22-06-2020,293697,2165,308,293389,Western Pacific
China,22-06-2020,329516,1165,888,328628,Western Pacific
China,22-06-2020,179181,2389,1071,178110,Western Pacific
China,22-06-2020,179082,180,172,178910,Western Pacific
China,22-06-2020,93252,2319,186,93066,Western Pacific
China,22-06-2020,187981,1377,836,187145,Western Pacific
China,22-06-2020,197154,875,369,196785,Western Pacific
China,22-06-2020,139516,1134,731,138785,Western Pacific
China,22-06-2020,100145,35,393,99752,Western Pacific
China,22-06-2020,364054,684,1000,363054,Western Pacific
China,22-06-2020,27804,813,37,27767,Western Pacific
Colombia,22-06-2020,33376,2410,586,32790,Americas
Congo (Brazzaville),22-06-2020,240350,955,31,240319,Africa
Congo (Kinshasa),22-06-2020,91386,1489,348,91038,Africa
Costa Rica,22-06-2020,91390,1961,711,90679,Americas
Cote d'Ivoire,22-06-2020,372968,658,1084,371884,Africa
Croatia,22-06-2020,121440,1075,93,121347,Europe
Cuba,22-06-2020,37707,689,332,37375,Americas
Cyprus,22-06-2020,358816,385,817,357999,Europe
Czechia,22-06-2020,71192,1074,673,70519,Europe
Denmark,22-06-2020,117312,1945,1209,116103,Europe
Greenland,22-06-2020,439523,1934,482,439041,Europe
Denmark,22-06-2020,425005,1271,1091,423914,Europe
Djibouti,22-06-2020,118104,2118,1177,116927,Eastern Mediterranean
Dominican Republic,22-06-2020,102931,242,577,102354,Americas
Ecuador,22-06-2020,262044,1560,735,261309,Americas
Egypt,22-06-2020,82357,2218,418,81939,Eastern Mediterranean
El Salvador,22-06-2020,57603,355,843,56760,Americas
Equatorial Guinea,22-06-2020,150648,2471,994,149654,Africa
Eritrea,22-06-2020,347320,1407,661,346659,Africa
Estonia,22-06-2020,360953,2045,1209,359744,Europe
Eswatini,22-06-2020,355197,1781,885,354312,Africa
Ethiopia,22-06-2020,23825,101,558,23267,Africa
Fiji,22-06-2020,349296,900,375,348921,Western Pacific
Finland,22-06-2020,9508,838,402,9106,Europe
France,22-06-2020,94280,1277,8,94272,Europe
France,22-06-2020,247232,419,711,246521,Europe
France,22-06-2020,416003,552,760,415243,Europe
France,22-06-2020,342686,2259,583,342103,Europe
France,22-06-2020,20882,1488,981,19901,Europe
France,22-06-2020,260884,1523,718,260166,Europe
France,22-06-2020,137183,875,143,137040,Europe
France,22-06-2020,5574,1148,766,4808,Europe
France,22-06-2020,186228,1155,171,186057,Europe
France,22-06-2020,393103,676,365,392738,Europe
Gabon,22-06-2020,64908,1700,235,64673,Africa
Gambia,22-06-2020,388717,1637,57,388660,Africa
Georgia,22-06-2020,196539,207,627,195912,Europe
Germany,22-06-2020,306708,1183,1228,305480,Europe
Ghana,22-06-2020,72659,1769,780,71879,Africa
Greece,22-06-2020,321532,1250,1202,320330,Europe
Guatemala,22-06-2020,152389,280,308,152081,Americas
Guinea,22-06-2020,426143,1658,283,425860,Africa
Guyana,22-06-2020,205386,1977,856,204530,Americas
Haiti,22-06-2020,259050,2103,740,258310,Americas
Holy See,22-06-2020,424710,2132,761,423949,Europe
Honduras,22-06-2020,245059,2100,1006,244053,Americas
Hungary,22-06-2020,114264,1327,150,114114,Europe
Iceland,22-06-2020,263068,1756,413,262655,Europe
India,22-06-2020,303776,2201,1019,302757,South-East Asia
Indonesia,22-06-2020,122264,2061,1001,121263,South-East Asia
Iran,22-06-2020,14776,1814,568,14208,Eastern Mediterranean
Iraq,22-06-2020,195943,1017,997,194946,Eastern Mediterranean
Ireland,22-06-2020,356319,789,438,355881,Europe
Israel,22-06-2020,409232,2105,272,408960,Europe
Italy,22-06-2020,250987,812,729,250258,Europe
Jamaica,22-06-2020,285886,1697,616,285270,Americas
Japan,22-06-2020,294268,2264,682,293586,Western Pacific
Jordan,22-06-2020,269785,926,561,269224,Eastern Mediterranean
Kazakhstan,22-06-2020,302191,1258,80,302111,Europe
Kenya,22-06-2020,136390,2040,704,135686,Africa
South Korea,22-06-2020,409130,429,890,408240,Western Pacific
Kuwait,22-06-2020,431527,2376,1236,430291,Eastern Mediterranean
Kyrgyzstan,22-06-2020,340435,1843,1169,339266,Europe
Latvia,22-06-2020,175398,1881,979,174419,Europe
Lebanon,22-06-2020,388085,2446,76,388009,Eastern Mediterranean
Liberia,22-06-2020,3071,868,477,2594,Africa
Liechtenstein,22-06-2020,95369,618,946,94423,Europe
Lithuania,22-06-2020,74087,2028,737,73350,Europe
Luxembourg,22-06-2020,172932,2180,822,172110,Europe
Madagascar,22-06-2020,440182,280,181,440001,Africa
Malaysia,22-06-2020,206640,211,1165,205475,Western Pacific
Maldives,22-06-2020,20842,1923,130,20712,South-East Asia
Malta,22-06-2020,103585,885,395,103190,Europe
Mauritania,22-06-2020,314697,922,718,313979,Africa
Mauritius,22-06-2020,46937,1519,72,46865,Africa
Mexico,22-06-2020,68620,127,66,68554,Americas
Moldova,22-06-2020,135115,503,83,135032,Europe
Monaco,22-06-2020,129792,986,918,128874,Europe
Mongolia,22-06-2020,103734,217,1142,102592,Western Pacific
Montenegro,22-06-2020,193020,1911,817,192203,Europe
Morocco,22-06-2020,226883,1065,670,226213,Eastern Mediterranean
Namibia,22-06-2020,127515,1341,328,127187,Africa
Nepal,22-06-2020,323397,2130,1057,322340,South-East Asia
Netherlands,22-06-2020,55900,1826,466,55434,Europe
Netherlands,22-06-2020,59777,560,218,59559,Europe
Netherlands,22-06-2020,444678,2441,403,444275,Europe
Netherlands,22-06-2020,351806,2006,387,351419,Europe
New Zealand,22-06-2020,287018,214,1103,285915,Western Pacific
Nicaragua,22-06-2020,7179,493,759,6420,Americas
Niger,22-06-2020,417531,111,1070,416461,Africa
Nigeria,22-06-2020,101156,1794,593,100563,Africa
North Macedonia,22-06-2020,299490,2360,415,299075,Europe
Norway,22-06-2020,67872,808,255,67617,Europe
Oman,22-06-2020,358359,474,454,357905,Eastern Mediterranean
Pakistan,22-06-2020,175533,383,416,175117,Eastern Mediterranean
Panama,22-06-2020,79323,359,975,78348,Americas
Papua New Guinea,22-06-2020,157596,616,103,157493,Western Pacific
Paraguay,22-06-2020,40890,619,157,40733,Americas
Peru,22-06-2020,240934,1015,768,240166,Americas
Philippines,22-06-2020,319083,1977,176,318907,Western Pacific
Poland,22-06-2020,384109,718,389,383720,Europe
Portugal,22-06-2020,79514,374,392,79122,Europe
Qatar,22-06-2020,133803,471,501,133302,Eastern Mediterranean
Romania,22-06-2020,391357,857,1069,390288,Europe
Russia,22-06-2020,406209,320,1247,404962,Europe
Rwanda,22-06-2020,99996,722,10,99986,Africa
Saint Lucia,22-06-2020,67581,2258,135,67446,Americas
Saint Vincent and the Grenadines,22-06-2020,408335,1550,965,407370,Americas
San Marino,22-06-2020,12771,2433,831,11940,Europe
Saudi Arabia,22-06-2020,425865,1858,1240,424625,Eastern Mediterranean
Senegal,22-06-2020,301898,2428,861,301037,Africa
Serbia,22-06-2020,387587,1745,1148,386439,Europe
Seychelles,22-06-2020,221243,96,223,221020,Africa
Singapore,22-06-2020,411727,709,660,411067,Western Pacific
Slovakia,22-06-2020,93122,1984,702,92420,Europe
Slovenia,22-06-2020,375453,1997,836,374617,Europe
Somalia,22-06-2020,240958,1659,1079,239879,Eastern Mediterranean
South Africa,22-06-2020,139558,1288,48,139510,Africa
Spain,22-06-2020,248960,332,499,248461,Europe
Sri Lanka,22-06-2020,400093,454,700,399393,South-East Asia
Sudan,22-06-2020,336846,1861,100,336746,Eastern Mediterranean
Suriname,22-06-2020,88277,197,1223,87054,Americas
Sweden,22-06-2020,260274,2348,633,259641,Europe
Switzerland,22-06-2020,76852,2288,396,76456,Europe
Taiwan*,22-06-2020,373062,1160,278,372784,Western Pacific
Tanzania,22-06-2020,278177,1555,475,277702,Africa
Thailand,22-06-2020,384249,1825,251,383998,South-East Asia
Togo,22-06-2020,100026,1781,102,99924,Africa
Trinidad and Tobago,22-06-2020,1521,946,1210,311,Americas
Tunisia,22-06-2020,420985,1052,532,420453,Eastern Mediterranean
Turkey,22-06-2020,391984,969,73,391911,Europe
Uganda,22-06-2020,187200,1916,230,186970,Africa
Ukraine,22-06-2020,93790,1940,1102,92688,Europe
United Arab Emirates,22-06-2020,37162,539,923,36239,Eastern Mediterranean
United Kingdom,22-06-2020,288916,2183,558,288358,Europe
United Kingdom,22-06-2020,162743,1344,520,162223,Europe
United Kingdom,22-06-2020,72877,1542,680,72197,Europe
United Kingdom,22-06-2020,359314,359,1041,358273,Europe
United Kingdom,22-06-2020,393748,1770,915,392833,Europe
United Kingdom,22-06-2020,265770,1159,1233,264537,Europe
United Kingdom,22-06-2020,307626,2125,1026,306600,Europe
Uruguay,22-06-2020,385810,598,232,385578,Americas
US,22-06-2020,186767,1128,514,186253,Americas
Uzbekistan,22-06-2020,393735,2024,715,393020,Europe
Venezuela,22-06-2020,278608,1882,874,277734,Americas
Vietnam,22-06-2020,119829,1127,805,119024,Western Pacific
Zambia,22-06-2020,119039,1391,820,118219,Africa
Zimbabwe,22-06-2020,408947,809,289,408658,Africa
Dominica,22-06-2020,269322,916,225,269097,Americas
Grenada,22-06-2020,71102,2460,357,70745,Americas
Mozambique,22-06-2020,227330,1911,493,226837,Africa
Syria,22-06-2020,294813,644,182,294631,Eastern Mediterranean
Timor-Leste,22-06-2020,430887,214,1012,429875,South-East Asia
Belize,22-06-2020,435799,1593,324,435475,Americas
Laos,22-06-2020,332047,883,1129,330918,Western Pacific
Libya,22-06-2020,268188,1177,685,267503,Eastern Mediterranean
West Bank and Gaza,22-06-2020,172728,154,87,172641,Eastern Mediterranean
Guinea-Bissau,22-06-2020,401961,1665,975,400986,Africa
Mali,22-06-2020,113681,1469,50,113631,Africa
Saint Kitts and Nevis,22-06-2020,354075,1913,573,353502,Americas
Canada,22-06-2020,48610,686,743,47867,Americas
Canada,22-06-2020,285473,2265,957,284516,Americas
Kosovo,22-06-2020,311091,1753,110,310981,Europe
Burma,22-06-2020,135214,1835,356,134858,South-East Asia
United Kingdom,22-06-2020,166964,2444,1179,165785,Europe
United Kingdom,22-06-2020,67675,656,1228,66447,Europe
United Kingdom,22-06-2020,8887,1568,479,8408,Europe
Botswana,22-06-2020,154242,929,1126,153116,Africa
Burundi,22-06-2020,235694,677,1072,234622,Africa
Sierra Leone,22-06-2020,313955,1740,662,313293,Africa
Malawi,22-06-2020,444785,2361,345,444440,Africa
United Kingdom,22-06-2020,358833,2444,535,358298,Europe
France,22-06-2020,45742,106,505,45237,Europe
South Sudan,22-06-2020,344490,591,1010,343480,Africa
Western Sahara,22-06-2020,143341,1005,1249,142092,Africa
Sao Tome and Principe,22-06-2020,214905,1746,48,214857,Africa
Yemen,22-06-2020,130663,764,499,130164,Eastern Mediterranean
Comoros,22-06-2020,393552,2402,248,393304,Africa
Tajikistan,22-06-2020,373037,1632,172,372865,Europe
Lesotho,22-06-2020,276376,1564,1067,275309,Africa
Afghanistan,23-06-2020,110919,210,456,110463,Eastern Mediterranean
Albania,23-06-2020,347111,1250,1060,346051,Europe
Algeria,23-06-2020,308562,1955,977,307585,Africa
Andorra,23-06-2020,272526,1493,1100,271426,Europe
Angola,23-06-2020,352548,1645,651,351897,Africa
Antigua and Barbuda,23-06-2020,196744,1734,1228,195516,Americas
Argentina,23-06-2020,281108,1693,767,280341,Americas
Armenia,23-06-2020,382296,436,763,381533,Europe
Australia,23-06-2020,78522,2135,684,77838,Western Pacific
Australia,23-06-2020,227017,156,852,226165,Western Pacific
Australia,23-06-2020,326515,819,615,325900,Western Pacific
Australia,23-06-2020,338729,2489,962,337767,Western Pacific
Australia,23-06-2020,343935,492,498,343437,Western Pacific
Australia,23-06-2020,432884,2312,420,432464,Western Pacific
Australia,23-06-2020,4033,1528,158,3875,Western Pacific
Australia,23-06-2020,324750,1561,434,324316,Western Pacific
Austria,23-06-2020,388577,1869,589,387988,Europe
Azerbaijan,23-06-2020,294429,1533,561,293868,Europe
Bahamas,23-06-2020,442296,767,972,441324,Americas
Bahrain,23-06-2020,329156,1396,586,328570,Eastern Mediterranean
Bangladesh,23-06-2020,114918,2000,889,114029,South-East Asia
Barbados,23-06-2020,219745,1331,688,219057,Americas
Belarus,23-06-2020,385585,298,660,384925,Europe
Belgium,23-06-2020,422743,25,169,422574,Europe
Benin,23-06-2020,293655,531,791,292864,Africa
Bhutan,23-06-2020,383691,513,871,382820,South-East Asia
Bolivia,23-06-2020,112380,2343,950,111430,Americas
Bosnia and Herzegovina,23-06-2020,68869,1659,847,68022,Europe
Brazil,23-06-2020,280111,2047,802,279309,Americas
Brunei,23-06-2020,214179,464,823,213356,Western Pacific
Bulgaria,23-06-2020,112732,471,1176,111556,Europe
Burkina Faso,23-06-2020,143464,1906,912,142552,Africa
Cabo Verde,23-06-2020,109349,2170,1069,108280,Africa
Cambodia,23-06-2020,361092,2152,179,360913,Western Pacific
Cameroon,23-06-2020,280213,176,252,279961,Africa
Canada,23-06-2020,136451,1014,325,136126,Americas
Canada,23-06-2020,136823,1790,779,136044,Americas
Canada,23-06-2020,201022,568,1055,199967,Americas
Canada,23-06-2020,430031,627,617,429414,Americas
Canada,23-06-2020,146458,2085,93,146365,Americas
Canada,23-06-2020,149556,2141,933,148623,Americas
Canada,23-06-2020,194236,1214,820,193416,Americas
Canada,23-06-2020,114545,618,1242,113303,Americas
Canada,23-06-2020,305507,1403,496,305011,Americas
Canada,23-06-2020,262096,2286,307,261789,Americas
Central African Republic,23-06-2020,289725,2431,30,289695,Africa
Chad,23-06-2020,321754,1737,1191,320563,Africa
Chile,23-06-2020,3226,1295,905,2321,Americas
China,23-06-2020,142530,654,954,141576,Western Pacific
China,23-06-2020,279146,1890,466,278680,Western Pacific
China,23-06-2020,173133,2072,657,172476,Western Pacific
China,23-06-2020,48334,1644,689,47645,Western Pacific
China,23-06-2020,200512,2092,1001,199511,Western Pacific
China,23-06-2020,261408,7,30,261378,Western Pacific
China,23-06-2020,40004,2040,692,39312,Western Pacific
China,23-06-2020,431599,1070,579,431020,Western Pacific
China,23-06-2020,97017,1222,1139,95878,Western Pacific
China,23-06-2020,185671,1252,335,185336,Western Pacific
China,23-06-2020,176576,23,1079,175497,Western Pacific
China,23-06-2020,414860,811,287,414573,Western Pacific
China,23-06-2020,183983,1255,677,183306,Western Pacific
China,23-06-2020,148019,1306,1084,146935,Western Pacific
China,23-06-2020,36929,173,238,36691,Western Pacific
China,23-06-2020,413538,162,247,413291,Western Pacific
China,23-06-2020,250915,231,744,250171,Western Pacific
China,23-06-2020,350732,1431,268,350464,Western Pacific
China,23-06-2020,388484,1881,641,387843,Western Pacific
China,23-06-2020,422884,2221,878,422006,Western Pacific
China,23-06-2020,401082,3,429,400653,Western Pacific
China,23-06-2020,368440,392,738,367702,Western Pacific
China,23-06-2020,339842,1419,205,339637,Western Pacific
China,23-06-2020,327043,289,1002,326041,Western Pacific
China,23-06-2020,47386,1429,733,46653,Western Pacific
China,23-06-2020,88452,1199,984,87468,Western Pacific
China,23-06-2020,263877,1204,1202,262675,Western Pacific
China,23-06-2020,422622,1947,1083,421539,Western Pacific
China,23-06-2020,303125,762,281,302844,Western Pacific
China,23-06-2020,67521,2148,830,66691,Western Pacific
China,23-06-2020,257553,470,69,257484,Western Pacific
China,23-06-2020,150249,2150,1047,149202,Western Pacific
China,23-06-2020,308279,1854,23,308256,Western Pacific
Colombia,23-06-2020,367244,725,830,366414,Americas
Congo (Brazzaville),23-06-2020,416036,660,1052,414984,Africa
Congo (Kinshasa),23-06-2020,52742,2438,340,52402,Africa
Costa Rica,23-06-2020,438324,1847,541,437783,Americas
Cote d'Ivoire,23-06-2020,160815,1874,460,160355,Africa
Croatia,23-06-2020,280724,1596,1070,279654,Europe
Cuba,23-06-2020,108686,333,637,108049,Americas
Cyprus,23-06-2020,184940,1677,20,184920,Europe
Czechia,23-06-2020,217752,1359,575,217177,Europe
Denmark,23-06-2020,104786,2497,918,103868,Europe
Greenland,23-06-2020,173098,280,1045,172053,Europe
Denmark,23-06-2020,377105,1146,841,376264,Europe
Djibouti,23-06-2020,270160,1459,1065,269095,Eastern Mediterranean
Dominican Republic,23-06-2020,261186,1866,771,260415,Americas
Ecuador,23-06-2020,269246,828,92,269154,Americas
Egypt,23-06-2020,209183,789,263,208920,Eastern Mediterranean
El Salvador,23-06-2020,137413,1407,251,137162,Americas
Equatorial Guinea,23-06-2020,118568,2179,468,118100,Africa
Eritrea,23-06-2020,157015,1460,587,156428,Africa
Estonia,23-06-2020,709,647,11,698,Europe
Eswatini,23-06-2020,412193,687,1078,411115,Africa
Ethiopia,23-06-2020,219167,2146,691,218476,Africa
Fiji,23-06-2020,152251,2315,829,151422,Western Pacific
Finland,23-06-2020,142292,970,1220,141072,Europe
France,23-06-2020,122559,2367,526,122033,Europe
France,23-06-2020,365430,1169,306,365124,Europe
France,23-06-2020,14097,2266,477,13620,Europe
France,23-06-2020,368081,979,1096,366985,Europe
France,23-06-2020,191639,2191,1024,190615,Europe
France,23-06-2020,37719,1134,535,37184,Europe
France,23-06-2020,13045,917,162,12883,Europe
France,23-06-2020,334174,1605,957,333217,Europe
France,23-06-2020,191170,253,253,190917,Europe
France,23-06-2020,291535,1922,852,290683,Europe
Gabon,23-06-2020,122500,1771,1183,121317,Africa
Gambia,23-06-2020,122521,190,334,122187,Africa
Georgia,23-06-2020,342768,406,1237,341531,Europe
Germany,23-06-2020,119766,738,1228,118538,Europe
Ghana,23-06-2020,70122,2055,823,69299,Africa
Greece,23-06-2020,287522,33,1015,286507,Europe
Guatemala,23-06-2020,402090,2478,575,401515,Americas
Guinea,23-06-2020,66977,1372,1025,65952,Africa
Guyana,23-06-2020,267938,398,612,267326,Americas
Haiti,23-06-2020,267739,1283,366,267373,Americas
Holy See,23-06-2020,152550,1121,885,151665,Europe
Honduras,23-06-2020,427222,747,307,426915,Americas
Hungary,23-06-2020,7071,1229,1146,5925,Europe
Iceland,23-06-2020,297614,266,21,297593,Europe
India,23-06-2020,358400,1906,255,358145,South-East Asia
Indonesia,23-06-2020,175689,369,176,175513,South-East Asia
Iran,23-06-2020,347350,203,441,346909,Eastern Mediterranean
Iraq,23-06-2020,315017,645,311,314706,Eastern Mediterranean
Ireland,23-06-2020,361009,823,1240,359769,Europe
Israel,23-06-2020,196643,900,903,195740,Europe
Italy,23-06-2020,354517,33,726,353791,Europe
Jamaica,23-06-2020,21506,143,802,20704,Americas
Japan,23-06-2020,185374,1676,985,184389,Western Pacific
Jordan,23-06-2020,177547,1819,381,177166,Eastern Mediterranean
Kazakhstan,23-06-2020,247148,2064,911,246237,Europe
Kenya,23-06-2020,206513,1274,695,205818,Africa
South Korea,23-06-2020,330735,69,814,329921,Western Pacific
Kuwait,23-06-2020,298704,861,228,298476,Eastern Mediterranean
Kyrgyzstan,23-06-2020,391876,1324,12,391864,Europe
Latvia,23-06-2020,46910,515,39,46871,Europe
Lebanon,23-06-2020,291234,1965,396,290838,Eastern Mediterranean
Liberia,23-06-2020,267397,1588,1248,266149,Africa
Liechtenstein,23-06-2020,363113,1446,362,362751,Europe
Lithuania,23-06-2020,219408,635,468,218940,Europe
Luxembourg,23-06-2020,24399,308,470,23929,Europe
Madagascar,23-06-2020,20610,1679,233,20377,Africa
Malaysia,23-06-2020,337805,2443,1250,336555,Western Pacific
Maldives,23-06-2020,414426,2344,0,414426,South-East Asia
Malta,23-06-2020,43484,1391,332,43152,Europe
Mauritania,23-06-2020,242160,1445,498,241662,Africa
Mauritius,23-06-2020,334055,2093,301,333754,Africa
Mexico,23-06-2020,118186,1310,187,117999,Americas
Moldova,23-06-2020,287387,817,1041,286346,Europe
Monaco,23-06-2020,49028,1808,395,48633,Europe
Mongolia,23-06-2020,156924,1743,481,156443,Western Pacific
Montenegro,23-06-2020,338968,1922,1167,337801,Europe
Morocco,23-06-2020,317903,2187,154,317749,Eastern Mediterranean
Namibia,23-06-2020,355590,1444,248,355342,Africa
Nepal,23-06-2020,9439,2116,1230,8209,South-East Asia
Netherlands,23-06-2020,380134,1821,152,379982,Europe
Netherlands,23-06-2020,249737,204,419,249318,Europe
Netherlands,23-06-2020,225642,1873,1111,224531,Europe
Netherlands,23-06-2020,254247,1679,765,253482,Europe
New Zealand,23-06-2020,94734,1451,936,93798,Western Pacific
Nicaragua,23-06-2020,259121,1689,302,258819,Americas
Niger,23-06-2020,79406,1424,1173,78233,Africa
Nigeria,23-06-2020,369062,731,30,369032,Africa
North Macedonia,23-06-2020,177747,278,1201,176546,Europe
Norway,23-06-2020,392929,1219,1070,391859,Europe
Oman,23-06-2020,47529,299,1167,46362,Eastern Mediterranean
Pakistan,23-06-2020,128463,1105,145,128318,Eastern Mediterranean
Panama,23-06-2020,255020,263,1145,253875,Americas
Papua New Guinea,23-06-2020,316535,523,816,315719,Western Pacific
Paraguay,23-06-2020,303006,1533,590,302416,Americas
Peru,23-06-2020,431397,806,879,430518,Americas
Philippines,23-06-2020,391212,1038,46,391166,Western Pacific
Poland,23-06-2020,127763,1506,789,126974,Europe
Portugal,23-06-2020,261040,618,493,260547,Europe
Qatar,23-06-2020,448601,1448,33,448568,Eastern Mediterranean
Romania,23-06-2020,398091,1611,469,397622,Europe
Russia,23-06-2020,39642,1805,1061,38581,Europe
Rwanda,23-06-2020,301990,254,823,301167,Africa
Saint Lucia,23-06-2020,317490,1127,1031,316459,Americas
Saint Vincent and the Grenadines,23-06-2020,89560,11,759,88801,Americas
San Marino,23-06-2020,398140,901,1199,396941,Europe
Saudi Arabia,23-06-2020,60446,1632,1125,59321,Eastern Mediterranean
Senegal,23-06-2020,52047,95,345,51702,Africa
Serbia,23-06-2020,180497,785,695,179802,Europe
Seychelles,23-06-2020,306840,1911,490,306350,Africa
Singapore,23-06-2020,239616,94,1010,238606,Western Pacific
Slovakia,23-06-2020,181091,1816,1246,179845,Europe
Slovenia,23-06-2020,186055,2237,1092,184963,Europe
Somalia,23-06-2020,427639,305,290,427349,Eastern Mediterranean
South Africa,23-06-2020,260107,294,697,259410,Africa
Spain,23-06-2020,396062,1926,414,395648,Europe
Sri Lanka,23-06-2020,91898,2496,114,91784,South-East Asia
Sudan,23-06-2020,397126,654,723,396403,Eastern Mediterranean
Suriname,23-06-2020,254120,1689,1208,252912,Americas
Sweden,23-06-2020,233810,235,131,233679,Europe
Switzerland,23-06-2020,437027,1347,487,436540,Europe
Taiwan*,23-06-2020,304201,702,725,303476,Western Pacific
Tanzania,23-06-2020,184444,1488,759,183685,Africa
Thailand,23-06-2020,141678,1619,1241,140437,South-East Asia
Togo,23-06-2020,242970,112,1129,241841,Africa
Trinidad and Tobago,23-06-2020,121911,2066,835,121076,Americas
Tunisia,23-06-2020,61039,843,586,60453,Eastern Mediterranean
Turkey,23-06-2020,356999,1779,326,356673,Europe
Uganda,23-06-2020,162921,142,346,162575,Africa
Ukraine,23-06-2020,44405,1718,1198,43207,Europe
United Arab Emirates,23-06-2020,27791,2461,389,27402,Eastern Mediterranean
United Kingdom,23-06-2020,149601,2160,396,149205,Europe
United Kingdom,23-06-2020,112884,573,568,112316,Europe
United Kingdom,23-06-2020,17302,2029,742,16560,Europe
United Kingdom,23-06-2020,351072,1971,57,351015,Europe
United Kingdom,23-06-2020,297859,973,197,297662,Europe
United Kingdom,23-06-2020,185811,458,190,185621,Europe
United Kingdom,23-06-2020,383248,2013,71,383177,Europe
Uruguay,23-06-2020,147027,635,662,146365,Americas
US,23-06-2020,245810,1442,874,244936,Americas
Uzbekistan,23-06-2020,433147,2093,538,432609,Europe
Venezuela,23-06-2020,334807,2425,1130,333677,Americas
Vietnam,23-06-2020,221987,24,1231,220756,Western Pacific
Zambia,23-06-2020,291267,2200,86,291181,Africa
Zimbabwe,23-06-2020,401594,1416,1012,400582,Africa
Dominica,23-06-2020,145253,1196,47,145206,Americas
Grenada,23-06-2020,93519,1357,957,92562,Americas
Mozambique,23-06-2020,288097,2427,516,287581,Africa
Syria,23-06-2020,422243,2359,982,421261,Eastern Mediterranean
Timor-Leste,23-06-2020,7105,364,448,6657,South-East Asia
Belize,23-06-2020,156704,1107,450,156254,Americas
Laos,23-06-2020,175196,2047,13,175183,Western Pacific
Libya,23-06-2020,418525,500,1127,417398,Eastern Mediterranean
West Bank and Gaza,23-06-2020,198588,388,991,197597,Eastern Mediterranean
Guinea-Bissau,23-06-2020,449997,1844,1198,448799,Africa
Mali,23-06-2020,295194,65,154,295040,Africa
Saint Kitts and Nevis,23-06-2020,198477,754,1053,197424,Americas
Canada,23-06-2020,335644,82,112,335532,Americas
Canada,23-06-2020,395632,13,32,395600,Americas
Kosovo,23-06-2020,23203,468,1179,22024,Europe
Burma,23-06-2020,428066,432,914,427152,South-East Asia
United Kingdom,23-06-2020,321991,2040,189,321802,Europe
United Kingdom,23-06-2020,265580,295,875,264705,Europe
United Kingdom,23-06-2020,184749,919,1188,183561,Europe
Botswana,23-06-2020,123470,21,26,123444,Africa
Burundi,23-06-2020,362188,2293,506,361682,Africa
Sierra Leone,23-06-2020,239134,730,1069,238065,Africa
Malawi,23-06-2020,259641,264,464,259177,Africa
United Kingdom,23-06-2020,330343,1868,740,329603,Europe
France,23-06-2020,262280,1089,94,262186,Europe
South Sudan,23-06-2020,158027,1859,910,157117,Africa
Western Sahara,23-06-2020,9873,383,1144,8729,Africa
Sao Tome and Principe,23-06-2020,125625,1004,341,125284,Africa
Yemen,23-06-2020,359986,638,1204,358782,Eastern Mediterranean
Comoros,23-06-2020,413430,2184,640,412790,Africa
Tajikistan,23-06-2020,426736,2311,1250,425486,Europe
Lesotho,23-06-2020,99354,1091,1012,98342,Africa
Afghanistan,24-06-2020,98361,1015,726,97635,Eastern Mediterranean
Albania,24-06-2020,1913,1828,1196,717,Europe
Algeria,24-06-2020,304441,34,1124,303317,Africa
Andorra,24-06-2020,441805,589,302,441503,Europe
Angola,24-06-2020,179908,363,42,179866,Africa
Antigua and Barbuda,24-06-2020,213311,2252,899,212412,Americas
Argentina,24-06-2020,223239,963,1166,222073,Americas
Armenia,24-06-2020,166069,2258,311,165758,Europe
Australia,24-06-2020,248952,1881,463,248489,Western Pacific
Australia,24-06-2020,104292,1182,631,103661,Western Pacific
Australia,24-06-2020,434703,82,454,434249,Western Pacific
Australia,24-06-2020,214987,2276,587,214400,Western Pacific
Australia,24-06-2020,410341,1378,0,410341,Western Pacific
Australia,24-06-2020,430501,461,212,430289,Western Pacific
Australia,24-06-2020,112324,1619,1135,111189,Western Pacific
Australia,24-06-2020,240144,949,216,239928,Western Pacific
Austria,24-06-2020,351550,767,455,351095,Europe
Azerbaijan,24-06-2020,3806,486,643,3163,Europe
Bahamas,24-06-2020,306698,2495,526,306172,Americas
Bahrain,24-06-2020,435319,2428,155,435164,Eastern Mediterranean
Bangladesh,24-06-2020,257050,446,825,256225,South-East Asia
Barbados,24-06-2020,438119,1027,1017,437102,Americas
Belarus,24-06-2020,261624,485,1116,260508,Europe
Belgium,24-06-2020,185521,2484,424,185097,Europe
Benin,24-06-2020,134712,2153,15,134697,Africa
Bhutan,24-06-2020,301510,837,325,301185,South-East Asia
Bolivia,24-06-2020,250379,1241,1245,249134,Americas
Bosnia and Herzegovina,24-06-2020,57976,1724,1159,56817,Europe
Brazil,24-06-2020,397162,58,1113,396049,Americas
Brunei,24-06-2020,330101,2315,504,329597,Western Pacific
Bulgaria,24-06-2020,135337,1350,759,134578,Europe
Burkina Faso,24-06-2020,358953,1041,98,358855,Africa
Cabo Verde,24-06-2020,282780,101,612,282168,Africa
Cambodia,24-06-2020,36146,735,1134,35012,Western Pacific
Cameroon,24-06-2020,295070,416,1187,293883,Africa
Canada,24-06-2020,60679,1335,853,59826,Americas
Canada,24-06-2020,153569,2006,927,152642,Americas
Canada,24-06-2020,255348,533,386,254962,Americas
Canada,24-06-2020,8075,2009,275,7800,Americas
Canada,24-06-2020,387121,517,122,386999,Americas
Canada,24-06-2020,259080,2241,692,258388,Americas
Canada,24-06-2020,202276,2308,1136,201140,Americas
Canada,24-06-2020,161400,922,644,160756,Americas
Canada,24-06-2020,379606,169,1129,378477,Americas
Canada,24-06-2020,425486,1142,640,424846,Americas
Central African Republic,24-06-2020,194299,1470,1201,193098,Africa
Chad,24-06-2020,223985,768,1130,222855,Africa
Chile,24-06-2020,55241,747,925,54316,Americas
China,24-06-2020,229278,1024,295,228983,Western Pacific
China,24-06-2020,326733,1040,1076,325657,Western Pacific
China,24-06-2020,447894,505,1103,446791,Western Pacific
China,24-06-2020,423861,1781,581,423280,Western Pacific
China,24-06-2020,320660,759,755,319905,Western Pacific
China,24-06-2020,264568,209,301,264267,Western Pacific
China,24-06-2020,303318,143,826,302492,Western Pacific
China,24-06-2020,153626,2181,445,153181,Western Pacific
China,24-06-2020,53858,1256,829,53029,Western Pacific
China,24-06-2020,97267,1681,956,96311,Western Pacific
China,24-06-2020,152319,678,821,151498,Western Pacific
China,24-06-2020,219851,243,1004,218847,Western Pacific
China,24-06-2020,118942,2491,335,118607,Western Pacific
China,24-06-2020,7082,500,560,6522,Western Pacific
China,24-06-2020,138364,1178,679,137685,Western Pacific
China,24-06-2020,413078,784,879,412199,Western Pacific
China,24-06-2020,127715,537,35,127680,Western Pacific
China,24-06-2020,224114,890,844,223270,Western Pacific
China,24-06-2020,1811,360,1189,622,Western Pacific
China,24-06-2020,97178,1997,168,97010,Western Pacific
China,24-06-2020,366758,966,367,366391,Western Pacific
China,24-06-2020,259246,1345,644,258602,Western Pacific
China,24-06-2020,270040,2385,244,269796,Western Pacific
China,24-06-2020,280278,1873,872,279406,Western Pacific
China,24-06-2020,251177,2357,255,250922,Western Pacific
China,24-06-2020,411317,168,1140,410177,Western Pacific
China,24-06-2020,334255,685,148,334107,Western Pacific
China,24-06-2020,276862,2201,1099,275763,Western Pacific
China,24-06-2020,414818,1241,505,414313,Western Pacific
China,24-06-2020,372095,340,15,372080,Western Pacific
China,24-06-2020,106577,270,646,105931,Western Pacific
China,24-06-2020,139632,1776,962,138670,Western Pacific
China,24-06-2020,400524,1077,32,400492,Western Pacific
Colombia,24-06-2020,297226,1062,109,297117,Americas
Congo (Brazzaville),24-06-2020,343678,498,176,343502,Africa
Congo (Kinshasa),24-06-2020,303949,2355,114,303835,Africa
Costa Rica,24-06-2020,1820,834,916,904,Americas
Cote d'Ivoire,24-06-2020,11762,220,861,10901,Africa
Croatia,24-06-2020,264891,2257,378,264513,Europe
Cuba,24-06-2020,198447,559,54,198393,Americas
Cyprus,24-06-2020,401247,2369,362,400885,Europe
Czechia,24-06-2020,120056,412,630,119426,Europe
Denmark,24-06-2020,171646,938,1100,170546,Europe
Greenland,24-06-2020,90874,1099,287,90587,Europe
Denmark,24-06-2020,385745,501,119,385626,Europe
Djibouti,24-06-2020,111957,689,719,111238,Eastern Mediterranean
Dominican Republic,24-06-2020,66660,791,296,66364,Americas
Ecuador,24-06-2020,139976,1779,1162,138814,Americas
Egypt,24-06-2020,56697,1944,1148,55549,Eastern Mediterranean
El Salvador,24-06-2020,289341,452,125,289216,Americas
Equatorial Guinea,24-06-2020,274878,2283,576,274302,Africa
Eritrea,24-06-2020,278716,726,233,278483,Africa
Estonia,24-06-2020,351656,1281,424,351232,Europe
Eswatini,24-06-2020,84851,260,46,84805,Africa
Ethiopia,24-06-2020,15795,2140,203,15592,Africa
Fiji,24-06-2020,395285,1236,1105,394180,Western Pacific
Finland,24-06-2020,22993,16,704,22289,Europe
France,24-06-2020,446334,1179,34,446300,Europe
France,24-06-2020,862,613,358,504,Europe
France,24-06-2020,449015,2338,1067,447948,Europe
France,24-06-2020,252125,1278,308,251817,Europe
France,24-06-2020,159217,2323,996,158221,Europe
France,24-06-2020,63152,1532,90,63062,Europe
France,24-06-2020,416003,1566,1056,414947,Europe
France,24-06-2020,50480,183,304,50176,Europe
France,24-06-2020,147094,1047,835,146259,Europe
France,24-06-2020,410061,2282,316,409745,Europe
Gabon,24-06-2020,300630,1886,750,299880,Africa
Gambia,24-06-2020,347448,1702,351,347097,Africa
Georgia,24-06-2020,186947,2085,319,186628,Europe
Germany,24-06-2020,246353,2057,1006,245347,Europe
Ghana,24-06-2020,412193,289,340,411853,Africa
Greece,24-06-2020,338921,538,15,338906,Europe
Guatemala,24-06-2020,107977,2098,673,107304,Americas
Guinea,24-06-2020,112818,1510,1125,111693,Africa
Guyana,24-06-2020,86879,526,102,86777,Americas
Haiti,24-06-2020,178934,189,167,178767,Americas
Holy See,24-06-2020,224385,1805,15,224370,Europe
Honduras,24-06-2020,79691,783,465,79226,Americas
Hungary,24-06-2020,79802,436,1186,78616,Europe
Iceland,24-06-2020,388457,2422,215,388242,Europe
India,24-06-2020,129480,2049,1194,128286,South-East Asia
Indonesia,24-06-2020,202501,1260,97,202404,South-East Asia
Iran,24-06-2020,162940,406,494,162446,Eastern Mediterranean
Iraq,24-06-2020,260731,1958,1182,259549,Eastern Mediterranean
Ireland,24-06-2020,252066,2153,1234,250832,Europe
Israel,24-06-2020,76992,1303,20,76972,Europe
Italy,24-06-2020,133709,1082,599,133110,Europe
Jamaica,24-06-2020,401161,839,987,400174,Americas
Japan,24-06-2020,401822,1511,423,401399,Western Pacific
Jordan,24-06-2020,121504,1084,179,121325,Eastern Mediterranean
Kazakhstan,24-06-2020,410736,123,77,410659,Europe
Kenya,24-06-2020,19753,858,598,19155,Africa
South Korea,24-06-2020,200305,1053,200,200105,Western Pacific
Kuwait,24-06-2020,16800,546,434,16366,Eastern Mediterranean
Kyrgyzstan,24-06-2020,41772,1713,154,41618,Europe
Latvia,24-06-2020,422916,941,595,422321,Europe
Lebanon,24-06-2020,216530,2114,40,216490,Eastern Mediterranean
Liberia,24-06-2020,143251,34,1099,142152,Africa
Liechtenstein,24-06-2020,415588,559,634,414954,Europe
Lithuania,24-06-2020,81602,433,1237,80365,Europe
Luxembourg,24-06-2020,9501,19,304,9197,Europe
Madagascar,24-06-2020,434222,436,756,433466,Africa
Malaysia,24-06-2020,279276,1835,851,278425,Western Pacific
Maldives,24-06-2020,376314,2167,1038,375276,South-East Asia
Malta,24-06-2020,112609,1651,38,112571,Europe
Mauritania,24-06-2020,306022,798,1039,304983,Africa
Mauritius,24-06-2020,83528,304,39,83489,Africa
Mexico,24-06-2020,337053,360,1246,335807,Americas
Moldova,24-06-2020,43379,1091,149,43230,Europe
Monaco,24-06-2020,297733,1116,499,297234,Europe
Mongolia,24-06-2020,88667,699,823,87844,Western Pacific
Montenegro,24-06-2020,75708,2108,1003,74705,Europe
Morocco,24-06-2020,49990,1088,993,48997,Eastern Mediterranean
Namibia,24-06-2020,62680,323,822,61858,Africa
Nepal,24-06-2020,121635,2430,763,120872,South-East Asia
Netherlands,24-06-2020,8290,1517,738,7552,Europe
Netherlands,24-06-2020,334164,1000,134,334030,Europe
Netherlands,24-06-2020,86714,1315,307,86407,Europe
Netherlands,24-06-2020,101561,1914,527,101034,Europe
New Zealand,24-06-2020,316746,858,778,315968,Western Pacific
Nicaragua,24-06-2020,201515,545,795,200720,Americas
Niger,24-06-2020,324356,705,1222,323134,Africa
Nigeria,24-06-2020,265753,2124,1097,264656,Africa
North Macedonia,24-06-2020,362014,2381,858,361156,Europe
Norway,24-06-2020,411495,1349,34,411461,Europe
Oman,24-06-2020,308714,1297,164,308550,Eastern Mediterranean
Pakistan,24-06-2020,301314,2010,223,301091,Eastern Mediterranean
Panama,24-06-2020,373201,2411,440,372761,Americas
Papua New Guinea,24-06-2020,449843,75,1162,448681,Western Pacific
Paraguay,24-06-2020,310530,852,1069,309461,Americas
Peru,24-06-2020,349912,1325,81,349831,Americas
Philippines,24-06-2020,435945,1217,435,435510,Western Pacific
Poland,24-06-2020,396886,1474,916,395970,Europe
Portugal,24-06-2020,370307,2206,315,369992,Europe
Qatar,24-06-2020,48350,287,1043,47307,Eastern Mediterranean
Romania,24-06-2020,237756,820,564,237192,Europe
Russia,24-06-2020,361770,1608,470,361300,Europe
Rwanda,24-06-2020,102727,1662,406,102321,Africa
Saint Lucia,24-06-2020,25330,1078,54,25276,Americas
Saint Vincent and the Grenadines,24-06-2020,149547,1663,1011,148536,Americas
San Marino,24-06-2020,7385,1628,1080,6305,Europe
Saudi Arabia,24-06-2020,41215,142,987,40228,Eastern Mediterranean
Senegal,24-06-2020,338718,512,257,338461,Africa
Serbia,24-06-2020,17669,755,913,16756,Europe
Seychelles,24-06-2020,272645,775,79,272566,Africa
Singapore,24-06-2020,30624,2452,287,30337,Western Pacific
Slovakia,24-06-2020,377712,1674,292,377420,Europe
Slovenia,24-06-2020,5458,1955,251,5207,Europe
Somalia,24-06-2020,88782,1651,1207,87575,Eastern Mediterranean
South Africa,24-06-2020,269116,1572,209,268907,Africa
Spain,24-06-2020,180667,697,691,179976,Europe
Sri Lanka,24-06-2020,292997,849,934,292063,South-East Asia
Sudan,24-06-2020,313664,1751,711,312953,Eastern Mediterranean
Suriname,24-06-2020,198205,2469,967,197238,Americas
Sweden,24-06-2020,53452,1289,845,52607,Europe
Switzerland,24-06-2020,65902,14,413,65489,Europe
Taiwan*,24-06-2020,69381,1888,944,68437,Western Pacific
Tanzania,24-06-2020,102501,1813,320,102181,Africa
Thailand,24-06-2020,64750,138,1055,63695,South-East Asia
Togo,24-06-2020,284864,2256,901,283963,Africa
Trinidad and Tobago,24-06-2020,256105,704,1244,254861,Americas
Tunisia,24-06-2020,143217,1581,872,142345,Eastern Mediterranean
Turkey,24-06-2020,219538,2398,992,218546,Europe
Uganda,24-06-2020,119936,2251,85,119851,Africa
Ukraine,24-06-2020,370902,2007,722,370180,Europe
United Arab Emirates,24-06-2020,438371,202,1193,437178,Eastern Mediterranean
United Kingdom,24-06-2020,103398,44,857,102541,Europe
United Kingdom,24-06-2020,138984,960,565,138419,Europe
United Kingdom,24-06-2020,152600,1780,61,152539,Europe
United Kingdom,24-06-2020,460,125,320,140,Europe
United Kingdom,24-06-2020,290478,1362,237,290241,Europe
United Kingdom,24-06-2020,244245,507,964,243281,Europe
United Kingdom,24-06-2020,330410,81,1077,329333,Europe
Uruguay,24-06-2020,414804,2146,100,414704,Americas
US,24-06-2020,367420,1020,756,366664,Americas
Uzbekistan,24-06-2020,60242,45,22,60220,Europe
Venezuela,24-06-2020,380386,2056,499,379887,Americas
Vietnam,24-06-2020,386314,335,264,386050,Western Pacific
Zambia,24-06-2020,61140,2305,210,60930,Africa
Zimbabwe,24-06-2020,211665,249,800,210865,Africa
Dominica,24-06-2020,127864,31,557,127307,Americas
Grenada,24-06-2020,370273,578,962,369311,Americas
Mozambique,24-06-2020,77502,2254,1028,76474,Africa
Syria,24-06-2020,60328,2499,868,59460,Eastern Mediterranean
Timor-Leste,24-06-2020,385527,361,72,385455,South-East Asia
Belize,24-06-2020,210884,1953,853,210031,Americas
Laos,24-06-2020,302333,2019,467,301866,Western Pacific
Libya,24-06-2020,1836,287,269,1567,Eastern Mediterranean
West Bank and Gaza,24-06-2020,128487,1264,663,127824,Eastern Mediterranean
Guinea-Bissau,24-06-2020,298728,1152,1180,297548,Africa
Mali,24-06-2020,398024,1455,103,397921,Africa
Saint Kitts and Nevis,24-06-2020,419063,401,860,418203,Americas
Canada,24-06-2020,202562,1102,1001,201561,Americas
Canada,24-06-2020,142981,2325,495,142486,Americas
Kosovo,24-06-2020,77606,1653,88,77518,Europe
Burma,24-06-2020,80300,64,1003,79297,South-East Asia
United Kingdom,24-06-2020,48131,2428,748,47383,Europe
United Kingdom,24-06-2020,395770,476,473,395297,Europe
United Kingdom,24-06-2020,418707,697,651,418056,Europe
Botswana,24-06-2020,100044,1155,166,99878,Africa
Burundi,24-06-2020,217772,1863,1188,216584,Africa
Sierra Leone,24-06-2020,248029,146,326,247703,Africa
Malawi,24-06-2020,281921,1569,1094,280827,Africa
United Kingdom,24-06-2020,220241,34,927,219314,Europe
France,24-06-2020,419551,1556,67,419484,Europe
South Sudan,24-06-2020,441786,1125,399,441387,Africa
Western Sahara,24-06-2020,12734,554,5,12729,Africa
Sao Tome and Principe,24-06-2020,289304,486,394,288910,Africa
Yemen,24-06-2020,27324,1181,1213,26111,Eastern Mediterranean
Comoros,24-06-2020,383166,1508,693,382473,Africa
Tajikistan,24-06-2020,378328,1611,444,377884,Europe
Lesotho,24-06-2020,26972,2009,340,26632,Africa
Afghanistan,25-06-2020,61424,544,1005,60419,Eastern Mediterranean
Albania,25-06-2020,377759,2067,721,377038,Europe
Algeria,25-06-2020,293568,472,676,292892,Africa
Andorra,25-06-2020,61148,1932,981,60167,Europe
Angola,25-06-2020,332336,762,473,331863,Africa
Antigua and Barbuda,25-06-2020,195777,472,235,195542,Americas
Argentina,25-06-2020,54201,2329,182,54019,Americas
Armenia,25-06-2020,337744,335,696,337048,Europe
Australia,25-06-2020,4413,769,744,3669,Western Pacific
Australia,25-06-2020,62091,74,824,61267,Western Pacific
Australia,25-06-2020,384916,977,575,384341,Western Pacific
Australia,25-06-2020,51536,550,810,50726,Western Pacific
Australia,25-06-2020,128532,981,321,128211,Western Pacific
Australia,25-06-2020,369693,179,386,369307,Western Pacific
Australia,25-06-2020,254407,657,1037,253370,Western Pacific
Australia,25-06-2020,411791,565,573,411218,Western Pacific
Austria,25-06-2020,311522,2112,120,311402,Europe
Azerbaijan,25-06-2020,428644,1592,471,428173,Europe
Bahamas,25-06-2020,186434,2317,58,186376,Americas
Bahrain,25-06-2020,346920,1902,508,346412,Eastern Mediterranean
Bangladesh,25-06-2020,252736,1438,1159,251577,South-East Asia
Barbados,25-06-2020,363826,1618,498,363328,Americas
Belarus,25-06-2020,147433,1188,209,147224,Europe
Belgium,25-06-2020,40768,1736,516,40252,Europe
Benin,25-06-2020,437770,1279,816,436954,Africa
Bhutan,25-06-2020,129187,567,704,128483,South-East Asia
Bolivia,25-06-2020,86921,1418,819,86102,Americas
Bosnia and Herzegovina,25-06-2020,340522,2375,1183,339339,Europe
Brazil,25-06-2020,46230,125,329,45901,Americas
Brunei,25-06-2020,259611,2423,102,259509,Western Pacific
Bulgaria,25-06-2020,374169,84,621,373548,Europe
Burkina Faso,25-06-2020,411424,2094,913,410511,Africa
Cabo Verde,25-06-2020,268732,2461,226,268506,Africa
Cambodia,25-06-2020,308955,454,395,308560,Western Pacific
Cameroon,25-06-2020,47598,157,1062,46536,Africa
Canada,25-06-2020,419866,2391,808,419058,Americas
Canada,25-06-2020,188343,112,130,188213,Americas
Canada,25-06-2020,96118,2434,100,96018,Americas
Canada,25-06-2020,250633,2455,1122,249511,Americas
Canada,25-06-2020,438864,456,376,438488,Americas
Canada,25-06-2020,198968,63,167,198801,Americas
Canada,25-06-2020,427234,571,229,427005,Americas
Canada,25-06-2020,343813,695,1132,342681,Americas
Canada,25-06-2020,160119,15,182,159937,Americas
Canada,25-06-2020,374510,92,561,373949,Americas
Central African Republic,25-06-2020,72478,37,1073,71405,Africa
Chad,25-06-2020,136518,2174,943,135575,Africa
Chile,25-06-2020,170575,2214,723,169852,Americas
China,25-06-2020,221430,2114,833,220597,Western Pacific
China,25-06-2020,302603,543,1029,301574,Western Pacific
China,25-06-2020,258647,889,599,258048,Western Pacific
China,25-06-2020,430653,1256,481,430172,Western Pacific
China,25-06-2020,59812,11,981,58831,Western Pacific
China,25-06-2020,271067,2084,211,270856,Western Pacific
China,25-06-2020,390396,2268,1128,389268,Western Pacific
China,25-06-2020,358406,1903,1190,357216,Western Pacific
China,25-06-2020,209833,2280,806,209027,Western Pacific
China,25-06-2020,379311,585,1080,378231,Western Pacific
China,25-06-2020,424220,1048,129,424091,Western Pacific
China,25-06-2020,249982,1001,577,249405,Western Pacific
China,25-06-2020,371836,1052,569,371267,Western Pacific
China,25-06-2020,152009,343,1195,150814,Western Pacific
China,25-06-2020,397906,1833,930,396976,Western Pacific
China,25-06-2020,12508,1044,428,12080,Western Pacific
China,25-06-2020,158194,987,862,157332,Western Pacific
China,25-06-2020,118801,1491,715,118086,Western Pacific
China,25-06-2020,112937,2023,1045,111892,Western Pacific
China,25-06-2020,38794,1621,543,38251,Western Pacific
China,25-06-2020,10555,1505,496,10059,Western Pacific
China,25-06-2020,121422,1030,288,121134,Western Pacific
China,25-06-2020,76845,1678,873,75972,Western Pacific
China,25-06-2020,82925,1343,1203,81722,Western Pacific
China,25-06-2020,246919,2478,1232,245687,Western Pacific
China,25-06-2020,117733,1714,577,117156,Western Pacific
China,25-06-2020,122649,1543,206,122443,Western Pacific
China,25-06-2020,313104,1015,159,312945,Western Pacific
China,25-06-2020,261266,479,273,260993,Western Pacific
China,25-06-2020,228646,2359,584,228062,Western Pacific
China,25-06-2020,239091,100,1014,238077,Western Pacific
China,25-06-2020,71854,1628,456,71398,Western Pacific
China,25-06-2020,235101,603,1211,233890,Western Pacific
Colombia,25-06-2020,126490,1760,601,125889,Americas
Congo (Brazzaville),25-06-2020,409896,1034,421,409475,Africa
Congo (Kinshasa),25-06-2020,430611,1089,452,430159,Africa
Costa Rica,25-06-2020,10706,790,240,10466,Americas
Cote d'Ivoire,25-06-2020,34497,1741,685,33812,Africa
Croatia,25-06-2020,396294,2239,243,396051,Europe
Cuba,25-06-2020,52783,785,1062,51721,Americas
Cyprus,25-06-2020,70513,2397,9,70504,Europe
Czechia,25-06-2020,65549,1779,0,65549,Europe
Denmark,25-06-2020,84370,647,1074,83296,Europe
Greenland,25-06-2020,270946,1619,338,270608,Europe
Denmark,25-06-2020,131222,2456,267,130955,Europe
Djibouti,25-06-2020,289555,1378,988,288567,Eastern Mediterranean
Dominican Republic,25-06-2020,378394,2218,375,378019,Americas
Ecuador,25-06-2020,355540,2236,387,355153,Americas
Egypt,25-06-2020,243453,178,2,243451,Eastern Mediterranean
El Salvador,25-06-2020,396975,1049,176,396799,Americas
Equatorial Guinea,25-06-2020,247842,1588,53,247789,Africa
Eritrea,25-06-2020,7542,133,454,7088,Africa
Estonia,25-06-2020,303121,68,633,302488,Europe
Eswatini,25-06-2020,253097,901,412,252685,Africa
Ethiopia,25-06-2020,383312,1080,445,382867,Africa
Fiji,25-06-2020,275041,1394,701,274340,Western Pacific
Finland,25-06-2020,415684,288,303,415381,Europe
France,25-06-2020,153198,882,260,152938,Europe
France,25-06-2020,113821,863,974,112847,Europe
France,25-06-2020,332556,2463,700,331856,Europe
France,25-06-2020,297351,1619,715,296636,Europe
France,25-06-2020,320114,1994,414,319700,Europe
France,25-06-2020,192935,2212,273,192662,Europe
France,25-06-2020,382616,570,453,382163,Europe
France,25-06-2020,417990,1290,879,417111,Europe
France,25-06-2020,337077,2398,304,336773,Europe
France,25-06-2020,51004,2346,811,50193,Europe
Gabon,25-06-2020,290016,1753,1012,289004,Africa
Gambia,25-06-2020,321176,2326,1019,320157,Africa
Georgia,25-06-2020,122911,1654,830,122081,Europe
Germany,25-06-2020,186668,1359,951,185717,Europe
Ghana,25-06-2020,258362,2016,969,257393,Africa
Greece,25-06-2020,309944,1777,1058,308886,Europe
Guatemala,25-06-2020,316589,295,921,315668,Americas
Guinea,25-06-2020,343242,2495,638,342604,Africa
Guyana,25-06-2020,235587,1688,498,235089,Americas
Haiti,25-06-2020,166194,1338,852,165342,Americas
Holy See,25-06-2020,133673,1328,1031,132642,Europe
Honduras,25-06-2020,314294,2091,1243,313051,Americas
Hungary,25-06-2020,230161,1841,861,229300,Europe
Iceland,25-06-2020,353806,45,550,353256,Europe
India,25-06-2020,293564,1665,785,292779,South-East Asia
Indonesia,25-06-2020,186091,115,849,185242,South-East Asia
Iran,25-06-2020,420420,1537,856,419564,Eastern Mediterranean
Iraq,25-06-2020,63781,530,544,63237,Eastern Mediterranean
Ireland,25-06-2020,88765,1697,398,88367,Europe
Israel,25-06-2020,299261,477,667,298594,Europe
Italy,25-06-2020,439097,2251,52,439045,Europe
Jamaica,25-06-2020,78546,648,1036,77510,Americas
Japan,25-06-2020,101066,613,816,100250,Western Pacific
Jordan,25-06-2020,256234,461,330,255904,Eastern Mediterranean
Kazakhstan,25-06-2020,261923,1527,545,261378,Europe
Kenya,25-06-2020,325908,359,1229,324679,Africa
South Korea,25-06-2020,216663,953,823,215840,Western Pacific
Kuwait,25-06-2020,178614,2222,570,178044,Eastern Mediterranean
Kyrgyzstan,25-06-2020,319887,830,81,319806,Europe
Latvia,25-06-2020,24967,595,1209,23758,Europe
Lebanon,25-06-2020,12235,1795,1103,11132,Eastern Mediterranean
Liberia,25-06-2020,154568,2141,1117,153451,Africa
Liechtenstein,25-06-2020,73484,313,201,73283,Europe
Lithuania,25-06-2020,330040,272,1025,329015,Europe
Luxembourg,25-06-2020,141368,2487,1196,140172,Europe
Madagascar,25-06-2020,193732,1077,972,192760,Africa
Malaysia,25-06-2020,354528,254,494,354034,Western Pacific
Maldives,25-06-2020,93066,1313,681,92385,South-East Asia
Malta,25-06-2020,416390,459,92,416298,Europe
Mauritania,25-06-2020,438238,1754,923,437315,Africa
Mauritius,25-06-2020,434805,1697,127,434678,Africa
Mexico,25-06-2020,242007,797,943,241064,Americas
Moldova,25-06-2020,31399,2035,671,30728,Europe
Monaco,25-06-2020,336994,1461,246,336748,Europe
Mongolia,25-06-2020,365971,1867,214,365757,Western Pacific
Montenegro,25-06-2020,246332,162,654,245678,Europe
Morocco,25-06-2020,306076,604,474,305602,Eastern Mediterranean
Namibia,25-06-2020,629,1141,151,478,Africa
Nepal,25-06-2020,46363,1793,821,45542,South-East Asia
Netherlands,25-06-2020,330505,2261,730,329775,Europe
Netherlands,25-06-2020,172711,2197,1,172710,Europe
Netherlands,25-06-2020,113113,1903,1066,112047,Europe
Netherlands,25-06-2020,207583,2020,494,207089,Europe
New Zealand,25-06-2020,127047,1185,745,126302,Western Pacific
Nicaragua,25-06-2020,162884,2466,406,162478,Americas
Niger,25-06-2020,193902,1690,1004,192898,Africa
Nigeria,25-06-2020,171288,1445,1123,170165,Africa
North Macedonia,25-06-2020,338463,760,11,338452,Europe
Norway,25-06-2020,280617,1522,779,279838,Europe
Oman,25-06-2020,126865,1438,30,126835,Eastern Mediterranean
Pakistan,25-06-2020,226331,1514,690,225641,Eastern Mediterranean
Panama,25-06-2020,62821,1201,1226,61595,Americas
Papua New Guinea,25-06-2020,124446,810,512,123934,Western Pacific
Paraguay,25-06-2020,270680,361,1014,269666,Americas
Peru,25-06-2020,220000,1066,1149,218851,Americas
Philippines,25-06-2020,18091,1096,286,17805,Western Pacific
Poland,25-06-2020,223919,982,131,223788,Europe
Portugal,25-06-2020,49466,1662,344,49122,Europe
Qatar,25-06-2020,333763,109,1002,332761,Eastern Mediterranean
Romania,25-06-2020,11672,1330,43,11629,Europe
Russia,25-06-2020,405887,2072,599,405288,Europe
Rwanda,25-06-2020,29698,989,940,28758,Africa
Saint Lucia,25-06-2020,181781,580,1191,180590,Americas
Saint Vincent and the Grenadines,25-06-2020,42849,177,1011,41838,Americas
San Marino,25-06-2020,410660,2266,735,409925,Europe
Saudi Arabia,25-06-2020,173130,2361,621,172509,Eastern Mediterranean
Senegal,25-06-2020,109769,1364,13,109756,Africa
Serbia,25-06-2020,396691,364,239,396452,Europe
Seychelles,25-06-2020,416815,2181,483,416332,Africa
Singapore,25-06-2020,194107,2077,90,194017,Western Pacific
Slovakia,25-06-2020,262372,311,737,261635,Europe
Slovenia,25-06-2020,259402,1164,920,258482,Europe
Somalia,25-06-2020,99216,461,402,98814,Eastern Mediterranean
South Africa,25-06-2020,157714,2489,42,157672,Africa
Spain,25-06-2020,17479,2413,774,16705,Europe
Sri Lanka,25-06-2020,103970,726,890,103080,South-East Asia
Sudan,25-06-2020,378207,89,962,377245,Eastern Mediterranean
Suriname,25-06-2020,401502,286,209,401293,Americas
Sweden,25-06-2020,43247,2320,259,42988,Europe
Switzerland,25-06-2020,114855,944,33,114822,Europe
Taiwan*,25-06-2020,249369,1181,883,248486,Western Pacific
Tanzania,25-06-2020,388813,2310,593,388220,Africa
Thailand,25-06-2020,108231,929,2,108229,South-East Asia
Togo,25-06-2020,439578,473,969,438609,Africa
Trinidad and Tobago,25-06-2020,191112,1690,946,190166,Americas
Tunisia,25-06-2020,196680,411,909,195771,Eastern Mediterranean
Turkey,25-06-2020,40389,309,390,39999,Europe
Uganda,25-06-2020,196151,1556,1029,195122,Africa
Ukraine,25-06-2020,375879,1591,657,375222,Europe
United Arab Emirates,25-06-2020,197745,1383,1048,196697,Eastern Mediterranean
United Kingdom,25-06-2020,59815,559,25,59790,Europe
United Kingdom,25-06-2020,374563,269,47,374516,Europe
United Kingdom,25-06-2020,215589,336,733,214856,Europe
United Kingdom,25-06-2020,354693,1071,301,354392,Europe
United Kingdom,25-06-2020,236044,901,304,235740,Europe
United Kingdom,25-06-2020,382214,1350,448,381766,Europe
United Kingdom,25-06-2020,428338,1056,1238,427100,Europe
Uruguay,25-06-2020,300348,1441,705,299643,Americas
US,25-06-2020,24956,1900,246,24710,Americas
Uzbekistan,25-06-2020,141610,566,50,141560,Europe
Venezuela,25-06-2020,356345,1652,1063,355282,Americas
Vietnam,25-06-2020,352109,1481,9,352100,Western Pacific
Zambia,25-06-2020,149712,1648,120,149592,Africa
Zimbabwe,25-06-2020,388202,160,564,387638,Africa
Dominica,25-06-2020,69539,187,733,68806,Americas
Grenada,25-06-2020,123158,1425,172,122986,Americas
Mozambique,25-06-2020,210283,1875,328,209955,Africa
Syria,25-06-2020,226160,2170,628,225532,Eastern Mediterranean
Timor-Leste,25-06-2020,173587,315,513,173074,South-East Asia
Belize,25-06-2020,65131,152,930,64201,Americas
Laos,25-06-2020,334304,656,158,334146,Western Pacific
Libya,25-06-2020,133233,1121,329,132904,Eastern Mediterranean
West Bank and Gaza,25-06-2020,38942,1740,1077,37865,Eastern Mediterranean
Guinea-Bissau,25-06-2020,316407,1854,689,315718,Africa
Mali,25-06-2020,427199,1804,1043,426156,Africa
Saint Kitts and Nevis,25-06-2020,66381,1379,735,65646,Americas
Canada,25-06-2020,307068,1212,117,306951,Americas
Canada,25-06-2020,181965,1999,74,181891,Americas
Kosovo,25-06-2020,184134,1238,95,184039,Europe
Burma,25-06-2020,161908,807,1202,160706,South-East Asia
United Kingdom,25-06-2020,446284,1308,316,445968,Europe
United Kingdom,25-06-2020,180952,627,1196,179756,Europe
United Kingdom,25-06-2020,254761,1976,711,254050,Europe
Botswana,25-06-2020,196599,2363,722,195877,Africa
Burundi,25-06-2020,250974,1379,1181,249793,Africa
Sierra Leone,25-06-2020,128817,977,693,128124,Africa
Malawi,25-06-2020,372235,145,1170,371065,Africa
United Kingdom,25-06-2020,209111,2386,534,208577,Europe
France,25-06-2020,424544,578,1232,423312,Europe
South Sudan,25-06-2020,135429,2365,478,134951,Africa
Western Sahara,25-06-2020,45443,1316,477,44966,Africa
Sao Tome and Principe,25-06-2020,21752,788,300,21452,Africa
Yemen,25-06-2020,170876,276,884,169992,Eastern Mediterranean
Comoros,25-06-2020,134975,941,1215,133760,Africa
Tajikistan,25-06-2020,404746,1796,595,404151,Europe
Lesotho,25-06-2020,127844,1305,897,126947,Africa
Afghanistan,26-06-2020,152865,1071,486,152379,Eastern Mediterranean
Albania,26-06-2020,208802,1005,680,208122,Europe
Algeria,26-06-2020,224282,106,315,223967,Africa
Andorra,26-06-2020,376212,1267,883,375329,Europe
Angola,26-06-2020,294320,294,1107,293213,Africa
Antigua and Barbuda,26-06-2020,345025,2120,179,344846,Americas
Argentina,26-06-2020,243976,1084,251,243725,Americas
Armenia,26-06-2020,2227,2090,172,2055,Europe
Australia,26-06-2020,417940,1027,595,417345,Western Pacific
Australia,26-06-2020,255901,1386,853,255048,Western Pacific
Australia,26-06-2020,378496,2491,206,378290,Western Pacific
Australia,26-06-2020,331679,1513,280,331399,Western Pacific
Australia,26-06-2020,272422,1596,350,272072,Western Pacific
Australia,26-06-2020,317684,1164,998,316686,Western Pacific
Australia,26-06-2020,425616,1939,1227,424389,Western Pacific
Australia,26-06-2020,382264,830,357,381907,Western Pacific
Austria,26-06-2020,22728,2080,501,22227,Europe
Azerbaijan,26-06-2020,358139,304,676,357463,Europe
Bahamas,26-06-2020,17459,29,221,17238,Americas
Bahrain,26-06-2020,295857,1211,403,295454,Eastern Mediterranean
Bangladesh,26-06-2020,131816,1769,633,131183,South-East Asia
Barbados,26-06-2020,28544,1126,1241,27303,Americas
Belarus,26-06-2020,279188,2411,1046,278142,Europe
Belgium,26-06-2020,151094,687,1187,149907,Europe
Benin,26-06-2020,163905,626,120,163785,Africa
Bhutan,26-06-2020,262924,364,1150,261774,South-East Asia
Bolivia,26-06-2020,174045,1156,1205,172840,Americas
Bosnia and Herzegovina,26-06-2020,110032,1405,42,109990,Europe
Brazil,26-06-2020,209254,624,1203,208051,Americas
Brunei,26-06-2020,88592,895,658,87934,Western Pacific
Bulgaria,26-06-2020,259237,734,187,259050,Europe
Burkina Faso,26-06-2020,425000,2341,18,424982,Africa
Cabo Verde,26-06-2020,204329,1711,331,203998,Africa
Cambodia,26-06-2020,430558,1500,238,430320,Western Pacific
Cameroon,26-06-2020,250114,358,610,249504,Africa
Canada,26-06-2020,158515,1890,404,158111,Americas
Canada,26-06-2020,28840,632,1017,27823,Americas
Canada,26-06-2020,137875,2249,1052,136823,Americas
Canada,26-06-2020,380611,1278,888,379723,Americas
Canada,26-06-2020,198689,971,885,197804,Americas
Canada,26-06-2020,233014,1193,639,232375,Americas
Canada,26-06-2020,445200,13,104,445096,Americas
Canada,26-06-2020,173229,1932,101,173128,Americas
Canada,26-06-2020,76982,2182,3,76979,Americas
Canada,26-06-2020,445857,1846,815,445042,Americas
Central African Republic,26-06-2020,420455,1420,1030,419425,Africa
Chad,26-06-2020,346686,1534,944,345742,Africa
Chile,26-06-2020,28056,115,624,27432,Americas
China,26-06-2020,294537,2220,489,294048,Western Pacific
China,26-06-2020,286106,2179,824,285282,Western Pacific
China,26-06-2020,266994,231,896,266098,Western Pacific
China,26-06-2020,342793,1386,660,342133,Western Pacific
China,26-06-2020,344100,841,359,343741,Western Pacific
China,26-06-2020,380921,2479,897,380024,Western Pacific
China,26-06-2020,330534,1263,1226,329308,Western Pacific
China,26-06-2020,76518,1215,1242,75276,Western Pacific
China,26-06-2020,235554,158,221,235333,Western Pacific
China,26-06-2020,349475,1605,501,348974,Western Pacific
China,26-06-2020,244245,1604,619,243626,Western Pacific
China,26-06-2020,346379,2200,965,345414,Western Pacific
China,26-06-2020,115585,1637,619,114966,Western Pacific
China,26-06-2020,325439,1772,779,324660,Western Pacific
China,26-06-2020,103033,2306,1055,101978,Western Pacific
China,26-06-2020,101027,0,508,100519,Western Pacific
China,26-06-2020,59914,2051,12,59902,Western Pacific
China,26-06-2020,100936,1091,1105,99831,Western Pacific
China,26-06-2020,181959,1127,999,180960,Western Pacific
China,26-06-2020,363613,1344,787,362826,Western Pacific
China,26-06-2020,358001,1278,747,357254,Western Pacific
China,26-06-2020,17444,490,51,17393,Western Pacific
China,26-06-2020,432347,608,281,432066,Western Pacific
China,26-06-2020,171641,290,756,170885,Western Pacific
China,26-06-2020,153481,1690,100,153381,Western Pacific
China,26-06-2020,166096,419,1216,164880,Western Pacific
China,26-06-2020,316804,37,14,316790,Western Pacific
China,26-06-2020,369963,1570,847,369116,Western Pacific
China,26-06-2020,252319,1844,186,252133,Western Pacific
China,26-06-2020,313518,1458,434,313084,Western Pacific
China,26-06-2020,258138,2045,579,257559,Western Pacific
China,26-06-2020,241061,646,1149,239912,Western Pacific
China,26-06-2020,350394,1480,1065,349329,Western Pacific
Colombia,26-06-2020,446693,575,1163,445530,Americas
Congo (Brazzaville),26-06-2020,121198,519,810,120388,Africa
Congo (Kinshasa),26-06-2020,294445,92,484,293961,Africa
Costa Rica,26-06-2020,92484,1341,1146,91338,Americas
Cote d'Ivoire,26-06-2020,120511,1155,782,119729,Africa
Croatia,26-06-2020,291334,234,675,290659,Europe
Cuba,26-06-2020,386205,1125,178,386027,Americas
Cyprus,26-06-2020,141046,1996,906,140140,Europe
Czechia,26-06-2020,46041,697,601,45440,Europe
Denmark,26-06-2020,40295,697,272,40023,Europe
Greenland,26-06-2020,37811,1680,790,37021,Europe
Denmark,26-06-2020,224405,677,787,223618,Europe
Djibouti,26-06-2020,100628,1925,402,100226,Eastern Mediterranean
Dominican Republic,26-06-2020,156181,1019,808,155373,Americas
Ecuador,26-06-2020,179514,577,70,179444,Americas
Egypt,26-06-2020,96464,430,559,95905,Eastern Mediterranean
El Salvador,26-06-2020,157018,2114,838,156180,Americas
Equatorial Guinea,26-06-2020,101680,1908,1137,100543,Africa
Eritrea,26-06-2020,55342,612,8,55334,Africa
Estonia,26-06-2020,126597,1403,465,126132,Europe
Eswatini,26-06-2020,394131,1628,436,393695,Africa
Ethiopia,26-06-2020,122046,121,1072,120974,Africa
Fiji,26-06-2020,70508,1137,903,69605,Western Pacific
Finland,26-06-2020,177409,2380,561,176848,Europe
France,26-06-2020,372428,321,1163,371265,Europe
France,26-06-2020,317737,837,22,317715,Europe
France,26-06-2020,382851,1067,802,382049,Europe
France,26-06-2020,179374,1669,481,178893,Europe
France,26-06-2020,231832,1319,143,231689,Europe
France,26-06-2020,378255,993,723,377532,Europe
France,26-06-2020,36122,520,1214,34908,Europe
France,26-06-2020,411268,1486,427,410841,Europe
France,26-06-2020,89943,974,237,89706,Europe
France,26-06-2020,262259,394,397,261862,Europe
Gabon,26-06-2020,384635,1624,677,383958,Africa
Gambia,26-06-2020,307666,755,606,307060,Africa
Georgia,26-06-2020,230233,420,296,229937,Europe
Germany,26-06-2020,89748,1061,520,89228,Europe
Ghana,26-06-2020,109377,455,506,108871,Africa
Greece,26-06-2020,299966,531,132,299834,Europe
Guatemala,26-06-2020,204028,1741,119,203909,Americas
Guinea,26-06-2020,286230,2458,663,285567,Africa
Guyana,26-06-2020,358310,1382,675,357635,Americas
Haiti,26-06-2020,361708,481,186,361522,Americas
Holy See,26-06-2020,381533,1185,250,381283,Europe
Honduras,26-06-2020,199333,1367,879,198454,Americas
Hungary,26-06-2020,415534,170,1003,414531,Europe
Iceland,26-06-2020,216766,840,453,216313,Europe
India,26-06-2020,448924,2428,746,448178,South-East Asia
Indonesia,26-06-2020,123879,595,986,122893,South-East Asia
Iran,26-06-2020,449102,1090,764,448338,Eastern Mediterranean
Iraq,26-06-2020,167582,1986,179,167403,Eastern Mediterranean
Ireland,26-06-2020,331503,326,270,331233,Europe
Israel,26-06-2020,62229,466,1022,61207,Europe
Italy,26-06-2020,300688,1704,638,300050,Europe
Jamaica,26-06-2020,250297,2266,951,249346,Americas
Japan,26-06-2020,324317,1251,624,323693,Western Pacific
Jordan,26-06-2020,5631,1415,291,5340,Eastern Mediterranean
Kazakhstan,26-06-2020,200838,770,669,200169,Europe
Kenya,26-06-2020,445713,1866,1158,444555,Africa
South Korea,26-06-2020,319091,84,1078,318013,Western Pacific
Kuwait,26-06-2020,7525,2018,1,7524,Eastern Mediterranean
Kyrgyzstan,26-06-2020,158912,724,740,158172,Europe
Latvia,26-06-2020,130909,785,1079,129830,Europe
Lebanon,26-06-2020,79446,1617,212,79234,Eastern Mediterranean
Liberia,26-06-2020,178343,1109,312,178031,Africa
Liechtenstein,26-06-2020,146942,109,740,146202,Europe
Lithuania,26-06-2020,53475,1630,236,53239,Europe
Luxembourg,26-06-2020,273719,1,303,273416,Europe
Madagascar,26-06-2020,405238,1889,1249,403989,Africa
Malaysia,26-06-2020,83185,1560,164,83021,Western Pacific
Maldives,26-06-2020,58802,1975,247,58555,South-East Asia
Malta,26-06-2020,393237,608,59,393178,Europe
Mauritania,26-06-2020,236271,1860,942,235329,Africa
Mauritius,26-06-2020,319814,605,226,319588,Africa
Mexico,26-06-2020,345530,2212,725,344805,Americas
Moldova,26-06-2020,300169,1655,373,299796,Europe
Monaco,26-06-2020,253815,2046,132,253683,Europe
Mongolia,26-06-2020,382412,1405,569,381843,Western Pacific
Montenegro,26-06-2020,335978,1447,884,335094,Europe
Morocco,26-06-2020,282509,1376,748,281761,Eastern Mediterranean
Namibia,26-06-2020,334085,2104,1006,333079,Africa
Nepal,26-06-2020,333672,472,800,332872,South-East Asia
Netherlands,26-06-2020,303832,184,987,302845,Europe
Netherlands,26-06-2020,358489,1913,213,358276,Europe
Netherlands,26-06-2020,317664,54,124,317540,Europe
Netherlands,26-06-2020,426622,419,398,426224,Europe
New Zealand,26-06-2020,206716,699,1075,205641,Western Pacific
Nicaragua,26-06-2020,397480,1815,904,396576,Americas
Niger,26-06-2020,300570,104,243,300327,Africa
Nigeria,26-06-2020,23677,1073,265,23412,Africa
North Macedonia,26-06-2020,163810,1145,758,163052,Europe
Norway,26-06-2020,344253,1855,976,343277,Europe
Oman,26-06-2020,223039,1806,802,222237,Eastern Mediterranean
Pakistan,26-06-2020,277802,2372,1035,276767,Eastern Mediterranean
Panama,26-06-2020,446826,1428,565,446261,Americas
Papua New Guinea,26-06-2020,61346,99,943,60403,Western Pacific
Paraguay,26-06-2020,65991,1362,383,65608,Americas
Peru,26-06-2020,307141,52,587,306554,Americas
Philippines,26-06-2020,12899,1105,161,12738,Western Pacific
Poland,26-06-2020,383369,2285,1162,382207,Europe
Portugal,26-06-2020,178596,743,920,177676,Europe
Qatar,26-06-2020,354710,1818,20,354690,Eastern Mediterranean
Romania,26-06-2020,409468,627,1202,408266,Europe
Russia,26-06-2020,235401,1305,383,235018,Europe
Rwanda,26-06-2020,241134,3,484,240650,Africa
Saint Lucia,26-06-2020,215276,1835,1239,214037,Americas
Saint Vincent and the Grenadines,26-06-2020,223882,2431,652,223230,Americas
San Marino,26-06-2020,291029,1812,1135,289894,Europe
Saudi Arabia,26-06-2020,418543,1273,233,418310,Eastern Mediterranean
Senegal,26-06-2020,310026,2408,469,309557,Africa
Serbia,26-06-2020,50316,2493,657,49659,Europe
Seychelles,26-06-2020,38630,1248,242,38388,Africa
Singapore,26-06-2020,238455,1333,1201,237254,Western Pacific
Slovakia,26-06-2020,119908,124,19,119889,Europe
Slovenia,26-06-2020,125177,1410,238,124939,Europe
Somalia,26-06-2020,276520,289,492,276028,Eastern Mediterranean
South Africa,26-06-2020,391347,757,1192,390155,Africa
Spain,26-06-2020,64985,1778,927,64058,Europe
Sri Lanka,26-06-2020,15701,1986,259,15442,South-East Asia
Sudan,26-06-2020,66927,1134,547,66380,Eastern Mediterranean
Suriname,26-06-2020,263410,505,524,262886,Americas
Sweden,26-06-2020,56614,2243,1205,55409,Europe
Switzerland,26-06-2020,55895,1292,201,55694,Europe
Taiwan*,26-06-2020,231490,1652,88,231402,Western Pacific
Tanzania,26-06-2020,231433,1245,21,231412,Africa
Thailand,26-06-2020,433816,1410,159,433657,South-East Asia
Togo,26-06-2020,402603,1415,346,402257,Africa
Trinidad and Tobago,26-06-2020,64431,477,1035,63396,Americas
Tunisia,26-06-2020,53743,1773,367,53376,Eastern Mediterranean
Turkey,26-06-2020,92788,39,39,92749,Europe
Uganda,26-06-2020,40716,1349,1201,39515,Africa
Ukraine,26-06-2020,14755,470,292,14463,Europe
United Arab Emirates,26-06-2020,154357,206,835,153522,Eastern Mediterranean
United Kingdom,26-06-2020,98799,246,226,98573,Europe
United Kingdom,26-06-2020,341079,90,745,340334,Europe
United Kingdom,26-06-2020,56190,2474,164,56026,Europe
United Kingdom,26-06-2020,112369,0,1080,111289,Europe
United Kingdom,26-06-2020,352053,695,1226,350827,Europe
United Kingdom,26-06-2020,394046,444,1025,393021,Europe
United Kingdom,26-06-2020,175828,1771,633,175195,Europe
Uruguay,26-06-2020,253737,232,174,253563,Americas
US,26-06-2020,137514,1368,513,137001,Americas
Uzbekistan,26-06-2020,3074,291,1165,1909,Europe
Venezuela,26-06-2020,253582,1587,61,253521,Americas
Vietnam,26-06-2020,410854,1579,752,410102,Western Pacific
Zambia,26-06-2020,106214,410,1172,105042,Africa
Zimbabwe,26-06-2020,438425,338,147,438278,Africa
Dominica,26-06-2020,322021,1985,323,321698,Americas
Grenada,26-06-2020,390792,1031,80,390712,Americas
Mozambique,26-06-2020,198040,2077,219,197821,Africa
Syria,26-06-2020,370706,766,304,370402,Eastern Mediterranean
Timor-Leste,26-06-2020,344249,597,565,343684,South-East Asia
Belize,26-06-2020,22380,0,1159,21221,Americas
Laos,26-06-2020,351806,859,116,351690,Western Pacific
Libya,26-06-2020,104696,1467,800,103896,Eastern Mediterranean
West Bank and Gaza,26-06-2020,180517,321,887,179630,Eastern Mediterranean
Guinea-Bissau,26-06-2020,224074,1910,218,223856,Africa
Mali,26-06-2020,109025,29,109,108916,Africa
Saint Kitts and Nevis,26-06-2020,21062,332,862,20200,Americas
Canada,26-06-2020,132677,727,135,132542,Americas
Canada,26-06-2020,36718,60,1048,35670,Americas
Kosovo,26-06-2020,4481,2246,407,4074,Europe
Burma,26-06-2020,169096,2043,7,169089,South-East Asia
United Kingdom,26-06-2020,395614,104,890,394724,Europe
United Kingdom,26-06-2020,357133,1214,1063,356070,Europe
United Kingdom,26-06-2020,162714,433,4,162710,Europe
Botswana,26-06-2020,225287,2366,887,224400,Africa
Burundi,26-06-2020,413777,1005,794,412983,Africa
Sierra Leone,26-06-2020,417819,436,761,417058,Africa
Malawi,26-06-2020,120074,851,1176,118898,Africa
United Kingdom,26-06-2020,337466,1472,322,337144,Europe
France,26-06-2020,50142,536,127,50015,Europe
South Sudan,26-06-2020,81272,1363,151,81121,Africa
Western Sahara,26-06-2020,362744,2224,256,362488,Africa
Sao Tome and Principe,26-06-2020,285657,1719,298,285359,Africa
Yemen,26-06-2020,432237,1590,1169,431068,Eastern Mediterranean
Comoros,26-06-2020,383276,50,95,383181,Africa
Tajikistan,26-06-2020,366380,2162,440,365940,Europe
Lesotho,26-06-2020,239259,212,555,238704,Africa
Afghanistan,27-06-2020,5173,1135,287,4886,Eastern Mediterranean
Albania,27-06-2020,217969,1333,431,217538,Europe
Algeria,27-06-2020,161969,880,764,161205,Africa
Andorra,27-06-2020,45035,890,393,44642,Europe
Angola,27-06-2020,193156,610,101,193055,Africa
Antigua and Barbuda,27-06-2020,121431,890,892,120539,Americas
Argentina,27-06-2020,326573,949,453,326120,Americas
Armenia,27-06-2020,80494,2408,661,79833,Europe
Australia,27-06-2020,62617,2432,402,62215,Western Pacific
Australia,27-06-2020,165556,2393,495,165061,Western Pacific
Australia,27-06-2020,676,625,463,213,Western Pacific
Australia,27-06-2020,305534,2391,239,305295,Western Pacific
Australia,27-06-2020,3119,1581,923,2196,Western Pacific
Australia,27-06-2020,440602,957,345,440257,Western Pacific
Australia,27-06-2020,128013,196,674,127339,Western Pacific
Australia,27-06-2020,332624,604,131,332493,Western Pacific
Austria,27-06-2020,358238,1960,421,357817,Europe
Azerbaijan,27-06-2020,414153,2237,444,413709,Europe
Bahamas,27-06-2020,293785,969,495,293290,Americas
Bahrain,27-06-2020,159095,531,87,159008,Eastern Mediterranean
Bangladesh,27-06-2020,34515,1070,780,33735,South-East Asia
Barbados,27-06-2020,421568,1371,1148,420420,Americas
Belarus,27-06-2020,375798,2099,388,375410,Europe
Belgium,27-06-2020,211957,580,1127,210830,Europe
Benin,27-06-2020,92629,1470,763,91866,Africa
Bhutan,27-06-2020,156832,87,377,156455,South-East Asia
Bolivia,27-06-2020,248533,2185,964,247569,Americas
Bosnia and Herzegovina,27-06-2020,344110,1432,945,343165,Europe
Brazil,27-06-2020,28107,2458,129,27978,Americas
Brunei,27-06-2020,362234,2320,376,361858,Western Pacific
Bulgaria,27-06-2020,394452,2393,800,393652,Europe
Burkina Faso,27-06-2020,83212,938,452,82760,Africa
Cabo Verde,27-06-2020,260757,1958,1001,259756,Africa
Cambodia,27-06-2020,328869,2064,57,328812,Western Pacific
Cameroon,27-06-2020,295746,2422,1091,294655,Africa
Canada,27-06-2020,397446,575,814,396632,Americas
Canada,27-06-2020,170346,1783,331,170015,Americas
Canada,27-06-2020,226316,1783,140,226176,Americas
Canada,27-06-2020,417139,2337,695,416444,Americas
Canada,27-06-2020,16801,1757,736,16065,Americas
Canada,27-06-2020,265913,276,254,265659,Americas
Canada,27-06-2020,295618,2416,1234,294384,Americas
Canada,27-06-2020,55776,2386,663,55113,Americas
Canada,27-06-2020,51328,326,29,51299,Americas
Canada,27-06-2020,94700,1154,879,93821,Americas
Central African Republic,27-06-2020,369784,742,854,368930,Africa
Chad,27-06-2020,142102,2261,266,141836,Africa
Chile,27-06-2020,208925,752,348,208577,Americas
China,27-06-2020,43766,642,1018,42748,Western Pacific
China,27-06-2020,157617,1848,462,157155,Western Pacific
China,27-06-2020,76150,1171,479,75671,Western Pacific
China,27-06-2020,98389,30,389,98000,Western Pacific
China,27-06-2020,58400,1256,128,58272,Western Pacific
China,27-06-2020,57924,786,314,57610,Western Pacific
China,27-06-2020,265217,1304,831,264386,Western Pacific
China,27-06-2020,46145,757,87,46058,Western Pacific
China,27-06-2020,184413,958,127,184286,Western Pacific
China,27-06-2020,367737,791,1081,366656,Western Pacific
China,27-06-2020,281201,1183,165,281036,Western Pacific
China,27-06-2020,110588,1035,121,110467,Western Pacific
China,27-06-2020,327637,1621,346,327291,Western Pacific
China,27-06-2020,36744,12,894,35850,Western Pacific
China,27-06-2020,1677,76,1010,667,Western Pacific
China,27-06-2020,354628,890,1145,353483,Western Pacific
China,27-06-2020,379991,1487,250,379741,Western Pacific
China,27-06-2020,110158,2039,432,109726,Western Pacific
China,27-06-2020,102333,2310,1201,101132,Western Pacific
China,27-06-2020,405584,997,1221,404363,Western Pacific
China,27-06-2020,381777,2169,1142,380635,Western Pacific
China,27-06-2020,346099,1709,731,345368,Western Pacific
China,27-06-2020,192501,449,923,191578,Western Pacific
China,27-06-2020,245658,1667,1018,244640,Western Pacific
China,27-06-2020,358712,933,1059,357653,Western Pacific
China,27-06-2020,215223,1108,914,214309,Western Pacific
China,27-06-2020,164087,1566,479,163608,Western Pacific
China,27-06-2020,216993,340,230,216763,Western Pacific
China,27-06-2020,239801,1194,739,239062,Western Pacific
China,27-06-2020,360614,238,1003,359611,Western Pacific
China,27-06-2020,179694,907,395,179299,Western Pacific
China,27-06-2020,1399,214,1107,292,Western Pacific
China,27-06-2020,437847,2357,1121,436726,Western Pacific
Colombia,27-06-2020,432068,1016,222,431846,Americas
Congo (Brazzaville),27-06-2020,59628,2474,307,59321,Africa
Congo (Kinshasa),27-06-2020,52404,1952,1204,51200,Africa
Costa Rica,27-06-2020,108021,1059,727,107294,Americas
Cote d'Ivoire,27-06-2020,185546,493,505,185041,Africa
Croatia,27-06-2020,56774,2364,498,56276,Europe
Cuba,27-06-2020,241931,1272,890,241041,Americas
Cyprus,27-06-2020,373693,1431,514,373179,Europe
Czechia,27-06-2020,322932,1523,423,322509,Europe
Denmark,27-06-2020,281312,2448,1168,280144,Europe
Greenland,27-06-2020,285679,1277,911,284768,Europe
Denmark,27-06-2020,162893,805,58,162835,Europe
Djibouti,27-06-2020,44333,191,942,43391,Eastern Mediterranean
Dominican Republic,27-06-2020,93109,1464,531,92578,Americas
Ecuador,27-06-2020,234060,2082,115,233945,Americas
Egypt,27-06-2020,197390,534,363,197027,Eastern Mediterranean
El Salvador,27-06-2020,2504,2422,916,1588,Americas
Equatorial Guinea,27-06-2020,196182,1041,645,195537,Africa
Eritrea,27-06-2020,350570,2305,940,349630,Africa
Estonia,27-06-2020,280649,1564,1036,279613,Europe
Eswatini,27-06-2020,274633,2119,866,273767,Africa
Ethiopia,27-06-2020,273664,1391,877,272787,Africa
Fiji,27-06-2020,302920,1331,838,302082,Western Pacific
Finland,27-06-2020,144852,2377,679,144173,Europe
France,27-06-2020,51525,781,674,50851,Europe
France,27-06-2020,360858,1569,234,360624,Europe
France,27-06-2020,186906,1566,939,185967,Europe
France,27-06-2020,389671,2273,539,389132,Europe
France,27-06-2020,208230,1254,1213,207017,Europe
France,27-06-2020,194315,1856,89,194226,Europe
France,27-06-2020,400820,2224,421,400399,Europe
France,27-06-2020,163718,2391,727,162991,Europe
France,27-06-2020,359097,2120,1197,357900,Europe
France,27-06-2020,96440,2415,154,96286,Europe
Gabon,27-06-2020,436881,598,498,436383,Africa
Gambia,27-06-2020,71326,306,1239,70087,Africa
Georgia,27-06-2020,156074,2118,331,155743,Europe
Germany,27-06-2020,327611,770,665,326946,Europe
Ghana,27-06-2020,57847,1624,506,57341,Africa
Greece,27-06-2020,4824,337,32,4792,Europe
Guatemala,27-06-2020,215991,185,423,215568,Americas
Guinea,27-06-2020,17178,1835,654,16524,Africa
Guyana,27-06-2020,213904,1314,1209,212695,Americas
Haiti,27-06-2020,142048,1464,1033,141015,Americas
Holy See,27-06-2020,59031,2308,1029,58002,Europe
Honduras,27-06-2020,375422,21,1077,374345,Americas
Hungary,27-06-2020,158391,2032,913,157478,Europe
Iceland,27-06-2020,365370,946,627,364743,Europe
India,27-06-2020,333904,1693,98,333806,South-East Asia
Indonesia,27-06-2020,222278,190,6,222272,South-East Asia
Iran,27-06-2020,2225,1295,811,1414,Eastern Mediterranean
Iraq,27-06-2020,312107,1468,1181,310926,Eastern Mediterranean
Ireland,27-06-2020,203851,1099,298,203553,Europe
Israel,27-06-2020,363775,2184,324,363451,Europe
Italy,27-06-2020,254025,369,964,253061,Europe
Jamaica,27-06-2020,381140,1527,907,380233,Americas
Japan,27-06-2020,364393,2073,288,364105,Western Pacific
Jordan,27-06-2020,56707,2483,1189,55518,Eastern Mediterranean
Kazakhstan,27-06-2020,225961,819,446,225515,Europe
Kenya,27-06-2020,140924,390,1142,139782,Africa
South Korea,27-06-2020,337115,763,904,336211,Western Pacific
Kuwait,27-06-2020,253698,2155,623,253075,Eastern Mediterranean
Kyrgyzstan,27-06-2020,15277,953,723,14554,Europe
Latvia,27-06-2020,407362,452,186,407176,Europe
Lebanon,27-06-2020,291103,2066,28,291075,Eastern Mediterranean
Liberia,27-06-2020,333218,1669,1081,332137,Africa
Liechtenstein,27-06-2020,373616,7,873,372743,Europe
Lithuania,27-06-2020,146987,1414,462,146525,Europe
Luxembourg,27-06-2020,96599,238,729,95870,Europe
Madagascar,27-06-2020,313052,1057,414,312638,Africa
Malaysia,27-06-2020,362132,2163,550,361582,Western Pacific
Maldives,27-06-2020,278646,710,293,278353,South-East Asia
Malta,27-06-2020,391027,965,199,390828,Europe
Mauritania,27-06-2020,390792,1528,1161,389631,Africa
Mauritius,27-06-2020,162208,76,66,162142,Africa
Mexico,27-06-2020,256211,723,439,255772,Americas
Moldova,27-06-2020,426656,100,650,426006,Europe
Monaco,27-06-2020,324538,1040,166,324372,Europe
Mongolia,27-06-2020,19052,62,742,18310,Western Pacific
Montenegro,27-06-2020,212418,651,998,211420,Europe
Morocco,27-06-2020,280783,10,61,280722,Eastern Mediterranean
Namibia,27-06-2020,112428,243,1246,111182,Africa
Nepal,27-06-2020,156236,1852,10,156226,South-East Asia
Netherlands,27-06-2020,186689,1945,1246,185443,Europe
Netherlands,27-06-2020,374084,1724,407,373677,Europe
Netherlands,27-06-2020,323169,2,1115,322054,Europe
Netherlands,27-06-2020,196341,1945,1010,195331,Europe
New Zealand,27-06-2020,316923,1308,1133,315790,Western Pacific
Nicaragua,27-06-2020,17993,67,887,17106,Americas
Niger,27-06-2020,397072,1879,937,396135,Africa
Nigeria,27-06-2020,91312,1650,1112,90200,Africa
North Macedonia,27-06-2020,444183,2007,884,443299,Europe
Norway,27-06-2020,85059,2148,536,84523,Europe
Oman,27-06-2020,197829,2113,967,196862,Eastern Mediterranean
Pakistan,27-06-2020,292971,856,838,292133,Eastern Mediterranean
Panama,27-06-2020,65591,1967,568,65023,Americas
Papua New Guinea,27-06-2020,209948,952,984,208964,Western Pacific
Paraguay,27-06-2020,58937,2192,1163,57774,Americas
Peru,27-06-2020,377175,1334,626,376549,Americas
Philippines,27-06-2020,236589,1279,218,236371,Western Pacific
Poland,27-06-2020,391644,477,569,391075,Europe
Portugal,27-06-2020,260976,1583,397,260579,Europe
Qatar,27-06-2020,409589,1269,785,408804,Eastern Mediterranean
Romania,27-06-2020,239789,619,86,239703,Europe
Russia,27-06-2020,270501,1359,1018,269483,Europe
Rwanda,27-06-2020,356235,2334,514,355721,Africa
Saint Lucia,27-06-2020,39953,88,849,39104,Americas
Saint Vincent and the Grenadines,27-06-2020,31790,625,367,31423,Americas
San Marino,27-06-2020,280148,1501,245,279903,Europe
Saudi Arabia,27-06-2020,381517,192,214,381303,Eastern Mediterranean
Senegal,27-06-2020,333295,2290,1245,332050,Africa
Serbia,27-06-2020,227454,1774,599,226855,Europe
Seychelles,27-06-2020,267617,389,58,267559,Africa
Singapore,27-06-2020,409959,1429,434,409525,Western Pacific
Slovakia,27-06-2020,210636,1715,559,210077,Europe
Slovenia,27-06-2020,48985,232,103,48882,Europe
Somalia,27-06-2020,42702,452,599,42103,Eastern Mediterranean
South Africa,27-06-2020,372970,581,955,372015,Africa
Spain,27-06-2020,53464,755,90,53374,Europe
Sri Lanka,27-06-2020,251608,1418,1125,250483,South-East Asia
Sudan,27-06-2020,172227,60,521,171706,Eastern Mediterranean
Suriname,27-06-2020,104801,1419,837,103964,Americas
Sweden,27-06-2020,351037,443,607,350430,Europe
Switzerland,27-06-2020,345884,2204,127,345757,Europe
Taiwan*,27-06-2020,118267,285,1060,117207,Western Pacific
Tanzania,27-06-2020,157107,1953,556,156551,Africa
Thailand,27-06-2020,65086,1452,1244,63842,South-East Asia
Togo,27-06-2020,229564,1320,462,229102,Africa
Trinidad and Tobago,27-06-2020,441293,762,300,440993,Americas
Tunisia,27-06-2020,33504,1082,1064,32440,Eastern Mediterranean
Turkey,27-06-2020,82040,2095,268,81772,Europe
Uganda,27-06-2020,415119,2111,727,414392,Africa
Ukraine,27-06-2020,322781,43,176,322605,Europe
United Arab Emirates,27-06-2020,344959,1474,841,344118,Eastern Mediterranean
United Kingdom,27-06-2020,211523,1379,79,211444,Europe
United Kingdom,27-06-2020,345478,1029,458,345020,Europe
United Kingdom,27-06-2020,224943,1753,70,224873,Europe
United Kingdom,27-06-2020,227924,675,112,227812,Europe
United Kingdom,27-06-2020,139237,482,933,138304,Europe
United Kingdom,27-06-2020,4804,1567,1017,3787,Europe
United Kingdom,27-06-2020,401400,755,916,400484,Europe
Uruguay,27-06-2020,414649,941,302,414347,Americas
US,27-06-2020,344122,1747,1114,343008,Americas
Uzbekistan,27-06-2020,330379,1045,1184,329195,Europe
Venezuela,27-06-2020,392863,1100,347,392516,Americas
Vietnam,27-06-2020,145656,2271,52,145604,Western Pacific
Zambia,27-06-2020,201146,2323,535,200611,Africa
Zimbabwe,27-06-2020,384679,2414,135,384544,Africa
Dominica,27-06-2020,437389,953,600,436789,Americas
Grenada,27-06-2020,74877,2275,1206,73671,Americas
Mozambique,27-06-2020,115978,1502,702,115276,Africa
Syria,27-06-2020,274140,2499,884,273256,Eastern Mediterranean
Timor-Leste,27-06-2020,424375,2122,960,423415,South-East Asia
Belize,27-06-2020,142506,141,1241,141265,Americas
Laos,27-06-2020,10755,70,509,10246,Western Pacific
Libya,27-06-2020,57447,663,407,57040,Eastern Mediterranean
West Bank and Gaza,27-06-2020,357172,2194,1002,356170,Eastern Mediterranean
Guinea-Bissau,27-06-2020,108331,2390,1114,107217,Africa
Mali,27-06-2020,164580,2272,574,164006,Africa
Saint Kitts and Nevis,27-06-2020,369938,2443,730,369208,Americas
Canada,27-06-2020,265458,727,524,264934,Americas
Canada,27-06-2020,32817,1854,235,32582,Americas
Kosovo,27-06-2020,395283,2407,559,394724,Europe
Burma,27-06-2020,129450,360,807,128643,South-East Asia
United Kingdom,27-06-2020,262363,2283,765,261598,Europe
United Kingdom,27-06-2020,113730,2433,460,113270,Europe
United Kingdom,27-06-2020,29021,1222,1129,27892,Europe
Botswana,27-06-2020,181243,555,554,180689,Africa
Burundi,27-06-2020,150090,1228,1072,149018,Africa
Sierra Leone,27-06-2020,380933,1244,644,380289,Africa
Malawi,27-06-2020,328900,1113,845,328055,Africa
United Kingdom,27-06-2020,420085,1319,866,419219,Europe
France,27-06-2020,436805,1713,863,435942,Europe
South Sudan,27-06-2020,120439,2231,721,119718,Africa
Western Sahara,27-06-2020,117475,1116,900,116575,Africa
Sao Tome and Principe,27-06-2020,267120,2459,88,267032,Africa
Yemen,27-06-2020,285593,2173,593,285000,Eastern Mediterranean
Comoros,27-06-2020,94329,2405,13,94316,Africa
Tajikistan,27-06-2020,363968,752,640,363328,Europe
Lesotho,27-06-2020,147545,307,93,147452,Africa
Afghanistan,28-06-2020,241203,2342,257,240946,Eastern Mediterranean
Albania,28-06-2020,99643,597,696,98947,Europe
Algeria,28-06-2020,273110,2462,559,272551,Africa
Andorra,28-06-2020,247396,145,366,247030,Europe
Angola,28-06-2020,120624,1372,960,119664,Africa
Antigua and Barbuda,28-06-2020,312975,880,890,312085,Americas
Argentina,28-06-2020,208107,123,570,207537,Americas
Armenia,28-06-2020,198342,2012,1196,197146,Europe
Australia,28-06-2020,147674,441,149,147525,Western Pacific
Australia,28-06-2020,48112,216,1016,47096,Western Pacific
Australia,28-06-2020,188935,1658,175,188760,Western Pacific
Australia,28-06-2020,112076,470,1036,111040,Western Pacific
Australia,28-06-2020,202048,345,391,201657,Western Pacific
Australia,28-06-2020,344380,518,513,343867,Western Pacific
Australia,28-06-2020,226704,2075,199,226505,Western Pacific
Australia,28-06-2020,251631,650,858,250773,Western Pacific
Austria,28-06-2020,154732,375,792,153940,Europe
Azerbaijan,28-06-2020,14383,881,1126,13257,Europe
Bahamas,28-06-2020,291768,1707,354,291414,Americas
Bahrain,28-06-2020,314492,1809,3,314489,Eastern Mediterranean
Bangladesh,28-06-2020,346222,746,735,345487,South-East Asia
Barbados,28-06-2020,277316,187,532,276784,Americas
Belarus,28-06-2020,125503,1952,1032,124471,Europe
Belgium,28-06-2020,73996,496,725,73271,Europe
Benin,28-06-2020,39726,671,877,38849,Africa
Bhutan,28-06-2020,311726,1362,901,310825,South-East Asia
Bolivia,28-06-2020,376849,1141,170,376679,Americas
Bosnia and Herzegovina,28-06-2020,194926,1966,738,194188,Europe
Brazil,28-06-2020,294769,229,321,294448,Americas
Brunei,28-06-2020,201458,303,1182,200276,Western Pacific
Bulgaria,28-06-2020,74559,2185,952,73607,Europe
Burkina Faso,28-06-2020,342543,1801,187,342356,Africa
Cabo Verde,28-06-2020,425578,363,425,425153,Africa
Cambodia,28-06-2020,76384,511,456,75928,Western Pacific
Cameroon,28-06-2020,132059,828,93,131966,Africa
Canada,28-06-2020,153685,1806,301,153384,Americas
Canada,28-06-2020,24205,273,600,23605,Americas
Canada,28-06-2020,375554,276,218,375336,Americas
Canada,28-06-2020,355007,1987,494,354513,Americas
Canada,28-06-2020,288122,1803,671,287451,Americas
Canada,28-06-2020,299225,1538,93,299132,Americas
Canada,28-06-2020,248651,1679,754,247897,Americas
Canada,28-06-2020,253328,1597,367,252961,Americas
Canada,28-06-2020,202248,1578,154,202094,Americas
Canada,28-06-2020,25795,1321,441,25354,Americas
Central African Republic,28-06-2020,21330,306,667,20663,Africa
Chad,28-06-2020,99030,1387,1125,97905,Africa
Chile,28-06-2020,220732,634,34,220698,Americas
China,28-06-2020,430445,1371,655,429790,Western Pacific
China,28-06-2020,111010,2460,50,110960,Western Pacific
China,28-06-2020,285558,698,6,285552,Western Pacific
China,28-06-2020,363411,525,115,363296,Western Pacific
China,28-06-2020,379943,1884,441,379502,Western Pacific
China,28-06-2020,194218,1847,69,194149,Western Pacific
China,28-06-2020,428726,1201,1195,427531,Western Pacific
China,28-06-2020,333657,1890,1036,332621,Western Pacific
China,28-06-2020,240351,2105,924,239427,Western Pacific
China,28-06-2020,311675,935,1100,310575,Western Pacific
China,28-06-2020,12381,1740,173,12208,Western Pacific
China,28-06-2020,207684,2028,32,207652,Western Pacific
China,28-06-2020,355206,1077,1042,354164,Western Pacific
China,28-06-2020,388503,1521,103,388400,Western Pacific
China,28-06-2020,321969,474,102,321867,Western Pacific
China,28-06-2020,345527,2464,72,345455,Western Pacific
China,28-06-2020,382348,1850,1146,381202,Western Pacific
China,28-06-2020,145894,2470,820,145074,Western Pacific
China,28-06-2020,367364,2015,868,366496,Western Pacific
China,28-06-2020,79641,494,822,78819,Western Pacific
China,28-06-2020,268346,2471,1145,267201,Western Pacific
China,28-06-2020,187069,2329,651,186418,Western Pacific
China,28-06-2020,399744,408,719,399025,Western Pacific
China,28-06-2020,321296,1925,535,320761,Western Pacific
China,28-06-2020,206680,2104,750,205930,Western Pacific
China,28-06-2020,178337,224,206,178131,Western Pacific
China,28-06-2020,126941,847,16,126925,Western Pacific
China,28-06-2020,369132,222,208,368924,Western Pacific
China,28-06-2020,9309,42,442,8867,Western Pacific
China,28-06-2020,384629,1710,614,384015,Western Pacific
China,28-06-2020,273494,2135,926,272568,Western Pacific
China,28-06-2020,148350,959,342,148008,Western Pacific
China,28-06-2020,391179,2363,728,390451,Western Pacific
Colombia,28-06-2020,441973,1890,913,441060,Americas
Congo (Brazzaville),28-06-2020,261523,666,222,261301,Africa
Congo (Kinshasa),28-06-2020,347602,2130,465,347137,Africa
Costa Rica,28-06-2020,191788,315,42,191746,Americas
Cote d'Ivoire,28-06-2020,286668,731,131,286537,Africa
Croatia,28-06-2020,386330,1350,1248,385082,Europe
Cuba,28-06-2020,327345,1929,423,326922,Americas
Cyprus,28-06-2020,302822,1069,1005,301817,Europe
Czechia,28-06-2020,390085,1070,881,389204,Europe
Denmark,28-06-2020,132608,1945,261,132347,Europe
Greenland,28-06-2020,414577,1508,880,413697,Europe
Denmark,28-06-2020,350629,433,262,350367,Europe
Djibouti,28-06-2020,138189,515,651,137538,Eastern Mediterranean
Dominican Republic,28-06-2020,329752,1725,148,329604,Americas
Ecuador,28-06-2020,311365,265,328,311037,Americas
Egypt,28-06-2020,207998,1728,330,207668,Eastern Mediterranean
El Salvador,28-06-2020,195654,972,331,195323,Americas
Equatorial Guinea,28-06-2020,310676,268,1052,309624,Africa
Eritrea,28-06-2020,408648,2317,831,407817,Africa
Estonia,28-06-2020,361462,1872,94,361368,Europe
Eswatini,28-06-2020,398685,1566,1036,397649,Africa
Ethiopia,28-06-2020,445508,1970,381,445127,Africa
Fiji,28-06-2020,374209,806,1147,373062,Western Pacific
Finland,28-06-2020,283803,2086,9,283794,Europe
France,28-06-2020,215265,783,316,214949,Europe
France,28-06-2020,345743,134,426,345317,Europe
France,28-06-2020,169484,1338,743,168741,Europe
France,28-06-2020,397016,269,1187,395829,Europe
France,28-06-2020,280019,1345,1159,278860,Europe
France,28-06-2020,405702,897,139,405563,Europe
France,28-06-2020,199514,286,1227,198287,Europe
France,28-06-2020,408285,911,431,407854,Europe
France,28-06-2020,21458,379,675,20783,Europe
France,28-06-2020,315181,615,1062,314119,Europe
Gabon,28-06-2020,80082,1076,330,79752,Africa
Gambia,28-06-2020,71448,1859,375,71073,Africa
Georgia,28-06-2020,271518,2027,415,271103,Europe
Germany,28-06-2020,400797,1664,575,400222,Europe
Ghana,28-06-2020,41005,1960,377,40628,Africa
Greece,28-06-2020,278160,2123,406,277754,Europe
Guatemala,28-06-2020,168288,117,237,168051,Americas
Guinea,28-06-2020,3592,170,616,2976,Africa
Guyana,28-06-2020,225618,4,459,225159,Americas
Haiti,28-06-2020,23155,383,1116,22039,Americas
Holy See,28-06-2020,361335,1501,1024,360311,Europe
Honduras,28-06-2020,86652,1295,528,86124,Americas
Hungary,28-06-2020,293338,113,1153,292185,Europe
Iceland,28-06-2020,256180,478,822,255358,Europe
India,28-06-2020,260139,2488,170,259969,South-East Asia
Indonesia,28-06-2020,386738,2082,4,386734,South-East Asia
Iran,28-06-2020,384425,1112,272,384153,Eastern Mediterranean
Iraq,28-06-2020,298343,1688,982,297361,Eastern Mediterranean
Ireland,28-06-2020,293339,2306,361,292978,Europe
Israel,28-06-2020,247423,816,893,246530,Europe
Italy,28-06-2020,312020,1483,1148,310872,Europe
Jamaica,28-06-2020,374042,44,1143,372899,Americas
Japan,28-06-2020,278274,1834,1019,277255,Western Pacific
Jordan,28-06-2020,174216,9,387,173829,Eastern Mediterranean
Kazakhstan,28-06-2020,400515,2145,841,399674,Europe
Kenya,28-06-2020,293817,34,4,293813,Africa
South Korea,28-06-2020,398821,2071,823,397998,Western Pacific
Kuwait,28-06-2020,189540,2370,762,188778,Eastern Mediterranean
Kyrgyzstan,28-06-2020,39412,1873,996,38416,Europe
Latvia,28-06-2020,203792,1958,229,203563,Europe
Lebanon,28-06-2020,441031,1662,189,440842,Eastern Mediterranean
Liberia,28-06-2020,375270,140,1199,374071,Africa
Liechtenstein,28-06-2020,314461,69,755,313706,Europe
Lithuania,28-06-2020,28752,2408,964,27788,Europe
Luxembourg,28-06-2020,156057,1668,273,155784,Europe
Madagascar,28-06-2020,440073,372,1231,438842,Africa
Malaysia,28-06-2020,85801,229,925,84876,Western Pacific
Maldives,28-06-2020,346238,632,1054,345184,South-East Asia
Malta,28-06-2020,333192,877,432,332760,Europe
Mauritania,28-06-2020,247799,22,1237,246562,Africa
Mauritius,28-06-2020,5282,1919,1108,4174,Africa
Mexico,28-06-2020,161346,494,876,160470,Americas
Moldova,28-06-2020,211128,1015,135,210993,Europe
Monaco,28-06-2020,383658,1012,1166,382492,Europe
Mongolia,28-06-2020,184992,1031,677,184315,Western Pacific
Montenegro,28-06-2020,16929,1827,324,16605,Europe
Morocco,28-06-2020,240360,261,700,239660,Eastern Mediterranean
Namibia,28-06-2020,389476,482,328,389148,Africa
Nepal,28-06-2020,35252,875,771,34481,South-East Asia
Netherlands,28-06-2020,315021,2162,1230,313791,Europe
Netherlands,28-06-2020,332664,1558,130,332534,Europe
Netherlands,28-06-2020,290203,50,414,289789,Europe
Netherlands,28-06-2020,114536,1236,654,113882,Europe
New Zealand,28-06-2020,82095,592,659,81436,Western Pacific
Nicaragua,28-06-2020,126079,2474,974,125105,Americas
Niger,28-06-2020,322012,311,536,321476,Africa
Nigeria,28-06-2020,376745,1944,862,375883,Africa
North Macedonia,28-06-2020,164018,247,288,163730,Europe
Norway,28-06-2020,428486,1731,774,427712,Europe
Oman,28-06-2020,448398,412,241,448157,Eastern Mediterranean
Pakistan,28-06-2020,269102,638,392,268710,Eastern Mediterranean
Panama,28-06-2020,266399,1800,680,265719,Americas
Papua New Guinea,28-06-2020,382033,2438,569,381464,Western Pacific
Paraguay,28-06-2020,181965,1401,113,181852,Americas
Peru,28-06-2020,415582,2435,1225,414357,Americas
Philippines,28-06-2020,122903,2306,126,122777,Western Pacific
Poland,28-06-2020,79339,303,76,79263,Europe
Portugal,28-06-2020,327246,325,747,326499,Europe
Qatar,28-06-2020,338825,117,534,338291,Eastern Mediterranean
Romania,28-06-2020,198608,1388,926,197682,Europe
Russia,28-06-2020,2496,379,24,2472,Europe
Rwanda,28-06-2020,84491,786,433,84058,Africa
Saint Lucia,28-06-2020,3205,1741,47,3158,Americas
Saint Vincent and the Grenadines,28-06-2020,248980,1400,43,248937,Americas
San Marino,28-06-2020,328123,387,1160,326963,Europe
Saudi Arabia,28-06-2020,167557,1080,1148,166409,Eastern Mediterranean
Senegal,28-06-2020,303264,1335,802,302462,Africa
Serbia,28-06-2020,135878,1833,196,135682,Europe
Seychelles,28-06-2020,188023,2348,137,187886,Africa
Singapore,28-06-2020,106089,1641,718,105371,Western Pacific
Slovakia,28-06-2020,106602,2399,563,106039,Europe
Slovenia,28-06-2020,426656,2050,630,426026,Europe
Somalia,28-06-2020,160914,991,549,160365,Eastern Mediterranean
South Africa,28-06-2020,334335,2098,109,334226,Africa
Spain,28-06-2020,62105,1110,132,61973,Europe
Sri Lanka,28-06-2020,352023,1597,132,351891,South-East Asia
Sudan,28-06-2020,435622,178,751,434871,Eastern Mediterranean
Suriname,28-06-2020,31546,636,799,30747,Americas
Sweden,28-06-2020,3983,2088,207,3776,Europe
Switzerland,28-06-2020,337614,119,256,337358,Europe
Taiwan*,28-06-2020,321656,2243,553,321103,Western Pacific
Tanzania,28-06-2020,246056,920,535,245521,Africa
Thailand,28-06-2020,78257,1786,975,77282,South-East Asia
Togo,28-06-2020,209865,1999,1097,208768,Africa
Trinidad and Tobago,28-06-2020,45,1840,162,-117,Americas
Tunisia,28-06-2020,76151,2452,956,75195,Eastern Mediterranean
Turkey,28-06-2020,334942,680,71,334871,Europe
Uganda,28-06-2020,270305,1702,401,269904,Africa
Ukraine,28-06-2020,383062,2274,861,382201,Europe
United Arab Emirates,28-06-2020,31844,122,191,31653,Eastern Mediterranean
United Kingdom,28-06-2020,429139,570,283,428856,Europe
United Kingdom,28-06-2020,274203,2379,513,273690,Europe
United Kingdom,28-06-2020,57570,1847,843,56727,Europe
United Kingdom,28-06-2020,242664,1878,1212,241452,Europe
United Kingdom,28-06-2020,191317,2401,67,191250,Europe
United Kingdom,28-06-2020,3650,770,931,2719,Europe
United Kingdom,28-06-2020,237716,550,354,237362,Europe
Uruguay,28-06-2020,104239,2341,956,103283,Americas
US,28-06-2020,198658,257,354,198304,Americas
Uzbekistan,28-06-2020,399817,2365,781,399036,Europe
Venezuela,28-06-2020,96188,1868,371,95817,Americas
Vietnam,28-06-2020,35099,1908,1164,33935,Western Pacific
Zambia,28-06-2020,107201,661,759,106442,Africa
Zimbabwe,28-06-2020,166775,110,154,166621,Africa
Dominica,28-06-2020,395167,527,20,395147,Americas
Grenada,28-06-2020,50185,2096,1068,49117,Americas
Mozambique,28-06-2020,303890,95,1220,302670,Africa
Syria,28-06-2020,303423,706,324,303099,Eastern Mediterranean
Timor-Leste,28-06-2020,99303,1579,558,98745,South-East Asia
Belize,28-06-2020,338355,366,376,337979,Americas
Laos,28-06-2020,121151,109,816,120335,Western Pacific
Libya,28-06-2020,291722,1597,341,291381,Eastern Mediterranean
West Bank and Gaza,28-06-2020,416054,572,333,415721,Eastern Mediterranean
Guinea-Bissau,28-06-2020,235249,1660,45,235204,Africa
Mali,28-06-2020,259491,2091,1079,258412,Africa
Saint Kitts and Nevis,28-06-2020,370812,2415,1090,369722,Americas
Canada,28-06-2020,277316,1681,538,276778,Americas
Canada,28-06-2020,240156,1974,206,239950,Americas
Kosovo,28-06-2020,141398,563,769,140629,Europe
Burma,28-06-2020,373196,2325,1142,372054,South-East Asia
United Kingdom,28-06-2020,404934,2131,67,404867,Europe
United Kingdom,28-06-2020,83785,2301,502,83283,Europe
United Kingdom,28-06-2020,248311,743,1229,247082,Europe
Botswana,28-06-2020,290106,308,944,289162,Africa
Burundi,28-06-2020,159426,455,593,158833,Africa
Sierra Leone,28-06-2020,94708,653,165,94543,Africa
Malawi,28-06-2020,411510,874,702,410808,Africa
United Kingdom,28-06-2020,335364,2498,958,334406,Europe
France,28-06-2020,218656,503,868,217788,Europe
South Sudan,28-06-2020,89949,1941,484,89465,Africa
Western Sahara,28-06-2020,303761,1096,1040,302721,Africa
Sao Tome and Principe,28-06-2020,336412,296,433,335979,Africa
Yemen,28-06-2020,313653,612,1002,312651,Eastern Mediterranean
Comoros,28-06-2020,256901,2212,1038,255863,Africa
Tajikistan,28-06-2020,383428,1408,529,382899,Europe
Lesotho,28-06-2020,73805,345,754,73051,Africa
Afghanistan,29-06-2020,232526,1155,1119,231407,Eastern Mediterranean
Albania,29-06-2020,205419,250,939,204480,Europe
Algeria,29-06-2020,14939,1047,395,14544,Africa
Andorra,29-06-2020,247032,2009,679,246353,Europe
Angola,29-06-2020,76149,144,229,75920,Africa
Antigua and Barbuda,29-06-2020,303673,1202,686,302987,Americas
Argentina,29-06-2020,428720,1307,549,428171,Americas
Armenia,29-06-2020,23207,2448,404,22803,Europe
Australia,29-06-2020,49290,776,752,48538,Western Pacific
Australia,29-06-2020,407330,1497,837,406493,Western Pacific
Australia,29-06-2020,24542,1149,545,23997,Western Pacific
Australia,29-06-2020,149423,1880,396,149027,Western Pacific
Australia,29-06-2020,131431,2234,1017,130414,Western Pacific
Australia,29-06-2020,110591,1163,601,109990,Western Pacific
Australia,29-06-2020,213423,1027,218,213205,Western Pacific
Australia,29-06-2020,361439,851,953,360486,Western Pacific
Austria,29-06-2020,351834,1893,1110,350724,Europe
Azerbaijan,29-06-2020,340069,2005,856,339213,Europe
Bahamas,29-06-2020,388983,322,671,388312,Americas
Bahrain,29-06-2020,225174,1656,528,224646,Eastern Mediterranean
Bangladesh,29-06-2020,291932,63,1201,290731,South-East Asia
Barbados,29-06-2020,126469,1511,225,126244,Americas
Belarus,29-06-2020,177367,554,736,176631,Europe
Belgium,29-06-2020,177952,2200,45,177907,Europe
Benin,29-06-2020,261307,1543,430,260877,Africa
Bhutan,29-06-2020,306904,1976,74,306830,South-East Asia
Bolivia,29-06-2020,332013,1228,1149,330864,Americas
Bosnia and Herzegovina,29-06-2020,377289,940,1137,376152,Europe
Brazil,29-06-2020,4444,1898,865,3579,Americas
Brunei,29-06-2020,388960,700,661,388299,Western Pacific
Bulgaria,29-06-2020,335793,482,948,334845,Europe
Burkina Faso,29-06-2020,81668,2151,590,81078,Africa
Cabo Verde,29-06-2020,254426,1442,195,254231,Africa
Cambodia,29-06-2020,297794,2402,999,296795,Western Pacific
Cameroon,29-06-2020,392162,1020,1141,391021,Africa
Canada,29-06-2020,46927,1722,877,46050,Americas
Canada,29-06-2020,306407,223,919,305488,Americas
Canada,29-06-2020,404225,846,685,403540,Americas
Canada,29-06-2020,264104,1091,1021,263083,Americas
Canada,29-06-2020,418069,665,62,418007,Americas
Canada,29-06-2020,189577,139,837,188740,Americas
Canada,29-06-2020,56091,518,1019,55072,Americas
Canada,29-06-2020,392067,900,163,391904,Americas
Canada,29-06-2020,319810,185,882,318928,Americas
Canada,29-06-2020,192689,2297,67,192622,Americas
Central African Republic,29-06-2020,377840,1166,232,377608,Africa
Chad,29-06-2020,52020,1038,375,51645,Africa
Chile,29-06-2020,247575,803,503,247072,Americas
China,29-06-2020,49935,1047,34,49901,Western Pacific
China,29-06-2020,12180,1384,407,11773,Western Pacific
China,29-06-2020,133891,521,1024,132867,Western Pacific
China,29-06-2020,200966,1474,876,200090,Western Pacific
China,29-06-2020,141277,962,1215,140062,Western Pacific
China,29-06-2020,183996,2094,390,183606,Western Pacific
China,29-06-2020,20976,1799,1245,19731,Western Pacific
China,29-06-2020,172536,803,262,172274,Western Pacific
China,29-06-2020,365447,455,418,365029,Western Pacific
China,29-06-2020,210656,1035,418,210238,Western Pacific
China,29-06-2020,142329,507,1091,141238,Western Pacific
China,29-06-2020,279672,2415,397,279275,Western Pacific
China,29-06-2020,300582,2373,352,300230,Western Pacific
China,29-06-2020,218863,2474,298,218565,Western Pacific
China,29-06-2020,67243,1146,1229,66014,Western Pacific
China,29-06-2020,281880,1658,804,281076,Western Pacific
China,29-06-2020,81914,1730,1051,80863,Western Pacific
China,29-06-2020,446797,110,1049,445748,Western Pacific
China,29-06-2020,339447,1375,287,339160,Western Pacific
China,29-06-2020,107685,2235,980,106705,Western Pacific
China,29-06-2020,158201,616,349,157852,Western Pacific
China,29-06-2020,337240,1222,1227,336013,Western Pacific
China,29-06-2020,69418,125,423,68995,Western Pacific
China,29-06-2020,106776,1612,192,106584,Western Pacific
China,29-06-2020,92145,99,1220,90925,Western Pacific
China,29-06-2020,239165,512,1012,238153,Western Pacific
China,29-06-2020,332859,2461,256,332603,Western Pacific
China,29-06-2020,136487,2249,863,135624,Western Pacific
China,29-06-2020,21650,1104,458,21192,Western Pacific
China,29-06-2020,351940,156,252,351688,Western Pacific
China,29-06-2020,103388,207,848,102540,Western Pacific
China,29-06-2020,70638,109,210,70428,Western Pacific
China,29-06-2020,87889,897,395,87494,Western Pacific
Colombia,29-06-2020,304495,2388,75,304420,Americas
Congo (Brazzaville),29-06-2020,301433,824,1174,300259,Africa
Congo (Kinshasa),29-06-2020,152745,2225,449,152296,Africa
Costa Rica,29-06-2020,210886,69,414,210472,Americas
Cote d'Ivoire,29-06-2020,288308,679,1076,287232,Africa
Croatia,29-06-2020,206224,1814,220,206004,Europe
Cuba,29-06-2020,249367,2368,426,248941,Americas
Cyprus,29-06-2020,130964,1448,372,130592,Europe
Czechia,29-06-2020,128072,2298,1235,126837,Europe
Denmark,29-06-2020,297457,393,796,296661,Europe
Greenland,29-06-2020,378862,2082,1002,377860,Europe
Denmark,29-06-2020,246769,1876,1205,245564,Europe
Djibouti,29-06-2020,187652,2296,508,187144,Eastern Mediterranean
Dominican Republic,29-06-2020,176273,1475,488,175785,Americas
Ecuador,29-06-2020,370512,1109,601,369911,Americas
Egypt,29-06-2020,394443,1330,1009,393434,Eastern Mediterranean
El Salvador,29-06-2020,13777,1153,819,12958,Americas
Equatorial Guinea,29-06-2020,247681,1304,47,247634,Africa
Eritrea,29-06-2020,307885,38,88,307797,Africa
Estonia,29-06-2020,343835,537,115,343720,Europe
Eswatini,29-06-2020,94471,722,773,93698,Africa
Ethiopia,29-06-2020,388610,2358,38,388572,Africa
Fiji,29-06-2020,416854,248,529,416325,Western Pacific
Finland,29-06-2020,29357,143,67,29290,Europe
France,29-06-2020,132236,1729,822,131414,Europe
France,29-06-2020,251128,1921,780,250348,Europe
France,29-06-2020,33191,525,563,32628,Europe
France,29-06-2020,118955,2236,798,118157,Europe
France,29-06-2020,393130,1149,1075,392055,Europe
France,29-06-2020,1695,644,800,895,Europe
France,29-06-2020,115326,1533,632,114694,Europe
France,29-06-2020,295628,1001,176,295452,Europe
France,29-06-2020,256439,423,543,255896,Europe
France,29-06-2020,63525,1137,48,63477,Europe
Gabon,29-06-2020,445243,2358,684,444559,Africa
Gambia,29-06-2020,27075,1489,1176,25899,Africa
Georgia,29-06-2020,49147,1445,616,48531,Europe
Germany,29-06-2020,309061,1539,1216,307845,Europe
Ghana,29-06-2020,160325,1996,459,159866,Africa
Greece,29-06-2020,23796,1146,583,23213,Europe
Guatemala,29-06-2020,150750,967,625,150125,Americas
Guinea,29-06-2020,224025,2352,264,223761,Africa
Guyana,29-06-2020,29588,2472,493,29095,Americas
Haiti,29-06-2020,230617,1630,717,229900,Americas
Holy See,29-06-2020,276628,1544,851,275777,Europe
Honduras,29-06-2020,142780,183,388,142392,Americas
Hungary,29-06-2020,21276,527,321,20955,Europe
Iceland,29-06-2020,437677,1617,424,437253,Europe
India,29-06-2020,81498,1230,532,80966,South-East Asia
Indonesia,29-06-2020,70542,1384,268,70274,South-East Asia
Iran,29-06-2020,384637,610,1045,383592,Eastern Mediterranean
Iraq,29-06-2020,279988,1116,422,279566,Eastern Mediterranean
Ireland,29-06-2020,22495,102,199,22296,Europe
Israel,29-06-2020,383057,1065,811,382246,Europe
Italy,29-06-2020,20719,835,351,20368,Europe
Jamaica,29-06-2020,312553,622,1220,311333,Americas
Japan,29-06-2020,155223,682,1009,154214,Western Pacific
Jordan,29-06-2020,271382,112,274,271108,Eastern Mediterranean
Kazakhstan,29-06-2020,104654,1882,934,103720,Europe
Kenya,29-06-2020,57061,1714,731,56330,Africa
South Korea,29-06-2020,262551,2067,443,262108,Western Pacific
Kuwait,29-06-2020,429876,1467,424,429452,Eastern Mediterranean
Kyrgyzstan,29-06-2020,367669,765,1189,366480,Europe
Latvia,29-06-2020,74582,1642,1055,73527,Europe
Lebanon,29-06-2020,381616,390,410,381206,Eastern Mediterranean
Liberia,29-06-2020,304991,1874,943,304048,Africa
Liechtenstein,29-06-2020,393421,1620,1188,392233,Europe
Lithuania,29-06-2020,91476,1113,206,91270,Europe
Luxembourg,29-06-2020,245948,2268,354,245594,Europe
Madagascar,29-06-2020,359201,1927,639,358562,Africa
Malaysia,29-06-2020,315006,72,526,314480,Western Pacific
Maldives,29-06-2020,302251,541,886,301365,South-East Asia
Malta,29-06-2020,100003,763,1249,98754,Europe
Mauritania,29-06-2020,232377,2450,58,232319,Africa
Mauritius,29-06-2020,385672,1772,5,385667,Africa
Mexico,29-06-2020,27112,2079,145,26967,Americas
Moldova,29-06-2020,49965,1324,267,49698,Europe
Monaco,29-06-2020,299641,389,1012,298629,Europe
Mongolia,29-06-2020,168123,1625,71,168052,Western Pacific
Montenegro,29-06-2020,250194,705,974,249220,Europe
Morocco,29-06-2020,212283,956,818,211465,Eastern Mediterranean
Namibia,29-06-2020,3216,106,42,3174,Africa
Nepal,29-06-2020,49838,17,167,49671,South-East Asia
Netherlands,29-06-2020,179648,1321,1096,178552,Europe
Netherlands,29-06-2020,15504,70,8,15496,Europe
Netherlands,29-06-2020,257712,1904,570,257142,Europe
Netherlands,29-06-2020,404849,1222,279,404570,Europe
New Zealand,29-06-2020,341363,1047,184,341179,Western Pacific
Nicaragua,29-06-2020,409102,1400,1001,408101,Americas
Niger,29-06-2020,15037,1823,874,14163,Africa
Nigeria,29-06-2020,266272,1360,798,265474,Africa
North Macedonia,29-06-2020,129459,250,816,128643,Europe
Norway,29-06-2020,319182,984,51,319131,Europe
Oman,29-06-2020,380065,1637,200,379865,Eastern Mediterranean
Pakistan,29-06-2020,62549,286,53,62496,Eastern Mediterranean
Panama,29-06-2020,279542,1920,716,278826,Americas
Papua New Guinea,29-06-2020,274521,2425,606,273915,Western Pacific
Paraguay,29-06-2020,311329,2051,229,311100,Americas
Peru,29-06-2020,367125,383,1045,366080,Americas
Philippines,29-06-2020,309970,1192,827,309143,Western Pacific
Poland,29-06-2020,132606,1248,438,132168,Europe
Portugal,29-06-2020,326936,382,255,326681,Europe
Qatar,29-06-2020,59095,2424,454,58641,Eastern Mediterranean
Romania,29-06-2020,121983,1822,1125,120858,Europe
Russia,29-06-2020,371619,1806,619,371000,Europe
Rwanda,29-06-2020,197170,799,809,196361,Africa
Saint Lucia,29-06-2020,71185,1954,719,70466,Americas
Saint Vincent and the Grenadines,29-06-2020,69648,1944,489,69159,Americas
San Marino,29-06-2020,61469,27,1076,60393,Europe
Saudi Arabia,29-06-2020,311682,1406,1163,310519,Eastern Mediterranean
Senegal,29-06-2020,356916,1768,230,356686,Africa
Serbia,29-06-2020,127452,2041,1023,126429,Europe
Seychelles,29-06-2020,353149,265,1002,352147,Africa
Singapore,29-06-2020,308545,226,618,307927,Western Pacific
Slovakia,29-06-2020,93902,1348,635,93267,Europe
Slovenia,29-06-2020,181581,1139,1200,180381,Europe
Somalia,29-06-2020,402327,1569,145,402182,Eastern Mediterranean
South Africa,29-06-2020,442496,2479,270,442226,Africa
Spain,29-06-2020,345541,1051,475,345066,Europe
Sri Lanka,29-06-2020,203088,960,1068,202020,South-East Asia
Sudan,29-06-2020,439786,1080,107,439679,Eastern Mediterranean
Suriname,29-06-2020,48699,1270,696,48003,Americas
Sweden,29-06-2020,370596,181,564,370032,Europe
Switzerland,29-06-2020,296914,393,487,296427,Europe
Taiwan*,29-06-2020,302389,2380,1039,301350,Western Pacific
Tanzania,29-06-2020,220666,1314,442,220224,Africa
Thailand,29-06-2020,431725,1153,356,431369,South-East Asia
Togo,29-06-2020,406653,2286,860,405793,Africa
Trinidad and Tobago,29-06-2020,45380,908,471,44909,Americas
Tunisia,29-06-2020,448877,617,267,448610,Eastern Mediterranean
Turkey,29-06-2020,243200,2178,598,242602,Europe
Uganda,29-06-2020,27354,288,270,27084,Africa
Ukraine,29-06-2020,9758,1764,285,9473,Europe
United Arab Emirates,29-06-2020,228986,686,439,228547,Eastern Mediterranean
United Kingdom,29-06-2020,430093,1767,1031,429062,Europe
United Kingdom,29-06-2020,16142,215,540,15602,Europe
United Kingdom,29-06-2020,327180,270,1158,326022,Europe
United Kingdom,29-06-2020,139646,322,877,138769,Europe
United Kingdom,29-06-2020,13686,2124,596,13090,Europe
United Kingdom,29-06-2020,206812,1705,4,206808,Europe
United Kingdom,29-06-2020,302185,2102,370,301815,Europe
Uruguay,29-06-2020,99613,57,1166,98447,Americas
US,29-06-2020,97021,2414,685,96336,Americas
Uzbekistan,29-06-2020,234129,1511,675,233454,Europe
Venezuela,29-06-2020,256132,47,708,255424,Americas
Vietnam,29-06-2020,13764,139,870,12894,Western Pacific
Zambia,29-06-2020,396555,1983,835,395720,Africa
Zimbabwe,29-06-2020,430323,186,1127,429196,Africa
Dominica,29-06-2020,449258,68,652,448606,Americas
Grenada,29-06-2020,260960,658,117,260843,Americas
Mozambique,29-06-2020,372,496,775,-403,Africa
Syria,29-06-2020,229192,1211,125,229067,Eastern Mediterranean
Timor-Leste,29-06-2020,431684,998,425,431259,South-East Asia
Belize,29-06-2020,177447,233,159,177288,Americas
Laos,29-06-2020,226551,106,976,225575,Western Pacific
Libya,29-06-2020,344160,814,107,344053,Eastern Mediterranean
West Bank and Gaza,29-06-2020,187700,175,1028,186672,Eastern Mediterranean
Guinea-Bissau,29-06-2020,231785,1851,488,231297,Africa
Mali,29-06-2020,109351,1445,1039,108312,Africa
Saint Kitts and Nevis,29-06-2020,302056,456,531,301525,Americas
Canada,29-06-2020,215118,570,16,215102,Americas
Canada,29-06-2020,187338,1812,100,187238,Americas
Kosovo,29-06-2020,130090,2234,281,129809,Europe
Burma,29-06-2020,9826,321,1213,8613,South-East Asia
United Kingdom,29-06-2020,17288,770,344,16944,Europe
United Kingdom,29-06-2020,339360,1884,452,338908,Europe
United Kingdom,29-06-2020,243124,82,943,242181,Europe
Botswana,29-06-2020,244489,349,763,243726,Africa
Burundi,29-06-2020,171243,1535,831,170412,Africa
Sierra Leone,29-06-2020,57241,2264,545,56696,Africa
Malawi,29-06-2020,100891,1425,225,100666,Africa
United Kingdom,29-06-2020,356091,764,87,356004,Europe
France,29-06-2020,403274,887,1230,402044,Europe
South Sudan,29-06-2020,107823,1020,975,106848,Africa
Western Sahara,29-06-2020,258272,1692,1215,257057,Africa
Sao Tome and Principe,29-06-2020,242232,1389,186,242046,Africa
Yemen,29-06-2020,312399,263,632,311767,Eastern Mediterranean
Comoros,29-06-2020,148750,2232,534,148216,Africa
Tajikistan,29-06-2020,332325,231,879,331446,Europe
Lesotho,29-06-2020,214493,958,1227,213266,Africa
Afghanistan,30-06-2020,287624,1272,649,286975,Eastern Mediterranean
Albania,30-06-2020,156834,2279,609,156225,Europe
Algeria,30-06-2020,192359,1044,79,192280,Africa
Andorra,30-06-2020,76376,1899,647,75729,Europe
Angola,30-06-2020,292805,2386,221,292584,Africa
Antigua and Barbuda,30-06-2020,76269,906,168,76101,Americas
Argentina,30-06-2020,31179,1652,1150,30029,Americas
Armenia,30-06-2020,33977,1458,1178,32799,Europe
Australia,30-06-2020,270029,1234,1101,268928,Western Pacific
Australia,30-06-2020,390154,735,53,390101,Western Pacific
Australia,30-06-2020,285842,624,201,285641,Western Pacific
Australia,30-06-2020,33445,241,588,32857,Western Pacific
Australia,30-06-2020,372410,549,453,371957,Western Pacific
Australia,30-06-2020,310389,1731,80,310309,Western Pacific
Australia,30-06-2020,124805,557,708,124097,Western Pacific
Australia,30-06-2020,82768,1681,375,82393,Western Pacific
Austria,30-06-2020,97603,205,979,96624,Europe
Azerbaijan,30-06-2020,131367,2251,536,130831,Europe
Bahamas,30-06-2020,42786,1812,1148,41638,Americas
Bahrain,30-06-2020,109425,2279,714,108711,Eastern Mediterranean
Bangladesh,30-06-2020,258337,2430,216,258121,South-East Asia
Barbados,30-06-2020,387758,203,218,387540,Americas
Belarus,30-06-2020,197926,637,330,197596,Europe
Belgium,30-06-2020,421431,566,921,420510,Europe
Benin,30-06-2020,1817,623,307,1510,Africa
Bhutan,30-06-2020,61825,791,875,60950,South-East Asia
Bolivia,30-06-2020,292123,74,412,291711,Americas
Bosnia and Herzegovina,30-06-2020,385087,46,754,384333,Europe
Brazil,30-06-2020,358996,674,1032,357964,Americas
Brunei,30-06-2020,280580,707,333,280247,Western Pacific
Bulgaria,30-06-2020,61627,1604,312,61315,Europe
Burkina Faso,30-06-2020,127819,704,800,127019,Africa
Cabo Verde,30-06-2020,278738,2250,631,278107,Africa
Cambodia,30-06-2020,51973,2289,816,51157,Western Pacific
Cameroon,30-06-2020,153663,319,253,153410,Africa
Canada,30-06-2020,182710,2369,916,181794,Americas
Canada,30-06-2020,317945,2362,1092,316853,Americas
Canada,30-06-2020,126867,2316,234,126633,Americas
Canada,30-06-2020,383962,935,91,383871,Americas
Canada,30-06-2020,9380,968,813,8567,Americas
Canada,30-06-2020,178544,542,720,177824,Americas
Canada,30-06-2020,402929,65,1227,401702,Americas
Canada,30-06-2020,293348,810,485,292863,Americas
Canada,30-06-2020,127376,124,286,127090,Americas
Canada,30-06-2020,240753,605,537,240216,Americas
Central African Republic,30-06-2020,79396,592,82,79314,Africa
Chad,30-06-2020,69568,948,629,68939,Africa
Chile,30-06-2020,222542,426,765,221777,Americas
China,30-06-2020,240117,1571,94,240023,Western Pacific
China,30-06-2020,425068,1580,869,424199,Western Pacific
China,30-06-2020,337848,438,487,337361,Western Pacific
China,30-06-2020,171837,2365,512,171325,Western Pacific
China,30-06-2020,394055,2039,406,393649,Western Pacific
China,30-06-2020,43864,1575,125,43739,Western Pacific
China,30-06-2020,143839,1413,570,143269,Western Pacific
China,30-06-2020,425440,1389,676,424764,Western Pacific
China,30-06-2020,235050,2296,1132,233918,Western Pacific
China,30-06-2020,110116,229,886,109230,Western Pacific
China,30-06-2020,137181,882,3,137178,Western Pacific
China,30-06-2020,371066,1060,363,370703,Western Pacific
China,30-06-2020,161676,1419,662,161014,Western Pacific
China,30-06-2020,182927,35,187,182740,Western Pacific
China,30-06-2020,443647,455,836,442811,Western Pacific
China,30-06-2020,428054,1341,477,427577,Western Pacific
China,30-06-2020,111140,669,235,110905,Western Pacific
China,30-06-2020,189359,1970,918,188441,Western Pacific
China,30-06-2020,143719,2124,1221,142498,Western Pacific
China,30-06-2020,233803,474,908,232895,Western Pacific
China,30-06-2020,70567,527,855,69712,Western Pacific
China,30-06-2020,26464,811,153,26311,Western Pacific
China,30-06-2020,349038,776,864,348174,Western Pacific
China,30-06-2020,151105,1253,640,150465,Western Pacific
China,30-06-2020,395406,1538,1082,394324,Western Pacific
China,30-06-2020,169949,2483,177,169772,Western Pacific
China,30-06-2020,92662,1571,972,91690,Western Pacific
China,30-06-2020,358714,4,318,358396,Western Pacific
China,30-06-2020,80557,821,906,79651,Western Pacific
China,30-06-2020,16952,2231,249,16703,Western Pacific
China,30-06-2020,178126,2184,82,178044,Western Pacific
China,30-06-2020,102099,188,2,102097,Western Pacific
China,30-06-2020,389773,798,1002,388771,Western Pacific
Colombia,30-06-2020,17082,1619,852,16230,Americas
Congo (Brazzaville),30-06-2020,181394,705,114,181280,Africa
Congo (Kinshasa),30-06-2020,72583,410,319,72264,Africa
Costa Rica,30-06-2020,112394,1245,435,111959,Americas
Cote d'Ivoire,30-06-2020,155470,2186,651,154819,Africa
Croatia,30-06-2020,362342,201,951,361391,Europe
Cuba,30-06-2020,418985,1897,555,418430,Americas
Cyprus,30-06-2020,113436,110,603,112833,Europe
Czechia,30-06-2020,192108,809,705,191403,Europe
Denmark,30-06-2020,262283,1858,266,262017,Europe
Greenland,30-06-2020,411797,265,220,411577,Europe
Denmark,30-06-2020,358117,1350,212,357905,Europe
Djibouti,30-06-2020,357144,1263,731,356413,Eastern Mediterranean
Dominican Republic,30-06-2020,2557,1142,317,2240,Americas
Ecuador,30-06-2020,17057,748,38,17019,Americas
Egypt,30-06-2020,328748,2495,95,328653,Eastern Mediterranean
El Salvador,30-06-2020,401112,1296,811,400301,Americas
Equatorial Guinea,30-06-2020,196626,1610,478,196148,Africa
Eritrea,30-06-2020,275669,1062,944,274725,Africa
Estonia,30-06-2020,121943,2323,1050,120893,Europe
Eswatini,30-06-2020,124234,594,1185,123049,Africa
Ethiopia,30-06-2020,313504,1258,246,313258,Africa
Fiji,30-06-2020,381935,1523,689,381246,Western Pacific
Finland,30-06-2020,288758,629,698,288060,Europe
France,30-06-2020,79442,383,62,79380,Europe
France,30-06-2020,173145,1373,739,172406,Europe
France,30-06-2020,289067,1402,891,288176,Europe
France,30-06-2020,155029,1940,877,154152,Europe
France,30-06-2020,425124,683,690,424434,Europe
France,30-06-2020,27757,131,1181,26576,Europe
France,30-06-2020,230742,1703,508,230234,Europe
France,30-06-2020,286497,767,1108,285389,Europe
France,30-06-2020,194158,906,582,193576,Europe
France,30-06-2020,90510,2273,727,89783,Europe
Gabon,30-06-2020,444907,1555,115,444792,Africa
Gambia,30-06-2020,282485,1090,821,281664,Africa
Georgia,30-06-2020,195909,2144,565,195344,Europe
Germany,30-06-2020,216602,2098,454,216148,Europe
Ghana,30-06-2020,41456,1526,1247,40209,Africa
Greece,30-06-2020,398786,1219,558,398228,Europe
Guatemala,30-06-2020,112386,507,530,111856,Americas
Guinea,30-06-2020,267510,220,333,267177,Africa
Guyana,30-06-2020,234193,1574,797,233396,Americas
Haiti,30-06-2020,102280,797,812,101468,Americas
Holy See,30-06-2020,323183,1964,0,323183,Europe
Honduras,30-06-2020,416685,2,418,416267,Americas
Hungary,30-06-2020,234121,159,534,233587,Europe
Iceland,30-06-2020,331039,2194,649,330390,Europe
India,30-06-2020,248566,456,150,248416,South-East Asia
Indonesia,30-06-2020,120703,1662,348,120355,South-East Asia
Iran,30-06-2020,69022,1042,1100,67922,Eastern Mediterranean
Iraq,30-06-2020,195244,1891,498,194746,Eastern Mediterranean
Ireland,30-06-2020,304921,1877,895,304026,Europe
Israel,30-06-2020,437890,612,341,437549,Europe
Italy,30-06-2020,311438,1226,1230,310208,Europe
Jamaica,30-06-2020,221266,732,890,220376,Americas
Japan,30-06-2020,162435,365,1049,161386,Western Pacific
Jordan,30-06-2020,407139,387,595,406544,Eastern Mediterranean
Kazakhstan,30-06-2020,425341,784,20,425321,Europe
Kenya,30-06-2020,422738,1501,1160,421578,Africa
South Korea,30-06-2020,236033,2469,656,235377,Western Pacific
Kuwait,30-06-2020,97461,1872,243,97218,Eastern Mediterranean
Kyrgyzstan,30-06-2020,23954,681,922,23032,Europe
Latvia,30-06-2020,93760,1228,70,93690,Europe
Lebanon,30-06-2020,274146,623,564,273582,Eastern Mediterranean
Liberia,30-06-2020,346507,1650,941,345566,Africa
Liechtenstein,30-06-2020,296940,1076,780,296160,Europe
Lithuania,30-06-2020,106797,676,671,106126,Europe
Luxembourg,30-06-2020,117583,2415,280,117303,Europe
Madagascar,30-06-2020,337353,1287,798,336555,Africa
Malaysia,30-06-2020,300613,747,855,299758,Western Pacific
Maldives,30-06-2020,288303,1983,371,287932,South-East Asia
Malta,30-06-2020,95803,878,707,95096,Europe
Mauritania,30-06-2020,196133,6,1149,194984,Africa
Mauritius,30-06-2020,347149,1779,819,346330,Africa
Mexico,30-06-2020,228002,1707,255,227747,Americas
Moldova,30-06-2020,117971,706,364,117607,Europe
Monaco,30-06-2020,442735,1808,1107,441628,Europe
Mongolia,30-06-2020,372350,693,323,372027,Western Pacific
Montenegro,30-06-2020,166947,706,124,166823,Europe
Morocco,30-06-2020,129327,1251,820,128507,Eastern Mediterranean
Namibia,30-06-2020,285950,1648,821,285129,Africa
Nepal,30-06-2020,226620,2147,1099,225521,South-East Asia
Netherlands,30-06-2020,82190,1200,14,82176,Europe
Netherlands,30-06-2020,178787,76,1099,177688,Europe
Netherlands,30-06-2020,147383,1776,498,146885,Europe
Netherlands,30-06-2020,20636,829,1014,19622,Europe
New Zealand,30-06-2020,398835,581,825,398010,Western Pacific
Nicaragua,30-06-2020,107565,260,109,107456,Americas
Niger,30-06-2020,238258,903,309,237949,Africa
Nigeria,30-06-2020,279975,1616,548,279427,Africa
North Macedonia,30-06-2020,376347,2185,402,375945,Europe
Norway,30-06-2020,288691,882,395,288296,Europe
Oman,30-06-2020,127500,1694,171,127329,Eastern Mediterranean
Pakistan,30-06-2020,364867,1086,928,363939,Eastern Mediterranean
Panama,30-06-2020,299529,2177,979,298550,Americas
Papua New Guinea,30-06-2020,118462,996,51,118411,Western Pacific
Paraguay,30-06-2020,233412,2358,667,232745,Americas
Peru,30-06-2020,342792,2099,45,342747,Americas
Philippines,30-06-2020,434444,1777,772,433672,Western Pacific
Poland,30-06-2020,272666,948,673,271993,Europe
Portugal,30-06-2020,377527,1070,611,376916,Europe
Qatar,30-06-2020,368527,937,93,368434,Eastern Mediterranean
Romania,30-06-2020,299920,1645,207,299713,Europe
Russia,30-06-2020,288655,2149,4,288651,Europe
Rwanda,30-06-2020,367727,1963,746,366981,Africa
Saint Lucia,30-06-2020,114936,1186,942,113994,Americas
Saint Vincent and the Grenadines,30-06-2020,230125,1087,241,229884,Americas
San Marino,30-06-2020,212590,1964,552,212038,Europe
Saudi Arabia,30-06-2020,193205,1873,490,192715,Eastern Mediterranean
Senegal,30-06-2020,279843,385,55,279788,Africa
Serbia,30-06-2020,338388,229,624,337764,Europe
Seychelles,30-06-2020,56820,1128,269,56551,Africa
Singapore,30-06-2020,3717,248,418,3299,Western Pacific
Slovakia,30-06-2020,250224,2116,882,249342,Europe
Slovenia,30-06-2020,399713,797,799,398914,Europe
Somalia,30-06-2020,399866,2403,366,399500,Eastern Mediterranean
South Africa,30-06-2020,235911,672,1065,234846,Africa
Spain,30-06-2020,320736,156,754,319982,Europe
Sri Lanka,30-06-2020,214941,2329,92,214849,South-East Asia
Sudan,30-06-2020,48654,323,1047,47607,Eastern Mediterranean
Suriname,30-06-2020,110890,1247,528,110362,Americas
Sweden,30-06-2020,4695,737,510,4185,Europe
Switzerland,30-06-2020,255651,18,1225,254426,Europe
Taiwan*,30-06-2020,167436,128,1068,166368,Western Pacific
Tanzania,30-06-2020,165143,1748,443,164700,Africa
Thailand,30-06-2020,370140,1779,723,369417,South-East Asia
Togo,30-06-2020,229847,1837,326,229521,Africa
Trinidad and Tobago,30-06-2020,108357,1230,411,107946,Americas
Tunisia,30-06-2020,97344,863,952,96392,Eastern Mediterranean
Turkey,30-06-2020,23511,1472,1080,22431,Europe
Uganda,30-06-2020,170566,1752,187,170379,Africa
Ukraine,30-06-2020,338326,1313,202,338124,Europe
United Arab Emirates,30-06-2020,204790,1753,438,204352,Eastern Mediterranean
United Kingdom,30-06-2020,159954,2471,331,159623,Europe
United Kingdom,30-06-2020,143390,1638,807,142583,Europe
United Kingdom,30-06-2020,154472,598,774,153698,Europe
United Kingdom,30-06-2020,143030,188,1180,141850,Europe
United Kingdom,30-06-2020,133053,1456,1124,131929,Europe
United Kingdom,30-06-2020,399409,1704,17,399392,Europe
United Kingdom,30-06-2020,436836,1754,642,436194,Europe
Uruguay,30-06-2020,182371,922,175,182196,Americas
US,30-06-2020,169428,412,1203,168225,Americas
Uzbekistan,30-06-2020,163152,1968,93,163059,Europe
Venezuela,30-06-2020,199573,745,1220,198353,Americas
Vietnam,30-06-2020,260037,1846,1189,258848,Western Pacific
Zambia,30-06-2020,397563,2068,378,397185,Africa
Zimbabwe,30-06-2020,88988,1358,813,88175,Africa
Dominica,30-06-2020,198954,2412,211,198743,Americas
Grenada,30-06-2020,366968,2496,624,366344,Americas
Mozambique,30-06-2020,298262,1345,1239,297023,Africa
Syria,30-06-2020,4679,239,987,3692,Eastern Mediterranean
Timor-Leste,30-06-2020,95383,1805,980,94403,South-East Asia
Belize,30-06-2020,201354,1696,342,201012,Americas
Laos,30-06-2020,344587,639,552,344035,Western Pacific
Libya,30-06-2020,45331,1455,262,45069,Eastern Mediterranean
West Bank and Gaza,30-06-2020,13130,1874,348,12782,Eastern Mediterranean
Guinea-Bissau,30-06-2020,120767,1367,589,120178,Africa
Mali,30-06-2020,33968,2020,734,33234,Africa
Saint Kitts and Nevis,30-06-2020,351410,1734,617,350793,Americas
Canada,30-06-2020,108517,1385,163,108354,Americas
Canada,30-06-2020,133132,1514,653,132479,Americas
Kosovo,30-06-2020,425920,692,143,425777,Europe
Burma,30-06-2020,71551,811,454,71097,South-East Asia
United Kingdom,30-06-2020,312988,1982,1018,311970,Europe
United Kingdom,30-06-2020,20524,2320,321,20203,Europe
United Kingdom,30-06-2020,126269,1666,554,125715,Europe
Botswana,30-06-2020,220517,1372,1184,219333,Africa
Burundi,30-06-2020,423781,1734,593,423188,Africa
Sierra Leone,30-06-2020,351948,1781,1041,350907,Africa
Malawi,30-06-2020,297339,1600,820,296519,Africa
United Kingdom,30-06-2020,385681,866,321,385360,Europe
France,30-06-2020,423042,524,384,422658,Europe
South Sudan,30-06-2020,233817,1661,1188,232629,Africa
Western Sahara,30-06-2020,320472,1299,1034,319438,Africa
Sao Tome and Principe,30-06-2020,222632,296,1197,221435,Africa
Yemen,30-06-2020,79803,738,481,79322,Eastern Mediterranean
Comoros,30-06-2020,81598,2254,983,80615,Africa
Tajikistan,30-06-2020,242129,662,1165,240964,Europe
Lesotho,30-06-2020,44533,111,761,43772,Africa
Afghanistan,01-07-2020,137780,554,804,136976,Eastern Mediterranean
Albania,01-07-2020,328212,500,215,327997,Europe
Algeria,01-07-2020,215529,1517,740,214789,Africa
Andorra,01-07-2020,81488,754,394,81094,Europe
Angola,01-07-2020,100535,408,869,99666,Africa
Antigua and Barbuda,01-07-2020,179329,2297,11,179318,Americas
Argentina,01-07-2020,311017,1998,358,310659,Americas
Armenia,01-07-2020,425249,93,62,425187,Europe
Australia,01-07-2020,339870,2372,271,339599,Western Pacific
Australia,01-07-2020,121137,1089,49,121088,Western Pacific
Australia,01-07-2020,278067,785,839,277228,Western Pacific
Australia,01-07-2020,219111,445,26,219085,Western Pacific
Australia,01-07-2020,138452,1254,971,137481,Western Pacific
Australia,01-07-2020,245621,700,976,244645,Western Pacific
Australia,01-07-2020,333214,1767,627,332587,Western Pacific
Australia,01-07-2020,368383,2032,666,367717,Western Pacific
Austria,01-07-2020,242665,819,63,242602,Europe
Azerbaijan,01-07-2020,64457,809,463,63994,Europe
Bahamas,01-07-2020,354815,612,579,354236,Americas
Bahrain,01-07-2020,189464,1033,11,189453,Eastern Mediterranean
Bangladesh,01-07-2020,272359,951,422,271937,South-East Asia
Barbados,01-07-2020,173938,2080,1213,172725,Americas
Belarus,01-07-2020,24885,2346,795,24090,Europe
Belgium,01-07-2020,203835,464,227,203608,Europe
Benin,01-07-2020,161894,1203,982,160912,Africa
Bhutan,01-07-2020,121703,2327,767,120936,South-East Asia
Bolivia,01-07-2020,203812,1461,806,203006,Americas
Bosnia and Herzegovina,01-07-2020,136585,1165,1177,135408,Europe
Brazil,01-07-2020,349236,794,345,348891,Americas
Brunei,01-07-2020,98252,919,1083,97169,Western Pacific
Bulgaria,01-07-2020,213371,634,1056,212315,Europe
Burkina Faso,01-07-2020,148013,602,295,147718,Africa
Cabo Verde,01-07-2020,208093,424,665,207428,Africa
Cambodia,01-07-2020,211396,2356,370,211026,Western Pacific
Cameroon,01-07-2020,125214,1113,102,125112,Africa
Canada,01-07-2020,231563,126,724,230839,Americas
Canada,01-07-2020,440388,621,28,440360,Americas
Canada,01-07-2020,286431,2010,1063,285368,Americas
Canada,01-07-2020,328509,1478,253,328256,Americas
Canada,01-07-2020,267332,1499,153,267179,Americas
Canada,01-07-2020,123840,436,914,122926,Americas
Canada,01-07-2020,316405,193,636,315769,Americas
Canada,01-07-2020,97140,1889,319,96821,Americas
Canada,01-07-2020,297752,2265,1033,296719,Americas
Canada,01-07-2020,387142,12,98,387044,Americas
Central African Republic,01-07-2020,290291,646,107,290184,Africa
Chad,01-07-2020,285986,1604,1140,284846,Africa
Chile,01-07-2020,449102,626,138,448964,Americas
China,01-07-2020,69530,268,730,68800,Western Pacific
China,01-07-2020,287848,2237,183,287665,Western Pacific
China,01-07-2020,438569,2365,930,437639,Western Pacific
China,01-07-2020,248519,165,26,248493,Western Pacific
China,01-07-2020,420982,69,1055,419927,Western Pacific
China,01-07-2020,88039,1851,113,87926,Western Pacific
China,01-07-2020,115001,1640,461,114540,Western Pacific
China,01-07-2020,318325,2045,76,318249,Western Pacific
China,01-07-2020,9715,2282,298,9417,Western Pacific
China,01-07-2020,309804,554,1082,308722,Western Pacific
China,01-07-2020,35241,2392,559,34682,Western Pacific
China,01-07-2020,370751,1229,409,370342,Western Pacific
China,01-07-2020,172094,2167,746,171348,Western Pacific
China,01-07-2020,392474,316,1013,391461,Western Pacific
China,01-07-2020,423486,513,576,422910,Western Pacific
China,01-07-2020,154812,1804,414,154398,Western Pacific
China,01-07-2020,364573,875,1021,363552,Western Pacific
China,01-07-2020,144707,1378,797,143910,Western Pacific
China,01-07-2020,199667,1910,831,198836,Western Pacific
China,01-07-2020,75287,2307,923,74364,Western Pacific
China,01-07-2020,116241,804,182,116059,Western Pacific
China,01-07-2020,67718,2019,38,67680,Western Pacific
China,01-07-2020,16989,580,1194,15795,Western Pacific
China,01-07-2020,421062,1973,679,420383,Western Pacific
China,01-07-2020,392614,454,1152,391462,Western Pacific
China,01-07-2020,139563,1527,392,139171,Western Pacific
China,01-07-2020,273505,2024,130,273375,Western Pacific
China,01-07-2020,423145,130,551,422594,Western Pacific
China,01-07-2020,81502,1369,660,80842,Western Pacific
China,01-07-2020,275723,1486,1022,274701,Western Pacific
China,01-07-2020,405432,12,476,404956,Western Pacific
China,01-07-2020,168422,2373,999,167423,Western Pacific
China,01-07-2020,195215,644,332,194883,Western Pacific
Colombia,01-07-2020,93000,2227,220,92780,Americas
Congo (Brazzaville),01-07-2020,299884,1255,209,299675,Africa
Congo (Kinshasa),01-07-2020,71246,1130,114,71132,Africa
Costa Rica,01-07-2020,169831,658,767,169064,Americas
Cote d'Ivoire,01-07-2020,212273,751,179,212094,Africa
Croatia,01-07-2020,358034,1438,285,357749,Europe
Cuba,01-07-2020,229696,1549,1122,228574,Americas
Cyprus,01-07-2020,167100,365,269,166831,Europe
Czechia,01-07-2020,430873,557,157,430716,Europe
Denmark,01-07-2020,269064,2436,596,268468,Europe
Greenland,01-07-2020,341297,37,949,340348,Europe
Denmark,01-07-2020,315800,1381,1059,314741,Europe
Djibouti,01-07-2020,55313,2075,1222,54091,Eastern Mediterranean
Dominican Republic,01-07-2020,226872,852,1123,225749,Americas
Ecuador,01-07-2020,5265,1724,942,4323,Americas
Egypt,01-07-2020,419163,234,973,418190,Eastern Mediterranean
El Salvador,01-07-2020,430155,427,605,429550,Americas
Equatorial Guinea,01-07-2020,337787,288,1176,336611,Africa
Eritrea,01-07-2020,106914,365,548,106366,Africa
Estonia,01-07-2020,294226,256,1143,293083,Europe
Eswatini,01-07-2020,313019,1792,481,312538,Africa
Ethiopia,01-07-2020,283268,2468,682,282586,Africa
Fiji,01-07-2020,253295,1308,918,252377,Western Pacific
Finland,01-07-2020,433080,2047,269,432811,Europe
France,01-07-2020,430646,2341,619,430027,Europe
France,01-07-2020,439928,1196,420,439508,Europe
France,01-07-2020,354961,1271,710,354251,Europe
France,01-07-2020,339457,1334,993,338464,Europe
France,01-07-2020,162836,578,30,162806,Europe
France,01-07-2020,84351,1765,1099,83252,Europe
France,01-07-2020,223418,911,761,222657,Europe
France,01-07-2020,325708,577,531,325177,Europe
France,01-07-2020,321783,432,62,321721,Europe
France,01-07-2020,357759,196,124,357635,Europe
Gabon,01-07-2020,242365,1088,562,241803,Africa
Gambia,01-07-2020,333131,270,505,332626,Africa
Georgia,01-07-2020,309951,460,207,309744,Europe
Germany,01-07-2020,275156,517,962,274194,Europe
Ghana,01-07-2020,270279,1409,384,269895,Africa
Greece,01-07-2020,144897,596,614,144283,Europe
Guatemala,01-07-2020,69963,2372,865,69098,Americas
Guinea,01-07-2020,261997,816,1074,260923,Africa
Guyana,01-07-2020,298354,246,973,297381,Americas
Haiti,01-07-2020,23274,2474,1224,22050,Americas
Holy See,01-07-2020,290736,1465,652,290084,Europe
Honduras,01-07-2020,102386,848,830,101556,Americas
Hungary,01-07-2020,308422,2484,842,307580,Europe
Iceland,01-07-2020,159314,486,1160,158154,Europe
India,01-07-2020,145792,495,1001,144791,South-East Asia
Indonesia,01-07-2020,348776,546,351,348425,South-East Asia
Iran,01-07-2020,354932,575,518,354414,Eastern Mediterranean
Iraq,01-07-2020,293445,743,461,292984,Eastern Mediterranean
Ireland,01-07-2020,190653,2018,592,190061,Europe
Israel,01-07-2020,186750,80,1203,185547,Europe
Italy,01-07-2020,54120,2285,212,53908,Europe
Jamaica,01-07-2020,92321,1273,583,91738,Americas
Japan,01-07-2020,321395,2103,363,321032,Western Pacific
Jordan,01-07-2020,119871,777,294,119577,Eastern Mediterranean
Kazakhstan,01-07-2020,134252,652,889,133363,Europe
Kenya,01-07-2020,245337,1151,805,244532,Africa
South Korea,01-07-2020,424824,2365,1182,423642,Western Pacific
Kuwait,01-07-2020,161816,2168,1233,160583,Eastern Mediterranean
Kyrgyzstan,01-07-2020,399746,1249,485,399261,Europe
Latvia,01-07-2020,281321,118,1144,280177,Europe
Lebanon,01-07-2020,76021,1140,223,75798,Eastern Mediterranean
Liberia,01-07-2020,306011,1637,1007,305004,Africa
Liechtenstein,01-07-2020,35046,1749,502,34544,Europe
Lithuania,01-07-2020,436555,377,138,436417,Europe
Luxembourg,01-07-2020,157747,770,46,157701,Europe
Madagascar,01-07-2020,150321,1685,24,150297,Africa
Malaysia,01-07-2020,309655,2046,465,309190,Western Pacific
Maldives,01-07-2020,220661,1032,465,220196,South-East Asia
Malta,01-07-2020,331206,488,817,330389,Europe
Mauritania,01-07-2020,135162,1478,711,134451,Africa
Mauritius,01-07-2020,375669,1461,97,375572,Africa
Mexico,01-07-2020,191559,49,603,190956,Americas
Moldova,01-07-2020,435193,2316,587,434606,Europe
Monaco,01-07-2020,209810,1975,690,209120,Europe
Mongolia,01-07-2020,294362,2149,402,293960,Western Pacific
Montenegro,01-07-2020,370149,501,718,369431,Europe
Morocco,01-07-2020,69621,1010,608,69013,Eastern Mediterranean
Namibia,01-07-2020,215744,63,1242,214502,Africa
Nepal,01-07-2020,47996,1236,743,47253,South-East Asia
Netherlands,01-07-2020,330559,2490,857,329702,Europe
Netherlands,01-07-2020,32378,1753,391,31987,Europe
Netherlands,01-07-2020,265965,1063,608,265357,Europe
Netherlands,01-07-2020,266015,526,596,265419,Europe
New Zealand,01-07-2020,320965,2456,348,320617,Western Pacific
Nicaragua,01-07-2020,300766,548,350,300416,Americas
Niger,01-07-2020,163219,54,541,162678,Africa
Nigeria,01-07-2020,349237,2328,86,349151,Africa
North Macedonia,01-07-2020,376625,1365,658,375967,Europe
Norway,01-07-2020,96773,443,867,95906,Europe
Oman,01-07-2020,219014,1114,46,218968,Eastern Mediterranean
Pakistan,01-07-2020,111029,2085,1018,110011,Eastern Mediterranean
Panama,01-07-2020,7332,2096,262,7070,Americas
Papua New Guinea,01-07-2020,28045,1477,846,27199,Western Pacific
Paraguay,01-07-2020,363469,487,330,363139,Americas
Peru,01-07-2020,149410,2144,354,149056,Americas
Philippines,01-07-2020,303773,914,414,303359,Western Pacific
Poland,01-07-2020,356874,1998,221,356653,Europe
Portugal,01-07-2020,326509,1551,224,326285,Europe
Qatar,01-07-2020,248980,1230,101,248879,Eastern Mediterranean
Romania,01-07-2020,406827,681,747,406080,Europe
Russia,01-07-2020,12787,1647,603,12184,Europe
Rwanda,01-07-2020,216105,2375,609,215496,Africa
Saint Lucia,01-07-2020,216752,612,610,216142,Americas
Saint Vincent and the Grenadines,01-07-2020,343589,432,864,342725,Americas
San Marino,01-07-2020,84967,1982,345,84622,Europe
Saudi Arabia,01-07-2020,365072,1396,543,364529,Eastern Mediterranean
Senegal,01-07-2020,282937,1096,365,282572,Africa
Serbia,01-07-2020,181246,1973,993,180253,Europe
Seychelles,01-07-2020,416283,2356,381,415902,Africa
Singapore,01-07-2020,159944,1962,701,159243,Western Pacific
Slovakia,01-07-2020,432313,899,577,431736,Europe
Slovenia,01-07-2020,375748,2452,633,375115,Europe
Somalia,01-07-2020,96495,2327,594,95901,Eastern Mediterranean
South Africa,01-07-2020,224231,2026,435,223796,Africa
Spain,01-07-2020,11214,1438,83,11131,Europe
Sri Lanka,01-07-2020,372173,1066,803,371370,South-East Asia
Sudan,01-07-2020,45810,985,780,45030,Eastern Mediterranean
Suriname,01-07-2020,98404,1542,685,97719,Americas
Sweden,01-07-2020,381495,844,798,380697,Europe
Switzerland,01-07-2020,228737,2355,930,227807,Europe
Taiwan*,01-07-2020,160673,1385,1021,159652,Western Pacific
Tanzania,01-07-2020,306752,1735,1090,305662,Africa
Thailand,01-07-2020,285016,438,607,284409,South-East Asia
Togo,01-07-2020,396567,1241,173,396394,Africa
Trinidad and Tobago,01-07-2020,252730,255,605,252125,Americas
Tunisia,01-07-2020,76821,2046,984,75837,Eastern Mediterranean
Turkey,01-07-2020,397911,170,384,397527,Europe
Uganda,01-07-2020,42034,2138,320,41714,Africa
Ukraine,01-07-2020,74188,1717,95,74093,Europe
United Arab Emirates,01-07-2020,127783,1379,187,127596,Eastern Mediterranean
United Kingdom,01-07-2020,582,2358,785,-203,Europe
United Kingdom,01-07-2020,447110,59,1141,445969,Europe
United Kingdom,01-07-2020,265265,2053,687,264578,Europe
United Kingdom,01-07-2020,224961,614,27,224934,Europe
United Kingdom,01-07-2020,205535,2382,436,205099,Europe
United Kingdom,01-07-2020,187618,407,126,187492,Europe
United Kingdom,01-07-2020,83810,336,0,83810,Europe
Uruguay,01-07-2020,416824,2257,816,416008,Americas
US,01-07-2020,128094,522,1103,126991,Americas
Uzbekistan,01-07-2020,47187,1410,564,46623,Europe
Venezuela,01-07-2020,249121,2428,417,248704,Americas
Vietnam,01-07-2020,297673,589,1128,296545,Western Pacific
Zambia,01-07-2020,238637,993,863,237774,Africa
Zimbabwe,01-07-2020,307386,1592,832,306554,Africa
Dominica,01-07-2020,225373,2409,689,224684,Americas
Grenada,01-07-2020,230758,1938,1080,229678,Americas
Mozambique,01-07-2020,304393,1019,129,304264,Africa
Syria,01-07-2020,123286,825,425,122861,Eastern Mediterranean
Timor-Leste,01-07-2020,233256,2272,978,232278,South-East Asia
Belize,01-07-2020,289461,1773,291,289170,Americas
Laos,01-07-2020,365079,2056,1111,363968,Western Pacific
Libya,01-07-2020,54875,2398,55,54820,Eastern Mediterranean
West Bank and Gaza,01-07-2020,58913,2036,966,57947,Eastern Mediterranean
Guinea-Bissau,01-07-2020,157866,2095,107,157759,Africa
Mali,01-07-2020,440556,324,520,440036,Africa
Saint Kitts and Nevis,01-07-2020,176382,767,1116,175266,Americas
Canada,01-07-2020,172712,244,923,171789,Americas
Canada,01-07-2020,231273,838,68,231205,Americas
Kosovo,01-07-2020,113940,2081,437,113503,Europe
Burma,01-07-2020,15833,963,855,14978,South-East Asia
United Kingdom,01-07-2020,373248,642,1105,372143,Europe
United Kingdom,01-07-2020,113380,1248,954,112426,Europe
United Kingdom,01-07-2020,30768,1675,273,30495,Europe
Botswana,01-07-2020,350702,2100,773,349929,Africa
Burundi,01-07-2020,427368,2364,22,427346,Africa
Sierra Leone,01-07-2020,138736,2200,9,138727,Africa
Malawi,01-07-2020,332938,723,692,332246,Africa
United Kingdom,01-07-2020,161189,1082,484,160705,Europe
France,01-07-2020,109767,165,590,109177,Europe
South Sudan,01-07-2020,445113,672,135,444978,Africa
Western Sahara,01-07-2020,394562,150,451,394111,Africa
Sao Tome and Principe,01-07-2020,437592,1990,876,436716,Africa
Yemen,01-07-2020,195809,1072,594,195215,Eastern Mediterranean
Comoros,01-07-2020,16714,906,291,16423,Africa
Tajikistan,01-07-2020,423008,2180,1079,421929,Europe
Lesotho,01-07-2020,91653,2479,1116,90537,Africa
Afghanistan,02-07-2020,85323,1134,489,84834,Eastern Mediterranean
Albania,02-07-2020,410956,600,636,410320,Europe
Algeria,02-07-2020,193607,1353,473,193134,Africa
Andorra,02-07-2020,334570,1415,1001,333569,Europe
Angola,02-07-2020,349753,1462,1186,348567,Africa
Antigua and Barbuda,02-07-2020,406296,1765,954,405342,Americas
Argentina,02-07-2020,133624,1400,30,133594,Americas
Armenia,02-07-2020,11616,463,1005,10611,Europe
Australia,02-07-2020,395263,44,816,394447,Western Pacific
Australia,02-07-2020,437598,2465,278,437320,Western Pacific
Australia,02-07-2020,315972,84,211,315761,Western Pacific
Australia,02-07-2020,212997,398,1110,211887,Western Pacific
Australia,02-07-2020,444606,533,16,444590,Western Pacific
Australia,02-07-2020,346265,1922,417,345848,Western Pacific
Australia,02-07-2020,221900,857,1247,220653,Western Pacific
Australia,02-07-2020,88815,1599,289,88526,Western Pacific
Austria,02-07-2020,215571,1944,761,214810,Europe
Azerbaijan,02-07-2020,187760,290,515,187245,Europe
Bahamas,02-07-2020,328866,318,593,328273,Americas
Bahrain,02-07-2020,229070,34,144,228926,Eastern Mediterranean
Bangladesh,02-07-2020,346015,1570,773,345242,South-East Asia
Barbados,02-07-2020,200241,2214,712,199529,Americas
Belarus,02-07-2020,407507,1754,829,406678,Europe
Belgium,02-07-2020,266015,2383,643,265372,Europe
Benin,02-07-2020,319728,272,688,319040,Africa
Bhutan,02-07-2020,145269,2023,460,144809,South-East Asia
Bolivia,02-07-2020,78286,807,917,77369,Americas
Bosnia and Herzegovina,02-07-2020,293096,130,656,292440,Europe
Brazil,02-07-2020,63764,638,243,63521,Americas
Brunei,02-07-2020,431307,677,305,431002,Western Pacific
Bulgaria,02-07-2020,275836,246,445,275391,Europe
Burkina Faso,02-07-2020,8002,1142,713,7289,Africa
Cabo Verde,02-07-2020,243963,1987,499,243464,Africa
Cambodia,02-07-2020,352385,526,1015,351370,Western Pacific
Cameroon,02-07-2020,142384,1306,661,141723,Africa
Canada,02-07-2020,446981,1835,538,446443,Americas
Canada,02-07-2020,134543,934,512,134031,Americas
Canada,02-07-2020,346265,1898,395,345870,Americas
Canada,02-07-2020,209935,252,362,209573,Americas
Canada,02-07-2020,96494,1548,209,96285,Americas
Canada,02-07-2020,340865,571,632,340233,Americas
Canada,02-07-2020,2447,1492,297,2150,Americas
Canada,02-07-2020,133628,5,918,132710,Americas
Canada,02-07-2020,801,2390,186,615,Americas
Canada,02-07-2020,51835,1061,901,50934,Americas
Central African Republic,02-07-2020,249172,2305,930,248242,Africa
Chad,02-07-2020,441234,1108,110,441124,Africa
Chile,02-07-2020,24764,705,778,23986,Americas
China,02-07-2020,85820,1824,391,85429,Western Pacific
China,02-07-2020,377789,853,567,377222,Western Pacific
China,02-07-2020,204459,2375,713,203746,Western Pacific
China,02-07-2020,441404,141,364,441040,Western Pacific
China,02-07-2020,200722,324,319,200403,Western Pacific
China,02-07-2020,200339,635,1111,199228,Western Pacific
China,02-07-2020,183384,1141,1207,182177,Western Pacific
China,02-07-2020,118853,429,107,118746,Western Pacific
China,02-07-2020,374390,1723,1078,373312,Western Pacific
China,02-07-2020,223033,2333,332,222701,Western Pacific
China,02-07-2020,145315,1120,488,144827,Western Pacific
China,02-07-2020,313962,156,1109,312853,Western Pacific
China,02-07-2020,367802,295,659,367143,Western Pacific
China,02-07-2020,203507,211,594,202913,Western Pacific
China,02-07-2020,66081,1835,832,65249,Western Pacific
China,02-07-2020,241358,7,976,240382,Western Pacific
China,02-07-2020,9546,240,837,8709,Western Pacific
China,02-07-2020,37880,2033,250,37630,Western Pacific
China,02-07-2020,271180,740,1134,270046,Western Pacific
China,02-07-2020,105113,486,452,104661,Western Pacific
China,02-07-2020,398713,2473,1016,397697,Western Pacific
China,02-07-2020,13199,1109,499,12700,Western Pacific
China,02-07-2020,138335,1806,815,137520,Western Pacific
China,02-07-2020,258475,404,1012,257463,Western Pacific
China,02-07-2020,230934,2041,920,230014,Western Pacific
China,02-07-2020,69423,808,291,69132,Western Pacific
China,02-07-2020,117337,2440,998,116339,Western Pacific
China,02-07-2020,217180,1058,660,216520,Western Pacific
China,02-07-2020,100324,35,878,99446,Western Pacific
China,02-07-2020,245198,563,907,244291,Western Pacific
China,02-07-2020,141431,1430,350,141081,Western Pacific
China,02-07-2020,38479,2315,1073,37406,Western Pacific
China,02-07-2020,179738,1479,407,179331,Western Pacific
Colombia,02-07-2020,357383,989,1140,356243,Americas
Congo (Brazzaville),02-07-2020,212360,1937,686,211674,Africa
Congo (Kinshasa),02-07-2020,41536,2419,748,40788,Africa
Costa Rica,02-07-2020,183665,1012,139,183526,Americas
Cote d'Ivoire,02-07-2020,350961,1981,1193,349768,Africa
Croatia,02-07-2020,67573,687,1086,66487,Europe
Cuba,02-07-2020,435368,470,763,434605,Americas
Cyprus,02-07-2020,430867,2174,1130,429737,Europe
Czechia,02-07-2020,313946,1110,1149,312797,Europe
Denmark,02-07-2020,342158,372,1099,341059,Europe
Greenland,02-07-2020,239207,2260,283,238924,Europe
Denmark,02-07-2020,378089,554,316,377773,Europe
Djibouti,02-07-2020,393850,2267,1249,392601,Eastern Mediterranean
Dominican Republic,02-07-2020,327668,177,440,327228,Americas
Ecuador,02-07-2020,280967,356,321,280646,Americas
Egypt,02-07-2020,262674,1345,135,262539,Eastern Mediterranean
El Salvador,02-07-2020,89988,28,395,89593,Americas
Equatorial Guinea,02-07-2020,176030,750,686,175344,Africa
Eritrea,02-07-2020,268213,1369,1166,267047,Africa
Estonia,02-07-2020,425787,1449,350,425437,Europe
Eswatini,02-07-2020,224029,987,48,223981,Africa
Ethiopia,02-07-2020,12628,2132,1131,11497,Africa
Fiji,02-07-2020,426913,745,1244,425669,Western Pacific
Finland,02-07-2020,206489,2110,1097,205392,Europe
France,02-07-2020,40265,442,150,40115,Europe
France,02-07-2020,420811,548,1137,419674,Europe
France,02-07-2020,22432,1303,710,21722,Europe
France,02-07-2020,366099,36,728,365371,Europe
France,02-07-2020,1843,1565,445,1398,Europe
France,02-07-2020,295294,1377,957,294337,Europe
France,02-07-2020,434205,10,1237,432968,Europe
France,02-07-2020,326799,2108,925,325874,Europe
France,02-07-2020,422017,1570,272,421745,Europe
France,02-07-2020,183164,1238,126,183038,Europe
Gabon,02-07-2020,336829,2293,1248,335581,Africa
Gambia,02-07-2020,397820,499,147,397673,Africa
Georgia,02-07-2020,118306,1824,1023,117283,Europe
Germany,02-07-2020,274286,188,527,273759,Europe
Ghana,02-07-2020,164183,90,1013,163170,Africa
Greece,02-07-2020,64814,1373,988,63826,Europe
Guatemala,02-07-2020,341109,567,357,340752,Americas
Guinea,02-07-2020,166189,1005,454,165735,Africa
Guyana,02-07-2020,77637,1872,174,77463,Americas
Haiti,02-07-2020,305352,668,159,305193,Americas
Holy See,02-07-2020,70433,293,1070,69363,Europe
Honduras,02-07-2020,177093,353,933,176160,Americas
Hungary,02-07-2020,373974,619,76,373898,Europe
Iceland,02-07-2020,154217,572,291,153926,Europe
India,02-07-2020,300280,1499,1160,299120,South-East Asia
Indonesia,02-07-2020,208458,2347,958,207500,South-East Asia
Iran,02-07-2020,426145,1287,224,425921,Eastern Mediterranean
Iraq,02-07-2020,334400,925,116,334284,Eastern Mediterranean
Ireland,02-07-2020,263640,184,972,262668,Europe
Israel,02-07-2020,277984,2209,811,277173,Europe
Italy,02-07-2020,261085,1757,862,260223,Europe
Jamaica,02-07-2020,323753,1158,1029,322724,Americas
Japan,02-07-2020,218113,1223,789,217324,Western Pacific
Jordan,02-07-2020,377492,1771,720,376772,Eastern Mediterranean
Kazakhstan,02-07-2020,151849,1485,812,151037,Europe
Kenya,02-07-2020,136723,1488,713,136010,Africa
South Korea,02-07-2020,322349,1137,35,322314,Western Pacific
Kuwait,02-07-2020,21348,106,1068,20280,Eastern Mediterranean
Kyrgyzstan,02-07-2020,446755,2223,569,446186,Europe
Latvia,02-07-2020,16996,1430,148,16848,Europe
Lebanon,02-07-2020,434847,2332,594,434253,Eastern Mediterranean
Liberia,02-07-2020,182951,2079,114,182837,Africa
Liechtenstein,02-07-2020,406521,490,1185,405336,Europe
Lithuania,02-07-2020,31840,1023,516,31324,Europe
Luxembourg,02-07-2020,130340,2245,1099,129241,Europe
Madagascar,02-07-2020,185641,289,480,185161,Africa
Malaysia,02-07-2020,69356,2275,735,68621,Western Pacific
Maldives,02-07-2020,126650,890,468,126182,South-East Asia
Malta,02-07-2020,408761,918,766,407995,Europe
Mauritania,02-07-2020,397553,158,82,397471,Africa
Mauritius,02-07-2020,210588,2385,443,210145,Africa
Mexico,02-07-2020,232991,396,1230,231761,Americas
Moldova,02-07-2020,344852,1340,771,344081,Europe
Monaco,02-07-2020,313566,1720,397,313169,Europe
Mongolia,02-07-2020,292675,300,458,292217,Western Pacific
Montenegro,02-07-2020,175966,669,547,175419,Europe
Morocco,02-07-2020,255846,2498,164,255682,Eastern Mediterranean
Namibia,02-07-2020,343725,1204,383,343342,Africa
Nepal,02-07-2020,291199,1673,992,290207,South-East Asia
Netherlands,02-07-2020,124739,1083,1234,123505,Europe
Netherlands,02-07-2020,267073,2289,623,266450,Europe
Netherlands,02-07-2020,8676,1686,933,7743,Europe
Netherlands,02-07-2020,300233,2308,163,300070,Europe
New Zealand,02-07-2020,308475,947,988,307487,Western Pacific
Nicaragua,02-07-2020,286098,1247,1045,285053,Americas
Niger,02-07-2020,276195,198,496,275699,Africa
Nigeria,02-07-2020,286015,1191,835,285180,Africa
North Macedonia,02-07-2020,24636,1613,812,23824,Europe
Norway,02-07-2020,334060,754,1145,332915,Europe
Oman,02-07-2020,371124,1906,569,370555,Eastern Mediterranean
Pakistan,02-07-2020,203567,341,1071,202496,Eastern Mediterranean
Panama,02-07-2020,197172,1705,698,196474,Americas
Papua New Guinea,02-07-2020,194522,1649,173,194349,Western Pacific
Paraguay,02-07-2020,255539,1104,705,254834,Americas
Peru,02-07-2020,38502,2046,762,37740,Americas
Philippines,02-07-2020,37614,514,949,36665,Western Pacific
Poland,02-07-2020,330580,544,836,329744,Europe
Portugal,02-07-2020,118188,819,804,117384,Europe
Qatar,02-07-2020,105818,2074,923,104895,Eastern Mediterranean
Romania,02-07-2020,449993,2278,947,449046,Europe
Russia,02-07-2020,150006,1150,424,149582,Europe
Rwanda,02-07-2020,70890,1817,137,70753,Africa
Saint Lucia,02-07-2020,383126,636,487,382639,Americas
Saint Vincent and the Grenadines,02-07-2020,313757,1062,769,312988,Americas
San Marino,02-07-2020,238719,169,1095,237624,Europe
Saudi Arabia,02-07-2020,75893,316,1124,74769,Eastern Mediterranean
Senegal,02-07-2020,168860,2246,616,168244,Africa
Serbia,02-07-2020,161201,330,645,160556,Europe
Seychelles,02-07-2020,180978,1670,1139,179839,Africa
Singapore,02-07-2020,110236,2495,513,109723,Western Pacific
Slovakia,02-07-2020,151343,1846,1063,150280,Europe
Slovenia,02-07-2020,372062,912,1025,371037,Europe
Somalia,02-07-2020,92468,57,665,91803,Eastern Mediterranean
South Africa,02-07-2020,301422,1848,870,300552,Africa
Spain,02-07-2020,202905,195,76,202829,Europe
Sri Lanka,02-07-2020,171411,2128,862,170549,South-East Asia
Sudan,02-07-2020,265438,718,908,264530,Eastern Mediterranean
Suriname,02-07-2020,2697,1247,559,2138,Americas
Sweden,02-07-2020,305498,1755,445,305053,Europe
Switzerland,02-07-2020,346928,1310,982,345946,Europe
Taiwan*,02-07-2020,6848,243,869,5979,Western Pacific
Tanzania,02-07-2020,412826,1692,1236,411590,Africa
Thailand,02-07-2020,392503,1567,752,391751,South-East Asia
Togo,02-07-2020,51481,1314,157,51324,Africa
Trinidad and Tobago,02-07-2020,227290,352,1073,226217,Americas
Tunisia,02-07-2020,42847,1210,1000,41847,Eastern Mediterranean
Turkey,02-07-2020,22749,281,686,22063,Europe
Uganda,02-07-2020,187569,2338,668,186901,Africa
Ukraine,02-07-2020,354251,1251,1069,353182,Europe
United Arab Emirates,02-07-2020,274775,1204,834,273941,Eastern Mediterranean
United Kingdom,02-07-2020,371815,1520,949,370866,Europe
United Kingdom,02-07-2020,438802,2357,1231,437571,Europe
United Kingdom,02-07-2020,358432,788,364,358068,Europe
United Kingdom,02-07-2020,324655,530,42,324613,Europe
United Kingdom,02-07-2020,8029,451,183,7846,Europe
United Kingdom,02-07-2020,425977,2018,854,425123,Europe
United Kingdom,02-07-2020,274400,67,63,274337,Europe
Uruguay,02-07-2020,84673,724,924,83749,Americas
US,02-07-2020,166063,2421,548,165515,Americas
Uzbekistan,02-07-2020,42637,80,429,42208,Europe
Venezuela,02-07-2020,320060,1731,188,319872,Americas
Vietnam,02-07-2020,126309,1841,1003,125306,Western Pacific
Zambia,02-07-2020,413926,1989,1026,412900,Africa
Zimbabwe,02-07-2020,16560,2298,647,15913,Africa
Dominica,02-07-2020,265773,1563,858,264915,Americas
Grenada,02-07-2020,320217,889,342,319875,Americas
Mozambique,02-07-2020,308955,840,1168,307787,Africa
Syria,02-07-2020,221919,1032,859,221060,Eastern Mediterranean
Timor-Leste,02-07-2020,275721,284,331,275390,South-East Asia
Belize,02-07-2020,241648,1873,746,240902,Americas
Laos,02-07-2020,243575,2485,237,243338,Western Pacific
Libya,02-07-2020,200145,1354,845,199300,Eastern Mediterranean
West Bank and Gaza,02-07-2020,86185,811,724,85461,Eastern Mediterranean
Guinea-Bissau,02-07-2020,305573,728,649,304924,Africa
Mali,02-07-2020,182626,569,1082,181544,Africa
Saint Kitts and Nevis,02-07-2020,304061,701,219,303842,Americas
Canada,02-07-2020,289669,102,2,289667,Americas
Canada,02-07-2020,251863,1876,915,250948,Americas
Kosovo,02-07-2020,325286,714,733,324553,Europe
Burma,02-07-2020,340833,2194,427,340406,South-East Asia
United Kingdom,02-07-2020,403683,1086,540,403143,Europe
United Kingdom,02-07-2020,345627,1701,158,345469,Europe
United Kingdom,02-07-2020,43669,816,129,43540,Europe
Botswana,02-07-2020,244367,977,92,244275,Africa
Burundi,02-07-2020,251417,1841,1230,250187,Africa
Sierra Leone,02-07-2020,208702,405,182,208520,Africa
Malawi,02-07-2020,73460,1987,80,73380,Africa
United Kingdom,02-07-2020,199862,994,76,199786,Europe
France,02-07-2020,429087,2216,939,428148,Europe
South Sudan,02-07-2020,164076,1968,889,163187,Africa
Western Sahara,02-07-2020,297644,2069,765,296879,Africa
Sao Tome and Principe,02-07-2020,159518,1562,1125,158393,Africa
Yemen,02-07-2020,207538,88,1085,206453,Eastern Mediterranean
Comoros,02-07-2020,84932,861,155,84777,Africa
Tajikistan,02-07-2020,42866,547,179,42687,Europe
Lesotho,02-07-2020,221188,1207,937,220251,Africa
Afghanistan,03-07-2020,335565,14,920,334645,Eastern Mediterranean
Albania,03-07-2020,60790,1480,356,60434,Europe
Algeria,03-07-2020,61306,2075,1055,60251,Africa
Andorra,03-07-2020,205390,794,519,204871,Europe
Angola,03-07-2020,376655,905,160,376495,Africa
Antigua and Barbuda,03-07-2020,125551,1690,268,125283,Americas
Argentina,03-07-2020,38986,1331,295,38691,Americas
Armenia,03-07-2020,329333,1998,1150,328183,Europe
Australia,03-07-2020,381893,2322,304,381589,Western Pacific
Australia,03-07-2020,75052,2334,904,74148,Western Pacific
Australia,03-07-2020,89266,1625,492,88774,Western Pacific
Australia,03-07-2020,133661,1662,182,133479,Western Pacific
Australia,03-07-2020,281881,505,1083,280798,Western Pacific
Australia,03-07-2020,268996,567,594,268402,Western Pacific
Australia,03-07-2020,4742,1513,1216,3526,Western Pacific
Australia,03-07-2020,150416,2463,507,149909,Western Pacific
Austria,03-07-2020,405469,167,550,404919,Europe
Azerbaijan,03-07-2020,241822,141,813,241009,Europe
Bahamas,03-07-2020,206751,1029,255,206496,Americas
Bahrain,03-07-2020,46483,274,820,45663,Eastern Mediterranean
Bangladesh,03-07-2020,342482,670,631,341851,South-East Asia
Barbados,03-07-2020,186043,1991,1180,184863,Americas
Belarus,03-07-2020,34137,33,275,33862,Europe
Belgium,03-07-2020,310113,1740,360,309753,Europe
Benin,03-07-2020,277464,1947,997,276467,Africa
Bhutan,03-07-2020,445688,2129,1047,444641,South-East Asia
Bolivia,03-07-2020,51139,523,798,50341,Americas
Bosnia and Herzegovina,03-07-2020,139970,380,1061,138909,Europe
Brazil,03-07-2020,140225,669,1176,139049,Americas
Brunei,03-07-2020,128012,2117,794,127218,Western Pacific
Bulgaria,03-07-2020,139557,2054,826,138731,Europe
Burkina Faso,03-07-2020,429747,533,674,429073,Africa
Cabo Verde,03-07-2020,274414,179,1180,273234,Africa
Cambodia,03-07-2020,199380,234,1140,198240,Western Pacific
Cameroon,03-07-2020,184354,573,1030,183324,Africa
Canada,03-07-2020,283012,411,278,282734,Americas
Canada,03-07-2020,12600,2172,793,11807,Americas
Canada,03-07-2020,43202,1306,108,43094,Americas
Canada,03-07-2020,426307,832,210,426097,Americas
Canada,03-07-2020,364922,39,881,364041,Americas
Canada,03-07-2020,80125,2208,219,79906,Americas
Canada,03-07-2020,314921,2025,486,314435,Americas
Canada,03-07-2020,281248,722,473,280775,Americas
Canada,03-07-2020,288985,119,646,288339,Americas
Canada,03-07-2020,186619,2070,1004,185615,Americas
Central African Republic,03-07-2020,410381,124,162,410219,Africa
Chad,03-07-2020,104040,2208,17,104023,Africa
Chile,03-07-2020,137443,180,147,137296,Americas
China,03-07-2020,360396,874,1198,359198,Western Pacific
China,03-07-2020,53441,1737,74,53367,Western Pacific
China,03-07-2020,368786,1179,1058,367728,Western Pacific
China,03-07-2020,301778,913,13,301765,Western Pacific
China,03-07-2020,298166,1753,1235,296931,Western Pacific
China,03-07-2020,347516,541,1183,346333,Western Pacific
China,03-07-2020,165291,1274,602,164689,Western Pacific
China,03-07-2020,59295,1583,27,59268,Western Pacific
China,03-07-2020,86083,2255,704,85379,Western Pacific
China,03-07-2020,284498,1378,587,283911,Western Pacific
China,03-07-2020,234649,1789,67,234582,Western Pacific
China,03-07-2020,125892,2407,888,125004,Western Pacific
China,03-07-2020,180822,1884,460,180362,Western Pacific
China,03-07-2020,268896,305,124,268772,Western Pacific
China,03-07-2020,348452,1148,1164,347288,Western Pacific
China,03-07-2020,48519,2486,237,48282,Western Pacific
China,03-07-2020,402147,2093,351,401796,Western Pacific
China,03-07-2020,21240,378,109,21131,Western Pacific
China,03-07-2020,156547,1068,887,155660,Western Pacific
China,03-07-2020,418616,1057,278,418338,Western Pacific
China,03-07-2020,302059,981,131,301928,Western Pacific
China,03-07-2020,158622,1448,788,157834,Western Pacific
China,03-07-2020,61847,948,628,61219,Western Pacific
China,03-07-2020,258809,2410,14,258795,Western Pacific
China,03-07-2020,217037,546,630,216407,Western Pacific
China,03-07-2020,296788,193,1209,295579,Western Pacific
China,03-07-2020,100381,147,1101,99280,Western Pacific
China,03-07-2020,341081,763,7,341074,Western Pacific
China,03-07-2020,160788,2464,1134,159654,Western Pacific
China,03-07-2020,234903,1930,474,234429,Western Pacific
China,03-07-2020,180552,37,566,179986,Western Pacific
China,03-07-2020,444184,2308,1144,443040,Western Pacific
China,03-07-2020,298636,845,722,297914,Western Pacific
Colombia,03-07-2020,182787,413,1060,181727,Americas
Congo (Brazzaville),03-07-2020,42769,106,658,42111,Africa
Congo (Kinshasa),03-07-2020,182150,1,101,182049,Africa
Costa Rica,03-07-2020,287932,1865,33,287899,Americas
Cote d'Ivoire,03-07-2020,83498,64,841,82657,Africa
Croatia,03-07-2020,320009,517,1026,318983,Europe
Cuba,03-07-2020,303147,635,821,302326,Americas
Cyprus,03-07-2020,26430,1210,234,26196,Europe
Czechia,03-07-2020,7868,2377,244,7624,Europe
Denmark,03-07-2020,150408,237,1015,149393,Europe
Greenland,03-07-2020,188761,194,1073,187688,Europe
Denmark,03-07-2020,297831,308,406,297425,Europe
Djibouti,03-07-2020,353471,427,1098,352373,Eastern Mediterranean
Dominican Republic,03-07-2020,319775,2329,790,318985,Americas
Ecuador,03-07-2020,422083,1558,880,421203,Americas
Egypt,03-07-2020,212671,2469,357,212314,Eastern Mediterranean
El Salvador,03-07-2020,360118,1893,652,359466,Americas
Equatorial Guinea,03-07-2020,246883,1404,1112,245771,Africa
Eritrea,03-07-2020,170940,964,643,170297,Africa
Estonia,03-07-2020,59513,68,813,58700,Europe
Eswatini,03-07-2020,55514,1011,137,55377,Africa
Ethiopia,03-07-2020,445030,1186,563,444467,Africa
Fiji,03-07-2020,306285,149,292,305993,Western Pacific
Finland,03-07-2020,179749,25,731,179018,Europe
France,03-07-2020,142350,1604,438,141912,Europe
France,03-07-2020,243165,15,48,243117,Europe
France,03-07-2020,382669,1334,167,382502,Europe
France,03-07-2020,295446,693,1214,294232,Europe
France,03-07-2020,157064,1306,429,156635,Europe
France,03-07-2020,393928,802,213,393715,Europe
France,03-07-2020,131788,1922,886,130902,Europe
France,03-07-2020,246597,1864,100,246497,Europe
France,03-07-2020,380082,1060,902,379180,Europe
France,03-07-2020,230154,2261,1019,229135,Europe
Gabon,03-07-2020,258561,1942,1043,257518,Africa
Gambia,03-07-2020,425892,9,187,425705,Africa
Georgia,03-07-2020,440656,1681,262,440394,Europe
Germany,03-07-2020,106262,2452,585,105677,Europe
Ghana,03-07-2020,425619,1133,171,425448,Africa
Greece,03-07-2020,230440,869,1082,229358,Europe
Guatemala,03-07-2020,286673,1859,380,286293,Americas
Guinea,03-07-2020,408015,477,783,407232,Africa
Guyana,03-07-2020,290284,1837,340,289944,Americas
Haiti,03-07-2020,30395,2082,748,29647,Americas
Holy See,03-07-2020,226037,974,128,225909,Europe
Honduras,03-07-2020,269852,2289,1119,268733,Americas
Hungary,03-07-2020,169614,333,964,168650,Europe
Iceland,03-07-2020,134615,914,202,134413,Europe
India,03-07-2020,78725,421,933,77792,South-East Asia
Indonesia,03-07-2020,92064,1225,242,91822,South-East Asia
Iran,03-07-2020,303383,1996,603,302780,Eastern Mediterranean
Iraq,03-07-2020,442401,837,65,442336,Eastern Mediterranean
Ireland,03-07-2020,6492,1127,976,5516,Europe
Israel,03-07-2020,291228,2180,1108,290120,Europe
Italy,03-07-2020,255240,837,443,254797,Europe
Jamaica,03-07-2020,292204,2477,310,291894,Americas
Japan,03-07-2020,314396,1083,1051,313345,Western Pacific
Jordan,03-07-2020,326441,183,555,325886,Eastern Mediterranean
Kazakhstan,03-07-2020,62994,1246,37,62957,Europe
Kenya,03-07-2020,58031,1688,806,57225,Africa
South Korea,03-07-2020,262002,2078,1056,260946,Western Pacific
Kuwait,03-07-2020,376465,2057,912,375553,Eastern Mediterranean
Kyrgyzstan,03-07-2020,93897,1231,818,93079,Europe
Latvia,03-07-2020,228084,1544,493,227591,Europe
Lebanon,03-07-2020,127048,921,1094,125954,Eastern Mediterranean
Liberia,03-07-2020,207735,2397,334,207401,Africa
Liechtenstein,03-07-2020,118652,1117,602,118050,Europe
Lithuania,03-07-2020,114113,487,72,114041,Europe
Luxembourg,03-07-2020,426210,1836,832,425378,Europe
Madagascar,03-07-2020,370359,938,1112,369247,Africa
Malaysia,03-07-2020,275184,1714,775,274409,Western Pacific
Maldives,03-07-2020,243116,2236,1044,242072,South-East Asia
Malta,03-07-2020,137452,243,36,137416,Europe
Mauritania,03-07-2020,135798,1256,621,135177,Africa
Mauritius,03-07-2020,208421,1282,478,207943,Africa
Mexico,03-07-2020,237421,2014,1093,236328,Americas
Moldova,03-07-2020,231751,90,223,231528,Europe
Monaco,03-07-2020,391204,914,128,391076,Europe
Mongolia,03-07-2020,428032,1968,703,427329,Western Pacific
Montenegro,03-07-2020,198957,161,82,198875,Europe
Morocco,03-07-2020,302555,1249,1126,301429,Eastern Mediterranean
Namibia,03-07-2020,347323,1241,43,347280,Africa
Nepal,03-07-2020,364169,2122,184,363985,South-East Asia
Netherlands,03-07-2020,201854,200,696,201158,Europe
Netherlands,03-07-2020,368065,1763,295,367770,Europe
Netherlands,03-07-2020,373106,558,33,373073,Europe
Netherlands,03-07-2020,137583,1375,813,136770,Europe
New Zealand,03-07-2020,273434,659,1026,272408,Western Pacific
Nicaragua,03-07-2020,370550,399,727,369823,Americas
Niger,03-07-2020,288617,882,919,287698,Africa
Nigeria,03-07-2020,397672,518,105,397567,Africa
North Macedonia,03-07-2020,172086,911,845,171241,Europe
Norway,03-07-2020,371375,2288,950,370425,Europe
Oman,03-07-2020,201768,1283,31,201737,Eastern Mediterranean
Pakistan,03-07-2020,438331,218,570,437761,Eastern Mediterranean
Panama,03-07-2020,107035,1100,186,106849,Americas
Papua New Guinea,03-07-2020,280277,247,563,279714,Western Pacific
Paraguay,03-07-2020,363717,378,29,363688,Americas
Peru,03-07-2020,310008,1380,101,309907,Americas
Philippines,03-07-2020,61252,2052,1057,60195,Western Pacific
Poland,03-07-2020,142636,1766,178,142458,Europe
Portugal,03-07-2020,400776,1181,912,399864,Europe
Qatar,03-07-2020,112938,1741,844,112094,Eastern Mediterranean
Romania,03-07-2020,232133,810,680,231453,Europe
Russia,03-07-2020,437593,1763,304,437289,Europe
Rwanda,03-07-2020,162920,707,615,162305,Africa
Saint Lucia,03-07-2020,141683,454,1008,140675,Americas
Saint Vincent and the Grenadines,03-07-2020,7466,1227,628,6838,Americas
San Marino,03-07-2020,59900,1693,560,59340,Europe
Saudi Arabia,03-07-2020,204114,2359,29,204085,Eastern Mediterranean
Senegal,03-07-2020,108952,1971,604,108348,Africa
Serbia,03-07-2020,56022,2138,260,55762,Europe
Seychelles,03-07-2020,320950,28,356,320594,Africa
Singapore,03-07-2020,101469,1362,921,100548,Western Pacific
Slovakia,03-07-2020,258722,2400,1033,257689,Europe
Slovenia,03-07-2020,391325,1098,378,390947,Europe
Somalia,03-07-2020,52205,1026,1003,51202,Eastern Mediterranean
South Africa,03-07-2020,420399,89,1141,419258,Africa
Spain,03-07-2020,91306,1842,1147,90159,Europe
Sri Lanka,03-07-2020,421238,149,631,420607,South-East Asia
Sudan,03-07-2020,346411,58,1142,345269,Eastern Mediterranean
Suriname,03-07-2020,248313,1661,602,247711,Americas
Sweden,03-07-2020,256303,2373,340,255963,Europe
Switzerland,03-07-2020,255040,2472,1125,253915,Europe
Taiwan*,03-07-2020,120221,1135,867,119354,Western Pacific
Tanzania,03-07-2020,45878,741,562,45316,Africa
Thailand,03-07-2020,361511,646,515,360996,South-East Asia
Togo,03-07-2020,213232,1258,603,212629,Africa
Trinidad and Tobago,03-07-2020,266622,953,266,266356,Americas
Tunisia,03-07-2020,203619,1901,628,202991,Eastern Mediterranean
Turkey,03-07-2020,23333,2151,415,22918,Europe
Uganda,03-07-2020,18578,326,790,17788,Africa
Ukraine,03-07-2020,117304,1178,585,116719,Europe
United Arab Emirates,03-07-2020,414981,1180,390,414591,Eastern Mediterranean
United Kingdom,03-07-2020,430056,1386,879,429177,Europe
United Kingdom,03-07-2020,410621,210,575,410046,Europe
United Kingdom,03-07-2020,40059,2279,645,39414,Europe
United Kingdom,03-07-2020,51436,93,902,50534,Europe
United Kingdom,03-07-2020,136492,2235,859,135633,Europe
United Kingdom,03-07-2020,327865,170,80,327785,Europe
United Kingdom,03-07-2020,102508,195,557,101951,Europe
Uruguay,03-07-2020,355158,348,943,354215,Americas
US,03-07-2020,248406,934,969,247437,Americas
Uzbekistan,03-07-2020,174717,820,1145,173572,Europe
Venezuela,03-07-2020,289565,1570,719,288846,Americas
Vietnam,03-07-2020,440794,1671,868,439926,Western Pacific
Zambia,03-07-2020,189966,2482,367,189599,Africa
Zimbabwe,03-07-2020,395533,1296,455,395078,Africa
Dominica,03-07-2020,204780,1317,701,204079,Americas
Grenada,03-07-2020,40617,1715,802,39815,Americas
Mozambique,03-07-2020,117336,2232,987,116349,Africa
Syria,03-07-2020,392361,1079,800,391561,Eastern Mediterranean
Timor-Leste,03-07-2020,108431,594,427,108004,South-East Asia
Belize,03-07-2020,96014,2096,474,95540,Americas
Laos,03-07-2020,18959,1698,528,18431,Western Pacific
Libya,03-07-2020,262699,679,113,262586,Eastern Mediterranean
West Bank and Gaza,03-07-2020,103798,1957,342,103456,Eastern Mediterranean
Guinea-Bissau,03-07-2020,233586,544,676,232910,Africa
Mali,03-07-2020,423338,2064,1086,422252,Africa
Saint Kitts and Nevis,03-07-2020,363459,604,741,362718,Americas
Canada,03-07-2020,102212,2146,785,101427,Americas
Canada,03-07-2020,186686,241,1111,185575,Americas
Kosovo,03-07-2020,269569,2319,447,269122,Europe
Burma,03-07-2020,367796,728,557,367239,South-East Asia
United Kingdom,03-07-2020,10978,2001,601,10377,Europe
United Kingdom,03-07-2020,346157,1393,160,345997,Europe
United Kingdom,03-07-2020,136589,2323,165,136424,Europe
Botswana,03-07-2020,119320,737,263,119057,Africa
Burundi,03-07-2020,45014,1050,577,44437,Africa
Sierra Leone,03-07-2020,201615,1946,142,201473,Africa
Malawi,03-07-2020,275881,1153,831,275050,Africa
United Kingdom,03-07-2020,355138,120,852,354286,Europe
France,03-07-2020,198561,1645,1207,197354,Europe
South Sudan,03-07-2020,172116,1861,930,171186,Africa
Western Sahara,03-07-2020,217452,426,544,216908,Africa
Sao Tome and Principe,03-07-2020,369226,1004,84,369142,Africa
Yemen,03-07-2020,437951,97,1086,436865,Eastern Mediterranean
Comoros,03-07-2020,294223,1104,1204,293019,Africa
Tajikistan,03-07-2020,97192,1449,65,97127,Europe
Lesotho,03-07-2020,253388,16,312,253076,Africa
Afghanistan,04-07-2020,149379,2142,756,148623,Eastern Mediterranean
Albania,04-07-2020,329231,2415,889,328342,Europe
Algeria,04-07-2020,376788,1721,101,376687,Africa
Andorra,04-07-2020,129248,1193,714,128534,Europe
Angola,04-07-2020,330441,138,0,330441,Africa
Antigua and Barbuda,04-07-2020,216006,2427,1194,214812,Americas
Argentina,04-07-2020,154056,261,310,153746,Americas
Armenia,04-07-2020,20101,25,694,19407,Europe
Australia,04-07-2020,347515,947,198,347317,Western Pacific
Australia,04-07-2020,308889,2272,547,308342,Western Pacific
Australia,04-07-2020,164458,1411,250,164208,Western Pacific
Australia,04-07-2020,188922,2066,648,188274,Western Pacific
Australia,04-07-2020,98686,654,447,98239,Western Pacific
Australia,04-07-2020,227055,867,141,226914,Western Pacific
Australia,04-07-2020,185958,356,1093,184865,Western Pacific
Australia,04-07-2020,302716,2076,980,301736,Western Pacific
Austria,04-07-2020,282329,1011,1026,281303,Europe
Azerbaijan,04-07-2020,211676,2185,860,210816,Europe
Bahamas,04-07-2020,102574,818,912,101662,Americas
Bahrain,04-07-2020,378633,542,28,378605,Eastern Mediterranean
Bangladesh,04-07-2020,22455,2093,660,21795,South-East Asia
Barbados,04-07-2020,309808,632,1074,308734,Americas
Belarus,04-07-2020,138513,1826,1126,137387,Europe
Belgium,04-07-2020,445653,421,97,445556,Europe
Benin,04-07-2020,423052,635,336,422716,Africa
Bhutan,04-07-2020,221878,2168,1003,220875,South-East Asia
Bolivia,04-07-2020,120640,320,644,119996,Americas
Bosnia and Herzegovina,04-07-2020,124922,375,234,124688,Europe
Brazil,04-07-2020,222365,2480,646,221719,Americas
Brunei,04-07-2020,253616,631,296,253320,Western Pacific
Bulgaria,04-07-2020,48426,2466,347,48079,Europe
Burkina Faso,04-07-2020,418996,2490,337,418659,Africa
Cabo Verde,04-07-2020,26328,844,620,25708,Africa
Cambodia,04-07-2020,148330,1804,762,147568,Western Pacific
Cameroon,04-07-2020,44091,2226,85,44006,Africa
Canada,04-07-2020,220211,2489,444,219767,Americas
Canada,04-07-2020,39672,1458,131,39541,Americas
Canada,04-07-2020,252792,1419,982,251810,Americas
Canada,04-07-2020,206282,1459,887,205395,Americas
Canada,04-07-2020,256343,2086,546,255797,Americas
Canada,04-07-2020,125643,202,1208,124435,Americas
Canada,04-07-2020,70490,795,1107,69383,Americas
Canada,04-07-2020,323507,1032,656,322851,Americas
Canada,04-07-2020,424627,263,274,424353,Americas
Canada,04-07-2020,60372,852,1154,59218,Americas
Central African Republic,04-07-2020,187043,1596,1213,185830,Africa
Chad,04-07-2020,141535,2241,405,141130,Africa
Chile,04-07-2020,376105,1012,142,375963,Americas
China,04-07-2020,361718,1504,981,360737,Western Pacific
China,04-07-2020,370031,1328,1174,368857,Western Pacific
China,04-07-2020,298927,2346,853,298074,Western Pacific
China,04-07-2020,249883,2313,651,249232,Western Pacific
China,04-07-2020,65420,608,364,65056,Western Pacific
China,04-07-2020,197397,1038,816,196581,Western Pacific
China,04-07-2020,300819,1117,631,300188,Western Pacific
China,04-07-2020,406298,2480,1036,405262,Western Pacific
China,04-07-2020,272494,483,842,271652,Western Pacific
China,04-07-2020,35325,1568,874,34451,Western Pacific
China,04-07-2020,149015,854,1062,147953,Western Pacific
China,04-07-2020,351000,660,1050,349950,Western Pacific
China,04-07-2020,213316,2043,624,212692,Western Pacific
China,04-07-2020,428160,1197,1140,427020,Western Pacific
China,04-07-2020,301121,1758,7,301114,Western Pacific
China,04-07-2020,158001,373,992,157009,Western Pacific
China,04-07-2020,50094,1127,210,49884,Western Pacific
China,04-07-2020,197033,705,449,196584,Western Pacific
China,04-07-2020,293794,922,200,293594,Western Pacific
China,04-07-2020,84388,2044,344,84044,Western Pacific
China,04-07-2020,256885,1656,1076,255809,Western Pacific
China,04-07-2020,412368,2454,766,411602,Western Pacific
China,04-07-2020,407481,2449,144,407337,Western Pacific
China,04-07-2020,365099,1674,1193,363906,Western Pacific
China,04-07-2020,162196,319,1181,161015,Western Pacific
China,04-07-2020,130296,1794,1184,129112,Western Pacific
China,04-07-2020,235390,459,1111,234279,Western Pacific
China,04-07-2020,325697,2228,9,325688,Western Pacific
China,04-07-2020,259243,2359,946,258297,Western Pacific
China,04-07-2020,360067,1028,293,359774,Western Pacific
China,04-07-2020,208921,785,818,208103,Western Pacific
China,04-07-2020,21693,105,576,21117,Western Pacific
China,04-07-2020,127688,695,535,127153,Western Pacific
Colombia,04-07-2020,332954,1063,449,332505,Americas
Congo (Brazzaville),04-07-2020,70188,1298,53,70135,Africa
Congo (Kinshasa),04-07-2020,125725,2122,64,125661,Africa
Costa Rica,04-07-2020,223334,319,811,222523,Americas
Cote d'Ivoire,04-07-2020,128295,99,900,127395,Africa
Croatia,04-07-2020,25247,1378,744,24503,Europe
Cuba,04-07-2020,226408,429,45,226363,Americas
Cyprus,04-07-2020,376974,39,301,376673,Europe
Czechia,04-07-2020,163085,1633,735,162350,Europe
Denmark,04-07-2020,117768,1906,1007,116761,Europe
Greenland,04-07-2020,374525,111,757,373768,Europe
Denmark,04-07-2020,401744,964,1099,400645,Europe
Djibouti,04-07-2020,293738,1026,1216,292522,Eastern Mediterranean
Dominican Republic,04-07-2020,3214,266,854,2360,Americas
Ecuador,04-07-2020,258948,2004,900,258048,Americas
Egypt,04-07-2020,220282,2295,107,220175,Eastern Mediterranean
El Salvador,04-07-2020,408749,608,1195,407554,Americas
Equatorial Guinea,04-07-2020,322214,9,430,321784,Africa
Eritrea,04-07-2020,135746,496,174,135572,Africa
Estonia,04-07-2020,306064,1206,747,305317,Europe
Eswatini,04-07-2020,377612,500,828,376784,Africa
Ethiopia,04-07-2020,382724,1140,493,382231,Africa
Fiji,04-07-2020,291579,181,1031,290548,Western Pacific
Finland,04-07-2020,126896,2251,323,126573,Europe
France,04-07-2020,246357,1559,320,246037,Europe
France,04-07-2020,211673,2376,211,211462,Europe
France,04-07-2020,206725,2050,154,206571,Europe
France,04-07-2020,352718,57,350,352368,Europe
France,04-07-2020,364670,280,486,364184,Europe
France,04-07-2020,243733,883,158,243575,Europe
France,04-07-2020,258922,1950,135,258787,Europe
France,04-07-2020,320111,559,112,319999,Europe
France,04-07-2020,68528,1652,830,67698,Europe
France,04-07-2020,425844,1782,55,425789,Europe
Gabon,04-07-2020,188368,1060,452,187916,Africa
Gambia,04-07-2020,107523,1031,1081,106442,Africa
Georgia,04-07-2020,379163,2144,1133,378030,Europe
Germany,04-07-2020,265571,231,736,264835,Europe
Ghana,04-07-2020,88781,2251,1143,87638,Africa
Greece,04-07-2020,54907,869,290,54617,Europe
Guatemala,04-07-2020,136089,267,115,135974,Americas
Guinea,04-07-2020,47705,940,767,46938,Africa
Guyana,04-07-2020,230875,1610,92,230783,Americas
Haiti,04-07-2020,369795,2406,17,369778,Americas
Holy See,04-07-2020,167493,1730,173,167320,Europe
Honduras,04-07-2020,441186,645,826,440360,Americas
Hungary,04-07-2020,88206,1816,80,88126,Europe
Iceland,04-07-2020,179922,988,970,178952,Europe
India,04-07-2020,334249,676,749,333500,South-East Asia
Indonesia,04-07-2020,421978,2158,546,421432,South-East Asia
Iran,04-07-2020,82083,309,152,81931,Eastern Mediterranean
Iraq,04-07-2020,284043,2486,1086,282957,Eastern Mediterranean
Ireland,04-07-2020,280617,371,532,280085,Europe
Israel,04-07-2020,449120,86,1229,447891,Europe
Italy,04-07-2020,413159,1225,298,412861,Europe
Jamaica,04-07-2020,83680,2041,453,83227,Americas
Japan,04-07-2020,242196,2339,656,241540,Western Pacific
Jordan,04-07-2020,300370,494,564,299806,Eastern Mediterranean
Kazakhstan,04-07-2020,130839,170,277,130562,Europe
Kenya,04-07-2020,233672,1980,32,233640,Africa
South Korea,04-07-2020,275812,2442,1107,274705,Western Pacific
Kuwait,04-07-2020,173146,496,1094,172052,Eastern Mediterranean
Kyrgyzstan,04-07-2020,350854,2160,101,350753,Europe
Latvia,04-07-2020,415386,259,671,414715,Europe
Lebanon,04-07-2020,273491,340,900,272591,Eastern Mediterranean
Liberia,04-07-2020,423440,60,969,422471,Africa
Liechtenstein,04-07-2020,223072,608,1206,221866,Europe
Lithuania,04-07-2020,434186,1372,736,433450,Europe
Luxembourg,04-07-2020,170409,988,5,170404,Europe
Madagascar,04-07-2020,35489,1293,912,34577,Africa
Malaysia,04-07-2020,137967,747,1015,136952,Western Pacific
Maldives,04-07-2020,111108,2365,1132,109976,South-East Asia
Malta,04-07-2020,116075,2058,802,115273,Europe
Mauritania,04-07-2020,214845,439,816,214029,Africa
Mauritius,04-07-2020,176744,1586,220,176524,Africa
Mexico,04-07-2020,75901,271,1214,74687,Americas
Moldova,04-07-2020,231559,1160,547,231012,Europe
Monaco,04-07-2020,315509,1475,324,315185,Europe
Mongolia,04-07-2020,122695,797,685,122010,Western Pacific
Montenegro,04-07-2020,194233,2272,955,193278,Europe
Morocco,04-07-2020,359430,175,531,358899,Eastern Mediterranean
Namibia,04-07-2020,174199,1213,962,173237,Africa
Nepal,04-07-2020,446921,1882,646,446275,South-East Asia
Netherlands,04-07-2020,300556,541,90,300466,Europe
Netherlands,04-07-2020,66070,1661,93,65977,Europe
Netherlands,04-07-2020,91221,1738,569,90652,Europe
Netherlands,04-07-2020,45945,379,311,45634,Europe
New Zealand,04-07-2020,216084,86,1128,214956,Western Pacific
Nicaragua,04-07-2020,163194,2117,621,162573,Americas
Niger,04-07-2020,125544,328,605,124939,Africa
Nigeria,04-07-2020,103540,2133,1038,102502,Africa
North Macedonia,04-07-2020,420724,1399,876,419848,Europe
Norway,04-07-2020,288939,1982,117,288822,Europe
Oman,04-07-2020,219822,1539,148,219674,Eastern Mediterranean
Pakistan,04-07-2020,441590,496,931,440659,Eastern Mediterranean
Panama,04-07-2020,97416,351,359,97057,Americas
Papua New Guinea,04-07-2020,84660,63,124,84536,Western Pacific
Paraguay,04-07-2020,104214,374,560,103654,Americas
Peru,04-07-2020,25746,706,166,25580,Americas
Philippines,04-07-2020,144128,1571,1056,143072,Western Pacific
Poland,04-07-2020,143142,1728,893,142249,Europe
Portugal,04-07-2020,435926,2415,824,435102,Europe
Qatar,04-07-2020,140814,264,920,139894,Eastern Mediterranean
Romania,04-07-2020,174426,798,85,174341,Europe
Russia,04-07-2020,120901,527,954,119947,Europe
Rwanda,04-07-2020,122210,2120,638,121572,Africa
Saint Lucia,04-07-2020,117517,404,1168,116349,Americas
Saint Vincent and the Grenadines,04-07-2020,325385,1293,847,324538,Americas
San Marino,04-07-2020,115179,1380,875,114304,Europe
Saudi Arabia,04-07-2020,96709,107,1104,95605,Eastern Mediterranean
Senegal,04-07-2020,56073,461,723,55350,Africa
Serbia,04-07-2020,231056,2029,1219,229837,Europe
Seychelles,04-07-2020,79872,285,571,79301,Africa
Singapore,04-07-2020,185513,704,252,185261,Western Pacific
Slovakia,04-07-2020,93594,1616,833,92761,Europe
Slovenia,04-07-2020,318474,1217,1103,317371,Europe
Somalia,04-07-2020,227385,579,850,226535,Eastern Mediterranean
South Africa,04-07-2020,300944,565,348,300596,Africa
Spain,04-07-2020,20588,581,245,20343,Europe
Sri Lanka,04-07-2020,326998,1171,576,326422,South-East Asia
Sudan,04-07-2020,104901,2066,202,104699,Eastern Mediterranean
Suriname,04-07-2020,318795,1191,423,318372,Americas
Sweden,04-07-2020,216997,1453,390,216607,Europe
Switzerland,04-07-2020,36935,238,1070,35865,Europe
Taiwan*,04-07-2020,19026,488,507,18519,Western Pacific
Tanzania,04-07-2020,413344,649,617,412727,Africa
Thailand,04-07-2020,338647,2306,395,338252,South-East Asia
Togo,04-07-2020,39473,972,827,38646,Africa
Trinidad and Tobago,04-07-2020,145664,1306,676,144988,Americas
Tunisia,04-07-2020,99320,1290,916,98404,Eastern Mediterranean
Turkey,04-07-2020,90081,209,547,89534,Europe
Uganda,04-07-2020,370873,2312,907,369966,Africa
Ukraine,04-07-2020,320188,498,1086,319102,Europe
United Arab Emirates,04-07-2020,424434,1432,893,423541,Eastern Mediterranean
United Kingdom,04-07-2020,269338,1777,398,268940,Europe
United Kingdom,04-07-2020,56896,1976,18,56878,Europe
United Kingdom,04-07-2020,70421,991,557,69864,Europe
United Kingdom,04-07-2020,126785,919,1218,125567,Europe
United Kingdom,04-07-2020,75524,2130,308,75216,Europe
United Kingdom,04-07-2020,304640,156,146,304494,Europe
United Kingdom,04-07-2020,194028,2206,995,193033,Europe
Uruguay,04-07-2020,5555,102,1192,4363,Americas
US,04-07-2020,242832,851,468,242364,Americas
Uzbekistan,04-07-2020,174786,2012,584,174202,Europe
Venezuela,04-07-2020,271366,1451,444,270922,Americas
Vietnam,04-07-2020,172201,1176,797,171404,Western Pacific
Zambia,04-07-2020,127083,2172,1124,125959,Africa
Zimbabwe,04-07-2020,134658,2257,512,134146,Africa
Dominica,04-07-2020,123961,489,1069,122892,Americas
Grenada,04-07-2020,127428,1758,17,127411,Americas
Mozambique,04-07-2020,424885,409,323,424562,Africa
Syria,04-07-2020,363972,1360,1138,362834,Eastern Mediterranean
Timor-Leste,04-07-2020,214025,874,1221,212804,South-East Asia
Belize,04-07-2020,266251,405,382,265869,Americas
Laos,04-07-2020,50462,384,283,50179,Western Pacific
Libya,04-07-2020,320641,825,766,319875,Eastern Mediterranean
West Bank and Gaza,04-07-2020,146885,1698,286,146599,Eastern Mediterranean
Guinea-Bissau,04-07-2020,422377,915,403,421974,Africa
Mali,04-07-2020,340762,2126,637,340125,Africa
Saint Kitts and Nevis,04-07-2020,340946,247,381,340565,Americas
Canada,04-07-2020,106189,2263,208,105981,Americas
Canada,04-07-2020,41165,518,1142,40023,Americas
Kosovo,04-07-2020,316880,752,727,316153,Europe
Burma,04-07-2020,7058,1845,508,6550,South-East Asia
United Kingdom,04-07-2020,357950,354,603,357347,Europe
United Kingdom,04-07-2020,421457,732,669,420788,Europe
United Kingdom,04-07-2020,347993,55,284,347709,Europe
Botswana,04-07-2020,2819,70,47,2772,Africa
Burundi,04-07-2020,279996,687,525,279471,Africa
Sierra Leone,04-07-2020,275133,2217,146,274987,Africa
Malawi,04-07-2020,318888,1721,1238,317650,Africa
United Kingdom,04-07-2020,382655,1090,669,381986,Europe
France,04-07-2020,195451,814,390,195061,Europe
South Sudan,04-07-2020,256922,126,1109,255813,Africa
Western Sahara,04-07-2020,296987,1886,20,296967,Africa
Sao Tome and Principe,04-07-2020,46471,1048,1059,45412,Africa
Yemen,04-07-2020,404771,576,925,403846,Eastern Mediterranean
Comoros,04-07-2020,329099,2498,915,328184,Africa
Tajikistan,04-07-2020,313504,829,709,312795,Europe
Lesotho,04-07-2020,19406,742,558,18848,Africa
Afghanistan,05-07-2020,140602,2,517,140085,Eastern Mediterranean
Albania,05-07-2020,209145,1196,423,208722,Europe
Algeria,05-07-2020,374411,369,500,373911,Africa
Andorra,05-07-2020,326857,1830,284,326573,Europe
Angola,05-07-2020,83856,2457,561,83295,Africa
Antigua and Barbuda,05-07-2020,100869,1293,732,100137,Americas
Argentina,05-07-2020,35854,1104,1078,34776,Americas
Armenia,05-07-2020,182482,975,966,181516,Europe
Australia,05-07-2020,291706,1653,640,291066,Western Pacific
Australia,05-07-2020,78578,1526,128,78450,Western Pacific
Australia,05-07-2020,5471,2423,134,5337,Western Pacific
Australia,05-07-2020,72047,366,1134,70913,Western Pacific
Australia,05-07-2020,353676,189,365,353311,Western Pacific
Australia,05-07-2020,180753,1500,405,180348,Western Pacific
Australia,05-07-2020,47040,1598,825,46215,Western Pacific
Australia,05-07-2020,355840,1758,415,355425,Western Pacific
Austria,05-07-2020,422810,1284,638,422172,Europe
Azerbaijan,05-07-2020,275519,1815,1026,274493,Europe
Bahamas,05-07-2020,373749,1541,243,373506,Americas
Bahrain,05-07-2020,337823,512,1081,336742,Eastern Mediterranean
Bangladesh,05-07-2020,259678,1745,247,259431,South-East Asia
Barbados,05-07-2020,240752,2255,1024,239728,Americas
Belarus,05-07-2020,65523,2323,547,64976,Europe
Belgium,05-07-2020,158298,502,756,157542,Europe
Benin,05-07-2020,418269,2392,526,417743,Africa
Bhutan,05-07-2020,75814,835,1101,74713,South-East Asia
Bolivia,05-07-2020,200405,1004,654,199751,Americas
Bosnia and Herzegovina,05-07-2020,443165,1359,869,442296,Europe
Brazil,05-07-2020,88592,1516,755,87837,Americas
Brunei,05-07-2020,446897,539,440,446457,Western Pacific
Bulgaria,05-07-2020,247042,747,132,246910,Europe
Burkina Faso,05-07-2020,49771,446,657,49114,Africa
Cabo Verde,05-07-2020,9338,2332,604,8734,Africa
Cambodia,05-07-2020,306742,1254,425,306317,Western Pacific
Cameroon,05-07-2020,413344,1935,484,412860,Africa
Canada,05-07-2020,37562,561,363,37199,Americas
Canada,05-07-2020,168190,2205,345,167845,Americas
Canada,05-07-2020,205538,707,535,205003,Americas
Canada,05-07-2020,167069,355,1140,165929,Americas
Canada,05-07-2020,433766,1384,715,433051,Americas
Canada,05-07-2020,221951,497,1113,220838,Americas
Canada,05-07-2020,252837,411,153,252684,Americas
Canada,05-07-2020,7205,6,964,6241,Americas
Canada,05-07-2020,184425,784,108,184317,Americas
Canada,05-07-2020,435776,919,594,435182,Americas
Central African Republic,05-07-2020,212410,1931,1189,211221,Africa
Chad,05-07-2020,78521,1977,955,77566,Africa
Chile,05-07-2020,375730,1151,202,375528,Americas
China,05-07-2020,59721,2058,772,58949,Western Pacific
China,05-07-2020,71279,1823,1100,70179,Western Pacific
China,05-07-2020,388074,717,553,387521,Western Pacific
China,05-07-2020,196008,1244,200,195808,Western Pacific
China,05-07-2020,172189,288,942,171247,Western Pacific
China,05-07-2020,408534,1699,331,408203,Western Pacific
China,05-07-2020,169184,1036,66,169118,Western Pacific
China,05-07-2020,206649,1237,1013,205636,Western Pacific
China,05-07-2020,334924,1208,1152,333772,Western Pacific
China,05-07-2020,447132,921,337,446795,Western Pacific
China,05-07-2020,84565,488,195,84370,Western Pacific
China,05-07-2020,102576,54,691,101885,Western Pacific
China,05-07-2020,384899,716,1025,383874,Western Pacific
China,05-07-2020,317071,1420,1223,315848,Western Pacific
China,05-07-2020,31537,1803,511,31026,Western Pacific
China,05-07-2020,429936,1007,659,429277,Western Pacific
China,05-07-2020,299077,1322,1023,298054,Western Pacific
China,05-07-2020,7917,470,344,7573,Western Pacific
China,05-07-2020,117246,1021,756,116490,Western Pacific
China,05-07-2020,26826,155,436,26390,Western Pacific
China,05-07-2020,106612,1464,749,105863,Western Pacific
China,05-07-2020,437640,60,316,437324,Western Pacific
China,05-07-2020,448189,432,115,448074,Western Pacific
China,05-07-2020,150835,2409,963,149872,Western Pacific
China,05-07-2020,218167,1555,517,217650,Western Pacific
China,05-07-2020,225440,2408,851,224589,Western Pacific
China,05-07-2020,72691,2072,51,72640,Western Pacific
China,05-07-2020,408340,1651,679,407661,Western Pacific
China,05-07-2020,314949,848,1015,313934,Western Pacific
China,05-07-2020,350327,245,253,350074,Western Pacific
China,05-07-2020,19133,769,401,18732,Western Pacific
China,05-07-2020,407733,1891,6,407727,Western Pacific
China,05-07-2020,173542,64,225,173317,Western Pacific
Colombia,05-07-2020,250897,2375,119,250778,Americas
Congo (Brazzaville),05-07-2020,428063,55,899,427164,Africa
Congo (Kinshasa),05-07-2020,437308,622,708,436600,Africa
Costa Rica,05-07-2020,146765,2118,1240,145525,Americas
Cote d'Ivoire,05-07-2020,81114,734,1065,80049,Africa
Croatia,05-07-2020,143914,1260,327,143587,Europe
Cuba,05-07-2020,163242,1532,5,163237,Americas
Cyprus,05-07-2020,101503,1499,22,101481,Europe
Czechia,05-07-2020,237705,693,429,237276,Europe
Denmark,05-07-2020,275872,2457,411,275461,Europe
Greenland,05-07-2020,77901,2058,373,77528,Europe
Denmark,05-07-2020,236994,1178,900,236094,Europe
Djibouti,05-07-2020,111400,2246,853,110547,Eastern Mediterranean
Dominican Republic,05-07-2020,49635,2482,553,49082,Americas
Ecuador,05-07-2020,126508,2031,838,125670,Americas
Egypt,05-07-2020,327727,489,500,327227,Eastern Mediterranean
El Salvador,05-07-2020,83611,1797,747,82864,Americas
Equatorial Guinea,05-07-2020,277171,1521,675,276496,Africa
Eritrea,05-07-2020,327872,372,1061,326811,Africa
Estonia,05-07-2020,318137,1532,1019,317118,Europe
Eswatini,05-07-2020,36217,1306,1025,35192,Africa
Ethiopia,05-07-2020,10099,1033,1154,8945,Africa
Fiji,05-07-2020,425605,1706,391,425214,Western Pacific
Finland,05-07-2020,363124,1286,610,362514,Europe
France,05-07-2020,223972,2200,1232,222740,Europe
France,05-07-2020,393630,1272,797,392833,Europe
France,05-07-2020,88259,115,39,88220,Europe
France,05-07-2020,209124,994,616,208508,Europe
France,05-07-2020,132794,2381,124,132670,Europe
France,05-07-2020,317946,267,834,317112,Europe
France,05-07-2020,202708,2424,475,202233,Europe
France,05-07-2020,105806,181,673,105133,Europe
France,05-07-2020,433028,474,35,432993,Europe
France,05-07-2020,307838,1846,1066,306772,Europe
Gabon,05-07-2020,242731,205,41,242690,Africa
Gambia,05-07-2020,368629,720,1228,367401,Africa
Georgia,05-07-2020,96954,2401,915,96039,Europe
Germany,05-07-2020,188274,1282,1204,187070,Europe
Ghana,05-07-2020,249922,2050,37,249885,Africa
Greece,05-07-2020,277084,1182,13,277071,Europe
Guatemala,05-07-2020,31298,704,40,31258,Americas
Guinea,05-07-2020,24366,871,1019,23347,Africa
Guyana,05-07-2020,403188,664,1093,402095,Americas
Haiti,05-07-2020,436660,1137,893,435767,Americas
Holy See,05-07-2020,19036,2190,1077,17959,Europe
Honduras,05-07-2020,333300,2342,432,332868,Americas
Hungary,05-07-2020,159321,756,284,159037,Europe
Iceland,05-07-2020,442140,1996,301,441839,Europe
India,05-07-2020,139238,1472,370,138868,South-East Asia
Indonesia,05-07-2020,90058,210,243,89815,South-East Asia
Iran,05-07-2020,35568,2342,776,34792,Eastern Mediterranean
Iraq,05-07-2020,375805,1403,15,375790,Eastern Mediterranean
Ireland,05-07-2020,68631,1860,670,67961,Europe
Israel,05-07-2020,229296,747,43,229253,Europe
Italy,05-07-2020,25493,1930,1248,24245,Europe
Jamaica,05-07-2020,277285,2126,18,277267,Americas
Japan,05-07-2020,306418,693,679,305739,Western Pacific
Jordan,05-07-2020,227972,1726,580,227392,Eastern Mediterranean
Kazakhstan,05-07-2020,197026,1824,1083,195943,Europe
Kenya,05-07-2020,417041,153,425,416616,Africa
South Korea,05-07-2020,15589,1669,211,15378,Western Pacific
Kuwait,05-07-2020,238385,1112,597,237788,Eastern Mediterranean
Kyrgyzstan,05-07-2020,266856,1681,492,266364,Europe
Latvia,05-07-2020,367632,658,951,366681,Europe
Lebanon,05-07-2020,85727,2236,473,85254,Eastern Mediterranean
Liberia,05-07-2020,198519,200,555,197964,Africa
Liechtenstein,05-07-2020,104227,2335,605,103622,Europe
Lithuania,05-07-2020,21347,222,116,21231,Europe
Luxembourg,05-07-2020,418056,1961,189,417867,Europe
Madagascar,05-07-2020,252180,1356,1101,251079,Africa
Malaysia,05-07-2020,348968,1686,266,348702,Western Pacific
Maldives,05-07-2020,16593,1966,1151,15442,South-East Asia
Malta,05-07-2020,368681,1897,535,368146,Europe
Mauritania,05-07-2020,49676,1416,457,49219,Africa
Mauritius,05-07-2020,272980,1756,721,272259,Africa
Mexico,05-07-2020,328172,1074,921,327251,Americas
Moldova,05-07-2020,29136,1870,875,28261,Europe
Monaco,05-07-2020,413056,1944,236,412820,Europe
Mongolia,05-07-2020,280741,44,90,280651,Western Pacific
Montenegro,05-07-2020,420731,786,613,420118,Europe
Morocco,05-07-2020,34884,1698,312,34572,Eastern Mediterranean
Namibia,05-07-2020,71250,2011,134,71116,Africa
Nepal,05-07-2020,88364,2421,86,88278,South-East Asia
Netherlands,05-07-2020,81593,747,835,80758,Europe
Netherlands,05-07-2020,187733,1514,783,186950,Europe
Netherlands,05-07-2020,226006,2481,841,225165,Europe
Netherlands,05-07-2020,353851,1568,109,353742,Europe
New Zealand,05-07-2020,233033,2113,240,232793,Western Pacific
Nicaragua,05-07-2020,236158,126,941,235217,Americas
Niger,05-07-2020,263194,1801,343,262851,Africa
Nigeria,05-07-2020,199811,1644,988,198823,Africa
North Macedonia,05-07-2020,37237,1433,200,37037,Europe
Norway,05-07-2020,296496,721,258,296238,Europe
Oman,05-07-2020,345136,1720,588,344548,Eastern Mediterranean
Pakistan,05-07-2020,355822,1769,1217,354605,Eastern Mediterranean
Panama,05-07-2020,91830,1235,1040,90790,Americas
Papua New Guinea,05-07-2020,23389,2235,564,22825,Western Pacific
Paraguay,05-07-2020,258566,2337,399,258167,Americas
Peru,05-07-2020,116846,1134,1222,115624,Americas
Philippines,05-07-2020,125600,151,267,125333,Western Pacific
Poland,05-07-2020,375071,1465,595,374476,Europe
Portugal,05-07-2020,141664,2181,1209,140455,Europe
Qatar,05-07-2020,190645,1605,1063,189582,Eastern Mediterranean
Romania,05-07-2020,166192,2017,284,165908,Europe
Russia,05-07-2020,343910,2147,50,343860,Europe
Rwanda,05-07-2020,331133,1759,772,330361,Africa
Saint Lucia,05-07-2020,147843,1413,519,147324,Americas
Saint Vincent and the Grenadines,05-07-2020,239388,2337,470,238918,Americas
San Marino,05-07-2020,42407,883,957,41450,Europe
Saudi Arabia,05-07-2020,268510,1932,479,268031,Eastern Mediterranean
Senegal,05-07-2020,295240,1898,353,294887,Africa
Serbia,05-07-2020,321907,1223,536,321371,Europe
Seychelles,05-07-2020,333986,946,1155,332831,Africa
Singapore,05-07-2020,35656,2434,893,34763,Western Pacific
Slovakia,05-07-2020,129697,553,367,129330,Europe
Slovenia,05-07-2020,321236,333,589,320647,Europe
Somalia,05-07-2020,261447,1994,631,260816,Eastern Mediterranean
South Africa,05-07-2020,316200,259,439,315761,Africa
Spain,05-07-2020,254837,631,407,254430,Europe
Sri Lanka,05-07-2020,107928,335,313,107615,South-East Asia
Sudan,05-07-2020,414013,502,833,413180,Eastern Mediterranean
Suriname,05-07-2020,416956,1803,955,416001,Americas
Sweden,05-07-2020,144974,29,381,144593,Europe
Switzerland,05-07-2020,278119,962,418,277701,Europe
Taiwan*,05-07-2020,381318,539,1187,380131,Western Pacific
Tanzania,05-07-2020,322814,232,934,321880,Africa
Thailand,05-07-2020,46009,990,1198,44811,South-East Asia
Togo,05-07-2020,310865,473,453,310412,Africa
Trinidad and Tobago,05-07-2020,154520,303,1073,153447,Americas
Tunisia,05-07-2020,92323,679,812,91511,Eastern Mediterranean
Turkey,05-07-2020,71193,2145,1014,70179,Europe
Uganda,05-07-2020,267940,268,1219,266721,Africa
Ukraine,05-07-2020,28356,93,765,27591,Europe
United Arab Emirates,05-07-2020,135098,2352,1166,133932,Eastern Mediterranean
United Kingdom,05-07-2020,194141,1558,696,193445,Europe
United Kingdom,05-07-2020,80994,2326,763,80231,Europe
United Kingdom,05-07-2020,137261,202,1155,136106,Europe
United Kingdom,05-07-2020,210209,848,216,209993,Europe
United Kingdom,05-07-2020,151342,1934,447,150895,Europe
United Kingdom,05-07-2020,393825,1286,840,392985,Europe
United Kingdom,05-07-2020,249655,2262,1246,248409,Europe
Uruguay,05-07-2020,277985,2481,791,277194,Americas
US,05-07-2020,284192,2069,263,283929,Americas
Uzbekistan,05-07-2020,174792,955,248,174544,Europe
Venezuela,05-07-2020,166400,1368,390,166010,Americas
Vietnam,05-07-2020,171716,1235,1130,170586,Western Pacific
Zambia,05-07-2020,337566,1995,807,336759,Africa
Zimbabwe,05-07-2020,100635,2285,670,99965,Africa
Dominica,05-07-2020,201716,1985,9,201707,Americas
Grenada,05-07-2020,296286,1553,1015,295271,Americas
Mozambique,05-07-2020,448264,441,920,447344,Africa
Syria,05-07-2020,50890,813,813,50077,Eastern Mediterranean
Timor-Leste,05-07-2020,187689,1499,1197,186492,South-East Asia
Belize,05-07-2020,124042,39,990,123052,Americas
Laos,05-07-2020,181678,728,1015,180663,Western Pacific
Libya,05-07-2020,139934,2491,762,139172,Eastern Mediterranean
West Bank and Gaza,05-07-2020,116732,1848,507,116225,Eastern Mediterranean
Guinea-Bissau,05-07-2020,144010,630,518,143492,Africa
Mali,05-07-2020,388559,336,680,387879,Africa
Saint Kitts and Nevis,05-07-2020,222774,2118,320,222454,Americas
Canada,05-07-2020,422359,2028,688,421671,Americas
Canada,05-07-2020,368276,1143,219,368057,Americas
Kosovo,05-07-2020,177978,242,870,177108,Europe
Burma,05-07-2020,282590,2026,946,281644,South-East Asia
United Kingdom,05-07-2020,135780,1400,561,135219,Europe
United Kingdom,05-07-2020,26508,2062,722,25786,Europe
United Kingdom,05-07-2020,289936,415,1074,288862,Europe
Botswana,05-07-2020,346614,68,1059,345555,Africa
Burundi,05-07-2020,223351,1804,688,222663,Africa
Sierra Leone,05-07-2020,99636,1364,691,98945,Africa
Malawi,05-07-2020,246008,1617,916,245092,Africa
United Kingdom,05-07-2020,22512,2214,887,21625,Europe
France,05-07-2020,20217,2415,878,19339,Europe
South Sudan,05-07-2020,347387,1765,1095,346292,Africa
Western Sahara,05-07-2020,31169,2106,1079,30090,Africa
Sao Tome and Principe,05-07-2020,196111,1906,150,195961,Africa
Yemen,05-07-2020,260441,1905,682,259759,Eastern Mediterranean
Comoros,05-07-2020,230482,2435,236,230246,Africa
Tajikistan,05-07-2020,397082,1384,9,397073,Europe
Lesotho,05-07-2020,325032,594,85,324947,Africa
Afghanistan,06-07-2020,60100,899,625,59475,Eastern Mediterranean
Albania,06-07-2020,346743,2044,311,346432,Europe
Algeria,06-07-2020,156913,1360,627,156286,Africa
Andorra,06-07-2020,192898,580,785,192113,Europe
Angola,06-07-2020,411243,565,1024,410219,Africa
Antigua and Barbuda,06-07-2020,183173,2192,258,182915,Americas
Argentina,06-07-2020,71336,803,606,70730,Americas
Armenia,06-07-2020,186439,350,596,185843,Europe
Australia,06-07-2020,252922,895,822,252100,Western Pacific
Australia,06-07-2020,239852,592,259,239593,Western Pacific
Australia,06-07-2020,191030,2150,762,190268,Western Pacific
Australia,06-07-2020,67215,1953,199,67016,Western Pacific
Australia,06-07-2020,404183,2321,416,403767,Western Pacific
Australia,06-07-2020,106233,133,581,105652,Western Pacific
Australia,06-07-2020,217681,2495,51,217630,Western Pacific
Australia,06-07-2020,354001,858,164,353837,Western Pacific
Austria,06-07-2020,50065,754,147,49918,Europe
Azerbaijan,06-07-2020,312179,2260,102,312077,Europe
Bahamas,06-07-2020,142317,1510,368,141949,Americas
Bahrain,06-07-2020,168947,383,673,168274,Eastern Mediterranean
Bangladesh,06-07-2020,263018,2005,1182,261836,South-East Asia
Barbados,06-07-2020,370629,2390,74,370555,Americas
Belarus,06-07-2020,10833,168,555,10278,Europe
Belgium,06-07-2020,143722,1584,1119,142603,Europe
Benin,06-07-2020,298523,527,56,298467,Africa
Bhutan,06-07-2020,25344,2139,236,25108,South-East Asia
Bolivia,06-07-2020,431709,1333,548,431161,Americas
Bosnia and Herzegovina,06-07-2020,381533,214,41,381492,Europe
Brazil,06-07-2020,105487,1352,833,104654,Americas
Brunei,06-07-2020,314197,2333,539,313658,Western Pacific
Bulgaria,06-07-2020,310214,1438,1038,309176,Europe
Burkina Faso,06-07-2020,413958,1595,672,413286,Africa
Cabo Verde,06-07-2020,7934,1892,211,7723,Africa
Cambodia,06-07-2020,432267,2453,633,431634,Western Pacific
Cameroon,06-07-2020,123101,2240,939,122162,Africa
Canada,06-07-2020,322904,2364,46,322858,Americas
Canada,06-07-2020,235931,381,1110,234821,Americas
Canada,06-07-2020,158068,1939,20,158048,Americas
Canada,06-07-2020,321664,2196,61,321603,Americas
Canada,06-07-2020,329982,212,1041,328941,Americas
Canada,06-07-2020,364876,774,579,364297,Americas
Canada,06-07-2020,441814,1809,1109,440705,Americas
Canada,06-07-2020,55891,1688,1095,54796,Americas
Canada,06-07-2020,173070,2429,1131,171939,Americas
Canada,06-07-2020,38487,412,29,38458,Americas
Central African Republic,06-07-2020,397489,572,596,396893,Africa
Chad,06-07-2020,369624,319,1181,368443,Africa
Chile,06-07-2020,353065,1133,294,352771,Americas
China,06-07-2020,397868,92,1175,396693,Western Pacific
China,06-07-2020,214618,1853,1184,213434,Western Pacific
China,06-07-2020,123833,2446,131,123702,Western Pacific
China,06-07-2020,213620,564,1185,212435,Western Pacific
China,06-07-2020,245646,1543,674,244972,Western Pacific
China,06-07-2020,320528,428,570,319958,Western Pacific
China,06-07-2020,283252,198,761,282491,Western Pacific
China,06-07-2020,432258,1348,966,431292,Western Pacific
China,06-07-2020,396712,1333,819,395893,Western Pacific
China,06-07-2020,351944,2452,500,351444,Western Pacific
China,06-07-2020,267623,1225,1039,266584,Western Pacific
China,06-07-2020,342763,970,35,342728,Western Pacific
China,06-07-2020,315122,1342,984,314138,Western Pacific
China,06-07-2020,361293,2167,158,361135,Western Pacific
China,06-07-2020,123177,2196,635,122542,Western Pacific
China,06-07-2020,155999,650,208,155791,Western Pacific
China,06-07-2020,71426,942,989,70437,Western Pacific
China,06-07-2020,306678,1217,310,306368,Western Pacific
China,06-07-2020,251142,2311,750,250392,Western Pacific
China,06-07-2020,412610,743,99,412511,Western Pacific
China,06-07-2020,94120,2354,322,93798,Western Pacific
China,06-07-2020,300547,1325,235,300312,Western Pacific
China,06-07-2020,302228,1720,663,301565,Western Pacific
China,06-07-2020,396861,2204,608,396253,Western Pacific
China,06-07-2020,426183,506,1124,425059,Western Pacific
China,06-07-2020,143001,2349,896,142105,Western Pacific
China,06-07-2020,107576,287,164,107412,Western Pacific
China,06-07-2020,206814,925,1060,205754,Western Pacific
China,06-07-2020,199690,334,324,199366,Western Pacific
China,06-07-2020,216489,332,979,215510,Western Pacific
China,06-07-2020,337491,193,852,336639,Western Pacific
China,06-07-2020,369125,1134,179,368946,Western Pacific
China,06-07-2020,141873,1505,255,141618,Western Pacific
Colombia,06-07-2020,67743,1570,442,67301,Americas
Congo (Brazzaville),06-07-2020,55738,1821,44,55694,Africa
Congo (Kinshasa),06-07-2020,13682,1547,270,13412,Africa
Costa Rica,06-07-2020,82298,2006,632,81666,Americas
Cote d'Ivoire,06-07-2020,137873,908,1001,136872,Africa
Croatia,06-07-2020,240061,2214,72,239989,Europe
Cuba,06-07-2020,64021,2263,814,63207,Americas
Cyprus,06-07-2020,9774,2111,271,9503,Europe
Czechia,06-07-2020,115944,2108,302,115642,Europe
Denmark,06-07-2020,59391,1804,205,59186,Europe
Greenland,06-07-2020,301734,1445,906,300828,Europe
Denmark,06-07-2020,236592,2492,1226,235366,Europe
Djibouti,06-07-2020,2481,2388,320,2161,Eastern Mediterranean
Dominican Republic,06-07-2020,389424,996,135,389289,Americas
Ecuador,06-07-2020,315928,1215,1091,314837,Americas
Egypt,06-07-2020,210005,1838,1142,208863,Eastern Mediterranean
El Salvador,06-07-2020,439619,600,317,439302,Americas
Equatorial Guinea,06-07-2020,222265,1277,1189,221076,Africa
Eritrea,06-07-2020,369701,1120,220,369481,Africa
Estonia,06-07-2020,288667,1616,711,287956,Europe
Eswatini,06-07-2020,217498,986,187,217311,Africa
Ethiopia,06-07-2020,43360,2225,781,42579,Africa
Fiji,06-07-2020,135603,332,300,135303,Western Pacific
Finland,06-07-2020,167812,915,992,166820,Europe
France,06-07-2020,104495,2458,26,104469,Europe
France,06-07-2020,337200,742,1166,336034,Europe
France,06-07-2020,168187,2267,738,167449,Europe
France,06-07-2020,32012,1843,1221,30791,Europe
France,06-07-2020,422013,1390,281,421732,Europe
France,06-07-2020,99052,1729,285,98767,Europe
France,06-07-2020,294573,1133,953,293620,Europe
France,06-07-2020,200854,1230,980,199874,Europe
France,06-07-2020,445384,2384,418,444966,Europe
France,06-07-2020,428615,63,583,428032,Europe
Gabon,06-07-2020,315910,773,753,315157,Africa
Gambia,06-07-2020,126692,1276,931,125761,Africa
Georgia,06-07-2020,174691,2212,1042,173649,Europe
Germany,06-07-2020,101038,1240,1091,99947,Europe
Ghana,06-07-2020,198600,66,536,198064,Africa
Greece,06-07-2020,419416,657,30,419386,Europe
Guatemala,06-07-2020,116455,867,1128,115327,Americas
Guinea,06-07-2020,139639,2,265,139374,Africa
Guyana,06-07-2020,229640,1701,560,229080,Americas
Haiti,06-07-2020,87314,2348,1191,86123,Americas
Holy See,06-07-2020,370672,1780,1065,369607,Europe
Honduras,06-07-2020,314361,1583,80,314281,Americas
Hungary,06-07-2020,437689,1280,737,436952,Europe
Iceland,06-07-2020,279320,2495,630,278690,Europe
India,06-07-2020,111538,1422,1144,110394,South-East Asia
Indonesia,06-07-2020,41779,246,1197,40582,South-East Asia
Iran,06-07-2020,11203,1120,504,10699,Eastern Mediterranean
Iraq,06-07-2020,438837,2320,381,438456,Eastern Mediterranean
Ireland,06-07-2020,360038,1527,465,359573,Europe
Israel,06-07-2020,331075,673,675,330400,Europe
Italy,06-07-2020,139048,2385,380,138668,Europe
Jamaica,06-07-2020,281929,287,1224,280705,Americas
Japan,06-07-2020,219383,1354,248,219135,Western Pacific
Jordan,06-07-2020,118413,2368,524,117889,Eastern Mediterranean
Kazakhstan,06-07-2020,241943,1817,623,241320,Europe
Kenya,06-07-2020,258018,1706,664,257354,Africa
South Korea,06-07-2020,386852,1441,385,386467,Western Pacific
Kuwait,06-07-2020,378439,1634,130,378309,Eastern Mediterranean
Kyrgyzstan,06-07-2020,193832,1071,602,193230,Europe
Latvia,06-07-2020,344722,653,872,343850,Europe
Lebanon,06-07-2020,52409,1056,39,52370,Eastern Mediterranean
Liberia,06-07-2020,392333,2215,46,392287,Africa
Liechtenstein,06-07-2020,449363,2292,909,448454,Europe
Lithuania,06-07-2020,312148,1293,223,311925,Europe
Luxembourg,06-07-2020,306123,954,860,305263,Europe
Madagascar,06-07-2020,3567,966,1234,2333,Africa
Malaysia,06-07-2020,67537,1639,1072,66465,Western Pacific
Maldives,06-07-2020,230411,951,453,229958,South-East Asia
Malta,06-07-2020,135677,1140,889,134788,Europe
Mauritania,06-07-2020,102340,192,173,102167,Africa
Mauritius,06-07-2020,39211,866,34,39177,Africa
Mexico,06-07-2020,356556,208,201,356355,Americas
Moldova,06-07-2020,435732,393,192,435540,Europe
Monaco,06-07-2020,340707,817,723,339984,Europe
Mongolia,06-07-2020,216464,1283,924,215540,Western Pacific
Montenegro,06-07-2020,92485,371,758,91727,Europe
Morocco,06-07-2020,359859,678,808,359051,Eastern Mediterranean
Namibia,06-07-2020,241696,1345,1244,240452,Africa
Nepal,06-07-2020,19158,2049,819,18339,South-East Asia
Netherlands,06-07-2020,439503,293,568,438935,Europe
Netherlands,06-07-2020,78836,1888,432,78404,Europe
Netherlands,06-07-2020,66464,2145,1075,65389,Europe
Netherlands,06-07-2020,112147,243,227,111920,Europe
New Zealand,06-07-2020,305406,1706,379,305027,Western Pacific
Nicaragua,06-07-2020,75481,2101,77,75404,Americas
Niger,06-07-2020,196540,2477,233,196307,Africa
Nigeria,06-07-2020,101202,1114,33,101169,Africa
North Macedonia,06-07-2020,398867,1583,795,398072,Europe
Norway,06-07-2020,237883,583,100,237783,Europe
Oman,06-07-2020,89249,1604,1137,88112,Eastern Mediterranean
Pakistan,06-07-2020,267375,694,195,267180,Eastern Mediterranean
Panama,06-07-2020,333439,406,302,333137,Americas
Papua New Guinea,06-07-2020,133750,1565,317,133433,Western Pacific
Paraguay,06-07-2020,417032,1768,627,416405,Americas
Peru,06-07-2020,132276,861,28,132248,Americas
Philippines,06-07-2020,20248,2034,449,19799,Western Pacific
Poland,06-07-2020,435583,776,584,434999,Europe
Portugal,06-07-2020,233722,833,765,232957,Europe
Qatar,06-07-2020,414602,1938,172,414430,Eastern Mediterranean
Romania,06-07-2020,260286,182,6,260280,Europe
Russia,06-07-2020,232378,1004,977,231401,Europe
Rwanda,06-07-2020,68057,591,279,67778,Africa
Saint Lucia,06-07-2020,373629,801,53,373576,Americas
Saint Vincent and the Grenadines,06-07-2020,39297,104,1115,38182,Americas
San Marino,06-07-2020,173896,1825,1205,172691,Europe
Saudi Arabia,06-07-2020,8247,2231,694,7553,Eastern Mediterranean
Senegal,06-07-2020,136316,1553,286,136030,Africa
Serbia,06-07-2020,140277,1675,43,140234,Europe
Seychelles,06-07-2020,386056,1039,499,385557,Africa
Singapore,06-07-2020,334044,510,583,333461,Western Pacific
Slovakia,06-07-2020,384728,96,154,384574,Europe
Slovenia,06-07-2020,116831,1641,552,116279,Europe
Somalia,06-07-2020,136609,2283,1030,135579,Eastern Mediterranean
South Africa,06-07-2020,91991,741,724,91267,Africa
Spain,06-07-2020,24214,2391,747,23467,Europe
Sri Lanka,06-07-2020,190101,791,971,189130,South-East Asia
Sudan,06-07-2020,372847,2013,1233,371614,Eastern Mediterranean
Suriname,06-07-2020,310457,1504,381,310076,Americas
Sweden,06-07-2020,273490,1081,1077,272413,Europe
Switzerland,06-07-2020,84705,1115,570,84135,Europe
Taiwan*,06-07-2020,236073,2304,1141,234932,Western Pacific
Tanzania,06-07-2020,343667,1916,1219,342448,Africa
Thailand,06-07-2020,338859,1047,272,338587,South-East Asia
Togo,06-07-2020,343013,660,1093,341920,Africa
Trinidad and Tobago,06-07-2020,398692,1250,16,398676,Americas
Tunisia,06-07-2020,232866,1645,595,232271,Eastern Mediterranean
Turkey,06-07-2020,204758,1758,435,204323,Europe
Uganda,06-07-2020,385598,2428,547,385051,Africa
Ukraine,06-07-2020,107772,321,414,107358,Europe
United Arab Emirates,06-07-2020,58186,2261,830,57356,Eastern Mediterranean
United Kingdom,06-07-2020,252035,1081,559,251476,Europe
United Kingdom,06-07-2020,141940,569,422,141518,Europe
United Kingdom,06-07-2020,367274,819,446,366828,Europe
United Kingdom,06-07-2020,218781,858,165,218616,Europe
United Kingdom,06-07-2020,18106,320,927,17179,Europe
United Kingdom,06-07-2020,413659,1764,787,412872,Europe
United Kingdom,06-07-2020,287059,2274,967,286092,Europe
Uruguay,06-07-2020,100395,1729,608,99787,Americas
US,06-07-2020,341784,2137,1234,340550,Americas
Uzbekistan,06-07-2020,298983,1241,637,298346,Europe
Venezuela,06-07-2020,125151,153,1223,123928,Americas
Vietnam,06-07-2020,287542,664,538,287004,Western Pacific
Zambia,06-07-2020,105317,2173,179,105138,Africa
Zimbabwe,06-07-2020,280243,142,100,280143,Africa
Dominica,06-07-2020,310503,531,1212,309291,Americas
Grenada,06-07-2020,358981,996,722,358259,Americas
Mozambique,06-07-2020,4192,554,78,4114,Africa
Syria,06-07-2020,319460,1468,740,318720,Eastern Mediterranean
Timor-Leste,06-07-2020,310299,533,355,309944,South-East Asia
Belize,06-07-2020,115661,1026,433,115228,Americas
Laos,06-07-2020,257579,2444,1,257578,Western Pacific
Libya,06-07-2020,288282,1409,148,288134,Eastern Mediterranean
West Bank and Gaza,06-07-2020,5611,102,482,5129,Eastern Mediterranean
Guinea-Bissau,06-07-2020,347219,1835,836,346383,Africa
Mali,06-07-2020,82929,1923,45,82884,Africa
Saint Kitts and Nevis,06-07-2020,113886,1580,766,113120,Americas
Canada,06-07-2020,48208,877,314,47894,Americas
Canada,06-07-2020,344228,955,457,343771,Americas
Kosovo,06-07-2020,169778,1260,690,169088,Europe
Burma,06-07-2020,150118,1550,742,149376,South-East Asia
United Kingdom,06-07-2020,275273,1219,1041,274232,Europe
United Kingdom,06-07-2020,152564,2022,567,151997,Europe
United Kingdom,06-07-2020,154754,782,844,153910,Europe
Botswana,06-07-2020,304051,1467,373,303678,Africa
Burundi,06-07-2020,122662,1472,953,121709,Africa
Sierra Leone,06-07-2020,240310,2285,1159,239151,Africa
Malawi,06-07-2020,37328,385,1226,36102,Africa
United Kingdom,06-07-2020,318152,1726,1093,317059,Europe
France,06-07-2020,70434,1656,684,69750,Europe
South Sudan,06-07-2020,91174,1,514,90660,Africa
Western Sahara,06-07-2020,159035,233,404,158631,Africa
Sao Tome and Principe,06-07-2020,86600,186,273,86327,Africa
Yemen,06-07-2020,102022,2253,1143,100879,Eastern Mediterranean
Comoros,06-07-2020,231580,573,295,231285,Africa
Tajikistan,06-07-2020,114867,1291,1052,113815,Europe
Lesotho,06-07-2020,126453,1345,214,126239,Africa
Afghanistan,07-07-2020,10760,553,385,10375,Eastern Mediterranean
Albania,07-07-2020,186189,1073,639,185550,Europe
Algeria,07-07-2020,195108,178,684,194424,Africa
Andorra,07-07-2020,313661,1075,727,312934,Europe
Angola,07-07-2020,438917,174,950,437967,Africa
Antigua and Barbuda,07-07-2020,82360,1659,1159,81201,Americas
Argentina,07-07-2020,241874,2406,559,241315,Americas
Armenia,07-07-2020,226267,663,899,225368,Europe
Australia,07-07-2020,48365,608,62,48303,Western Pacific
Australia,07-07-2020,397386,1391,171,397215,Western Pacific
Australia,07-07-2020,89225,608,1099,88126,Western Pacific
Australia,07-07-2020,368611,393,393,368218,Western Pacific
Australia,07-07-2020,348312,1391,1086,347226,Western Pacific
Australia,07-07-2020,15000,901,479,14521,Western Pacific
Australia,07-07-2020,17929,802,1090,16839,Western Pacific
Australia,07-07-2020,25426,688,1025,24401,Western Pacific
Austria,07-07-2020,374507,280,404,374103,Europe
Azerbaijan,07-07-2020,349651,747,580,349071,Europe
Bahamas,07-07-2020,123385,512,1058,122327,Americas
Bahrain,07-07-2020,167000,18,179,166821,Eastern Mediterranean
Bangladesh,07-07-2020,301373,1321,1226,300147,South-East Asia
Barbados,07-07-2020,216741,639,187,216554,Americas
Belarus,07-07-2020,212779,1613,336,212443,Europe
Belgium,07-07-2020,253095,1016,705,252390,Europe
Benin,07-07-2020,34521,444,68,34453,Africa
Bhutan,07-07-2020,126287,259,283,126004,South-East Asia
Bolivia,07-07-2020,2853,1678,1166,1687,Americas
Bosnia and Herzegovina,07-07-2020,105333,1871,956,104377,Europe
Brazil,07-07-2020,143755,628,1034,142721,Americas
Brunei,07-07-2020,142752,835,602,142150,Western Pacific
Bulgaria,07-07-2020,382649,2296,1148,381501,Europe
Burkina Faso,07-07-2020,442236,420,771,441465,Africa
Cabo Verde,07-07-2020,330841,559,231,330610,Africa
Cambodia,07-07-2020,218634,394,598,218036,Western Pacific
Cameroon,07-07-2020,52827,1611,649,52178,Africa
Canada,07-07-2020,171489,762,525,170964,Americas
Canada,07-07-2020,364547,2308,500,364047,Americas
Canada,07-07-2020,207648,51,603,207045,Americas
Canada,07-07-2020,219214,856,347,218867,Americas
Canada,07-07-2020,290988,1908,602,290386,Americas
Canada,07-07-2020,148975,1701,966,148009,Americas
Canada,07-07-2020,211569,2117,468,211101,Americas
Canada,07-07-2020,74188,2202,58,74130,Americas
Canada,07-07-2020,46726,993,1243,45483,Americas
Canada,07-07-2020,88884,1964,328,88556,Americas
Central African Republic,07-07-2020,397077,2283,134,396943,Africa
Chad,07-07-2020,328671,574,380,328291,Africa
Chile,07-07-2020,310425,497,914,309511,Americas
China,07-07-2020,397054,1670,922,396132,Western Pacific
China,07-07-2020,255855,2249,1051,254804,Western Pacific
China,07-07-2020,438703,1415,8,438695,Western Pacific
China,07-07-2020,424364,987,136,424228,Western Pacific
China,07-07-2020,326402,43,783,325619,Western Pacific
China,07-07-2020,322275,11,521,321754,Western Pacific
China,07-07-2020,209931,1729,370,209561,Western Pacific
China,07-07-2020,337338,472,403,336935,Western Pacific
China,07-07-2020,163455,2231,815,162640,Western Pacific
China,07-07-2020,153914,304,1126,152788,Western Pacific
China,07-07-2020,194762,199,883,193879,Western Pacific
China,07-07-2020,24686,2216,785,23901,Western Pacific
China,07-07-2020,165378,2119,370,165008,Western Pacific
China,07-07-2020,15312,1504,969,14343,Western Pacific
China,07-07-2020,302980,1919,928,302052,Western Pacific
China,07-07-2020,398920,1613,229,398691,Western Pacific
China,07-07-2020,220192,64,710,219482,Western Pacific
China,07-07-2020,151841,893,1089,150752,Western Pacific
China,07-07-2020,75307,2295,384,74923,Western Pacific
China,07-07-2020,273922,1467,586,273336,Western Pacific
China,07-07-2020,103239,2194,365,102874,Western Pacific
China,07-07-2020,307710,2145,824,306886,Western Pacific
China,07-07-2020,18524,1506,611,17913,Western Pacific
China,07-07-2020,20773,2042,1092,19681,Western Pacific
China,07-07-2020,169726,2379,94,169632,Western Pacific
China,07-07-2020,309568,2039,1182,308386,Western Pacific
China,07-07-2020,243601,2100,1163,242438,Western Pacific
China,07-07-2020,407879,946,1080,406799,Western Pacific
China,07-07-2020,216218,2172,994,215224,Western Pacific
China,07-07-2020,310476,2343,282,310194,Western Pacific
China,07-07-2020,37313,157,52,37261,Western Pacific
China,07-07-2020,11447,2441,856,10591,Western Pacific
China,07-07-2020,87797,1931,787,87010,Western Pacific
Colombia,07-07-2020,147807,1029,422,147385,Americas
Congo (Brazzaville),07-07-2020,97963,987,993,96970,Africa
Congo (Kinshasa),07-07-2020,161977,1966,518,161459,Africa
Costa Rica,07-07-2020,338375,990,436,337939,Americas
Cote d'Ivoire,07-07-2020,334088,1257,714,333374,Africa
Croatia,07-07-2020,22776,2430,868,21908,Europe
Cuba,07-07-2020,344317,136,189,344128,Americas
Cyprus,07-07-2020,340866,2416,1067,339799,Europe
Czechia,07-07-2020,64424,250,1031,63393,Europe
Denmark,07-07-2020,265410,1530,651,264759,Europe
Greenland,07-07-2020,66751,1651,1004,65747,Europe
Denmark,07-07-2020,256871,663,1228,255643,Europe
Djibouti,07-07-2020,420015,880,812,419203,Eastern Mediterranean
Dominican Republic,07-07-2020,415135,407,950,414185,Americas
Ecuador,07-07-2020,125682,1237,702,124980,Americas
Egypt,07-07-2020,15298,807,338,14960,Eastern Mediterranean
El Salvador,07-07-2020,425299,810,332,424967,Americas
Equatorial Guinea,07-07-2020,166265,419,1113,165152,Africa
Eritrea,07-07-2020,184143,133,1008,183135,Africa
Estonia,07-07-2020,33135,2238,45,33090,Europe
Eswatini,07-07-2020,329808,1314,64,329744,Africa
Ethiopia,07-07-2020,12151,1115,895,11256,Africa
Fiji,07-07-2020,247395,1233,20,247375,Western Pacific
Finland,07-07-2020,141028,747,518,140510,Europe
France,07-07-2020,405443,664,951,404492,Europe
France,07-07-2020,63364,1174,488,62876,Europe
France,07-07-2020,254144,279,39,254105,Europe
France,07-07-2020,417787,830,100,417687,Europe
France,07-07-2020,201624,58,921,200703,Europe
France,07-07-2020,416165,71,537,415628,Europe
France,07-07-2020,375994,1478,69,375925,Europe
France,07-07-2020,401740,2191,976,400764,Europe
France,07-07-2020,211682,1307,564,211118,Europe
France,07-07-2020,251078,686,239,250839,Europe
Gabon,07-07-2020,90150,1717,1172,88978,Africa
Gambia,07-07-2020,263791,2133,1134,262657,Africa
Georgia,07-07-2020,423114,1371,719,422395,Europe
Germany,07-07-2020,180008,799,813,179195,Europe
Ghana,07-07-2020,340311,1692,514,339797,Africa
Greece,07-07-2020,233516,2195,341,233175,Europe
Guatemala,07-07-2020,280480,481,758,279722,Americas
Guinea,07-07-2020,333060,1302,945,332115,Africa
Guyana,07-07-2020,115997,811,302,115695,Americas
Haiti,07-07-2020,265907,1509,1243,264664,Americas
Holy See,07-07-2020,420188,2385,582,419606,Europe
Honduras,07-07-2020,434560,2077,1015,433545,Americas
Hungary,07-07-2020,100860,2207,559,100301,Europe
Iceland,07-07-2020,216524,36,145,216379,Europe
India,07-07-2020,198317,145,446,197871,South-East Asia
Indonesia,07-07-2020,120970,551,959,120011,South-East Asia
Iran,07-07-2020,156798,158,24,156774,Eastern Mediterranean
Iraq,07-07-2020,444370,1296,966,443404,Eastern Mediterranean
Ireland,07-07-2020,380432,2336,361,380071,Europe
Israel,07-07-2020,430172,837,1146,429026,Europe
Italy,07-07-2020,33755,257,535,33220,Europe
Jamaica,07-07-2020,307841,1241,369,307472,Americas
Japan,07-07-2020,257187,2352,567,256620,Western Pacific
Jordan,07-07-2020,30099,1852,893,29206,Eastern Mediterranean
Kazakhstan,07-07-2020,329509,451,836,328673,Europe
Kenya,07-07-2020,160035,2486,800,159235,Africa
South Korea,07-07-2020,113520,454,775,112745,Western Pacific
Kuwait,07-07-2020,230852,2264,192,230660,Eastern Mediterranean
Kyrgyzstan,07-07-2020,110721,549,573,110148,Europe
Latvia,07-07-2020,197799,338,121,197678,Europe
Lebanon,07-07-2020,275097,825,610,274487,Eastern Mediterranean
Liberia,07-07-2020,390332,39,749,389583,Africa
Liechtenstein,07-07-2020,365115,1907,789,364326,Europe
Lithuania,07-07-2020,210492,2328,54,210438,Europe
Luxembourg,07-07-2020,420715,1728,1210,419505,Europe
Madagascar,07-07-2020,215510,248,69,215441,Africa
Malaysia,07-07-2020,69093,795,995,68098,Western Pacific
Maldives,07-07-2020,402486,2217,460,402026,South-East Asia
Malta,07-07-2020,399730,1778,1181,398549,Europe
Mauritania,07-07-2020,14954,1890,1071,13883,Africa
Mauritius,07-07-2020,284986,2500,630,284356,Africa
Mexico,07-07-2020,274556,1926,567,273989,Americas
Moldova,07-07-2020,248260,397,874,247386,Europe
Monaco,07-07-2020,54638,175,393,54245,Europe
Mongolia,07-07-2020,300145,183,365,299780,Western Pacific
Montenegro,07-07-2020,109418,1926,0,109418,Europe
Morocco,07-07-2020,322903,1119,677,322226,Eastern Mediterranean
Namibia,07-07-2020,205895,1372,409,205486,Africa
Nepal,07-07-2020,104260,903,76,104184,South-East Asia
Netherlands,07-07-2020,11026,163,105,10921,Europe
Netherlands,07-07-2020,51037,80,609,50428,Europe
Netherlands,07-07-2020,391466,1590,274,391192,Europe
Netherlands,07-07-2020,222021,1317,52,221969,Europe
New Zealand,07-07-2020,203776,1008,900,202876,Western Pacific
Nicaragua,07-07-2020,144233,2166,114,144119,Americas
Niger,07-07-2020,155303,1447,353,154950,Africa
Nigeria,07-07-2020,91882,1239,168,91714,Africa
North Macedonia,07-07-2020,403587,887,706,402881,Europe
Norway,07-07-2020,157138,385,250,156888,Europe
Oman,07-07-2020,333873,724,185,333688,Eastern Mediterranean
Pakistan,07-07-2020,51254,1265,1020,50234,Eastern Mediterranean
Panama,07-07-2020,201305,2243,460,200845,Americas
Papua New Guinea,07-07-2020,249522,1981,1019,248503,Western Pacific
Paraguay,07-07-2020,389643,1485,870,388773,Americas
Peru,07-07-2020,200743,2191,147,200596,Americas
Philippines,07-07-2020,297774,335,612,297162,Western Pacific
Poland,07-07-2020,375439,2163,642,374797,Europe
Portugal,07-07-2020,43699,1138,342,43357,Europe
Qatar,07-07-2020,161325,494,771,160554,Eastern Mediterranean
Romania,07-07-2020,126838,2400,415,126423,Europe
Russia,07-07-2020,194900,101,1169,193731,Europe
Rwanda,07-07-2020,13689,2015,1033,12656,Africa
Saint Lucia,07-07-2020,21908,236,985,20923,Americas
Saint Vincent and the Grenadines,07-07-2020,299029,1089,12,299017,Americas
San Marino,07-07-2020,25428,2239,82,25346,Europe
Saudi Arabia,07-07-2020,41802,1681,1020,40782,Eastern Mediterranean
Senegal,07-07-2020,60205,1240,852,59353,Africa
Serbia,07-07-2020,217434,755,133,217301,Europe
Seychelles,07-07-2020,444311,502,835,443476,Africa
Singapore,07-07-2020,115878,992,530,115348,Western Pacific
Slovakia,07-07-2020,127070,2345,693,126377,Europe
Slovenia,07-07-2020,111551,1438,1233,110318,Europe
Somalia,07-07-2020,434652,550,1210,433442,Eastern Mediterranean
South Africa,07-07-2020,88690,52,594,88096,Africa
Spain,07-07-2020,432668,2443,95,432573,Europe
Sri Lanka,07-07-2020,337754,1561,381,337373,South-East Asia
Sudan,07-07-2020,29982,1580,975,29007,Eastern Mediterranean
Suriname,07-07-2020,357399,1196,304,357095,Americas
Sweden,07-07-2020,444747,1744,1188,443559,Europe
Switzerland,07-07-2020,137023,1439,34,136989,Europe
Taiwan*,07-07-2020,96163,491,412,95751,Western Pacific
Tanzania,07-07-2020,30537,2238,565,29972,Africa
Thailand,07-07-2020,281268,2498,381,280887,South-East Asia
Togo,07-07-2020,85689,2476,528,85161,Africa
Trinidad and Tobago,07-07-2020,267441,797,461,266980,Americas
Tunisia,07-07-2020,322873,1085,989,321884,Eastern Mediterranean
Turkey,07-07-2020,301859,586,386,301473,Europe
Uganda,07-07-2020,66626,1082,183,66443,Africa
Ukraine,07-07-2020,259284,860,744,258540,Europe
United Arab Emirates,07-07-2020,118199,892,560,117639,Eastern Mediterranean
United Kingdom,07-07-2020,100415,1099,302,100113,Europe
United Kingdom,07-07-2020,9511,1128,1129,8382,Europe
United Kingdom,07-07-2020,308889,1098,348,308541,Europe
United Kingdom,07-07-2020,146413,2298,1018,145395,Europe
United Kingdom,07-07-2020,312976,1781,1010,311966,Europe
United Kingdom,07-07-2020,399244,90,504,398740,Europe
United Kingdom,07-07-2020,70829,2158,833,69996,Europe
Uruguay,07-07-2020,376412,1825,1211,375201,Americas
US,07-07-2020,30858,1254,491,30367,Americas
Uzbekistan,07-07-2020,1020,1471,240,780,Europe
Venezuela,07-07-2020,324793,250,796,323997,Americas
Vietnam,07-07-2020,36413,64,293,36120,Western Pacific
Zambia,07-07-2020,235779,1200,1056,234723,Africa
Zimbabwe,07-07-2020,150165,1832,182,149983,Africa
Dominica,07-07-2020,159351,813,19,159332,Americas
Grenada,07-07-2020,325949,1717,2,325947,Americas
Mozambique,07-07-2020,70251,1122,801,69450,Africa
Syria,07-07-2020,47053,289,758,46295,Eastern Mediterranean
Timor-Leste,07-07-2020,307043,798,980,306063,South-East Asia
Belize,07-07-2020,171939,91,1147,170792,Americas
Laos,07-07-2020,21206,448,236,20970,Western Pacific
Libya,07-07-2020,177108,213,982,176126,Eastern Mediterranean
West Bank and Gaza,07-07-2020,143606,2129,131,143475,Eastern Mediterranean
Guinea-Bissau,07-07-2020,170661,1779,584,170077,Africa
Mali,07-07-2020,446335,1761,807,445528,Africa
Saint Kitts and Nevis,07-07-2020,58798,1980,867,57931,Americas
Canada,07-07-2020,151358,301,512,150846,Americas
Canada,07-07-2020,307756,1142,671,307085,Americas
Kosovo,07-07-2020,318500,778,1123,317377,Europe
Burma,07-07-2020,296295,632,401,295894,South-East Asia
United Kingdom,07-07-2020,350063,1486,963,349100,Europe
United Kingdom,07-07-2020,405398,652,903,404495,Europe
United Kingdom,07-07-2020,325011,1719,365,324646,Europe
Botswana,07-07-2020,408291,1926,622,407669,Africa
Burundi,07-07-2020,174534,193,959,173575,Africa
Sierra Leone,07-07-2020,48616,1548,158,48458,Africa
Malawi,07-07-2020,129216,945,268,128948,Africa
United Kingdom,07-07-2020,37315,1641,744,36571,Europe
France,07-07-2020,420232,2466,708,419524,Europe
South Sudan,07-07-2020,327971,2276,740,327231,Africa
Western Sahara,07-07-2020,421347,814,758,420589,Africa
Sao Tome and Principe,07-07-2020,265877,758,511,265366,Africa
Yemen,07-07-2020,418768,959,354,418414,Eastern Mediterranean
Comoros,07-07-2020,347180,1564,186,346994,Africa
Tajikistan,07-07-2020,357006,513,1086,355920,Europe
Lesotho,07-07-2020,281593,1709,831,280762,Africa
Afghanistan,08-07-2020,131328,1567,921,130407,Eastern Mediterranean
Albania,08-07-2020,294479,1974,125,294354,Europe
Algeria,08-07-2020,154306,326,704,153602,Africa
Andorra,08-07-2020,216252,1162,991,215261,Europe
Angola,08-07-2020,42425,1358,332,42093,Africa
Antigua and Barbuda,08-07-2020,422986,2483,734,422252,Americas
Argentina,08-07-2020,122126,66,375,121751,Americas
Armenia,08-07-2020,397169,767,600,396569,Europe
Australia,08-07-2020,349112,1197,597,348515,Western Pacific
Australia,08-07-2020,390783,774,86,390697,Western Pacific
Australia,08-07-2020,219179,1384,1075,218104,Western Pacific
Australia,08-07-2020,261157,1971,734,260423,Western Pacific
Australia,08-07-2020,200269,2344,187,200082,Western Pacific
Australia,08-07-2020,413665,1636,847,412818,Western Pacific
Australia,08-07-2020,109185,2211,890,108295,Western Pacific
Australia,08-07-2020,59241,1040,166,59075,Western Pacific
Austria,08-07-2020,160365,682,690,159675,Europe
Azerbaijan,08-07-2020,67012,846,534,66478,Europe
Bahamas,08-07-2020,107009,1391,867,106142,Americas
Bahrain,08-07-2020,347464,77,671,346793,Eastern Mediterranean
Bangladesh,08-07-2020,205968,1496,667,205301,South-East Asia
Barbados,08-07-2020,232796,1644,706,232090,Americas
Belarus,08-07-2020,3260,1512,1101,2159,Europe
Belgium,08-07-2020,368107,472,588,367519,Europe
Benin,08-07-2020,420180,1873,1003,419177,Africa
Bhutan,08-07-2020,97344,1822,507,96837,South-East Asia
Bolivia,08-07-2020,107316,2206,456,106860,Americas
Bosnia and Herzegovina,08-07-2020,19126,2109,270,18856,Europe
Brazil,08-07-2020,196571,906,484,196087,Americas
Brunei,08-07-2020,11548,1619,566,10982,Western Pacific
Bulgaria,08-07-2020,33807,746,750,33057,Europe
Burkina Faso,08-07-2020,133215,254,635,132580,Africa
Cabo Verde,08-07-2020,138572,1971,359,138213,Africa
Cambodia,08-07-2020,446846,1436,746,446100,Western Pacific
Cameroon,08-07-2020,377536,2046,416,377120,Africa
Canada,08-07-2020,154667,1547,181,154486,Americas
Canada,08-07-2020,125259,2313,632,124627,Americas
Canada,08-07-2020,315696,594,650,315046,Americas
Canada,08-07-2020,431171,167,955,430216,Americas
Canada,08-07-2020,376822,2129,440,376382,Americas
Canada,08-07-2020,396054,1560,535,395519,Americas
Canada,08-07-2020,346110,94,1204,344906,Americas
Canada,08-07-2020,73214,1007,830,72384,Americas
Canada,08-07-2020,151279,1850,107,151172,Americas
Canada,08-07-2020,393765,395,1016,392749,Americas
Central African Republic,08-07-2020,303502,2169,880,302622,Africa
Chad,08-07-2020,284412,416,1211,283201,Africa
Chile,08-07-2020,159989,1510,959,159030,Americas
China,08-07-2020,158203,1405,251,157952,Western Pacific
China,08-07-2020,135567,705,1134,134433,Western Pacific
China,08-07-2020,55023,3,1043,53980,Western Pacific
China,08-07-2020,250516,1570,562,249954,Western Pacific
China,08-07-2020,133805,1381,169,133636,Western Pacific
China,08-07-2020,353989,1741,1044,352945,Western Pacific
China,08-07-2020,225359,1964,253,225106,Western Pacific
China,08-07-2020,66557,206,854,65703,Western Pacific
China,08-07-2020,302607,27,472,302135,Western Pacific
China,08-07-2020,141808,25,287,141521,Western Pacific
China,08-07-2020,304970,745,966,304004,Western Pacific
China,08-07-2020,440890,1508,1016,439874,Western Pacific
China,08-07-2020,217270,1539,168,217102,Western Pacific
China,08-07-2020,167928,1589,63,167865,Western Pacific
China,08-07-2020,235817,618,926,234891,Western Pacific
China,08-07-2020,168466,191,668,167798,Western Pacific
China,08-07-2020,10997,236,1214,9783,Western Pacific
China,08-07-2020,36411,2305,8,36403,Western Pacific
China,08-07-2020,226336,1025,341,225995,Western Pacific
China,08-07-2020,441813,893,1036,440777,Western Pacific
China,08-07-2020,374231,882,698,373533,Western Pacific
China,08-07-2020,409950,1885,157,409793,Western Pacific
China,08-07-2020,3588,413,575,3013,Western Pacific
China,08-07-2020,139566,1616,1065,138501,Western Pacific
China,08-07-2020,24640,2296,702,23938,Western Pacific
China,08-07-2020,103221,222,234,102987,Western Pacific
China,08-07-2020,294329,1050,64,294265,Western Pacific
China,08-07-2020,135953,1542,841,135112,Western Pacific
China,08-07-2020,317162,152,92,317070,Western Pacific
China,08-07-2020,277429,2062,1146,276283,Western Pacific
China,08-07-2020,116806,2361,1130,115676,Western Pacific
China,08-07-2020,202751,2089,213,202538,Western Pacific
China,08-07-2020,359199,2433,38,359161,Western Pacific
Colombia,08-07-2020,91238,769,627,90611,Americas
Congo (Brazzaville),08-07-2020,43509,1513,1146,42363,Africa
Congo (Kinshasa),08-07-2020,226972,1231,976,225996,Africa
Costa Rica,08-07-2020,17086,727,987,16099,Americas
Cote d'Ivoire,08-07-2020,313336,1282,738,312598,Africa
Croatia,08-07-2020,300307,430,911,299396,Europe
Cuba,08-07-2020,96306,1960,94,96212,Americas
Cyprus,08-07-2020,126960,1417,766,126194,Europe
Czechia,08-07-2020,360546,815,1058,359488,Europe
Denmark,08-07-2020,410787,690,119,410668,Europe
Greenland,08-07-2020,382686,166,1094,381592,Europe
Denmark,08-07-2020,267804,2475,980,266824,Europe
Djibouti,08-07-2020,224725,2207,725,224000,Eastern Mediterranean
Dominican Republic,08-07-2020,189876,53,888,188988,Americas
Ecuador,08-07-2020,325826,1513,601,325225,Americas
Egypt,08-07-2020,50150,415,1221,48929,Eastern Mediterranean
El Salvador,08-07-2020,331791,2458,439,331352,Americas
Equatorial Guinea,08-07-2020,412859,1788,407,412452,Africa
Eritrea,08-07-2020,333687,1549,74,333613,Africa
Estonia,08-07-2020,303206,2377,837,302369,Europe
Eswatini,08-07-2020,332170,1714,73,332097,Africa
Ethiopia,08-07-2020,317322,1525,410,316912,Africa
Fiji,08-07-2020,260769,2260,517,260252,Western Pacific
Finland,08-07-2020,56675,541,604,56071,Europe
France,08-07-2020,141209,1884,709,140500,Europe
France,08-07-2020,428722,635,750,427972,Europe
France,08-07-2020,267491,2364,115,267376,Europe
France,08-07-2020,340689,1821,825,339864,Europe
France,08-07-2020,139084,791,1228,137856,Europe
France,08-07-2020,54175,690,96,54079,Europe
France,08-07-2020,441798,2048,1126,440672,Europe
France,08-07-2020,68011,2349,1191,66820,Europe
France,08-07-2020,371394,2240,89,371305,Europe
France,08-07-2020,165259,966,905,164354,Europe
Gabon,08-07-2020,22537,2415,755,21782,Africa
Gambia,08-07-2020,281074,687,968,280106,Africa
Georgia,08-07-2020,239697,861,718,238979,Europe
Germany,08-07-2020,212403,244,118,212285,Europe
Ghana,08-07-2020,274492,2204,546,273946,Africa
Greece,08-07-2020,381703,2467,317,381386,Europe
Guatemala,08-07-2020,290488,1138,539,289949,Americas
Guinea,08-07-2020,83145,1268,193,82952,Africa
Guyana,08-07-2020,38863,1445,89,38774,Americas
Haiti,08-07-2020,370638,1645,427,370211,Americas
Holy See,08-07-2020,26508,83,75,26433,Europe
Honduras,08-07-2020,431472,1932,972,430500,Americas
Hungary,08-07-2020,149781,1984,426,149355,Europe
Iceland,08-07-2020,136373,949,943,135430,Europe
India,08-07-2020,115989,2223,290,115699,South-East Asia
Indonesia,08-07-2020,277479,608,655,276824,South-East Asia
Iran,08-07-2020,355162,398,890,354272,Eastern Mediterranean
Iraq,08-07-2020,204610,1275,79,204531,Eastern Mediterranean
Ireland,08-07-2020,206447,2372,486,205961,Europe
Israel,08-07-2020,340400,1645,893,339507,Europe
Italy,08-07-2020,261356,633,670,260686,Europe
Jamaica,08-07-2020,233856,184,349,233507,Americas
Japan,08-07-2020,46691,1831,199,46492,Western Pacific
Jordan,08-07-2020,309549,1347,1193,308356,Eastern Mediterranean
Kazakhstan,08-07-2020,142044,836,413,141631,Europe
Kenya,08-07-2020,253481,1029,318,253163,Africa
South Korea,08-07-2020,149740,296,1061,148679,Western Pacific
Kuwait,08-07-2020,380638,120,1082,379556,Eastern Mediterranean
Kyrgyzstan,08-07-2020,197872,1146,448,197424,Europe
Latvia,08-07-2020,318435,1963,70,318365,Europe
Lebanon,08-07-2020,125448,57,913,124535,Eastern Mediterranean
Liberia,08-07-2020,320757,1122,271,320486,Africa
Liechtenstein,08-07-2020,432158,2043,8,432150,Europe
Lithuania,08-07-2020,127297,472,134,127163,Europe
Luxembourg,08-07-2020,441116,217,988,440128,Europe
Madagascar,08-07-2020,233099,1366,193,232906,Africa
Malaysia,08-07-2020,330052,931,735,329317,Western Pacific
Maldives,08-07-2020,379414,272,728,378686,South-East Asia
Malta,08-07-2020,397866,604,82,397784,Europe
Mauritania,08-07-2020,273843,1641,794,273049,Africa
Mauritius,08-07-2020,325909,1586,752,325157,Africa
Mexico,08-07-2020,133744,588,908,132836,Americas
Moldova,08-07-2020,284681,45,841,283840,Europe
Monaco,08-07-2020,346938,1007,882,346056,Europe
Mongolia,08-07-2020,184745,784,847,183898,Western Pacific
Montenegro,08-07-2020,188844,1517,454,188390,Europe
Morocco,08-07-2020,394024,2203,723,393301,Eastern Mediterranean
Namibia,08-07-2020,6472,1599,463,6009,Africa
Nepal,08-07-2020,448244,2198,966,447278,South-East Asia
Netherlands,08-07-2020,299342,2298,492,298850,Europe
Netherlands,08-07-2020,219112,1026,1240,217872,Europe
Netherlands,08-07-2020,285755,419,186,285569,Europe
Netherlands,08-07-2020,322644,591,768,321876,Europe
New Zealand,08-07-2020,340472,103,347,340125,Western Pacific
Nicaragua,08-07-2020,412350,562,821,411529,Americas
Niger,08-07-2020,26727,2186,815,25912,Africa
Nigeria,08-07-2020,88100,630,1168,86932,Africa
North Macedonia,08-07-2020,373648,1734,289,373359,Europe
Norway,08-07-2020,379640,439,1031,378609,Europe
Oman,08-07-2020,107760,1955,576,107184,Eastern Mediterranean
Pakistan,08-07-2020,317858,505,368,317490,Eastern Mediterranean
Panama,08-07-2020,180543,1162,858,179685,Americas
Papua New Guinea,08-07-2020,384129,2171,526,383603,Western Pacific
Paraguay,08-07-2020,86104,1725,912,85192,Americas
Peru,08-07-2020,278427,684,806,277621,Americas
Philippines,08-07-2020,17649,410,80,17569,Western Pacific
Poland,08-07-2020,300832,2083,777,300055,Europe
Portugal,08-07-2020,240224,1933,843,239381,Europe
Qatar,08-07-2020,176907,1792,580,176327,Eastern Mediterranean
Romania,08-07-2020,152746,1677,403,152343,Europe
Russia,08-07-2020,416693,907,156,416537,Europe
Rwanda,08-07-2020,210121,1509,464,209657,Africa
Saint Lucia,08-07-2020,138291,325,1095,137196,Americas
Saint Vincent and the Grenadines,08-07-2020,321314,1448,430,320884,Americas
San Marino,08-07-2020,373385,934,714,372671,Europe
Saudi Arabia,08-07-2020,203410,1940,1127,202283,Eastern Mediterranean
Senegal,08-07-2020,322274,2311,753,321521,Africa
Serbia,08-07-2020,71954,788,658,71296,Europe
Seychelles,08-07-2020,76097,1174,81,76016,Africa
Singapore,08-07-2020,228674,104,1197,227477,Western Pacific
Slovakia,08-07-2020,60281,519,367,59914,Europe
Slovenia,08-07-2020,59433,1663,394,59039,Europe
Somalia,08-07-2020,40429,2054,437,39992,Eastern Mediterranean
South Africa,08-07-2020,253528,591,955,252573,Africa
Spain,08-07-2020,64364,197,1015,63349,Europe
Sri Lanka,08-07-2020,86099,1499,896,85203,South-East Asia
Sudan,08-07-2020,431387,290,471,430916,Eastern Mediterranean
Suriname,08-07-2020,11357,329,988,10369,Americas
Sweden,08-07-2020,269048,1338,359,268689,Europe
Switzerland,08-07-2020,201150,1379,358,200792,Europe
Taiwan*,08-07-2020,136673,1931,750,135923,Western Pacific
Tanzania,08-07-2020,178971,1904,829,178142,Africa
Thailand,08-07-2020,232711,767,653,232058,South-East Asia
Togo,08-07-2020,319662,507,934,318728,Africa
Trinidad and Tobago,08-07-2020,204319,1980,643,203676,Americas
Tunisia,08-07-2020,270200,777,1151,269049,Eastern Mediterranean
Turkey,08-07-2020,376646,2469,83,376563,Europe
Uganda,08-07-2020,362046,861,1129,360917,Africa
Ukraine,08-07-2020,75776,1698,411,75365,Europe
United Arab Emirates,08-07-2020,366477,1842,576,365901,Eastern Mediterranean
United Kingdom,08-07-2020,163984,1974,719,163265,Europe
United Kingdom,08-07-2020,289375,1189,1090,288285,Europe
United Kingdom,08-07-2020,124445,515,517,123928,Europe
United Kingdom,08-07-2020,72086,63,14,72072,Europe
United Kingdom,08-07-2020,429778,777,0,429778,Europe
United Kingdom,08-07-2020,307115,374,423,306692,Europe
United Kingdom,08-07-2020,260375,1018,1043,259332,Europe
Uruguay,08-07-2020,265030,2159,688,264342,Americas
US,08-07-2020,179027,301,1032,177995,Americas
Uzbekistan,08-07-2020,422734,2088,957,421777,Europe
Venezuela,08-07-2020,4202,2164,541,3661,Americas
Vietnam,08-07-2020,205033,342,331,204702,Western Pacific
Zambia,08-07-2020,214495,1115,629,213866,Africa
Zimbabwe,08-07-2020,161506,1936,1034,160472,Africa
Dominica,08-07-2020,238407,65,479,237928,Americas
Grenada,08-07-2020,56145,722,212,55933,Americas
Mozambique,08-07-2020,224937,1716,1011,223926,Africa
Syria,08-07-2020,282121,1758,992,281129,Eastern Mediterranean
Timor-Leste,08-07-2020,93003,2068,591,92412,South-East Asia
Belize,08-07-2020,251136,1568,647,250489,Americas
Laos,08-07-2020,48295,1223,928,47367,Western Pacific
Libya,08-07-2020,126868,199,70,126798,Eastern Mediterranean
West Bank and Gaza,08-07-2020,250262,686,14,250248,Eastern Mediterranean
Guinea-Bissau,08-07-2020,26284,1707,606,25678,Africa
Mali,08-07-2020,60364,2355,1073,59291,Africa
Saint Kitts and Nevis,08-07-2020,14586,1343,42,14544,Americas
Canada,08-07-2020,247953,2292,270,247683,Americas
Canada,08-07-2020,181571,841,298,181273,Americas
Kosovo,08-07-2020,24688,2126,265,24423,Europe
Burma,08-07-2020,250291,665,325,249966,South-East Asia
United Kingdom,08-07-2020,359611,553,380,359231,Europe
United Kingdom,08-07-2020,66790,906,999,65791,Europe
United Kingdom,08-07-2020,205619,1171,480,205139,Europe
Botswana,08-07-2020,275232,2223,788,274444,Africa
Burundi,08-07-2020,281007,1744,1143,279864,Africa
Sierra Leone,08-07-2020,379078,1714,550,378528,Africa
Malawi,08-07-2020,422390,2076,1069,421321,Africa
United Kingdom,08-07-2020,126975,1488,442,126533,Europe
France,08-07-2020,67755,1938,672,67083,Europe
South Sudan,08-07-2020,377618,333,831,376787,Africa
Western Sahara,08-07-2020,166677,516,901,165776,Africa
Sao Tome and Principe,08-07-2020,2778,457,241,2537,Africa
Yemen,08-07-2020,170708,1304,875,169833,Eastern Mediterranean
Comoros,08-07-2020,254914,825,1180,253734,Africa
Tajikistan,08-07-2020,23020,577,538,22482,Europe
Lesotho,08-07-2020,126042,253,980,125062,Africa
Afghanistan,09-07-2020,446150,1150,200,445950,Eastern Mediterranean
Albania,09-07-2020,395274,449,337,394937,Europe
Algeria,09-07-2020,447849,570,454,447395,Africa
Andorra,09-07-2020,237287,624,1105,236182,Europe
Angola,09-07-2020,164414,2219,145,164269,Africa
Antigua and Barbuda,09-07-2020,175631,617,222,175409,Americas
Argentina,09-07-2020,90393,2161,892,89501,Americas
Armenia,09-07-2020,229822,995,1087,228735,Europe
Australia,09-07-2020,339274,1728,407,338867,Western Pacific
Australia,09-07-2020,188161,551,1067,187094,Western Pacific
Australia,09-07-2020,94837,2284,554,94283,Western Pacific
Australia,09-07-2020,431141,1065,1186,429955,Western Pacific
Australia,09-07-2020,60358,490,82,60276,Western Pacific
Australia,09-07-2020,164762,1433,872,163890,Western Pacific
Australia,09-07-2020,10422,223,1004,9418,Western Pacific
Australia,09-07-2020,229671,1083,948,228723,Western Pacific
Austria,09-07-2020,129982,2467,478,129504,Europe
Azerbaijan,09-07-2020,294062,2294,828,293234,Europe
Bahamas,09-07-2020,290864,2115,103,290761,Americas
Bahrain,09-07-2020,20084,508,532,19552,Eastern Mediterranean
Bangladesh,09-07-2020,327124,879,78,327046,South-East Asia
Barbados,09-07-2020,162530,232,198,162332,Americas
Belarus,09-07-2020,79534,2356,712,78822,Europe
Belgium,09-07-2020,190271,2271,821,189450,Europe
Benin,09-07-2020,105824,1961,137,105687,Africa
Bhutan,09-07-2020,321652,2449,177,321475,South-East Asia
Bolivia,09-07-2020,363900,83,888,363012,Americas
Bosnia and Herzegovina,09-07-2020,394439,364,493,393946,Europe
Brazil,09-07-2020,91117,2226,166,90951,Americas
Brunei,09-07-2020,338196,1106,274,337922,Western Pacific
Bulgaria,09-07-2020,390098,1905,665,389433,Europe
Burkina Faso,09-07-2020,273190,2142,644,272546,Africa
Cabo Verde,09-07-2020,177727,2052,267,177460,Africa
Cambodia,09-07-2020,332777,221,760,332017,Western Pacific
Cameroon,09-07-2020,380289,642,1224,379065,Africa
Canada,09-07-2020,358952,260,476,358476,Americas
Canada,09-07-2020,411048,1733,378,410670,Americas
Canada,09-07-2020,11778,1798,1096,10682,Americas
Canada,09-07-2020,247014,1143,631,246383,Americas
Canada,09-07-2020,105571,466,784,104787,Americas
Canada,09-07-2020,62417,802,621,61796,Americas
Canada,09-07-2020,330908,1623,164,330744,Americas
Canada,09-07-2020,104981,1558,968,104013,Americas
Canada,09-07-2020,324123,700,939,323184,Americas
Canada,09-07-2020,375249,1975,1137,374112,Americas
Central African Republic,09-07-2020,188540,1383,341,188199,Africa
Chad,09-07-2020,34201,1529,838,33363,Africa
Chile,09-07-2020,102996,263,150,102846,Americas
China,09-07-2020,298404,77,621,297783,Western Pacific
China,09-07-2020,181273,2422,290,180983,Western Pacific
China,09-07-2020,390578,1831,1159,389419,Western Pacific
China,09-07-2020,201603,1761,955,200648,Western Pacific
China,09-07-2020,105912,1999,202,105710,Western Pacific
China,09-07-2020,284510,2410,1043,283467,Western Pacific
China,09-07-2020,217180,1475,419,216761,Western Pacific
China,09-07-2020,37824,1471,52,37772,Western Pacific
China,09-07-2020,99094,1344,475,98619,Western Pacific
China,09-07-2020,406608,2115,537,406071,Western Pacific
China,09-07-2020,342684,701,822,341862,Western Pacific
China,09-07-2020,354879,2271,415,354464,Western Pacific
China,09-07-2020,412049,1604,85,411964,Western Pacific
China,09-07-2020,113935,1672,1013,112922,Western Pacific
China,09-07-2020,240256,445,783,239473,Western Pacific
China,09-07-2020,123637,20,1183,122454,Western Pacific
China,09-07-2020,311290,1107,62,311228,Western Pacific
China,09-07-2020,218283,2110,1109,217174,Western Pacific
China,09-07-2020,277410,634,888,276522,Western Pacific
China,09-07-2020,17079,1754,690,16389,Western Pacific
China,09-07-2020,251913,319,449,251464,Western Pacific
China,09-07-2020,119213,824,327,118886,Western Pacific
China,09-07-2020,66147,1524,1089,65058,Western Pacific
China,09-07-2020,74030,2359,79,73951,Western Pacific
China,09-07-2020,52450,2112,21,52429,Western Pacific
China,09-07-2020,11489,1459,651,10838,Western Pacific
China,09-07-2020,329429,2222,663,328766,Western Pacific
China,09-07-2020,316814,823,856,315958,Western Pacific
China,09-07-2020,211910,1711,696,211214,Western Pacific
China,09-07-2020,95587,2497,936,94651,Western Pacific
China,09-07-2020,165780,1987,170,165610,Western Pacific
China,09-07-2020,274193,0,455,273738,Western Pacific
China,09-07-2020,181708,120,111,181597,Western Pacific
Colombia,09-07-2020,95830,1248,516,95314,Americas
Congo (Brazzaville),09-07-2020,156441,1846,787,155654,Africa
Congo (Kinshasa),09-07-2020,120973,2435,274,120699,Africa
Costa Rica,09-07-2020,39492,1652,536,38956,Americas
Cote d'Ivoire,09-07-2020,430082,437,674,429408,Africa
Croatia,09-07-2020,60448,298,613,59835,Europe
Cuba,09-07-2020,233022,2047,750,232272,Americas
Cyprus,09-07-2020,155416,439,836,154580,Europe
Czechia,09-07-2020,286268,1232,948,285320,Europe
Denmark,09-07-2020,165022,824,518,164504,Europe
Greenland,09-07-2020,230360,1334,576,229784,Europe
Denmark,09-07-2020,413601,461,204,413397,Europe
Djibouti,09-07-2020,71733,1448,257,71476,Eastern Mediterranean
Dominican Republic,09-07-2020,64992,1517,638,64354,Americas
Ecuador,09-07-2020,411950,1288,174,411776,Americas
Egypt,09-07-2020,359564,181,504,359060,Eastern Mediterranean
El Salvador,09-07-2020,376511,1083,657,375854,Americas
Equatorial Guinea,09-07-2020,152541,1796,461,152080,Africa
Eritrea,09-07-2020,106952,1446,805,106147,Africa
Estonia,09-07-2020,397211,1028,1238,395973,Europe
Eswatini,09-07-2020,86117,567,1240,84877,Africa
Ethiopia,09-07-2020,127596,239,1236,126360,Africa
Fiji,09-07-2020,235775,1955,813,234962,Western Pacific
Finland,09-07-2020,252749,1222,1150,251599,Europe
France,09-07-2020,210642,2047,827,209815,Europe
France,09-07-2020,130423,270,581,129842,Europe
France,09-07-2020,16667,616,468,16199,Europe
France,09-07-2020,289334,1917,522,288812,Europe
France,09-07-2020,272179,822,135,272044,Europe
France,09-07-2020,111952,2095,1047,110905,Europe
France,09-07-2020,153859,1645,920,152939,Europe
France,09-07-2020,368515,2266,779,367736,Europe
France,09-07-2020,268385,476,46,268339,Europe
France,09-07-2020,185864,2153,111,185753,Europe
Gabon,09-07-2020,326907,1285,62,326845,Africa
Gambia,09-07-2020,280974,1575,1071,279903,Africa
Georgia,09-07-2020,113645,508,1235,112410,Europe
Germany,09-07-2020,111250,414,782,110468,Europe
Ghana,09-07-2020,280141,814,17,280124,Africa
Greece,09-07-2020,398026,404,471,397555,Europe
Guatemala,09-07-2020,376207,480,260,375947,Americas
Guinea,09-07-2020,27779,1769,1105,26674,Africa
Guyana,09-07-2020,147052,2113,966,146086,Americas
Haiti,09-07-2020,55123,1678,1112,54011,Americas
Holy See,09-07-2020,265490,2313,526,264964,Europe
Honduras,09-07-2020,389184,768,601,388583,Americas
Hungary,09-07-2020,383570,1816,308,383262,Europe
Iceland,09-07-2020,300165,785,1042,299123,Europe
India,09-07-2020,213183,595,323,212860,South-East Asia
Indonesia,09-07-2020,189851,311,315,189536,South-East Asia
Iran,09-07-2020,194109,133,626,193483,Eastern Mediterranean
Iraq,09-07-2020,81970,1403,1016,80954,Eastern Mediterranean
Ireland,09-07-2020,352850,1258,586,352264,Europe
Israel,09-07-2020,180995,2164,1161,179834,Europe
Italy,09-07-2020,81598,2367,192,81406,Europe
Jamaica,09-07-2020,348822,2265,189,348633,Americas
Japan,09-07-2020,174505,176,920,173585,Western Pacific
Jordan,09-07-2020,374733,1939,746,373987,Eastern Mediterranean
Kazakhstan,09-07-2020,350914,2415,647,350267,Europe
Kenya,09-07-2020,93054,1040,475,92579,Africa
South Korea,09-07-2020,398877,1006,1219,397658,Western Pacific
Kuwait,09-07-2020,33160,1790,858,32302,Eastern Mediterranean
Kyrgyzstan,09-07-2020,53018,1632,188,52830,Europe
Latvia,09-07-2020,95941,676,903,95038,Europe
Lebanon,09-07-2020,219878,1004,377,219501,Eastern Mediterranean
Liberia,09-07-2020,59203,2051,369,58834,Africa
Liechtenstein,09-07-2020,349396,61,1048,348348,Europe
Lithuania,09-07-2020,71894,1219,10,71884,Europe
Luxembourg,09-07-2020,217870,1311,608,217262,Europe
Madagascar,09-07-2020,133188,786,721,132467,Africa
Malaysia,09-07-2020,159458,1591,503,158955,Western Pacific
Maldives,09-07-2020,77992,5,20,77972,South-East Asia
Malta,09-07-2020,296366,1398,997,295369,Europe
Mauritania,09-07-2020,354808,2010,326,354482,Africa
Mauritius,09-07-2020,334435,1825,866,333569,Africa
Mexico,09-07-2020,254252,273,376,253876,Americas
Moldova,09-07-2020,447545,544,95,447450,Europe
Monaco,09-07-2020,12721,2110,202,12519,Europe
Mongolia,09-07-2020,294944,2253,561,294383,Western Pacific
Montenegro,09-07-2020,33857,995,476,33381,Europe
Morocco,09-07-2020,57276,434,684,56592,Eastern Mediterranean
Namibia,09-07-2020,217070,1331,872,216198,Africa
Nepal,09-07-2020,71876,1832,27,71849,South-East Asia
Netherlands,09-07-2020,446074,2279,719,445355,Europe
Netherlands,09-07-2020,194317,311,474,193843,Europe
Netherlands,09-07-2020,270899,1983,611,270288,Europe
Netherlands,09-07-2020,397961,1900,155,397806,Europe
New Zealand,09-07-2020,360679,1057,932,359747,Western Pacific
Nicaragua,09-07-2020,26679,323,1135,25544,Americas
Niger,09-07-2020,377639,853,485,377154,Africa
Nigeria,09-07-2020,122960,1161,1012,121948,Africa
North Macedonia,09-07-2020,168273,1759,168,168105,Europe
Norway,09-07-2020,380975,531,18,380957,Europe
Oman,09-07-2020,80644,1145,594,80050,Eastern Mediterranean
Pakistan,09-07-2020,341458,1758,34,341424,Eastern Mediterranean
Panama,09-07-2020,117859,223,25,117834,Americas
Papua New Guinea,09-07-2020,313406,787,240,313166,Western Pacific
Paraguay,09-07-2020,6379,759,793,5586,Americas
Peru,09-07-2020,118388,241,785,117603,Americas
Philippines,09-07-2020,360160,550,370,359790,Western Pacific
Poland,09-07-2020,184107,1732,337,183770,Europe
Portugal,09-07-2020,389169,95,760,388409,Europe
Qatar,09-07-2020,159860,807,707,159153,Eastern Mediterranean
Romania,09-07-2020,145914,1425,1191,144723,Europe
Russia,09-07-2020,448118,2420,438,447680,Europe
Rwanda,09-07-2020,70567,284,1057,69510,Africa
Saint Lucia,09-07-2020,161710,1825,1094,160616,Americas
Saint Vincent and the Grenadines,09-07-2020,240846,1896,958,239888,Americas
San Marino,09-07-2020,65092,15,950,64142,Europe
Saudi Arabia,09-07-2020,29883,767,40,29843,Eastern Mediterranean
Senegal,09-07-2020,330296,957,467,329829,Africa
Serbia,09-07-2020,72394,84,463,71931,Europe
Seychelles,09-07-2020,299152,73,251,298901,Africa
Singapore,09-07-2020,396060,1477,433,395627,Western Pacific
Slovakia,09-07-2020,117364,2215,972,116392,Europe
Slovenia,09-07-2020,195162,1881,1079,194083,Europe
Somalia,09-07-2020,101815,830,221,101594,Eastern Mediterranean
South Africa,09-07-2020,383622,488,337,383285,Africa
Spain,09-07-2020,294236,2330,956,293280,Europe
Sri Lanka,09-07-2020,136069,290,529,135540,South-East Asia
Sudan,09-07-2020,288492,2148,167,288325,Eastern Mediterranean
Suriname,09-07-2020,421494,1182,928,420566,Americas
Sweden,09-07-2020,315410,2053,767,314643,Europe
Switzerland,09-07-2020,294735,1630,235,294500,Europe
Taiwan*,09-07-2020,15527,1351,629,14898,Western Pacific
Tanzania,09-07-2020,432692,2159,920,431772,Africa
Thailand,09-07-2020,373149,1617,827,372322,South-East Asia
Togo,09-07-2020,296128,1539,917,295211,Africa
Trinidad and Tobago,09-07-2020,356048,47,1002,355046,Americas
Tunisia,09-07-2020,231918,1757,592,231326,Eastern Mediterranean
Turkey,09-07-2020,330504,2007,1217,329287,Europe
Uganda,09-07-2020,406361,1655,750,405611,Africa
Ukraine,09-07-2020,108991,1687,1031,107960,Europe
United Arab Emirates,09-07-2020,163984,1320,439,163545,Eastern Mediterranean
United Kingdom,09-07-2020,265779,1671,311,265468,Europe
United Kingdom,09-07-2020,56441,1158,156,56285,Europe
United Kingdom,09-07-2020,394190,1771,718,393472,Europe
United Kingdom,09-07-2020,193121,737,600,192521,Europe
United Kingdom,09-07-2020,14501,1065,995,13506,Europe
United Kingdom,09-07-2020,99573,415,1229,98344,Europe
United Kingdom,09-07-2020,239565,1862,1167,238398,Europe
Uruguay,09-07-2020,41027,7,697,40330,Americas
US,09-07-2020,267407,1181,1223,266184,Americas
Uzbekistan,09-07-2020,77287,2421,754,76533,Europe
Venezuela,09-07-2020,361136,240,827,360309,Americas
Vietnam,09-07-2020,370974,1619,1250,369724,Western Pacific
Zambia,09-07-2020,269019,1891,418,268601,Africa
Zimbabwe,09-07-2020,183195,826,2,183193,Africa
Dominica,09-07-2020,77094,2292,486,76608,Americas
Grenada,09-07-2020,318113,2495,725,317388,Americas
Mozambique,09-07-2020,297160,589,115,297045,Africa
Syria,09-07-2020,187125,2373,1025,186100,Eastern Mediterranean
Timor-Leste,09-07-2020,144163,153,669,143494,South-East Asia
Belize,09-07-2020,82833,411,315,82518,Americas
Laos,09-07-2020,396431,955,1087,395344,Western Pacific
Libya,09-07-2020,179775,1850,579,179196,Eastern Mediterranean
West Bank and Gaza,09-07-2020,298965,19,763,298202,Eastern Mediterranean
Guinea-Bissau,09-07-2020,441843,208,249,441594,Africa
Mali,09-07-2020,331169,1577,220,330949,Africa
Saint Kitts and Nevis,09-07-2020,6288,299,232,6056,Americas
Canada,09-07-2020,316902,1956,1027,315875,Americas
Canada,09-07-2020,314753,1882,608,314145,Americas
Kosovo,09-07-2020,293968,451,1216,292752,Europe
Burma,09-07-2020,8688,1728,291,8397,South-East Asia
United Kingdom,09-07-2020,207263,199,176,207087,Europe
United Kingdom,09-07-2020,239197,1452,364,238833,Europe
United Kingdom,09-07-2020,440466,202,210,440256,Europe
Botswana,09-07-2020,438276,1649,381,437895,Africa
Burundi,09-07-2020,177828,2155,418,177410,Africa
Sierra Leone,09-07-2020,323931,368,1049,322882,Africa
Malawi,09-07-2020,272265,962,390,271875,Africa
United Kingdom,09-07-2020,126831,945,237,126594,Europe
France,09-07-2020,295884,1118,10,295874,Europe
South Sudan,09-07-2020,370541,410,327,370214,Africa
Western Sahara,09-07-2020,385754,2210,473,385281,Africa
Sao Tome and Principe,09-07-2020,41926,2256,1103,40823,Africa
Yemen,09-07-2020,418612,2295,48,418564,Eastern Mediterranean
Comoros,09-07-2020,96595,799,82,96513,Africa
Tajikistan,09-07-2020,75647,1088,360,75287,Europe
Lesotho,09-07-2020,207908,1369,148,207760,Africa
Afghanistan,10-07-2020,247410,386,767,246643,Eastern Mediterranean
Albania,10-07-2020,273734,1609,545,273189,Europe
Algeria,10-07-2020,448231,219,617,447614,Africa
Andorra,10-07-2020,213894,485,424,213470,Europe
Angola,10-07-2020,90046,1793,728,89318,Africa
Antigua and Barbuda,10-07-2020,182994,2303,1179,181815,Americas
Argentina,10-07-2020,82879,298,273,82606,Americas
Armenia,10-07-2020,27361,1844,999,26362,Europe
Australia,10-07-2020,159241,2458,950,158291,Western Pacific
Australia,10-07-2020,294854,30,321,294533,Western Pacific
Australia,10-07-2020,245568,170,876,244692,Western Pacific
Australia,10-07-2020,353211,1032,755,352456,Western Pacific
Australia,10-07-2020,221414,185,241,221173,Western Pacific
Australia,10-07-2020,268240,827,341,267899,Western Pacific
Australia,10-07-2020,112507,1118,133,112374,Western Pacific
Australia,10-07-2020,209187,2080,952,208235,Western Pacific
Austria,10-07-2020,24352,2165,700,23652,Europe
Azerbaijan,10-07-2020,291611,2289,435,291176,Europe
Bahamas,10-07-2020,38675,1983,782,37893,Americas
Bahrain,10-07-2020,178385,1834,1029,177356,Eastern Mediterranean
Bangladesh,10-07-2020,345895,2334,609,345286,South-East Asia
Barbados,10-07-2020,23721,1711,529,23192,Americas
Belarus,10-07-2020,264124,22,955,263169,Europe
Belgium,10-07-2020,373988,848,322,373666,Europe
Benin,10-07-2020,9765,1811,211,9554,Africa
Bhutan,10-07-2020,252725,2164,787,251938,South-East Asia
Bolivia,10-07-2020,359964,785,655,359309,Americas
Bosnia and Herzegovina,10-07-2020,28218,1504,526,27692,Europe
Brazil,10-07-2020,308136,1963,1210,306926,Americas
Brunei,10-07-2020,125380,1141,1222,124158,Western Pacific
Bulgaria,10-07-2020,418915,1193,642,418273,Europe
Burkina Faso,10-07-2020,218232,1467,452,217780,Africa
Cabo Verde,10-07-2020,229767,1191,203,229564,Africa
Cambodia,10-07-2020,143840,738,226,143614,Western Pacific
Cameroon,10-07-2020,9750,869,342,9408,Africa
Canada,10-07-2020,362565,745,464,362101,Americas
Canada,10-07-2020,223514,1906,972,222542,Americas
Canada,10-07-2020,126339,1295,533,125806,Americas
Canada,10-07-2020,280945,272,155,280790,Americas
Canada,10-07-2020,117265,1601,185,117080,Americas
Canada,10-07-2020,241113,1335,142,240971,Americas
Canada,10-07-2020,413111,1210,849,412262,Americas
Canada,10-07-2020,437243,282,1103,436140,Americas
Canada,10-07-2020,341283,586,615,340668,Americas
Canada,10-07-2020,388322,2465,665,387657,Americas
Central African Republic,10-07-2020,20598,2282,738,19860,Africa
Chad,10-07-2020,83794,418,1191,82603,Africa
Chile,10-07-2020,101703,1865,894,100809,Americas
China,10-07-2020,303526,2318,33,303493,Western Pacific
China,10-07-2020,86650,1225,555,86095,Western Pacific
China,10-07-2020,198969,2232,711,198258,Western Pacific
China,10-07-2020,250463,508,1082,249381,Western Pacific
China,10-07-2020,224103,1740,1245,222858,Western Pacific
China,10-07-2020,357459,1391,599,356860,Western Pacific
China,10-07-2020,74279,784,387,73892,Western Pacific
China,10-07-2020,396108,631,965,395143,Western Pacific
China,10-07-2020,360297,1215,369,359928,Western Pacific
China,10-07-2020,133741,669,562,133179,Western Pacific
China,10-07-2020,30908,1567,310,30598,Western Pacific
China,10-07-2020,278519,2488,529,277990,Western Pacific
China,10-07-2020,313712,1740,494,313218,Western Pacific
China,10-07-2020,378919,223,976,377943,Western Pacific
China,10-07-2020,342011,1895,297,341714,Western Pacific
China,10-07-2020,227163,2306,704,226459,Western Pacific
China,10-07-2020,293295,340,144,293151,Western Pacific
China,10-07-2020,96222,2055,251,95971,Western Pacific
China,10-07-2020,224930,1228,834,224096,Western Pacific
China,10-07-2020,226059,1106,595,225464,Western Pacific
China,10-07-2020,362743,559,218,362525,Western Pacific
China,10-07-2020,158664,1692,1205,157459,Western Pacific
China,10-07-2020,343208,2411,258,342950,Western Pacific
China,10-07-2020,115756,895,219,115537,Western Pacific
China,10-07-2020,335425,2074,286,335139,Western Pacific
China,10-07-2020,11228,978,1088,10140,Western Pacific
China,10-07-2020,192133,1892,1146,190987,Western Pacific
China,10-07-2020,149469,1366,618,148851,Western Pacific
China,10-07-2020,148648,417,449,148199,Western Pacific
China,10-07-2020,423798,1096,175,423623,Western Pacific
China,10-07-2020,186209,327,534,185675,Western Pacific
China,10-07-2020,270266,758,333,269933,Western Pacific
China,10-07-2020,101512,2053,212,101300,Western Pacific
Colombia,10-07-2020,263724,386,1147,262577,Americas
Congo (Brazzaville),10-07-2020,131233,200,262,130971,Africa
Congo (Kinshasa),10-07-2020,142733,1815,254,142479,Africa
Costa Rica,10-07-2020,286177,298,1005,285172,Americas
Cote d'Ivoire,10-07-2020,351478,431,1108,350370,Africa
Croatia,10-07-2020,398429,1649,682,397747,Europe
Cuba,10-07-2020,248816,447,898,247918,Americas
Cyprus,10-07-2020,5477,75,1210,4267,Europe
Czechia,10-07-2020,418868,1149,65,418803,Europe
Denmark,10-07-2020,294530,583,920,293610,Europe
Greenland,10-07-2020,226,606,451,-225,Europe
Denmark,10-07-2020,446488,1693,232,446256,Europe
Djibouti,10-07-2020,197627,668,766,196861,Eastern Mediterranean
Dominican Republic,10-07-2020,286723,1595,801,285922,Americas
Ecuador,10-07-2020,25512,1523,707,24805,Americas
Egypt,10-07-2020,463,2183,221,242,Eastern Mediterranean
El Salvador,10-07-2020,41150,675,1009,40141,Americas
Equatorial Guinea,10-07-2020,298755,1036,592,298163,Africa
Eritrea,10-07-2020,90141,984,373,89768,Africa
Estonia,10-07-2020,191698,2144,212,191486,Europe
Eswatini,10-07-2020,349219,1023,57,349162,Africa
Ethiopia,10-07-2020,47803,1770,1118,46685,Africa
Fiji,10-07-2020,246926,770,1057,245869,Western Pacific
Finland,10-07-2020,420941,2207,507,420434,Europe
France,10-07-2020,338403,1245,443,337960,Europe
France,10-07-2020,284952,1744,622,284330,Europe
France,10-07-2020,88765,1667,260,88505,Europe
France,10-07-2020,328249,2273,302,327947,Europe
France,10-07-2020,8847,7,481,8366,Europe
France,10-07-2020,396944,1521,114,396830,Europe
France,10-07-2020,416704,1194,180,416524,Europe
France,10-07-2020,388036,730,183,387853,Europe
France,10-07-2020,282160,8,797,281363,Europe
France,10-07-2020,115057,1676,1104,113953,Europe
Gabon,10-07-2020,373585,744,658,372927,Africa
Gambia,10-07-2020,20645,874,1128,19517,Africa
Georgia,10-07-2020,75476,219,73,75403,Europe
Germany,10-07-2020,188231,2179,1243,186988,Europe
Ghana,10-07-2020,21958,2308,1188,20770,Africa
Greece,10-07-2020,76300,1190,512,75788,Europe
Guatemala,10-07-2020,85720,1025,1165,84555,Americas
Guinea,10-07-2020,293179,2196,262,292917,Africa
Guyana,10-07-2020,65054,672,559,64495,Americas
Haiti,10-07-2020,399812,1659,318,399494,Americas
Holy See,10-07-2020,444499,2152,182,444317,Europe
Honduras,10-07-2020,121795,2050,892,120903,Americas
Hungary,10-07-2020,314877,1224,1232,313645,Europe
Iceland,10-07-2020,274320,1757,1190,273130,Europe
India,10-07-2020,352750,263,704,352046,South-East Asia
Indonesia,10-07-2020,384451,2305,673,383778,South-East Asia
Iran,10-07-2020,248842,2147,399,248443,Eastern Mediterranean
Iraq,10-07-2020,116715,1704,892,115823,Eastern Mediterranean
Ireland,10-07-2020,243885,157,483,243402,Europe
Israel,10-07-2020,218945,575,951,217994,Europe
Italy,10-07-2020,432826,2230,315,432511,Europe
Jamaica,10-07-2020,67115,801,1072,66043,Americas
Japan,10-07-2020,120731,1430,1184,119547,Western Pacific
Jordan,10-07-2020,268879,956,212,268667,Eastern Mediterranean
Kazakhstan,10-07-2020,364099,14,606,363493,Europe
Kenya,10-07-2020,440025,539,165,439860,Africa
South Korea,10-07-2020,7786,1662,70,7716,Western Pacific
Kuwait,10-07-2020,183068,1705,758,182310,Eastern Mediterranean
Kyrgyzstan,10-07-2020,217053,1196,257,216796,Europe
Latvia,10-07-2020,319115,471,542,318573,Europe
Lebanon,10-07-2020,156045,9,454,155591,Eastern Mediterranean
Liberia,10-07-2020,267967,266,462,267505,Africa
Liechtenstein,10-07-2020,237552,1864,60,237492,Europe
Lithuania,10-07-2020,30002,135,384,29618,Europe
Luxembourg,10-07-2020,344828,2473,779,344049,Europe
Madagascar,10-07-2020,85629,4,755,84874,Africa
Malaysia,10-07-2020,68551,221,9,68542,Western Pacific
Maldives,10-07-2020,392034,1991,170,391864,South-East Asia
Malta,10-07-2020,26914,1943,428,26486,Europe
Mauritania,10-07-2020,230995,498,692,230303,Africa
Mauritius,10-07-2020,424384,809,217,424167,Africa
Mexico,10-07-2020,346149,640,1247,344902,Americas
Moldova,10-07-2020,270082,12,472,269610,Europe
Monaco,10-07-2020,267759,1245,107,267652,Europe
Mongolia,10-07-2020,427905,886,106,427799,Western Pacific
Montenegro,10-07-2020,431673,807,331,431342,Europe
Morocco,10-07-2020,350421,424,953,349468,Eastern Mediterranean
Namibia,10-07-2020,341940,1999,802,341138,Africa
Nepal,10-07-2020,98068,1375,832,97236,South-East Asia
Netherlands,10-07-2020,146684,1411,111,146573,Europe
Netherlands,10-07-2020,147609,1773,968,146641,Europe
Netherlands,10-07-2020,379282,2157,209,379073,Europe
Netherlands,10-07-2020,38596,1666,506,38090,Europe
New Zealand,10-07-2020,1889,333,317,1572,Western Pacific
Nicaragua,10-07-2020,29080,65,216,28864,Americas
Niger,10-07-2020,34061,823,819,33242,Africa
Nigeria,10-07-2020,405222,1027,634,404588,Africa
North Macedonia,10-07-2020,171480,1662,1012,170468,Europe
Norway,10-07-2020,324113,1202,1172,322941,Europe
Oman,10-07-2020,391394,570,195,391199,Eastern Mediterranean
Pakistan,10-07-2020,449858,1241,317,449541,Eastern Mediterranean
Panama,10-07-2020,383181,1403,1145,382036,Americas
Papua New Guinea,10-07-2020,113850,1011,384,113466,Western Pacific
Paraguay,10-07-2020,99893,1108,526,99367,Americas
Peru,10-07-2020,109199,971,1013,108186,Americas
Philippines,10-07-2020,184324,1437,1006,183318,Western Pacific
Poland,10-07-2020,64733,2143,631,64102,Europe
Portugal,10-07-2020,289528,2236,909,288619,Europe
Qatar,10-07-2020,437400,1461,94,437306,Eastern Mediterranean
Romania,10-07-2020,371620,645,283,371337,Europe
Russia,10-07-2020,212558,1746,289,212269,Europe
Rwanda,10-07-2020,243519,1696,1080,242439,Africa
Saint Lucia,10-07-2020,373870,436,221,373649,Americas
Saint Vincent and the Grenadines,10-07-2020,21385,895,820,20565,Americas
San Marino,10-07-2020,405363,1570,1011,404352,Europe
Saudi Arabia,10-07-2020,130698,2342,809,129889,Eastern Mediterranean
Senegal,10-07-2020,73870,2320,222,73648,Africa
Serbia,10-07-2020,385362,1105,127,385235,Europe
Seychelles,10-07-2020,194082,1169,255,193827,Africa
Singapore,10-07-2020,413419,2272,836,412583,Western Pacific
Slovakia,10-07-2020,328569,1857,720,327849,Europe
Slovenia,10-07-2020,253953,1694,548,253405,Europe
Somalia,10-07-2020,247140,1539,1230,245910,Eastern Mediterranean
South Africa,10-07-2020,34853,1792,1075,33778,Africa
Spain,10-07-2020,168344,1320,49,168295,Europe
Sri Lanka,10-07-2020,74048,1492,471,73577,South-East Asia
Sudan,10-07-2020,66301,753,1112,65189,Eastern Mediterranean
Suriname,10-07-2020,210067,2013,784,209283,Americas
Sweden,10-07-2020,249963,711,732,249231,Europe
Switzerland,10-07-2020,103949,1076,547,103402,Europe
Taiwan*,10-07-2020,43818,60,1139,42679,Western Pacific
Tanzania,10-07-2020,90267,710,571,89696,Africa
Thailand,10-07-2020,21298,1939,1207,20091,South-East Asia
Togo,10-07-2020,338643,1282,1229,337414,Africa
Trinidad and Tobago,10-07-2020,229492,1535,960,228532,Americas
Tunisia,10-07-2020,107596,1360,282,107314,Eastern Mediterranean
Turkey,10-07-2020,230604,619,613,229991,Europe
Uganda,10-07-2020,223923,1695,86,223837,Africa
Ukraine,10-07-2020,4466,760,181,4285,Europe
United Arab Emirates,10-07-2020,133150,2165,685,132465,Eastern Mediterranean
United Kingdom,10-07-2020,215725,1571,816,214909,Europe
United Kingdom,10-07-2020,160537,1721,1172,159365,Europe
United Kingdom,10-07-2020,344563,330,619,343944,Europe
United Kingdom,10-07-2020,172328,1701,747,171581,Europe
United Kingdom,10-07-2020,109635,381,667,108968,Europe
United Kingdom,10-07-2020,250095,1810,1146,248949,Europe
United Kingdom,10-07-2020,227087,206,62,227025,Europe
Uruguay,10-07-2020,226332,1153,49,226283,Americas
US,10-07-2020,133781,2402,1045,132736,Americas
Uzbekistan,10-07-2020,159228,2008,397,158831,Europe
Venezuela,10-07-2020,35081,1921,1139,33942,Americas
Vietnam,10-07-2020,397086,2337,47,397039,Western Pacific
Zambia,10-07-2020,155853,814,351,155502,Africa
Zimbabwe,10-07-2020,7656,2276,1075,6581,Africa
Dominica,10-07-2020,362923,461,264,362659,Americas
Grenada,10-07-2020,270047,390,858,269189,Americas
Mozambique,10-07-2020,247727,697,62,247665,Africa
Syria,10-07-2020,39173,1594,314,38859,Eastern Mediterranean
Timor-Leste,10-07-2020,30087,979,112,29975,South-East Asia
Belize,10-07-2020,436201,795,1099,435102,Americas
Laos,10-07-2020,129028,1270,373,128655,Western Pacific
Libya,10-07-2020,166110,1346,6,166104,Eastern Mediterranean
West Bank and Gaza,10-07-2020,46588,1723,476,46112,Eastern Mediterranean
Guinea-Bissau,10-07-2020,221741,629,711,221030,Africa
Mali,10-07-2020,125433,224,839,124594,Africa
Saint Kitts and Nevis,10-07-2020,226047,352,401,225646,Americas
Canada,10-07-2020,16521,1039,41,16480,Americas
Canada,10-07-2020,198562,2394,777,197785,Americas
Kosovo,10-07-2020,294159,142,72,294087,Europe
Burma,10-07-2020,158085,492,1022,157063,South-East Asia
United Kingdom,10-07-2020,86667,2211,657,86010,Europe
United Kingdom,10-07-2020,67182,2404,23,67159,Europe
United Kingdom,10-07-2020,419967,139,412,419555,Europe
Botswana,10-07-2020,158873,1516,1164,157709,Africa
Burundi,10-07-2020,412732,2107,756,411976,Africa
Sierra Leone,10-07-2020,334286,802,913,333373,Africa
Malawi,10-07-2020,72102,295,1167,70935,Africa
United Kingdom,10-07-2020,366080,147,225,365855,Europe
France,10-07-2020,243035,1606,491,242544,Europe
South Sudan,10-07-2020,283567,1187,258,283309,Africa
Western Sahara,10-07-2020,99945,2194,994,98951,Africa
Sao Tome and Principe,10-07-2020,412545,552,972,411573,Africa
Yemen,10-07-2020,126903,134,954,125949,Eastern Mediterranean
Comoros,10-07-2020,220209,131,583,219626,Africa
Tajikistan,10-07-2020,41248,1092,1079,40169,Europe
Lesotho,10-07-2020,234418,636,677,233741,Africa
Afghanistan,11-07-2020,445651,1221,4,445647,Eastern Mediterranean
Albania,11-07-2020,266556,2414,1204,265352,Europe
Algeria,11-07-2020,225199,302,11,225188,Africa
Andorra,11-07-2020,204281,2470,469,203812,Europe
Angola,11-07-2020,17442,2381,410,17032,Africa
Antigua and Barbuda,11-07-2020,320716,60,1023,319693,Americas
Argentina,11-07-2020,85059,2017,194,84865,Americas
Armenia,11-07-2020,394276,2375,1161,393115,Europe
Australia,11-07-2020,47879,647,834,47045,Western Pacific
Australia,11-07-2020,389019,1108,451,388568,Western Pacific
Australia,11-07-2020,248788,385,786,248002,Western Pacific
Australia,11-07-2020,435768,2489,10,435758,Western Pacific
Australia,11-07-2020,224392,614,398,223994,Western Pacific
Australia,11-07-2020,145526,697,431,145095,Western Pacific
Australia,11-07-2020,265509,802,647,264862,Western Pacific
Australia,11-07-2020,23195,1941,1135,22060,Western Pacific
Austria,11-07-2020,154750,2468,913,153837,Europe
Azerbaijan,11-07-2020,349018,598,109,348909,Europe
Bahamas,11-07-2020,239439,550,615,238824,Americas
Bahrain,11-07-2020,266735,4,0,266735,Eastern Mediterranean
Bangladesh,11-07-2020,68728,292,78,68650,South-East Asia
Barbados,11-07-2020,447187,812,337,446850,Americas
Belarus,11-07-2020,281923,1967,320,281603,Europe
Belgium,11-07-2020,310245,614,931,309314,Europe
Benin,11-07-2020,443722,858,1110,442612,Africa
Bhutan,11-07-2020,291860,649,1147,290713,South-East Asia
Bolivia,11-07-2020,12879,1221,19,12860,Americas
Bosnia and Herzegovina,11-07-2020,186308,2470,1162,185146,Europe
Brazil,11-07-2020,32077,400,870,31207,Americas
Brunei,11-07-2020,232906,488,239,232667,Western Pacific
Bulgaria,11-07-2020,359884,1991,524,359360,Europe
Burkina Faso,11-07-2020,304126,34,867,303259,Africa
Cabo Verde,11-07-2020,266530,1902,178,266352,Africa
Cambodia,11-07-2020,433565,1540,227,433338,Western Pacific
Cameroon,11-07-2020,181721,421,352,181369,Africa
Canada,11-07-2020,52638,1155,321,52317,Americas
Canada,11-07-2020,168403,361,568,167835,Americas
Canada,11-07-2020,445304,961,398,444906,Americas
Canada,11-07-2020,235187,2496,696,234491,Americas
Canada,11-07-2020,153649,1748,181,153468,Americas
Canada,11-07-2020,377568,2126,1114,376454,Americas
Canada,11-07-2020,187338,2444,697,186641,Americas
Canada,11-07-2020,63141,1412,1249,61892,Americas
Canada,11-07-2020,355775,2242,416,355359,Americas
Canada,11-07-2020,12120,1925,461,11659,Americas
Central African Republic,11-07-2020,206222,2213,221,206001,Africa
Chad,11-07-2020,4020,1820,1001,3019,Africa
Chile,11-07-2020,136072,1779,300,135772,Americas
China,11-07-2020,76485,2230,578,75907,Western Pacific
China,11-07-2020,301658,877,950,300708,Western Pacific
China,11-07-2020,100463,1722,1062,99401,Western Pacific
China,11-07-2020,243632,1843,750,242882,Western Pacific
China,11-07-2020,82630,2288,1152,81478,Western Pacific
China,11-07-2020,144841,1152,923,143918,Western Pacific
China,11-07-2020,117686,891,148,117538,Western Pacific
China,11-07-2020,108063,911,1054,107009,Western Pacific
China,11-07-2020,315110,1002,613,314497,Western Pacific
China,11-07-2020,191404,1637,568,190836,Western Pacific
China,11-07-2020,49668,1184,67,49601,Western Pacific
China,11-07-2020,260181,1110,33,260148,Western Pacific
China,11-07-2020,12537,1171,853,11684,Western Pacific
China,11-07-2020,53007,514,1077,51930,Western Pacific
China,11-07-2020,2793,1926,668,2125,Western Pacific
China,11-07-2020,28600,2387,444,28156,Western Pacific
China,11-07-2020,74528,2342,168,74360,Western Pacific
China,11-07-2020,195484,272,925,194559,Western Pacific
China,11-07-2020,93040,2143,681,92359,Western Pacific
China,11-07-2020,337192,323,1086,336106,Western Pacific
China,11-07-2020,21981,629,484,21497,Western Pacific
China,11-07-2020,180973,1934,680,180293,Western Pacific
China,11-07-2020,49639,1044,570,49069,Western Pacific
China,11-07-2020,89433,2309,1062,88371,Western Pacific
China,11-07-2020,170526,2412,1114,169412,Western Pacific
China,11-07-2020,102167,2208,813,101354,Western Pacific
China,11-07-2020,72352,2273,951,71401,Western Pacific
China,11-07-2020,122190,374,904,121286,Western Pacific
China,11-07-2020,22365,398,1217,21148,Western Pacific
China,11-07-2020,191036,190,825,190211,Western Pacific
China,11-07-2020,304723,2264,127,304596,Western Pacific
China,11-07-2020,227982,234,719,227263,Western Pacific
China,11-07-2020,288104,801,1046,287058,Western Pacific
Colombia,11-07-2020,129611,1470,444,129167,Americas
Congo (Brazzaville),11-07-2020,296568,2311,1089,295479,Africa
Congo (Kinshasa),11-07-2020,350031,2458,544,349487,Africa
Costa Rica,11-07-2020,381794,940,415,381379,Americas
Cote d'Ivoire,11-07-2020,427985,1814,293,427692,Africa
Croatia,11-07-2020,254706,2218,305,254401,Europe
Cuba,11-07-2020,271689,1222,778,270911,Americas
Cyprus,11-07-2020,383119,1175,1239,381880,Europe
Czechia,11-07-2020,289608,1867,485,289123,Europe
Denmark,11-07-2020,218549,535,1153,217396,Europe
Greenland,11-07-2020,25650,1129,384,25266,Europe
Denmark,11-07-2020,231884,2055,1095,230789,Europe
Djibouti,11-07-2020,74936,1158,377,74559,Eastern Mediterranean
Dominican Republic,11-07-2020,374060,2393,219,373841,Americas
Ecuador,11-07-2020,378960,465,409,378551,Americas
Egypt,11-07-2020,399896,1168,900,398996,Eastern Mediterranean
El Salvador,11-07-2020,323978,1398,639,323339,Americas
Equatorial Guinea,11-07-2020,376058,708,660,375398,Africa
Eritrea,11-07-2020,107404,1204,1205,106199,Africa
Estonia,11-07-2020,439936,1123,924,439012,Europe
Eswatini,11-07-2020,343093,1315,1199,341894,Africa
Ethiopia,11-07-2020,446026,282,904,445122,Africa
Fiji,11-07-2020,364456,744,573,363883,Western Pacific
Finland,11-07-2020,118722,1588,732,117990,Europe
France,11-07-2020,11967,2103,1158,10809,Europe
France,11-07-2020,309855,1218,1214,308641,Europe
France,11-07-2020,239121,812,664,238457,Europe
France,11-07-2020,119420,148,709,118711,Europe
France,11-07-2020,409971,1178,428,409543,Europe
France,11-07-2020,279819,1779,838,278981,Europe
France,11-07-2020,130308,321,806,129502,Europe
France,11-07-2020,112649,1767,99,112550,Europe
France,11-07-2020,407178,1684,416,406762,Europe
France,11-07-2020,23950,528,144,23806,Europe
Gabon,11-07-2020,215195,186,498,214697,Africa
Gambia,11-07-2020,443504,1359,775,442729,Africa
Georgia,11-07-2020,57390,119,302,57088,Europe
Germany,11-07-2020,359345,961,837,358508,Europe
Ghana,11-07-2020,251937,1093,218,251719,Africa
Greece,11-07-2020,365337,128,62,365275,Europe
Guatemala,11-07-2020,16395,913,679,15716,Americas
Guinea,11-07-2020,113620,151,816,112804,Africa
Guyana,11-07-2020,138248,488,850,137398,Americas
Haiti,11-07-2020,20913,789,1150,19763,Americas
Holy See,11-07-2020,145064,1196,1156,143908,Europe
Honduras,11-07-2020,150853,118,601,150252,Americas
Hungary,11-07-2020,404666,549,681,403985,Europe
Iceland,11-07-2020,88737,93,464,88273,Europe
India,11-07-2020,87378,222,1211,86167,South-East Asia
Indonesia,11-07-2020,432860,1286,832,432028,South-East Asia
Iran,11-07-2020,404369,1622,329,404040,Eastern Mediterranean
Iraq,11-07-2020,181940,1417,1001,180939,Eastern Mediterranean
Ireland,11-07-2020,5321,298,423,4898,Europe
Israel,11-07-2020,32668,1245,817,31851,Europe
Italy,11-07-2020,361680,1970,833,360847,Europe
Jamaica,11-07-2020,145578,582,420,145158,Americas
Japan,11-07-2020,125141,1154,163,124978,Western Pacific
Jordan,11-07-2020,256641,200,386,256255,Eastern Mediterranean
Kazakhstan,11-07-2020,2233,502,786,1447,Europe
Kenya,11-07-2020,251269,378,84,251185,Africa
South Korea,11-07-2020,13608,2427,545,13063,Western Pacific
Kuwait,11-07-2020,309644,1941,95,309549,Eastern Mediterranean
Kyrgyzstan,11-07-2020,178710,421,1148,177562,Europe
Latvia,11-07-2020,285871,1287,367,285504,Europe
Lebanon,11-07-2020,40482,2383,489,39993,Eastern Mediterranean
Liberia,11-07-2020,132603,1488,361,132242,Africa
Liechtenstein,11-07-2020,153907,2047,1152,152755,Europe
Lithuania,11-07-2020,8312,1020,364,7948,Europe
Luxembourg,11-07-2020,255750,293,587,255163,Europe
Madagascar,11-07-2020,350621,2373,205,350416,Africa
Malaysia,11-07-2020,157282,1592,587,156695,Western Pacific
Maldives,11-07-2020,215352,803,600,214752,South-East Asia
Malta,11-07-2020,111044,1485,824,110220,Europe
Mauritania,11-07-2020,124653,174,671,123982,Africa
Mauritius,11-07-2020,236872,2369,800,236072,Africa
Mexico,11-07-2020,331126,421,1135,329991,Americas
Moldova,11-07-2020,167529,2202,492,167037,Europe
Monaco,11-07-2020,256173,988,562,255611,Europe
Mongolia,11-07-2020,230038,2230,593,229445,Western Pacific
Montenegro,11-07-2020,194590,610,490,194100,Europe
Morocco,11-07-2020,375368,734,446,374922,Eastern Mediterranean
Namibia,11-07-2020,7931,56,1064,6867,Africa
Nepal,11-07-2020,322324,2487,229,322095,South-East Asia
Netherlands,11-07-2020,224539,1259,649,223890,Europe
Netherlands,11-07-2020,402110,1177,326,401784,Europe
Netherlands,11-07-2020,67191,871,97,67094,Europe
Netherlands,11-07-2020,233830,444,997,232833,Europe
New Zealand,11-07-2020,174341,971,1146,173195,Western Pacific
Nicaragua,11-07-2020,29414,7,778,28636,Americas
Niger,11-07-2020,237041,1406,293,236748,Africa
Nigeria,11-07-2020,43761,1788,1091,42670,Africa
North Macedonia,11-07-2020,338706,1961,416,338290,Europe
Norway,11-07-2020,126261,436,1238,125023,Europe
Oman,11-07-2020,337534,683,931,336603,Eastern Mediterranean
Pakistan,11-07-2020,249786,1723,862,248924,Eastern Mediterranean
Panama,11-07-2020,418939,952,137,418802,Americas
Papua New Guinea,11-07-2020,241210,251,697,240513,Western Pacific
Paraguay,11-07-2020,225020,2051,1118,223902,Americas
Peru,11-07-2020,109874,2212,1,109873,Americas
Philippines,11-07-2020,48984,1246,1049,47935,Western Pacific
Poland,11-07-2020,16375,318,681,15694,Europe
Portugal,11-07-2020,209326,141,57,209269,Europe
Qatar,11-07-2020,191544,283,358,191186,Eastern Mediterranean
Romania,11-07-2020,151951,1516,1149,150802,Europe
Russia,11-07-2020,84029,2375,527,83502,Europe
Rwanda,11-07-2020,14252,1001,326,13926,Africa
Saint Lucia,11-07-2020,334585,773,314,334271,Americas
Saint Vincent and the Grenadines,11-07-2020,217544,1351,691,216853,Americas
San Marino,11-07-2020,14688,249,171,14517,Europe
Saudi Arabia,11-07-2020,21545,31,836,20709,Eastern Mediterranean
Senegal,11-07-2020,130799,1192,1051,129748,Africa
Serbia,11-07-2020,277517,1282,724,276793,Europe
Seychelles,11-07-2020,39031,1040,262,38769,Africa
Singapore,11-07-2020,252,2069,1049,-797,Western Pacific
Slovakia,11-07-2020,368337,450,321,368016,Europe
Slovenia,11-07-2020,334591,107,244,334347,Europe
Somalia,11-07-2020,237992,1793,867,237125,Eastern Mediterranean
South Africa,11-07-2020,239167,228,867,238300,Africa
Spain,11-07-2020,216713,662,276,216437,Europe
Sri Lanka,11-07-2020,311737,832,1135,310602,South-East Asia
Sudan,11-07-2020,211631,1429,21,211610,Eastern Mediterranean
Suriname,11-07-2020,16051,110,4,16047,Americas
Sweden,11-07-2020,180387,2125,1224,179163,Europe
Switzerland,11-07-2020,197890,1711,153,197737,Europe
Taiwan*,11-07-2020,247248,1428,408,246840,Western Pacific
Tanzania,11-07-2020,239552,2421,859,238693,Africa
Thailand,11-07-2020,8838,2428,984,7854,South-East Asia
Togo,11-07-2020,113536,1746,176,113360,Africa
Trinidad and Tobago,11-07-2020,165209,156,71,165138,Americas
Tunisia,11-07-2020,103729,1390,323,103406,Eastern Mediterranean
Turkey,11-07-2020,115072,955,428,114644,Europe
Uganda,11-07-2020,332621,1117,580,332041,Africa
Ukraine,11-07-2020,351252,771,356,350896,Europe
United Arab Emirates,11-07-2020,292994,947,96,292898,Eastern Mediterranean
United Kingdom,11-07-2020,114018,1398,570,113448,Europe
United Kingdom,11-07-2020,447839,1706,522,447317,Europe
United Kingdom,11-07-2020,299014,1071,1157,297857,Europe
United Kingdom,11-07-2020,180745,17,553,180192,Europe
United Kingdom,11-07-2020,337816,2094,215,337601,Europe
United Kingdom,11-07-2020,212860,1188,625,212235,Europe
United Kingdom,11-07-2020,341671,2377,736,340935,Europe
Uruguay,11-07-2020,198473,188,545,197928,Americas
US,11-07-2020,361774,1377,288,361486,Americas
Uzbekistan,11-07-2020,335458,439,312,335146,Europe
Venezuela,11-07-2020,83748,1356,1004,82744,Americas
Vietnam,11-07-2020,170253,1948,669,169584,Western Pacific
Zambia,11-07-2020,62041,317,502,61539,Africa
Zimbabwe,11-07-2020,294869,2348,112,294757,Africa
Dominica,11-07-2020,323410,1562,875,322535,Americas
Grenada,11-07-2020,443480,1233,676,442804,Americas
Mozambique,11-07-2020,148608,505,1016,147592,Africa
Syria,11-07-2020,311793,332,420,311373,Eastern Mediterranean
Timor-Leste,11-07-2020,238143,396,387,237756,South-East Asia
Belize,11-07-2020,246452,2139,528,245924,Americas
Laos,11-07-2020,384360,923,570,383790,Western Pacific
Libya,11-07-2020,405095,1919,27,405068,Eastern Mediterranean
West Bank and Gaza,11-07-2020,261240,314,948,260292,Eastern Mediterranean
Guinea-Bissau,11-07-2020,56671,2154,28,56643,Africa
Mali,11-07-2020,170395,1295,201,170194,Africa
Saint Kitts and Nevis,11-07-2020,372009,2413,863,371146,Americas
Canada,11-07-2020,393694,969,1190,392504,Americas
Canada,11-07-2020,171037,1812,818,170219,Americas
Kosovo,11-07-2020,115091,1043,1078,114013,Europe
Burma,11-07-2020,278271,444,199,278072,South-East Asia
United Kingdom,11-07-2020,292364,4,259,292105,Europe
United Kingdom,11-07-2020,247124,1222,566,246558,Europe
United Kingdom,11-07-2020,313711,55,1095,312616,Europe
Botswana,11-07-2020,79467,1698,696,78771,Africa
Burundi,11-07-2020,283235,1839,903,282332,Africa
Sierra Leone,11-07-2020,418683,2021,364,418319,Africa
Malawi,11-07-2020,10934,1120,896,10038,Africa
United Kingdom,11-07-2020,147388,177,589,146799,Europe
France,11-07-2020,285142,869,415,284727,Europe
South Sudan,11-07-2020,321528,551,1206,320322,Africa
Western Sahara,11-07-2020,362149,1857,719,361430,Africa
Sao Tome and Principe,11-07-2020,197245,2321,122,197123,Africa
Yemen,11-07-2020,413776,2412,335,413441,Eastern Mediterranean
Comoros,11-07-2020,17917,2082,916,17001,Africa
Tajikistan,11-07-2020,303461,74,453,303008,Europe
Lesotho,11-07-2020,109820,1235,458,109362,Africa
Afghanistan,12-07-2020,241054,2211,840,240214,Eastern Mediterranean
Albania,12-07-2020,296545,1738,1233,295312,Europe
Algeria,12-07-2020,407502,2435,641,406861,Africa
Andorra,12-07-2020,204131,1985,654,203477,Europe
Angola,12-07-2020,407235,1121,68,407167,Africa
Antigua and Barbuda,12-07-2020,354082,2189,222,353860,Americas
Argentina,12-07-2020,434862,2065,760,434102,Americas
Armenia,12-07-2020,403939,942,717,403222,Europe
Australia,12-07-2020,201082,1931,944,200138,Western Pacific
Australia,12-07-2020,313397,1350,1055,312342,Western Pacific
Australia,12-07-2020,33889,1837,1119,32770,Western Pacific
Australia,12-07-2020,413371,812,917,412454,Western Pacific
Australia,12-07-2020,80823,1036,352,80471,Western Pacific
Australia,12-07-2020,293457,299,926,292531,Western Pacific
Australia,12-07-2020,339076,750,475,338601,Western Pacific
Australia,12-07-2020,364124,646,763,363361,Western Pacific
Austria,12-07-2020,219988,2057,501,219487,Europe
Azerbaijan,12-07-2020,33204,2114,1221,31983,Europe
Bahamas,12-07-2020,68774,2403,285,68489,Americas
Bahrain,12-07-2020,76033,878,323,75710,Eastern Mediterranean
Bangladesh,12-07-2020,12702,544,689,12013,South-East Asia
Barbados,12-07-2020,281588,880,378,281210,Americas
Belarus,12-07-2020,143496,1640,586,142910,Europe
Belgium,12-07-2020,13212,1505,797,12415,Europe
Benin,12-07-2020,129701,2344,290,129411,Africa
Bhutan,12-07-2020,243483,2420,968,242515,South-East Asia
Bolivia,12-07-2020,329203,1608,874,328329,Americas
Bosnia and Herzegovina,12-07-2020,289311,1958,820,288491,Europe
Brazil,12-07-2020,131679,2238,705,130974,Americas
Brunei,12-07-2020,413838,882,779,413059,Western Pacific
Bulgaria,12-07-2020,29359,2091,563,28796,Europe
Burkina Faso,12-07-2020,282604,1690,951,281653,Africa
Cabo Verde,12-07-2020,295593,1369,365,295228,Africa
Cambodia,12-07-2020,446624,25,1104,445520,Western Pacific
Cameroon,12-07-2020,333869,1881,58,333811,Africa
Canada,12-07-2020,58467,896,512,57955,Americas
Canada,12-07-2020,357656,859,157,357499,Americas
Canada,12-07-2020,443932,1327,1191,442741,Americas
Canada,12-07-2020,351268,2374,924,350344,Americas
Canada,12-07-2020,388452,2383,288,388164,Americas
Canada,12-07-2020,343520,1379,400,343120,Americas
Canada,12-07-2020,351974,1617,937,351037,Americas
Canada,12-07-2020,445035,2323,124,444911,Americas
Canada,12-07-2020,155183,94,290,154893,Americas
Canada,12-07-2020,278028,2064,1022,277006,Americas
Central African Republic,12-07-2020,159660,655,1008,158652,Africa
Chad,12-07-2020,32251,1953,162,32089,Africa
Chile,12-07-2020,172269,1285,720,171549,Americas
China,12-07-2020,73210,1190,117,73093,Western Pacific
China,12-07-2020,449267,712,964,448303,Western Pacific
China,12-07-2020,175787,2065,746,175041,Western Pacific
China,12-07-2020,49393,105,396,48997,Western Pacific
China,12-07-2020,254739,1683,507,254232,Western Pacific
China,12-07-2020,258270,599,537,257733,Western Pacific
China,12-07-2020,438361,300,505,437856,Western Pacific
China,12-07-2020,384915,394,1127,383788,Western Pacific
China,12-07-2020,121673,451,672,121001,Western Pacific
China,12-07-2020,69383,1738,293,69090,Western Pacific
China,12-07-2020,103659,213,640,103019,Western Pacific
China,12-07-2020,207702,2244,364,207338,Western Pacific
China,12-07-2020,308650,904,498,308152,Western Pacific
China,12-07-2020,45333,930,249,45084,Western Pacific
China,12-07-2020,181154,20,124,181030,Western Pacific
China,12-07-2020,337230,2477,74,337156,Western Pacific
China,12-07-2020,51135,2084,1172,49963,Western Pacific
China,12-07-2020,177029,760,678,176351,Western Pacific
China,12-07-2020,380045,852,600,379445,Western Pacific
China,12-07-2020,325960,1806,487,325473,Western Pacific
China,12-07-2020,42855,408,654,42201,Western Pacific
China,12-07-2020,400840,59,148,400692,Western Pacific
China,12-07-2020,400174,2283,789,399385,Western Pacific
China,12-07-2020,438332,42,442,437890,Western Pacific
China,12-07-2020,123586,700,323,123263,Western Pacific
China,12-07-2020,45135,1345,1143,43992,Western Pacific
China,12-07-2020,322311,1775,333,321978,Western Pacific
China,12-07-2020,377291,591,1242,376049,Western Pacific
China,12-07-2020,222374,1380,305,222069,Western Pacific
China,12-07-2020,220875,2023,947,219928,Western Pacific
China,12-07-2020,125755,2015,104,125651,Western Pacific
China,12-07-2020,324993,1794,261,324732,Western Pacific
China,12-07-2020,286790,2107,202,286588,Western Pacific
Colombia,12-07-2020,72890,1825,852,72038,Americas
Congo (Brazzaville),12-07-2020,260260,2048,517,259743,Africa
Congo (Kinshasa),12-07-2020,331268,1879,699,330569,Africa
Costa Rica,12-07-2020,143757,1073,802,142955,Americas
Cote d'Ivoire,12-07-2020,59983,1556,545,59438,Africa
Croatia,12-07-2020,183403,254,908,182495,Europe
Cuba,12-07-2020,387271,562,807,386464,Americas
Cyprus,12-07-2020,16701,1070,569,16132,Europe
Czechia,12-07-2020,368071,68,615,367456,Europe
Denmark,12-07-2020,291540,930,639,290901,Europe
Greenland,12-07-2020,73861,272,339,73522,Europe
Denmark,12-07-2020,71287,869,123,71164,Europe
Djibouti,12-07-2020,102248,1135,552,101696,Eastern Mediterranean
Dominican Republic,12-07-2020,122292,1326,24,122268,Americas
Ecuador,12-07-2020,44714,48,26,44688,Americas
Egypt,12-07-2020,42524,1807,1123,41401,Eastern Mediterranean
El Salvador,12-07-2020,58400,2251,588,57812,Americas
Equatorial Guinea,12-07-2020,232967,2158,1001,231966,Africa
Eritrea,12-07-2020,414661,468,917,413744,Africa
Estonia,12-07-2020,317408,977,681,316727,Europe
Eswatini,12-07-2020,212649,2308,597,212052,Africa
Ethiopia,12-07-2020,381625,317,386,381239,Africa
Fiji,12-07-2020,21629,1395,767,20862,Western Pacific
Finland,12-07-2020,291702,536,364,291338,Europe
France,12-07-2020,21448,2492,796,20652,Europe
France,12-07-2020,91990,1229,995,90995,Europe
France,12-07-2020,439814,2489,860,438954,Europe
France,12-07-2020,34811,760,416,34395,Europe
France,12-07-2020,129886,1912,459,129427,Europe
France,12-07-2020,43312,1338,999,42313,Europe
France,12-07-2020,201121,338,376,200745,Europe
France,12-07-2020,166401,604,952,165449,Europe
France,12-07-2020,194498,2468,616,193882,Europe
France,12-07-2020,304463,803,743,303720,Europe
Gabon,12-07-2020,431616,2135,1100,430516,Africa
Gambia,12-07-2020,145446,820,988,144458,Africa
Georgia,12-07-2020,213122,1339,745,212377,Europe
Germany,12-07-2020,243175,1604,1044,242131,Europe
Ghana,12-07-2020,289061,1826,57,289004,Africa
Greece,12-07-2020,198621,2127,944,197677,Europe
Guatemala,12-07-2020,359432,782,127,359305,Americas
Guinea,12-07-2020,73453,88,205,73248,Africa
Guyana,12-07-2020,293506,2013,660,292846,Americas
Haiti,12-07-2020,185291,2281,1184,184107,Americas
Holy See,12-07-2020,140120,1425,83,140037,Europe
Honduras,12-07-2020,28551,1470,683,27868,Americas
Hungary,12-07-2020,406051,2095,369,405682,Europe
Iceland,12-07-2020,281613,1546,561,281052,Europe
India,12-07-2020,155393,1890,322,155071,South-East Asia
Indonesia,12-07-2020,422481,1662,689,421792,South-East Asia
Iran,12-07-2020,158965,1524,1188,157777,Eastern Mediterranean
Iraq,12-07-2020,403535,1119,347,403188,Eastern Mediterranean
Ireland,12-07-2020,272277,1299,453,271824,Europe
Israel,12-07-2020,314447,428,50,314397,Europe
Italy,12-07-2020,192638,1426,226,192412,Europe
Jamaica,12-07-2020,237797,1174,129,237668,Americas
Japan,12-07-2020,247064,1534,138,246926,Western Pacific
Jordan,12-07-2020,210761,1217,761,210000,Eastern Mediterranean
Kazakhstan,12-07-2020,90226,312,786,89440,Europe
Kenya,12-07-2020,301835,1598,783,301052,Africa
South Korea,12-07-2020,268069,740,262,267807,Western Pacific
Kuwait,12-07-2020,407069,1246,286,406783,Eastern Mediterranean
Kyrgyzstan,12-07-2020,29928,295,1201,28727,Europe
Latvia,12-07-2020,442292,2114,1148,441144,Europe
Lebanon,12-07-2020,91216,1964,349,90867,Eastern Mediterranean
Liberia,12-07-2020,358896,866,1232,357664,Africa
Liechtenstein,12-07-2020,369185,296,98,369087,Europe
Lithuania,12-07-2020,291466,748,856,290610,Europe
Luxembourg,12-07-2020,313991,1852,864,313127,Europe
Madagascar,12-07-2020,378057,1014,1004,377053,Africa
Malaysia,12-07-2020,393911,721,1126,392785,Western Pacific
Maldives,12-07-2020,416341,2285,1228,415113,South-East Asia
Malta,12-07-2020,116656,1033,717,115939,Europe
Mauritania,12-07-2020,352713,651,772,351941,Africa
Mauritius,12-07-2020,353119,499,184,352935,Africa
Mexico,12-07-2020,256230,460,167,256063,Americas
Moldova,12-07-2020,217844,724,491,217353,Europe
Monaco,12-07-2020,345832,976,270,345562,Europe
Mongolia,12-07-2020,115140,460,1235,113905,Western Pacific
Montenegro,12-07-2020,36130,977,1107,35023,Europe
Morocco,12-07-2020,196927,1775,523,196404,Eastern Mediterranean
Namibia,12-07-2020,445695,1598,622,445073,Africa
Nepal,12-07-2020,367666,2418,369,367297,South-East Asia
Netherlands,12-07-2020,79648,60,613,79035,Europe
Netherlands,12-07-2020,174485,2310,996,173489,Europe
Netherlands,12-07-2020,195277,274,188,195089,Europe
Netherlands,12-07-2020,42485,354,1245,41240,Europe
New Zealand,12-07-2020,316871,2123,954,315917,Western Pacific
Nicaragua,12-07-2020,348241,2398,1,348240,Americas
Niger,12-07-2020,225852,914,215,225637,Africa
Nigeria,12-07-2020,79267,1737,124,79143,Africa
North Macedonia,12-07-2020,268386,538,67,268319,Europe
Norway,12-07-2020,52850,563,703,52147,Europe
Oman,12-07-2020,431455,1928,1086,430369,Eastern Mediterranean
Pakistan,12-07-2020,381118,441,340,380778,Eastern Mediterranean
Panama,12-07-2020,298590,2017,819,297771,Americas
Papua New Guinea,12-07-2020,20383,886,421,19962,Western Pacific
Paraguay,12-07-2020,230520,1570,516,230004,Americas
Peru,12-07-2020,353037,2221,548,352489,Americas
Philippines,12-07-2020,109635,107,248,109387,Western Pacific
Poland,12-07-2020,374533,1127,1213,373320,Europe
Portugal,12-07-2020,403026,460,1214,401812,Europe
Qatar,12-07-2020,24514,2347,410,24104,Eastern Mediterranean
Romania,12-07-2020,174332,1464,431,173901,Europe
Russia,12-07-2020,426599,1199,328,426271,Europe
Rwanda,12-07-2020,207853,1466,502,207351,Africa
Saint Lucia,12-07-2020,201778,609,1212,200566,Americas
Saint Vincent and the Grenadines,12-07-2020,162087,1242,636,161451,Americas
San Marino,12-07-2020,329569,132,746,328823,Europe
Saudi Arabia,12-07-2020,419409,2146,1194,418215,Eastern Mediterranean
Senegal,12-07-2020,410794,121,746,410048,Africa
Serbia,12-07-2020,142459,1216,643,141816,Europe
Seychelles,12-07-2020,346370,634,1137,345233,Africa
Singapore,12-07-2020,405283,96,562,404721,Western Pacific
Slovakia,12-07-2020,429108,1843,106,429002,Europe
Slovenia,12-07-2020,369667,1206,1008,368659,Europe
Somalia,12-07-2020,67166,529,858,66308,Eastern Mediterranean
South Africa,12-07-2020,421811,1945,917,420894,Africa
Spain,12-07-2020,66105,1274,773,65332,Europe
Sri Lanka,12-07-2020,89534,560,387,89147,South-East Asia
Sudan,12-07-2020,20470,821,844,19626,Eastern Mediterranean
Suriname,12-07-2020,18120,1130,773,17347,Americas
Sweden,12-07-2020,310094,363,633,309461,Europe
Switzerland,12-07-2020,6875,2118,196,6679,Europe
Taiwan*,12-07-2020,126010,642,1015,124995,Western Pacific
Tanzania,12-07-2020,263138,236,998,262140,Africa
Thailand,12-07-2020,199819,1630,394,199425,South-East Asia
Togo,12-07-2020,44706,919,114,44592,Africa
Trinidad and Tobago,12-07-2020,145067,1826,745,144322,Americas
Tunisia,12-07-2020,7056,1876,650,6406,Eastern Mediterranean
Turkey,12-07-2020,118091,277,616,117475,Europe
Uganda,12-07-2020,230280,1875,766,229514,Africa
Ukraine,12-07-2020,183358,730,120,183238,Europe
United Arab Emirates,12-07-2020,200298,1799,213,200085,Eastern Mediterranean
United Kingdom,12-07-2020,447028,499,704,446324,Europe
United Kingdom,12-07-2020,35581,2049,728,34853,Europe
United Kingdom,12-07-2020,367674,1992,297,367377,Europe
United Kingdom,12-07-2020,413333,929,463,412870,Europe
United Kingdom,12-07-2020,274611,1610,388,274223,Europe
United Kingdom,12-07-2020,98777,909,165,98612,Europe
United Kingdom,12-07-2020,194547,1359,637,193910,Europe
Uruguay,12-07-2020,110125,2068,106,110019,Americas
US,12-07-2020,355036,2473,530,354506,Americas
Uzbekistan,12-07-2020,369385,1578,317,369068,Europe
Venezuela,12-07-2020,183574,803,1250,182324,Americas
Vietnam,12-07-2020,344769,1354,1230,343539,Western Pacific
Zambia,12-07-2020,323736,1318,735,323001,Africa
Zimbabwe,12-07-2020,271775,2105,919,270856,Africa
Dominica,12-07-2020,197573,221,761,196812,Americas
Grenada,12-07-2020,253011,1225,75,252936,Americas
Mozambique,12-07-2020,432867,2355,461,432406,Africa
Syria,12-07-2020,33881,1531,580,33301,Eastern Mediterranean
Timor-Leste,12-07-2020,103147,1372,176,102971,South-East Asia
Belize,12-07-2020,9615,1297,50,9565,Americas
Laos,12-07-2020,65544,1642,393,65151,Western Pacific
Libya,12-07-2020,108131,575,899,107232,Eastern Mediterranean
West Bank and Gaza,12-07-2020,212988,1747,1170,211818,Eastern Mediterranean
Guinea-Bissau,12-07-2020,85699,316,673,85026,Africa
Mali,12-07-2020,399790,674,592,399198,Africa
Saint Kitts and Nevis,12-07-2020,354303,1923,526,353777,Americas
Canada,12-07-2020,315096,383,71,315025,Americas
Canada,12-07-2020,388992,220,200,388792,Americas
Kosovo,12-07-2020,241551,685,999,240552,Europe
Burma,12-07-2020,95405,65,68,95337,South-East Asia
United Kingdom,12-07-2020,10706,1789,1047,9659,Europe
United Kingdom,12-07-2020,105682,1615,54,105628,Europe
United Kingdom,12-07-2020,232150,926,106,232044,Europe
Botswana,12-07-2020,64715,341,1241,63474,Africa
Burundi,12-07-2020,306,473,1248,-942,Africa
Sierra Leone,12-07-2020,382955,2284,1114,381841,Africa
Malawi,12-07-2020,73023,1510,1133,71890,Africa
United Kingdom,12-07-2020,89831,1782,1039,88792,Europe
France,12-07-2020,422141,622,646,421495,Europe
South Sudan,12-07-2020,331108,2185,490,330618,Africa
Western Sahara,12-07-2020,159123,1588,1200,157923,Africa
Sao Tome and Principe,12-07-2020,10693,1177,935,9758,Africa
Yemen,12-07-2020,348091,435,940,347151,Eastern Mediterranean
Comoros,12-07-2020,122510,51,1175,121335,Africa
Tajikistan,12-07-2020,170776,1470,938,169838,Europe
Lesotho,12-07-2020,97561,232,366,97195,Africa
Afghanistan,13-07-2020,12358,719,727,11631,Eastern Mediterranean
Albania,13-07-2020,336633,2431,997,335636,Europe
Algeria,13-07-2020,144403,545,336,144067,Africa
Andorra,13-07-2020,105064,1314,890,104174,Europe
Angola,13-07-2020,145796,1663,755,145041,Africa
Antigua and Barbuda,13-07-2020,159954,485,679,159275,Americas
Argentina,13-07-2020,196325,91,1211,195114,Americas
Armenia,13-07-2020,48541,762,387,48154,Europe
Australia,13-07-2020,285626,2244,144,285482,Western Pacific
Australia,13-07-2020,243005,938,167,242838,Western Pacific
Australia,13-07-2020,424734,1170,1081,423653,Western Pacific
Australia,13-07-2020,110950,222,336,110614,Western Pacific
Australia,13-07-2020,137124,484,498,136626,Western Pacific
Australia,13-07-2020,72104,1436,488,71616,Western Pacific
Australia,13-07-2020,129793,83,991,128802,Western Pacific
Australia,13-07-2020,42640,1841,658,41982,Western Pacific
Austria,13-07-2020,308848,750,1096,307752,Europe
Azerbaijan,13-07-2020,142946,1676,1129,141817,Europe
Bahamas,13-07-2020,261921,998,25,261896,Americas
Bahrain,13-07-2020,275607,2491,246,275361,Eastern Mediterranean
Bangladesh,13-07-2020,107546,117,1244,106302,South-East Asia
Barbados,13-07-2020,141584,1856,782,140802,Americas
Belarus,13-07-2020,33372,59,3,33369,Europe
Belgium,13-07-2020,263950,1024,473,263477,Europe
Benin,13-07-2020,353552,2022,739,352813,Africa
Bhutan,13-07-2020,370014,1292,1038,368976,South-East Asia
Bolivia,13-07-2020,24748,1148,2,24746,Americas
Bosnia and Herzegovina,13-07-2020,255258,1065,230,255028,Europe
Brazil,13-07-2020,15035,674,537,14498,Americas
Brunei,13-07-2020,440434,1454,60,440374,Western Pacific
Bulgaria,13-07-2020,215406,1177,992,214414,Europe
Burkina Faso,13-07-2020,75556,1609,832,74724,Africa
Cabo Verde,13-07-2020,172575,1297,1000,171575,Africa
Cambodia,13-07-2020,217618,2276,724,216894,Western Pacific
Cameroon,13-07-2020,368063,482,50,368013,Africa
Canada,13-07-2020,205497,456,646,204851,Americas
Canada,13-07-2020,182591,1037,1038,181553,Americas
Canada,13-07-2020,253027,1994,252,252775,Americas
Canada,13-07-2020,48982,2434,1143,47839,Americas
Canada,13-07-2020,230371,2280,508,229863,Americas
Canada,13-07-2020,100281,1089,253,100028,Americas
Canada,13-07-2020,246366,187,723,245643,Americas
Canada,13-07-2020,32246,807,504,31742,Americas
Canada,13-07-2020,45244,40,1225,44019,Americas
Canada,13-07-2020,340395,2095,1213,339182,Americas
Central African Republic,13-07-2020,52340,1997,735,51605,Africa
Chad,13-07-2020,6880,1139,277,6603,Africa
Chile,13-07-2020,58256,1278,350,57906,Americas
China,13-07-2020,403348,1135,409,402939,Western Pacific
China,13-07-2020,148270,1155,237,148033,Western Pacific
China,13-07-2020,339040,711,530,338510,Western Pacific
China,13-07-2020,235246,2113,758,234488,Western Pacific
China,13-07-2020,363644,1955,528,363116,Western Pacific
China,13-07-2020,438402,2088,431,437971,Western Pacific
China,13-07-2020,382515,1124,30,382485,Western Pacific
China,13-07-2020,139045,2138,1241,137804,Western Pacific
China,13-07-2020,286425,1202,1083,285342,Western Pacific
China,13-07-2020,82295,1015,980,81315,Western Pacific
China,13-07-2020,128474,1277,179,128295,Western Pacific
China,13-07-2020,223026,1460,782,222244,Western Pacific
China,13-07-2020,223492,1775,552,222940,Western Pacific
China,13-07-2020,2673,2233,691,1982,Western Pacific
China,13-07-2020,289764,2476,1234,288530,Western Pacific
China,13-07-2020,127921,223,814,127107,Western Pacific
China,13-07-2020,161420,1633,436,160984,Western Pacific
China,13-07-2020,204967,1908,60,204907,Western Pacific
China,13-07-2020,22527,2262,1148,21379,Western Pacific
China,13-07-2020,393836,373,1125,392711,Western Pacific
China,13-07-2020,332412,1689,240,332172,Western Pacific
China,13-07-2020,117091,855,157,116934,Western Pacific
China,13-07-2020,90165,2349,163,90002,Western Pacific
China,13-07-2020,89143,113,1110,88033,Western Pacific
China,13-07-2020,105231,2069,312,104919,Western Pacific
China,13-07-2020,74502,1016,633,73869,Western Pacific
China,13-07-2020,175743,1744,384,175359,Western Pacific
China,13-07-2020,7618,597,335,7283,Western Pacific
China,13-07-2020,31777,1670,1138,30639,Western Pacific
China,13-07-2020,379239,650,350,378889,Western Pacific
China,13-07-2020,363335,288,1194,362141,Western Pacific
China,13-07-2020,28174,1934,864,27310,Western Pacific
China,13-07-2020,138792,99,75,138717,Western Pacific
Colombia,13-07-2020,41644,1174,673,40971,Americas
Congo (Brazzaville),13-07-2020,195069,725,428,194641,Africa
Congo (Kinshasa),13-07-2020,143927,587,975,142952,Africa
Costa Rica,13-07-2020,265477,1666,1247,264230,Americas
Cote d'Ivoire,13-07-2020,263614,857,323,263291,Africa
Croatia,13-07-2020,116921,2140,493,116428,Europe
Cuba,13-07-2020,274540,61,12,274528,Americas
Cyprus,13-07-2020,60226,1514,194,60032,Europe
Czechia,13-07-2020,242557,238,1229,241328,Europe
Denmark,13-07-2020,430002,1732,216,429786,Europe
Greenland,13-07-2020,139616,1366,686,138930,Europe
Denmark,13-07-2020,270622,615,1089,269533,Europe
Djibouti,13-07-2020,164387,301,800,163587,Eastern Mediterranean
Dominican Republic,13-07-2020,392499,53,598,391901,Americas
Ecuador,13-07-2020,270410,559,951,269459,Americas
Egypt,13-07-2020,187840,2029,890,186950,Eastern Mediterranean
El Salvador,13-07-2020,339652,850,462,339190,Americas
Equatorial Guinea,13-07-2020,4739,191,540,4199,Africa
Eritrea,13-07-2020,265447,1433,1174,264273,Africa
Estonia,13-07-2020,384120,477,683,383437,Europe
Eswatini,13-07-2020,89810,1430,962,88848,Africa
Ethiopia,13-07-2020,398674,1911,196,398478,Africa
Fiji,13-07-2020,423024,833,538,422486,Western Pacific
Finland,13-07-2020,12348,1055,752,11596,Europe
France,13-07-2020,244804,128,595,244209,Europe
France,13-07-2020,181024,2172,759,180265,Europe
France,13-07-2020,191845,547,1092,190753,Europe
France,13-07-2020,330040,2372,795,329245,Europe
France,13-07-2020,284337,2440,635,283702,Europe
France,13-07-2020,2867,1786,1038,1829,Europe
France,13-07-2020,174492,1122,123,174369,Europe
France,13-07-2020,329724,299,197,329527,Europe
France,13-07-2020,155350,1947,1090,154260,Europe
France,13-07-2020,95254,411,1239,94015,Europe
Gabon,13-07-2020,442769,1511,830,441939,Africa
Gambia,13-07-2020,400955,1717,5,400950,Africa
Georgia,13-07-2020,232159,89,626,231533,Europe
Germany,13-07-2020,34127,993,503,33624,Europe
Ghana,13-07-2020,146920,682,967,145953,Africa
Greece,13-07-2020,444923,158,524,444399,Europe
Guatemala,13-07-2020,180208,259,856,179352,Americas
Guinea,13-07-2020,101079,1953,382,100697,Africa
Guyana,13-07-2020,131018,2178,833,130185,Americas
Haiti,13-07-2020,292583,1346,301,292282,Americas
Holy See,13-07-2020,283561,1671,797,282764,Europe
Honduras,13-07-2020,28783,436,1064,27719,Americas
Hungary,13-07-2020,295155,1524,319,294836,Europe
Iceland,13-07-2020,2878,2427,613,2265,Europe
India,13-07-2020,41874,153,1220,40654,South-East Asia
Indonesia,13-07-2020,183857,1396,329,183528,South-East Asia
Iran,13-07-2020,234193,1208,53,234140,Eastern Mediterranean
Iraq,13-07-2020,439050,1178,561,438489,Eastern Mediterranean
Ireland,13-07-2020,225383,1715,565,224818,Europe
Israel,13-07-2020,401849,1491,1018,400831,Europe
Italy,13-07-2020,258281,1636,1232,257049,Europe
Jamaica,13-07-2020,278248,2031,454,277794,Americas
Japan,13-07-2020,99969,761,568,99401,Western Pacific
Jordan,13-07-2020,84126,1800,788,83338,Eastern Mediterranean
Kazakhstan,13-07-2020,389381,1505,459,388922,Europe
Kenya,13-07-2020,77752,656,698,77054,Africa
South Korea,13-07-2020,366502,1746,508,365994,Western Pacific
Kuwait,13-07-2020,231742,230,984,230758,Eastern Mediterranean
Kyrgyzstan,13-07-2020,150464,1113,131,150333,Europe
Latvia,13-07-2020,399391,1382,847,398544,Europe
Lebanon,13-07-2020,407775,2467,836,406939,Eastern Mediterranean
Liberia,13-07-2020,448684,124,133,448551,Africa
Liechtenstein,13-07-2020,24846,732,448,24398,Europe
Lithuania,13-07-2020,408721,1636,987,407734,Europe
Luxembourg,13-07-2020,113422,450,373,113049,Europe
Madagascar,13-07-2020,354728,660,800,353928,Africa
Malaysia,13-07-2020,134300,2301,1097,133203,Western Pacific
Maldives,13-07-2020,37356,1785,1149,36207,South-East Asia
Malta,13-07-2020,23462,856,960,22502,Europe
Mauritania,13-07-2020,189780,733,804,188976,Africa
Mauritius,13-07-2020,385333,1995,887,384446,Africa
Mexico,13-07-2020,221247,62,125,221122,Americas
Moldova,13-07-2020,278478,1893,455,278023,Europe
Monaco,13-07-2020,385120,2481,1186,383934,Europe
Mongolia,13-07-2020,87073,854,531,86542,Western Pacific
Montenegro,13-07-2020,391267,2404,310,390957,Europe
Morocco,13-07-2020,190624,894,697,189927,Eastern Mediterranean
Namibia,13-07-2020,246755,1916,706,246049,Africa
Nepal,13-07-2020,34720,210,475,34245,South-East Asia
Netherlands,13-07-2020,407053,719,1097,405956,Europe
Netherlands,13-07-2020,61276,1339,112,61164,Europe
Netherlands,13-07-2020,16468,111,18,16450,Europe
Netherlands,13-07-2020,449656,1523,544,449112,Europe
New Zealand,13-07-2020,65850,2472,1216,64634,Western Pacific
Nicaragua,13-07-2020,287893,2465,1010,286883,Americas
Niger,13-07-2020,410844,489,969,409875,Africa
Nigeria,13-07-2020,266214,61,203,266011,Africa
North Macedonia,13-07-2020,178335,2165,882,177453,Europe
Norway,13-07-2020,405890,297,726,405164,Europe
Oman,13-07-2020,8663,1778,481,8182,Eastern Mediterranean
Pakistan,13-07-2020,426221,273,955,425266,Eastern Mediterranean
Panama,13-07-2020,348006,1315,921,347085,Americas
Papua New Guinea,13-07-2020,371962,2401,288,371674,Western Pacific
Paraguay,13-07-2020,385993,1650,792,385201,Americas
Peru,13-07-2020,355358,523,11,355347,Americas
Philippines,13-07-2020,232456,1720,981,231475,Western Pacific
Poland,13-07-2020,151906,968,988,150918,Europe
Portugal,13-07-2020,418244,695,287,417957,Europe
Qatar,13-07-2020,321915,1469,464,321451,Eastern Mediterranean
Romania,13-07-2020,108418,1656,6,108412,Europe
Russia,13-07-2020,107108,2284,64,107044,Europe
Rwanda,13-07-2020,284122,397,586,283536,Africa
Saint Lucia,13-07-2020,392913,1321,997,391916,Americas
Saint Vincent and the Grenadines,13-07-2020,254981,1601,276,254705,Americas
San Marino,13-07-2020,284613,2459,1010,283603,Europe
Saudi Arabia,13-07-2020,227959,1667,317,227642,Eastern Mediterranean
Senegal,13-07-2020,427784,1483,749,427035,Africa
Serbia,13-07-2020,46072,757,583,45489,Europe
Seychelles,13-07-2020,138455,957,49,138406,Africa
Singapore,13-07-2020,182077,1979,836,181241,Western Pacific
Slovakia,13-07-2020,93585,2006,154,93431,Europe
Slovenia,13-07-2020,209625,2454,260,209365,Europe
Somalia,13-07-2020,343852,1881,161,343691,Eastern Mediterranean
South Africa,13-07-2020,174147,212,1081,173066,Africa
Spain,13-07-2020,425505,539,1005,424500,Europe
Sri Lanka,13-07-2020,84300,1396,298,84002,South-East Asia
Sudan,13-07-2020,310243,2231,329,309914,Eastern Mediterranean
Suriname,13-07-2020,87651,442,1194,86457,Americas
Sweden,13-07-2020,219202,1691,387,218815,Europe
Switzerland,13-07-2020,429936,1813,1079,428857,Europe
Taiwan*,13-07-2020,158684,1083,134,158550,Western Pacific
Tanzania,13-07-2020,88211,1847,166,88045,Africa
Thailand,13-07-2020,163658,897,457,163201,South-East Asia
Togo,13-07-2020,409900,2012,255,409645,Africa
Trinidad and Tobago,13-07-2020,125846,2449,161,125685,Americas
Tunisia,13-07-2020,443543,656,81,443462,Eastern Mediterranean
Turkey,13-07-2020,203225,1085,509,202716,Europe
Uganda,13-07-2020,177064,2206,877,176187,Africa
Ukraine,13-07-2020,167147,2080,188,166959,Europe
United Arab Emirates,13-07-2020,169810,1233,762,169048,Eastern Mediterranean
United Kingdom,13-07-2020,425733,634,314,425419,Europe
United Kingdom,13-07-2020,240250,1099,710,239540,Europe
United Kingdom,13-07-2020,323335,1130,340,322995,Europe
United Kingdom,13-07-2020,390270,1287,925,389345,Europe
United Kingdom,13-07-2020,128278,198,886,127392,Europe
United Kingdom,13-07-2020,343433,798,88,343345,Europe
United Kingdom,13-07-2020,208938,1144,336,208602,Europe
Uruguay,13-07-2020,205425,469,362,205063,Americas
US,13-07-2020,128026,2074,1070,126956,Americas
Uzbekistan,13-07-2020,222167,490,32,222135,Europe
Venezuela,13-07-2020,81503,1099,1183,80320,Americas
Vietnam,13-07-2020,385177,2367,806,384371,Western Pacific
Zambia,13-07-2020,378130,61,572,377558,Africa
Zimbabwe,13-07-2020,142716,2187,440,142276,Africa
Dominica,13-07-2020,297397,725,622,296775,Americas
Grenada,13-07-2020,390277,254,608,389669,Americas
Mozambique,13-07-2020,37048,1302,567,36481,Africa
Syria,13-07-2020,73579,223,832,72747,Eastern Mediterranean
Timor-Leste,13-07-2020,34478,2087,1101,33377,South-East Asia
Belize,13-07-2020,354093,568,1020,353073,Americas
Laos,13-07-2020,275582,672,443,275139,Western Pacific
Libya,13-07-2020,311373,131,755,310618,Eastern Mediterranean
West Bank and Gaza,13-07-2020,223877,2019,23,223854,Eastern Mediterranean
Guinea-Bissau,13-07-2020,378117,2216,738,377379,Africa
Mali,13-07-2020,22738,881,885,21853,Africa
Saint Kitts and Nevis,13-07-2020,312240,2143,858,311382,Americas
Canada,13-07-2020,270386,1078,181,270205,Americas
Canada,13-07-2020,44413,449,613,43800,Americas
Kosovo,13-07-2020,298655,857,831,297824,Europe
Burma,13-07-2020,158515,2012,728,157787,South-East Asia
United Kingdom,13-07-2020,156216,2269,2,156214,Europe
United Kingdom,13-07-2020,304736,2278,578,304158,Europe
United Kingdom,13-07-2020,385022,805,717,384305,Europe
Botswana,13-07-2020,32790,2384,204,32586,Africa
Burundi,13-07-2020,7368,1478,743,6625,Africa
Sierra Leone,13-07-2020,137340,324,880,136460,Africa
Malawi,13-07-2020,226681,843,313,226368,Africa
United Kingdom,13-07-2020,150058,984,40,150018,Europe
France,13-07-2020,397463,76,188,397275,Europe
South Sudan,13-07-2020,303351,1430,858,302493,Africa
Western Sahara,13-07-2020,147371,659,678,146693,Africa
Sao Tome and Principe,13-07-2020,264119,1340,852,263267,Africa
Yemen,13-07-2020,322707,269,0,322707,Eastern Mediterranean
Comoros,13-07-2020,185436,628,293,185143,Africa
Tajikistan,13-07-2020,220783,2046,339,220444,Europe
Lesotho,13-07-2020,321738,1059,1086,320652,Africa
Afghanistan,14-07-2020,256193,520,1073,255120,Eastern Mediterranean
Albania,14-07-2020,320893,339,193,320700,Europe
Algeria,14-07-2020,106267,286,244,106023,Africa
Andorra,14-07-2020,164686,1767,834,163852,Europe
Angola,14-07-2020,229798,919,408,229390,Africa
Antigua and Barbuda,14-07-2020,100261,1986,187,100074,Americas
Argentina,14-07-2020,351475,324,960,350515,Americas
Armenia,14-07-2020,410740,1449,83,410657,Europe
Australia,14-07-2020,87162,386,987,86175,Western Pacific
Australia,14-07-2020,391196,1057,878,390318,Western Pacific
Australia,14-07-2020,181980,2398,885,181095,Western Pacific
Australia,14-07-2020,370337,1703,48,370289,Western Pacific
Australia,14-07-2020,27701,552,214,27487,Western Pacific
Australia,14-07-2020,340043,2399,134,339909,Western Pacific
Australia,14-07-2020,98091,2487,626,97465,Western Pacific
Australia,14-07-2020,78406,1310,378,78028,Western Pacific
Austria,14-07-2020,363654,1596,234,363420,Europe
Azerbaijan,14-07-2020,284660,482,576,284084,Europe
Bahamas,14-07-2020,172105,2305,302,171803,Americas
Bahrain,14-07-2020,74739,787,1232,73507,Eastern Mediterranean
Bangladesh,14-07-2020,233905,2302,169,233736,South-East Asia
Barbados,14-07-2020,297978,1080,632,297346,Americas
Belarus,14-07-2020,207574,2366,260,207314,Europe
Belgium,14-07-2020,326785,695,384,326401,Europe
Benin,14-07-2020,184590,160,1138,183452,Africa
Bhutan,14-07-2020,313680,2321,662,313018,South-East Asia
Bolivia,14-07-2020,440426,1622,707,439719,Americas
Bosnia and Herzegovina,14-07-2020,171016,1155,1173,169843,Europe
Brazil,14-07-2020,135762,1423,1121,134641,Americas
Brunei,14-07-2020,170249,2144,787,169462,Western Pacific
Bulgaria,14-07-2020,232293,1699,928,231365,Europe
Burkina Faso,14-07-2020,110267,2005,1214,109053,Africa
Cabo Verde,14-07-2020,210528,664,835,209693,Africa
Cambodia,14-07-2020,319374,607,758,318616,Western Pacific
Cameroon,14-07-2020,162965,1749,129,162836,Africa
Canada,14-07-2020,310638,1319,1132,309506,Americas
Canada,14-07-2020,167949,1508,637,167312,Americas
Canada,14-07-2020,397311,846,243,397068,Americas
Canada,14-07-2020,301620,1765,1172,300448,Americas
Canada,14-07-2020,190457,92,775,189682,Americas
Canada,14-07-2020,424125,2485,1133,422992,Americas
Canada,14-07-2020,404424,2309,279,404145,Americas
Canada,14-07-2020,21767,154,691,21076,Americas
Canada,14-07-2020,52633,1890,1163,51470,Americas
Canada,14-07-2020,22244,11,362,21882,Americas
Central African Republic,14-07-2020,139333,2001,562,138771,Africa
Chad,14-07-2020,380699,1041,607,380092,Africa
Chile,14-07-2020,225311,859,1020,224291,Americas
China,14-07-2020,220004,1944,638,219366,Western Pacific
China,14-07-2020,347977,1511,468,347509,Western Pacific
China,14-07-2020,352765,1029,362,352403,Western Pacific
China,14-07-2020,188578,184,242,188336,Western Pacific
China,14-07-2020,344103,457,835,343268,Western Pacific
China,14-07-2020,342714,1321,316,342398,Western Pacific
China,14-07-2020,112548,1876,18,112530,Western Pacific
China,14-07-2020,137084,380,380,136704,Western Pacific
China,14-07-2020,243140,2124,385,242755,Western Pacific
China,14-07-2020,437064,1964,1082,435982,Western Pacific
China,14-07-2020,382752,2375,792,381960,Western Pacific
China,14-07-2020,160271,2475,891,159380,Western Pacific
China,14-07-2020,319818,919,849,318969,Western Pacific
China,14-07-2020,77411,2232,254,77157,Western Pacific
China,14-07-2020,250805,2080,769,250036,Western Pacific
China,14-07-2020,92379,1571,1237,91142,Western Pacific
China,14-07-2020,139895,208,942,138953,Western Pacific
China,14-07-2020,84610,810,1212,83398,Western Pacific
China,14-07-2020,344395,683,945,343450,Western Pacific
China,14-07-2020,70003,795,825,69178,Western Pacific
China,14-07-2020,29333,1935,112,29221,Western Pacific
China,14-07-2020,7375,1762,756,6619,Western Pacific
China,14-07-2020,238530,2412,1212,237318,Western Pacific
China,14-07-2020,80831,82,917,79914,Western Pacific
China,14-07-2020,82828,1810,184,82644,Western Pacific
China,14-07-2020,399354,1502,63,399291,Western Pacific
China,14-07-2020,188610,505,713,187897,Western Pacific
China,14-07-2020,83480,217,882,82598,Western Pacific
China,14-07-2020,387276,2213,157,387119,Western Pacific
China,14-07-2020,69389,1069,866,68523,Western Pacific
China,14-07-2020,442851,1425,768,442083,Western Pacific
China,14-07-2020,414669,1449,144,414525,Western Pacific
China,14-07-2020,168512,386,1089,167423,Western Pacific
Colombia,14-07-2020,318805,1716,752,318053,Americas
Congo (Brazzaville),14-07-2020,204157,2398,10,204147,Africa
Congo (Kinshasa),14-07-2020,303992,2396,751,303241,Africa
Costa Rica,14-07-2020,57814,878,548,57266,Americas
Cote d'Ivoire,14-07-2020,302825,654,654,302171,Africa
Croatia,14-07-2020,174770,1633,1084,173686,Europe
Cuba,14-07-2020,252485,1061,231,252254,Americas
Cyprus,14-07-2020,284817,1966,1008,283809,Europe
Czechia,14-07-2020,388710,1247,1021,387689,Europe
Denmark,14-07-2020,365761,1746,713,365048,Europe
Greenland,14-07-2020,299707,351,429,299278,Europe
Denmark,14-07-2020,244140,992,730,243410,Europe
Djibouti,14-07-2020,55946,2132,1161,54785,Eastern Mediterranean
Dominican Republic,14-07-2020,421996,1711,86,421910,Americas
Ecuador,14-07-2020,58131,588,912,57219,Americas
Egypt,14-07-2020,95216,365,651,94565,Eastern Mediterranean
El Salvador,14-07-2020,370656,1878,205,370451,Americas
Equatorial Guinea,14-07-2020,281870,2243,1160,280710,Africa
Eritrea,14-07-2020,416230,2279,1046,415184,Africa
Estonia,14-07-2020,327885,2249,1031,326854,Europe
Eswatini,14-07-2020,243270,2013,697,242573,Africa
Ethiopia,14-07-2020,297896,2031,122,297774,Africa
Fiji,14-07-2020,447850,66,118,447732,Western Pacific
Finland,14-07-2020,349784,1731,242,349542,Europe
France,14-07-2020,207156,2479,64,207092,Europe
France,14-07-2020,316680,345,103,316577,Europe
France,14-07-2020,204969,397,1067,203902,Europe
France,14-07-2020,428194,368,1246,426948,Europe
France,14-07-2020,202625,839,110,202515,Europe
France,14-07-2020,191752,2205,1228,190524,Europe
France,14-07-2020,63414,902,104,63310,Europe
France,14-07-2020,215797,2471,324,215473,Europe
France,14-07-2020,282514,1270,1032,281482,Europe
France,14-07-2020,358928,2299,989,357939,Europe
Gabon,14-07-2020,136770,2474,778,135992,Africa
Gambia,14-07-2020,266452,2310,555,265897,Africa
Georgia,14-07-2020,38047,2242,298,37749,Europe
Germany,14-07-2020,228127,809,471,227656,Europe
Ghana,14-07-2020,285772,777,681,285091,Africa
Greece,14-07-2020,171164,943,289,170875,Europe
Guatemala,14-07-2020,422064,1676,359,421705,Americas
Guinea,14-07-2020,127093,280,154,126939,Africa
Guyana,14-07-2020,291503,2348,236,291267,Americas
Haiti,14-07-2020,15370,2110,952,14418,Americas
Holy See,14-07-2020,295324,1302,545,294779,Europe
Honduras,14-07-2020,2169,571,344,1825,Americas
Hungary,14-07-2020,436840,2266,781,436059,Europe
Iceland,14-07-2020,257487,1296,170,257317,Europe
India,14-07-2020,392529,2142,251,392278,South-East Asia
Indonesia,14-07-2020,55597,478,1223,54374,South-East Asia
Iran,14-07-2020,33230,1005,880,32350,Eastern Mediterranean
Iraq,14-07-2020,395832,1291,420,395412,Eastern Mediterranean
Ireland,14-07-2020,369460,258,278,369182,Europe
Israel,14-07-2020,207999,1925,796,207203,Europe
Italy,14-07-2020,140911,1553,1198,139713,Europe
Jamaica,14-07-2020,122263,1749,1116,121147,Americas
Japan,14-07-2020,171476,541,49,171427,Western Pacific
Jordan,14-07-2020,290177,774,578,289599,Eastern Mediterranean
Kazakhstan,14-07-2020,65581,1783,797,64784,Europe
Kenya,14-07-2020,127072,1018,894,126178,Africa
South Korea,14-07-2020,120682,908,801,119881,Western Pacific
Kuwait,14-07-2020,260709,1373,859,259850,Eastern Mediterranean
Kyrgyzstan,14-07-2020,104185,747,947,103238,Europe
Latvia,14-07-2020,283371,817,403,282968,Europe
Lebanon,14-07-2020,389927,2318,1000,388927,Eastern Mediterranean
Liberia,14-07-2020,119636,129,59,119577,Africa
Liechtenstein,14-07-2020,69293,1116,930,68363,Europe
Lithuania,14-07-2020,324742,1504,543,324199,Europe
Luxembourg,14-07-2020,90377,2095,638,89739,Europe
Madagascar,14-07-2020,299009,39,1176,297833,Africa
Malaysia,14-07-2020,182468,1379,727,181741,Western Pacific
Maldives,14-07-2020,46001,402,274,45727,South-East Asia
Malta,14-07-2020,11823,45,519,11304,Europe
Mauritania,14-07-2020,248077,296,849,247228,Africa
Mauritius,14-07-2020,186139,979,738,185401,Africa
Mexico,14-07-2020,248318,2468,69,248249,Americas
Moldova,14-07-2020,215513,1365,165,215348,Europe
Monaco,14-07-2020,314004,2422,545,313459,Europe
Mongolia,14-07-2020,55736,625,471,55265,Western Pacific
Montenegro,14-07-2020,416352,788,828,415524,Europe
Morocco,14-07-2020,324265,2031,287,323978,Eastern Mediterranean
Namibia,14-07-2020,65554,1040,387,65167,Africa
Nepal,14-07-2020,273743,1537,989,272754,South-East Asia
Netherlands,14-07-2020,63810,1084,132,63678,Europe
Netherlands,14-07-2020,157854,993,877,156977,Europe
Netherlands,14-07-2020,239764,459,43,239721,Europe
Netherlands,14-07-2020,155535,1516,991,154544,Europe
New Zealand,14-07-2020,194900,2037,570,194330,Western Pacific
Nicaragua,14-07-2020,278019,1225,97,277922,Americas
Niger,14-07-2020,94169,2326,769,93400,Africa
Nigeria,14-07-2020,307499,224,83,307416,Africa
North Macedonia,14-07-2020,289919,227,695,289224,Europe
Norway,14-07-2020,110612,593,416,110196,Europe
Oman,14-07-2020,364431,2478,929,363502,Eastern Mediterranean
Pakistan,14-07-2020,384423,1875,1173,383250,Eastern Mediterranean
Panama,14-07-2020,202888,2082,567,202321,Americas
Papua New Guinea,14-07-2020,144304,83,180,144124,Western Pacific
Paraguay,14-07-2020,57808,619,386,57422,Americas
Peru,14-07-2020,208467,643,1006,207461,Americas
Philippines,14-07-2020,163861,336,225,163636,Western Pacific
Poland,14-07-2020,167425,40,25,167400,Europe
Portugal,14-07-2020,2223,1252,1028,1195,Europe
Qatar,14-07-2020,1474,1251,621,853,Eastern Mediterranean
Romania,14-07-2020,171686,2461,400,171286,Europe
Russia,14-07-2020,294643,2032,745,293898,Europe
Rwanda,14-07-2020,17755,1879,46,17709,Africa
Saint Lucia,14-07-2020,326668,757,563,326105,Americas
Saint Vincent and the Grenadines,14-07-2020,250991,311,774,250217,Americas
San Marino,14-07-2020,400995,179,35,400960,Europe
Saudi Arabia,14-07-2020,73008,297,368,72640,Eastern Mediterranean
Senegal,14-07-2020,124993,2235,833,124160,Africa
Serbia,14-07-2020,57172,611,267,56905,Europe
Seychelles,14-07-2020,409254,146,348,408906,Africa
Singapore,14-07-2020,230047,2130,931,229116,Western Pacific
Slovakia,14-07-2020,100319,848,8,100311,Europe
Slovenia,14-07-2020,76922,310,334,76588,Europe
Somalia,14-07-2020,371480,1343,564,370916,Eastern Mediterranean
South Africa,14-07-2020,417674,1618,499,417175,Africa
Spain,14-07-2020,413462,1226,169,413293,Europe
Sri Lanka,14-07-2020,338724,1694,1041,337683,South-East Asia
Sudan,14-07-2020,151381,1700,902,150479,Eastern Mediterranean
Suriname,14-07-2020,179768,1218,871,178897,Americas
Sweden,14-07-2020,325437,1713,997,324440,Europe
Switzerland,14-07-2020,279153,2033,1170,277983,Europe
Taiwan*,14-07-2020,289702,1709,261,289441,Western Pacific
Tanzania,14-07-2020,359779,1607,568,359211,Africa
Thailand,14-07-2020,77285,2214,15,77270,South-East Asia
Togo,14-07-2020,124217,1781,810,123407,Africa
Trinidad and Tobago,14-07-2020,191091,2126,1001,190090,Americas
Tunisia,14-07-2020,296057,500,949,295108,Eastern Mediterranean
Turkey,14-07-2020,322396,2122,881,321515,Europe
Uganda,14-07-2020,83477,437,1025,82452,Africa
Ukraine,14-07-2020,247316,1827,615,246701,Europe
United Arab Emirates,14-07-2020,295629,1043,1138,294491,Eastern Mediterranean
United Kingdom,14-07-2020,206591,1820,259,206332,Europe
United Kingdom,14-07-2020,273123,1045,350,272773,Europe
United Kingdom,14-07-2020,86644,132,702,85942,Europe
United Kingdom,14-07-2020,276211,109,1097,275114,Europe
United Kingdom,14-07-2020,292770,426,546,292224,Europe
United Kingdom,14-07-2020,374698,2412,113,374585,Europe
United Kingdom,14-07-2020,337609,724,969,336640,Europe
Uruguay,14-07-2020,449047,867,703,448344,Americas
US,14-07-2020,120746,105,1108,119638,Americas
Uzbekistan,14-07-2020,75848,107,576,75272,Europe
Venezuela,14-07-2020,81584,1822,1119,80465,Americas
Vietnam,14-07-2020,75217,1853,730,74487,Western Pacific
Zambia,14-07-2020,350490,2295,1120,349370,Africa
Zimbabwe,14-07-2020,231635,1344,153,231482,Africa
Dominica,14-07-2020,411944,2176,368,411576,Americas
Grenada,14-07-2020,198971,333,844,198127,Americas
Mozambique,14-07-2020,208007,1755,401,207606,Africa
Syria,14-07-2020,291753,1146,519,291234,Eastern Mediterranean
Timor-Leste,14-07-2020,322928,1354,1021,321907,South-East Asia
Belize,14-07-2020,212295,2043,954,211341,Americas
Laos,14-07-2020,70074,1690,916,69158,Western Pacific
Libya,14-07-2020,203341,2461,435,202906,Eastern Mediterranean
West Bank and Gaza,14-07-2020,159866,927,858,159008,Eastern Mediterranean
Guinea-Bissau,14-07-2020,333189,989,532,332657,Africa
Mali,14-07-2020,232081,1318,626,231455,Africa
Saint Kitts and Nevis,14-07-2020,103623,2255,553,103070,Americas
Canada,14-07-2020,69853,1446,222,69631,Americas
Canada,14-07-2020,239672,933,1157,238515,Americas
Kosovo,14-07-2020,397435,890,959,396476,Europe
Burma,14-07-2020,443972,1203,998,442974,South-East Asia
United Kingdom,14-07-2020,212294,1442,1017,211277,Europe
United Kingdom,14-07-2020,316478,1122,585,315893,Europe
United Kingdom,14-07-2020,325691,950,1087,324604,Europe
Botswana,14-07-2020,424557,457,258,424299,Africa
Burundi,14-07-2020,359772,1886,315,359457,Africa
Sierra Leone,14-07-2020,270921,2276,1072,269849,Africa
Malawi,14-07-2020,366069,620,511,365558,Africa
United Kingdom,14-07-2020,195606,2280,932,194674,Europe
France,14-07-2020,253505,2321,181,253324,Europe
South Sudan,14-07-2020,111068,1557,623,110445,Africa
Western Sahara,14-07-2020,40509,281,527,39982,Africa
Sao Tome and Principe,14-07-2020,278340,1342,976,277364,Africa
Yemen,14-07-2020,61101,247,816,60285,Eastern Mediterranean
Comoros,14-07-2020,226557,1835,770,225787,Africa
Tajikistan,14-07-2020,433901,897,1178,432723,Europe
Lesotho,14-07-2020,47230,2207,258,46972,Africa
Afghanistan,15-07-2020,35937,316,1098,34839,Eastern Mediterranean
Albania,15-07-2020,43423,1188,1233,42190,Europe
Algeria,15-07-2020,423017,1348,893,422124,Africa
Andorra,15-07-2020,254372,2457,928,253444,Europe
Angola,15-07-2020,103360,1971,30,103330,Africa
Antigua and Barbuda,15-07-2020,207441,1975,1030,206411,Americas
Argentina,15-07-2020,195440,2451,485,194955,Americas
Armenia,15-07-2020,46361,700,1158,45203,Europe
Australia,15-07-2020,125660,1118,1153,124507,Western Pacific
Australia,15-07-2020,206680,1864,551,206129,Western Pacific
Australia,15-07-2020,380771,1933,525,380246,Western Pacific
Australia,15-07-2020,188963,1843,833,188130,Western Pacific
Australia,15-07-2020,286696,163,202,286494,Western Pacific
Australia,15-07-2020,76807,1682,976,75831,Western Pacific
Australia,15-07-2020,208856,1451,60,208796,Western Pacific
Australia,15-07-2020,413340,690,981,412359,Western Pacific
Austria,15-07-2020,37277,1991,41,37236,Europe
Azerbaijan,15-07-2020,215521,635,272,215249,Europe
Bahamas,15-07-2020,316759,2149,300,316459,Americas
Bahrain,15-07-2020,89772,2321,1071,88701,Eastern Mediterranean
Bangladesh,15-07-2020,95427,2263,815,94612,South-East Asia
Barbados,15-07-2020,190395,923,798,189597,Americas
Belarus,15-07-2020,178078,430,128,177950,Europe
Belgium,15-07-2020,33364,235,670,32694,Europe
Benin,15-07-2020,14237,2071,685,13552,Africa
Bhutan,15-07-2020,254016,578,986,253030,South-East Asia
Bolivia,15-07-2020,404019,1495,188,403831,Americas
Bosnia and Herzegovina,15-07-2020,245022,2418,1072,243950,Europe
Brazil,15-07-2020,306333,1125,391,305942,Americas
Brunei,15-07-2020,404078,1128,52,404026,Western Pacific
Bulgaria,15-07-2020,95737,1932,331,95406,Europe
Burkina Faso,15-07-2020,418489,1944,945,417544,Africa
Cabo Verde,15-07-2020,102508,227,939,101569,Africa
Cambodia,15-07-2020,169875,449,961,168914,Western Pacific
Cameroon,15-07-2020,439606,1664,1017,438589,Africa
Canada,15-07-2020,15521,1345,524,14997,Americas
Canada,15-07-2020,448854,2087,147,448707,Americas
Canada,15-07-2020,7040,906,1158,5882,Americas
Canada,15-07-2020,90509,445,919,89590,Americas
Canada,15-07-2020,111522,378,822,110700,Americas
Canada,15-07-2020,75740,880,1108,74632,Americas
Canada,15-07-2020,417526,748,18,417508,Americas
Canada,15-07-2020,375152,355,419,374733,Americas
Canada,15-07-2020,11100,968,405,10695,Americas
Canada,15-07-2020,385936,1111,949,384987,Americas
Central African Republic,15-07-2020,321135,709,279,320856,Africa
Chad,15-07-2020,334076,1965,940,333136,Africa
Chile,15-07-2020,9621,1089,222,9399,Americas
China,15-07-2020,174937,1734,318,174619,Western Pacific
China,15-07-2020,162758,1821,361,162397,Western Pacific
China,15-07-2020,116653,1725,863,115790,Western Pacific
China,15-07-2020,362003,968,783,361220,Western Pacific
China,15-07-2020,442034,2435,991,441043,Western Pacific
China,15-07-2020,229128,1629,1038,228090,Western Pacific
China,15-07-2020,244402,103,665,243737,Western Pacific
China,15-07-2020,359346,768,441,358905,Western Pacific
China,15-07-2020,238207,72,60,238147,Western Pacific
China,15-07-2020,181413,1954,1135,180278,Western Pacific
China,15-07-2020,131958,1339,414,131544,Western Pacific
China,15-07-2020,321985,746,508,321477,Western Pacific
China,15-07-2020,293476,2077,619,292857,Western Pacific
China,15-07-2020,51633,1822,789,50844,Western Pacific
China,15-07-2020,289792,420,940,288852,Western Pacific
China,15-07-2020,304781,6,1218,303563,Western Pacific
China,15-07-2020,171184,1195,504,170680,Western Pacific
China,15-07-2020,345591,83,165,345426,Western Pacific
China,15-07-2020,312637,289,861,311776,Western Pacific
China,15-07-2020,115018,2030,179,114839,Western Pacific
China,15-07-2020,165156,1812,459,164697,Western Pacific
China,15-07-2020,207486,1843,338,207148,Western Pacific
China,15-07-2020,367272,1270,1115,366157,Western Pacific
China,15-07-2020,70099,940,353,69746,Western Pacific
China,15-07-2020,281922,2227,251,281671,Western Pacific
China,15-07-2020,275435,847,537,274898,Western Pacific
China,15-07-2020,147488,762,202,147286,Western Pacific
China,15-07-2020,410928,1511,900,410028,Western Pacific
China,15-07-2020,279799,1319,1146,278653,Western Pacific
China,15-07-2020,239077,1646,569,238508,Western Pacific
China,15-07-2020,232191,477,588,231603,Western Pacific
China,15-07-2020,40768,657,238,40530,Western Pacific
China,15-07-2020,239521,1119,303,239218,Western Pacific
Colombia,15-07-2020,11303,762,945,10358,Americas
Congo (Brazzaville),15-07-2020,234197,1698,1005,233192,Africa
Congo (Kinshasa),15-07-2020,89990,1588,1120,88870,Africa
Costa Rica,15-07-2020,47047,969,1186,45861,Americas
Cote d'Ivoire,15-07-2020,224746,1350,831,223915,Africa
Croatia,15-07-2020,253870,1107,97,253773,Europe
Cuba,15-07-2020,220271,2391,716,219555,Americas
Cyprus,15-07-2020,107310,2473,119,107191,Europe
Czechia,15-07-2020,9089,2196,505,8584,Europe
Denmark,15-07-2020,246775,2039,1113,245662,Europe
Greenland,15-07-2020,130350,1300,421,129929,Europe
Denmark,15-07-2020,184886,1117,287,184599,Europe
Djibouti,15-07-2020,437581,1844,222,437359,Eastern Mediterranean
Dominican Republic,15-07-2020,111555,944,1178,110377,Americas
Ecuador,15-07-2020,239407,1934,204,239203,Americas
Egypt,15-07-2020,281762,1458,1139,280623,Eastern Mediterranean
El Salvador,15-07-2020,399784,978,1198,398586,Americas
Equatorial Guinea,15-07-2020,293236,1565,313,292923,Africa
Eritrea,15-07-2020,74674,941,778,73896,Africa
Estonia,15-07-2020,151837,543,447,151390,Europe
Eswatini,15-07-2020,33759,1015,1110,32649,Africa
Ethiopia,15-07-2020,221095,1015,1171,219924,Africa
Fiji,15-07-2020,66473,1449,600,65873,Western Pacific
Finland,15-07-2020,229606,194,1078,228528,Europe
France,15-07-2020,352773,113,168,352605,Europe
France,15-07-2020,317834,1789,950,316884,Europe
France,15-07-2020,319955,401,276,319679,Europe
France,15-07-2020,216701,2323,47,216654,Europe
France,15-07-2020,258543,203,381,258162,Europe
France,15-07-2020,406959,551,817,406142,Europe
France,15-07-2020,219224,1639,1012,218212,Europe
France,15-07-2020,348423,1383,215,348208,Europe
France,15-07-2020,99266,222,767,98499,Europe
France,15-07-2020,345378,1874,332,345046,Europe
Gabon,15-07-2020,432728,21,581,432147,Africa
Gambia,15-07-2020,98932,761,986,97946,Africa
Georgia,15-07-2020,118296,1234,734,117562,Europe
Germany,15-07-2020,61253,1774,536,60717,Europe
Ghana,15-07-2020,229776,2159,259,229517,Africa
Greece,15-07-2020,443654,535,933,442721,Europe
Guatemala,15-07-2020,335069,1277,166,334903,Americas
Guinea,15-07-2020,415113,1842,805,414308,Africa
Guyana,15-07-2020,371557,188,1192,370365,Americas
Haiti,15-07-2020,181371,963,807,180564,Americas
Holy See,15-07-2020,423484,842,333,423151,Europe
Honduras,15-07-2020,232670,663,947,231723,Americas
Hungary,15-07-2020,65549,294,46,65503,Europe
Iceland,15-07-2020,210006,2439,737,209269,Europe
India,15-07-2020,448451,461,257,448194,South-East Asia
Indonesia,15-07-2020,302101,2217,724,301377,South-East Asia
Iran,15-07-2020,238072,2440,397,237675,Eastern Mediterranean
Iraq,15-07-2020,63445,1218,499,62946,Eastern Mediterranean
Ireland,15-07-2020,318262,1518,1133,317129,Europe
Israel,15-07-2020,56063,657,304,55759,Europe
Italy,15-07-2020,88457,2375,777,87680,Europe
Jamaica,15-07-2020,57104,1036,1097,56007,Americas
Japan,15-07-2020,43520,485,897,42623,Western Pacific
Jordan,15-07-2020,385323,157,864,384459,Eastern Mediterranean
Kazakhstan,15-07-2020,288144,1086,778,287366,Europe
Kenya,15-07-2020,427937,1980,388,427549,Africa
South Korea,15-07-2020,171457,2468,396,171061,Western Pacific
Kuwait,15-07-2020,383223,1269,721,382502,Eastern Mediterranean
Kyrgyzstan,15-07-2020,346304,1054,1236,345068,Europe
Latvia,15-07-2020,351433,1865,632,350801,Europe
Lebanon,15-07-2020,254714,941,731,253983,Eastern Mediterranean
Liberia,15-07-2020,139705,542,995,138710,Africa
Liechtenstein,15-07-2020,62014,2356,479,61535,Europe
Lithuania,15-07-2020,247221,383,598,246623,Europe
Luxembourg,15-07-2020,388473,1508,252,388221,Europe
Madagascar,15-07-2020,29736,209,999,28737,Africa
Malaysia,15-07-2020,2055,1320,1142,913,Western Pacific
Maldives,15-07-2020,242074,400,1136,240938,South-East Asia
Malta,15-07-2020,211301,264,178,211123,Europe
Mauritania,15-07-2020,54112,853,856,53256,Africa
Mauritius,15-07-2020,205158,925,663,204495,Africa
Mexico,15-07-2020,108524,834,191,108333,Americas
Moldova,15-07-2020,235983,1012,217,235766,Europe
Monaco,15-07-2020,98528,1334,1030,97498,Europe
Mongolia,15-07-2020,212488,2496,45,212443,Western Pacific
Montenegro,15-07-2020,307335,1687,707,306628,Europe
Morocco,15-07-2020,438726,313,215,438511,Eastern Mediterranean
Namibia,15-07-2020,232630,610,686,231944,Africa
Nepal,15-07-2020,146438,1322,574,145864,South-East Asia
Netherlands,15-07-2020,120657,1844,944,119713,Europe
Netherlands,15-07-2020,276902,2307,770,276132,Europe
Netherlands,15-07-2020,256754,1594,532,256222,Europe
Netherlands,15-07-2020,405188,2277,617,404571,Europe
New Zealand,15-07-2020,172390,1807,95,172295,Western Pacific
Nicaragua,15-07-2020,358782,2138,940,357842,Americas
Niger,15-07-2020,95645,1703,865,94780,Africa
Nigeria,15-07-2020,175420,972,803,174617,Africa
North Macedonia,15-07-2020,282273,1711,564,281709,Europe
Norway,15-07-2020,223680,936,1171,222509,Europe
Oman,15-07-2020,224994,2243,678,224316,Eastern Mediterranean
Pakistan,15-07-2020,226976,1352,852,226124,Eastern Mediterranean
Panama,15-07-2020,222911,2140,774,222137,Americas
Papua New Guinea,15-07-2020,355320,2443,468,354852,Western Pacific
Paraguay,15-07-2020,396459,67,110,396349,Americas
Peru,15-07-2020,413312,1926,697,412615,Americas
Philippines,15-07-2020,80420,2141,950,79470,Western Pacific
Poland,15-07-2020,320015,1714,474,319541,Europe
Portugal,15-07-2020,203352,692,1120,202232,Europe
Qatar,15-07-2020,371477,318,509,370968,Eastern Mediterranean
Romania,15-07-2020,187300,2451,250,187050,Europe
Russia,15-07-2020,139768,336,99,139669,Europe
Rwanda,15-07-2020,63374,2234,882,62492,Africa
Saint Lucia,15-07-2020,130097,641,17,130080,Americas
Saint Vincent and the Grenadines,15-07-2020,235155,1929,25,235130,Americas
San Marino,15-07-2020,121905,1129,452,121453,Europe
Saudi Arabia,15-07-2020,336041,1658,437,335604,Eastern Mediterranean
Senegal,15-07-2020,34259,236,768,33491,Africa
Serbia,15-07-2020,349984,2344,807,349177,Europe
Seychelles,15-07-2020,280728,1110,115,280613,Africa
Singapore,15-07-2020,97074,1985,489,96585,Western Pacific
Slovakia,15-07-2020,432659,1219,193,432466,Europe
Slovenia,15-07-2020,193661,999,324,193337,Europe
Somalia,15-07-2020,95715,1333,604,95111,Eastern Mediterranean
South Africa,15-07-2020,116956,117,1081,115875,Africa
Spain,15-07-2020,385821,2205,420,385401,Europe
Sri Lanka,15-07-2020,46760,1299,1051,45709,South-East Asia
Sudan,15-07-2020,47353,1679,373,46980,Eastern Mediterranean
Suriname,15-07-2020,70807,478,704,70103,Americas
Sweden,15-07-2020,369994,332,236,369758,Europe
Switzerland,15-07-2020,130085,2040,1104,128981,Europe
Taiwan*,15-07-2020,156671,2285,344,156327,Western Pacific
Tanzania,15-07-2020,227682,1530,589,227093,Africa
Thailand,15-07-2020,294534,666,610,293924,South-East Asia
Togo,15-07-2020,189315,683,1147,188168,Africa
Trinidad and Tobago,15-07-2020,5194,217,1061,4133,Americas
Tunisia,15-07-2020,297320,2253,792,296528,Eastern Mediterranean
Turkey,15-07-2020,229886,2229,328,229558,Europe
Uganda,15-07-2020,77039,1499,929,76110,Africa
Ukraine,15-07-2020,124175,558,606,123569,Europe
United Arab Emirates,15-07-2020,123197,1748,901,122296,Eastern Mediterranean
United Kingdom,15-07-2020,308746,217,1190,307556,Europe
United Kingdom,15-07-2020,59867,1070,483,59384,Europe
United Kingdom,15-07-2020,421853,2022,301,421552,Europe
United Kingdom,15-07-2020,220407,2371,1028,219379,Europe
United Kingdom,15-07-2020,310330,219,858,309472,Europe
United Kingdom,15-07-2020,363657,965,813,362844,Europe
United Kingdom,15-07-2020,350776,474,652,350124,Europe
Uruguay,15-07-2020,13494,2302,925,12569,Americas
US,15-07-2020,435584,1297,15,435569,Americas
Uzbekistan,15-07-2020,361359,710,911,360448,Europe
Venezuela,15-07-2020,77919,2387,648,77271,Americas
Vietnam,15-07-2020,95573,2140,1072,94501,Western Pacific
Zambia,15-07-2020,362519,1811,1080,361439,Africa
Zimbabwe,15-07-2020,286163,437,84,286079,Africa
Dominica,15-07-2020,19942,2033,816,19126,Americas
Grenada,15-07-2020,317176,1530,810,316366,Americas
Mozambique,15-07-2020,278536,1511,1006,277530,Africa
Syria,15-07-2020,231792,284,900,230892,Eastern Mediterranean
Timor-Leste,15-07-2020,162920,1753,1027,161893,South-East Asia
Belize,15-07-2020,367622,395,335,367287,Americas
Laos,15-07-2020,347379,2229,1109,346270,Western Pacific
Libya,15-07-2020,408612,395,737,407875,Eastern Mediterranean
West Bank and Gaza,15-07-2020,246009,1532,765,245244,Eastern Mediterranean
Guinea-Bissau,15-07-2020,425342,1006,58,425284,Africa
Mali,15-07-2020,80606,1079,235,80371,Africa
Saint Kitts and Nevis,15-07-2020,259062,1941,1056,258006,Americas
Canada,15-07-2020,431253,486,720,430533,Americas
Canada,15-07-2020,177815,1486,300,177515,Americas
Kosovo,15-07-2020,303670,321,177,303493,Europe
Burma,15-07-2020,415312,964,66,415246,South-East Asia
United Kingdom,15-07-2020,331552,28,953,330599,Europe
United Kingdom,15-07-2020,83083,34,373,82710,Europe
United Kingdom,15-07-2020,382267,1449,262,382005,Europe
Botswana,15-07-2020,370696,489,33,370663,Africa
Burundi,15-07-2020,124588,2192,900,123688,Africa
Sierra Leone,15-07-2020,324630,50,1050,323580,Africa
Malawi,15-07-2020,66457,726,225,66232,Africa
United Kingdom,15-07-2020,70378,690,335,70043,Europe
France,15-07-2020,99251,1921,466,98785,Europe
South Sudan,15-07-2020,129424,140,617,128807,Africa
Western Sahara,15-07-2020,56066,2388,1147,54919,Africa
Sao Tome and Principe,15-07-2020,277008,2256,589,276419,Africa
Yemen,15-07-2020,216221,1981,1229,214992,Eastern Mediterranean
Comoros,15-07-2020,176268,2313,734,175534,Africa
Tajikistan,15-07-2020,78955,328,206,78749,Europe
Lesotho,15-07-2020,447891,526,626,447265,Africa
Afghanistan,16-07-2020,315046,829,391,314655,Eastern Mediterranean
Albania,16-07-2020,413087,976,966,412121,Europe
Algeria,16-07-2020,51651,40,28,51623,Africa
Andorra,16-07-2020,202948,1706,1204,201744,Europe
Angola,16-07-2020,113415,168,52,113363,Africa
Antigua and Barbuda,16-07-2020,205707,1748,195,205512,Americas
Argentina,16-07-2020,49701,2188,166,49535,Americas
Armenia,16-07-2020,48174,1149,41,48133,Europe
Australia,16-07-2020,248507,66,570,247937,Western Pacific
Australia,16-07-2020,162451,1192,336,162115,Western Pacific
Australia,16-07-2020,234536,2302,1190,233346,Western Pacific
Australia,16-07-2020,432471,444,692,431779,Western Pacific
Australia,16-07-2020,109685,217,98,109587,Western Pacific
Australia,16-07-2020,356393,2224,506,355887,Western Pacific
Australia,16-07-2020,111900,36,1207,110693,Western Pacific
Australia,16-07-2020,406324,1528,254,406070,Western Pacific
Austria,16-07-2020,409587,411,541,409046,Europe
Azerbaijan,16-07-2020,95028,1496,532,94496,Europe
Bahamas,16-07-2020,418927,111,983,417944,Americas
Bahrain,16-07-2020,162648,966,997,161651,Eastern Mediterranean
Bangladesh,16-07-2020,102988,2443,1138,101850,South-East Asia
Barbados,16-07-2020,383714,720,748,382966,Americas
Belarus,16-07-2020,59306,578,957,58349,Europe
Belgium,16-07-2020,331200,1,204,330996,Europe
Benin,16-07-2020,132373,1107,1190,131183,Africa
Bhutan,16-07-2020,259915,2214,655,259260,South-East Asia
Bolivia,16-07-2020,400312,389,481,399831,Americas
Bosnia and Herzegovina,16-07-2020,287673,923,201,287472,Europe
Brazil,16-07-2020,221340,538,401,220939,Americas
Brunei,16-07-2020,226622,1525,604,226018,Western Pacific
Bulgaria,16-07-2020,89381,2306,115,89266,Europe
Burkina Faso,16-07-2020,191868,2107,1107,190761,Africa
Cabo Verde,16-07-2020,210844,2342,375,210469,Africa
Cambodia,16-07-2020,403172,1401,18,403154,Western Pacific
Cameroon,16-07-2020,325913,1800,1115,324798,Africa
Canada,16-07-2020,112158,611,758,111400,Americas
Canada,16-07-2020,138247,1094,691,137556,Americas
Canada,16-07-2020,236693,407,1214,235479,Americas
Canada,16-07-2020,318626,2099,576,318050,Americas
Canada,16-07-2020,39919,2071,411,39508,Americas
Canada,16-07-2020,9045,1405,849,8196,Americas
Canada,16-07-2020,83073,13,69,83004,Americas
Canada,16-07-2020,38728,357,851,37877,Americas
Canada,16-07-2020,5046,2419,774,4272,Americas
Canada,16-07-2020,414542,1627,261,414281,Americas
Central African Republic,16-07-2020,413434,268,682,412752,Africa
Chad,16-07-2020,165578,1432,392,165186,Africa
Chile,16-07-2020,344881,736,291,344590,Americas
China,16-07-2020,446560,1367,886,445674,Western Pacific
China,16-07-2020,286659,2068,888,285771,Western Pacific
China,16-07-2020,80473,1630,522,79951,Western Pacific
China,16-07-2020,366858,546,1018,365840,Western Pacific
China,16-07-2020,436057,2401,817,435240,Western Pacific
China,16-07-2020,76151,2109,100,76051,Western Pacific
China,16-07-2020,221081,827,39,221042,Western Pacific
China,16-07-2020,339055,522,274,338781,Western Pacific
China,16-07-2020,199882,1647,844,199038,Western Pacific
China,16-07-2020,439873,2327,621,439252,Western Pacific
China,16-07-2020,241306,1690,965,240341,Western Pacific
China,16-07-2020,279228,274,1196,278032,Western Pacific
China,16-07-2020,9560,1989,941,8619,Western Pacific
China,16-07-2020,313990,2304,798,313192,Western Pacific
China,16-07-2020,303732,1441,905,302827,Western Pacific
China,16-07-2020,95658,1817,528,95130,Western Pacific
China,16-07-2020,328774,757,298,328476,Western Pacific
China,16-07-2020,77658,1755,684,76974,Western Pacific
China,16-07-2020,284352,691,487,283865,Western Pacific
China,16-07-2020,180328,1870,426,179902,Western Pacific
China,16-07-2020,419724,923,1120,418604,Western Pacific
China,16-07-2020,226050,468,508,225542,Western Pacific
China,16-07-2020,199488,1127,459,199029,Western Pacific
China,16-07-2020,82487,234,1171,81316,Western Pacific
China,16-07-2020,175528,1973,988,174540,Western Pacific
China,16-07-2020,443385,715,756,442629,Western Pacific
China,16-07-2020,388483,1185,1091,387392,Western Pacific
China,16-07-2020,378851,931,1050,377801,Western Pacific
China,16-07-2020,73982,1443,554,73428,Western Pacific
China,16-07-2020,424984,2499,1059,423925,Western Pacific
China,16-07-2020,266122,2078,927,265195,Western Pacific
China,16-07-2020,445901,607,217,445684,Western Pacific
China,16-07-2020,72202,1323,1199,71003,Western Pacific
Colombia,16-07-2020,205749,1026,1248,204501,Americas
Congo (Brazzaville),16-07-2020,257554,2048,35,257519,Africa
Congo (Kinshasa),16-07-2020,119561,2429,414,119147,Africa
Costa Rica,16-07-2020,150541,1532,1150,149391,Americas
Cote d'Ivoire,16-07-2020,439195,1967,491,438704,Africa
Croatia,16-07-2020,356524,732,896,355628,Europe
Cuba,16-07-2020,331350,1221,662,330688,Americas
Cyprus,16-07-2020,187829,510,925,186904,Europe
Czechia,16-07-2020,50737,1488,246,50491,Europe
Denmark,16-07-2020,231791,1979,876,230915,Europe
Greenland,16-07-2020,260339,1733,387,259952,Europe
Denmark,16-07-2020,79475,1906,184,79291,Europe
Djibouti,16-07-2020,405122,2143,717,404405,Eastern Mediterranean
Dominican Republic,16-07-2020,398376,1778,328,398048,Americas
Ecuador,16-07-2020,88109,1846,715,87394,Americas
Egypt,16-07-2020,119749,375,20,119729,Eastern Mediterranean
El Salvador,16-07-2020,294479,1350,215,294264,Americas
Equatorial Guinea,16-07-2020,97860,1079,220,97640,Africa
Eritrea,16-07-2020,388668,1882,786,387882,Africa
Estonia,16-07-2020,213701,1979,1009,212692,Europe
Eswatini,16-07-2020,87977,1835,72,87905,Africa
Ethiopia,16-07-2020,18098,1451,422,17676,Africa
Fiji,16-07-2020,57312,526,115,57197,Western Pacific
Finland,16-07-2020,417822,936,651,417171,Europe
France,16-07-2020,162266,2153,30,162236,Europe
France,16-07-2020,104601,168,212,104389,Europe
France,16-07-2020,428427,251,1147,427280,Europe
France,16-07-2020,318343,908,1028,317315,Europe
France,16-07-2020,303581,2259,666,302915,Europe
France,16-07-2020,62730,2270,481,62249,Europe
France,16-07-2020,228077,890,990,227087,Europe
France,16-07-2020,430819,854,777,430042,Europe
France,16-07-2020,386365,1463,1043,385322,Europe
France,16-07-2020,28837,1488,1084,27753,Europe
Gabon,16-07-2020,140154,598,558,139596,Africa
Gambia,16-07-2020,234854,1784,1140,233714,Africa
Georgia,16-07-2020,297659,1493,236,297423,Europe
Germany,16-07-2020,202126,2385,390,201736,Europe
Ghana,16-07-2020,268585,1522,520,268065,Africa
Greece,16-07-2020,233968,1926,370,233598,Europe
Guatemala,16-07-2020,177958,150,987,176971,Americas
Guinea,16-07-2020,155908,1060,148,155760,Africa
Guyana,16-07-2020,298292,2105,331,297961,Americas
Haiti,16-07-2020,337932,40,469,337463,Americas
Holy See,16-07-2020,101690,842,887,100803,Europe
Honduras,16-07-2020,13802,2167,1215,12587,Americas
Hungary,16-07-2020,355877,1110,1217,354660,Europe
Iceland,16-07-2020,330900,967,384,330516,Europe
India,16-07-2020,314761,1168,804,313957,South-East Asia
Indonesia,16-07-2020,173086,1690,750,172336,South-East Asia
Iran,16-07-2020,449568,1208,322,449246,Eastern Mediterranean
Iraq,16-07-2020,447246,776,625,446621,Eastern Mediterranean
Ireland,16-07-2020,130850,2016,1208,129642,Europe
Israel,16-07-2020,76083,1272,497,75586,Europe
Italy,16-07-2020,233242,1313,1047,232195,Europe
Jamaica,16-07-2020,19557,931,316,19241,Americas
Japan,16-07-2020,59750,2455,1001,58749,Western Pacific
Jordan,16-07-2020,340816,1670,1188,339628,Eastern Mediterranean
Kazakhstan,16-07-2020,48747,159,659,48088,Europe
Kenya,16-07-2020,296079,551,954,295125,Africa
South Korea,16-07-2020,191519,1115,798,190721,Western Pacific
Kuwait,16-07-2020,307050,489,839,306211,Eastern Mediterranean
Kyrgyzstan,16-07-2020,401723,1499,467,401256,Europe
Latvia,16-07-2020,64343,913,850,63493,Europe
Lebanon,16-07-2020,69647,2465,573,69074,Eastern Mediterranean
Liberia,16-07-2020,422083,16,219,421864,Africa
Liechtenstein,16-07-2020,109126,1665,313,108813,Europe
Lithuania,16-07-2020,335405,1650,223,335182,Europe
Luxembourg,16-07-2020,366015,1577,500,365515,Europe
Madagascar,16-07-2020,374827,1961,629,374198,Africa
Malaysia,16-07-2020,360160,464,1215,358945,Western Pacific
Maldives,16-07-2020,38216,1594,556,37660,South-East Asia
Malta,16-07-2020,38357,827,240,38117,Europe
Mauritania,16-07-2020,266156,1138,931,265225,Africa
Mauritius,16-07-2020,316259,503,416,315843,Africa
Mexico,16-07-2020,288554,1151,920,287634,Americas
Moldova,16-07-2020,339289,2058,1160,338129,Europe
Monaco,16-07-2020,359353,283,875,358478,Europe
Mongolia,16-07-2020,286979,1744,386,286593,Western Pacific
Montenegro,16-07-2020,251877,808,822,251055,Europe
Morocco,16-07-2020,388342,1043,129,388213,Eastern Mediterranean
Namibia,16-07-2020,356927,2443,547,356380,Africa
Nepal,16-07-2020,220600,584,768,219832,South-East Asia
Netherlands,16-07-2020,226978,1913,1043,225935,Europe
Netherlands,16-07-2020,236981,2411,1144,235837,Europe
Netherlands,16-07-2020,153845,851,416,153429,Europe
Netherlands,16-07-2020,7154,1321,41,7113,Europe
New Zealand,16-07-2020,406357,1145,1207,405150,Western Pacific
Nicaragua,16-07-2020,155088,133,473,154615,Americas
Niger,16-07-2020,37711,1816,1235,36476,Africa
Nigeria,16-07-2020,123422,1558,160,123262,Africa
North Macedonia,16-07-2020,209315,905,316,208999,Europe
Norway,16-07-2020,22495,261,721,21774,Europe
Oman,16-07-2020,441832,1635,1106,440726,Eastern Mediterranean
Pakistan,16-07-2020,298978,1249,1203,297775,Eastern Mediterranean
Panama,16-07-2020,402426,1628,741,401685,Americas
Papua New Guinea,16-07-2020,344141,604,254,343887,Western Pacific
Paraguay,16-07-2020,162944,2070,568,162376,Americas
Peru,16-07-2020,47116,15,622,46494,Americas
Philippines,16-07-2020,147748,1333,980,146768,Western Pacific
Poland,16-07-2020,172602,1606,194,172408,Europe
Portugal,16-07-2020,351490,2489,359,351131,Europe
Qatar,16-07-2020,209067,1628,567,208500,Eastern Mediterranean
Romania,16-07-2020,37620,520,299,37321,Europe
Russia,16-07-2020,362793,1834,999,361794,Europe
Rwanda,16-07-2020,378094,1336,794,377300,Africa
Saint Lucia,16-07-2020,112531,1881,284,112247,Americas
Saint Vincent and the Grenadines,16-07-2020,112517,392,384,112133,Americas
San Marino,16-07-2020,174423,271,792,173631,Europe
Saudi Arabia,16-07-2020,444871,1312,832,444039,Eastern Mediterranean
Senegal,16-07-2020,317481,1820,230,317251,Africa
Serbia,16-07-2020,358133,1965,413,357720,Europe
Seychelles,16-07-2020,214087,2292,599,213488,Africa
Singapore,16-07-2020,104084,1997,1010,103074,Western Pacific
Slovakia,16-07-2020,404174,584,1013,403161,Europe
Slovenia,16-07-2020,349114,815,405,348709,Europe
Somalia,16-07-2020,394941,1974,187,394754,Eastern Mediterranean
South Africa,16-07-2020,345056,2398,1072,343984,Africa
Spain,16-07-2020,29032,1580,734,28298,Europe
Sri Lanka,16-07-2020,240946,211,937,240009,South-East Asia
Sudan,16-07-2020,321459,1361,804,320655,Eastern Mediterranean
Suriname,16-07-2020,43982,1677,1161,42821,Americas
Sweden,16-07-2020,119194,310,1208,117986,Europe
Switzerland,16-07-2020,227366,1818,454,226912,Europe
Taiwan*,16-07-2020,338712,268,200,338512,Western Pacific
Tanzania,16-07-2020,214960,2141,51,214909,Africa
Thailand,16-07-2020,134523,1333,882,133641,South-East Asia
Togo,16-07-2020,360674,916,143,360531,Africa
Trinidad and Tobago,16-07-2020,103128,758,290,102838,Americas
Tunisia,16-07-2020,312871,1781,892,311979,Eastern Mediterranean
Turkey,16-07-2020,178574,209,205,178369,Europe
Uganda,16-07-2020,259043,1836,624,258419,Africa
Ukraine,16-07-2020,331818,206,749,331069,Europe
United Arab Emirates,16-07-2020,184912,3,596,184316,Eastern Mediterranean
United Kingdom,16-07-2020,71885,1103,310,71575,Europe
United Kingdom,16-07-2020,61164,1797,451,60713,Europe
United Kingdom,16-07-2020,213877,890,1033,212844,Europe
United Kingdom,16-07-2020,158760,505,356,158404,Europe
United Kingdom,16-07-2020,27673,1993,951,26722,Europe
United Kingdom,16-07-2020,349081,2038,1089,347992,Europe
United Kingdom,16-07-2020,320002,1774,167,319835,Europe
Uruguay,16-07-2020,81938,448,568,81370,Americas
US,16-07-2020,354792,187,343,354449,Americas
Uzbekistan,16-07-2020,303567,2403,91,303476,Europe
Venezuela,16-07-2020,317437,1998,1218,316219,Americas
Vietnam,16-07-2020,424569,1502,1103,423466,Western Pacific
Zambia,16-07-2020,400156,1087,348,399808,Africa
Zimbabwe,16-07-2020,193636,74,35,193601,Africa
Dominica,16-07-2020,363820,16,405,363415,Americas
Grenada,16-07-2020,54755,2364,102,54653,Americas
Mozambique,16-07-2020,148354,2097,137,148217,Africa
Syria,16-07-2020,5558,683,646,4912,Eastern Mediterranean
Timor-Leste,16-07-2020,372315,1145,1241,371074,South-East Asia
Belize,16-07-2020,135574,784,411,135163,Americas
Laos,16-07-2020,314973,240,56,314917,Western Pacific
Libya,16-07-2020,73163,487,336,72827,Eastern Mediterranean
West Bank and Gaza,16-07-2020,140648,2428,25,140623,Eastern Mediterranean
Guinea-Bissau,16-07-2020,56049,1229,949,55100,Africa
Mali,16-07-2020,438259,207,546,437713,Africa
Saint Kitts and Nevis,16-07-2020,442819,1827,1078,441741,Americas
Canada,16-07-2020,210446,1527,1177,209269,Americas
Canada,16-07-2020,268974,818,733,268241,Americas
Kosovo,16-07-2020,443343,2012,119,443224,Europe
Burma,16-07-2020,295817,1183,495,295322,South-East Asia
United Kingdom,16-07-2020,116224,2361,303,115921,Europe
United Kingdom,16-07-2020,53882,809,550,53332,Europe
United Kingdom,16-07-2020,320603,1769,917,319686,Europe
Botswana,16-07-2020,308740,215,902,307838,Africa
Burundi,16-07-2020,56032,2487,15,56017,Africa
Sierra Leone,16-07-2020,104947,1267,194,104753,Africa
Malawi,16-07-2020,147337,1555,718,146619,Africa
United Kingdom,16-07-2020,377751,2489,173,377578,Europe
France,16-07-2020,375047,904,153,374894,Europe
South Sudan,16-07-2020,420336,802,229,420107,Africa
Western Sahara,16-07-2020,434722,969,383,434339,Africa
Sao Tome and Principe,16-07-2020,390321,2225,94,390227,Africa
Yemen,16-07-2020,100940,1829,1208,99732,Eastern Mediterranean
Comoros,16-07-2020,395680,2467,130,395550,Africa
Tajikistan,16-07-2020,299193,1114,491,298702,Europe
Lesotho,16-07-2020,73564,156,153,73411,Africa
Afghanistan,17-07-2020,177043,1058,1006,176037,Eastern Mediterranean
Albania,17-07-2020,235409,952,433,234976,Europe
Algeria,17-07-2020,144843,1264,325,144518,Africa
Andorra,17-07-2020,312222,1135,1158,311064,Europe
Angola,17-07-2020,52695,1040,954,51741,Africa
Antigua and Barbuda,17-07-2020,72310,954,63,72247,Americas
Argentina,17-07-2020,359233,1342,1037,358196,Americas
Armenia,17-07-2020,347489,1274,230,347259,Europe
Australia,17-07-2020,292460,1568,1225,291235,Western Pacific
Australia,17-07-2020,186305,1078,1192,185113,Western Pacific
Australia,17-07-2020,89572,2276,1212,88360,Western Pacific
Australia,17-07-2020,2815,1883,296,2519,Western Pacific
Australia,17-07-2020,54247,1980,293,53954,Western Pacific
Australia,17-07-2020,297830,329,1017,296813,Western Pacific
Australia,17-07-2020,300911,872,41,300870,Western Pacific
Australia,17-07-2020,273199,1993,219,272980,Western Pacific
Austria,17-07-2020,392563,1960,346,392217,Europe
Azerbaijan,17-07-2020,363739,379,1017,362722,Europe
Bahamas,17-07-2020,44218,1740,508,43710,Americas
Bahrain,17-07-2020,406716,892,304,406412,Eastern Mediterranean
Bangladesh,17-07-2020,300042,2142,521,299521,South-East Asia
Barbados,17-07-2020,86444,1014,165,86279,Americas
Belarus,17-07-2020,401854,1202,187,401667,Europe
Belgium,17-07-2020,349869,771,330,349539,Europe
Benin,17-07-2020,395556,763,1089,394467,Africa
Bhutan,17-07-2020,436228,99,574,435654,South-East Asia
Bolivia,17-07-2020,166416,1511,477,165939,Americas
Bosnia and Herzegovina,17-07-2020,67651,1829,1192,66459,Europe
Brazil,17-07-2020,91387,2087,197,91190,Americas
Brunei,17-07-2020,73798,935,500,73298,Western Pacific
Bulgaria,17-07-2020,310662,1292,986,309676,Europe
Burkina Faso,17-07-2020,200875,1570,1105,199770,Africa
Cabo Verde,17-07-2020,402954,424,1168,401786,Africa
Cambodia,17-07-2020,92628,950,125,92503,Western Pacific
Cameroon,17-07-2020,338934,2313,385,338549,Africa
Canada,17-07-2020,180039,164,1138,178901,Americas
Canada,17-07-2020,272413,2051,199,272214,Americas
Canada,17-07-2020,123910,2153,873,123037,Americas
Canada,17-07-2020,435382,1735,1087,434295,Americas
Canada,17-07-2020,80466,79,373,80093,Americas
Canada,17-07-2020,157997,1679,342,157655,Americas
Canada,17-07-2020,264062,2095,659,263403,Americas
Canada,17-07-2020,61363,236,576,60787,Americas
Canada,17-07-2020,49503,2232,719,48784,Americas
Canada,17-07-2020,210831,1613,219,210612,Americas
Central African Republic,17-07-2020,423520,2333,69,423451,Africa
Chad,17-07-2020,229246,669,768,228478,Africa
Chile,17-07-2020,59720,1395,1201,58519,Americas
China,17-07-2020,356622,1000,255,356367,Western Pacific
China,17-07-2020,106527,479,935,105592,Western Pacific
China,17-07-2020,364241,1151,568,363673,Western Pacific
China,17-07-2020,435400,1750,867,434533,Western Pacific
China,17-07-2020,40098,292,1115,38983,Western Pacific
China,17-07-2020,392667,818,621,392046,Western Pacific
China,17-07-2020,221713,821,323,221390,Western Pacific
China,17-07-2020,173325,1422,585,172740,Western Pacific
China,17-07-2020,322352,374,112,322240,Western Pacific
China,17-07-2020,437419,1215,60,437359,Western Pacific
China,17-07-2020,385647,1344,1179,384468,Western Pacific
China,17-07-2020,16399,1432,890,15509,Western Pacific
China,17-07-2020,1511,207,396,1115,Western Pacific
China,17-07-2020,254093,163,402,253691,Western Pacific
China,17-07-2020,119237,351,540,118697,Western Pacific
China,17-07-2020,69735,1740,826,68909,Western Pacific
China,17-07-2020,78316,1948,374,77942,Western Pacific
China,17-07-2020,431169,1356,404,430765,Western Pacific
China,17-07-2020,363634,1874,683,362951,Western Pacific
China,17-07-2020,7204,884,817,6387,Western Pacific
China,17-07-2020,200544,1915,1192,199352,Western Pacific
China,17-07-2020,178168,1451,652,177516,Western Pacific
China,17-07-2020,257124,124,1236,255888,Western Pacific
China,17-07-2020,324094,413,506,323588,Western Pacific
China,17-07-2020,438531,1503,729,437802,Western Pacific
China,17-07-2020,374622,1669,364,374258,Western Pacific
China,17-07-2020,152996,2239,217,152779,Western Pacific
China,17-07-2020,227323,1313,256,227067,Western Pacific
China,17-07-2020,18207,217,781,17426,Western Pacific
China,17-07-2020,407339,1882,264,407075,Western Pacific
China,17-07-2020,112346,2072,886,111460,Western Pacific
China,17-07-2020,165253,1384,514,164739,Western Pacific
China,17-07-2020,118055,1903,316,117739,Western Pacific
Colombia,17-07-2020,202666,1735,50,202616,Americas
Congo (Brazzaville),17-07-2020,363054,420,482,362572,Africa
Congo (Kinshasa),17-07-2020,448981,2321,640,448341,Africa
Costa Rica,17-07-2020,3507,423,658,2849,Americas
Cote d'Ivoire,17-07-2020,228963,673,297,228666,Africa
Croatia,17-07-2020,346678,732,506,346172,Europe
Cuba,17-07-2020,371066,2088,73,370993,Americas
Cyprus,17-07-2020,104192,1193,233,103959,Europe
Czechia,17-07-2020,100970,1055,189,100781,Europe
Denmark,17-07-2020,55603,83,1053,54550,Europe
Greenland,17-07-2020,400434,1234,1059,399375,Europe
Denmark,17-07-2020,28724,1239,710,28014,Europe
Djibouti,17-07-2020,59551,1150,539,59012,Eastern Mediterranean
Dominican Republic,17-07-2020,137070,1547,804,136266,Americas
Ecuador,17-07-2020,364166,950,970,363196,Americas
Egypt,17-07-2020,213407,1756,671,212736,Eastern Mediterranean
El Salvador,17-07-2020,380428,1602,987,379441,Americas
Equatorial Guinea,17-07-2020,174072,1869,111,173961,Africa
Eritrea,17-07-2020,221808,2254,570,221238,Africa
Estonia,17-07-2020,17645,2047,520,17125,Europe
Eswatini,17-07-2020,186389,355,281,186108,Africa
Ethiopia,17-07-2020,71020,1847,923,70097,Africa
Fiji,17-07-2020,443104,1912,1127,441977,Western Pacific
Finland,17-07-2020,174812,549,1166,173646,Europe
France,17-07-2020,437739,1266,97,437642,Europe
France,17-07-2020,162601,353,526,162075,Europe
France,17-07-2020,182663,1398,730,181933,Europe
France,17-07-2020,334198,1084,722,333476,Europe
France,17-07-2020,337535,824,303,337232,Europe
France,17-07-2020,47718,2395,160,47558,Europe
France,17-07-2020,88145,1425,38,88107,Europe
France,17-07-2020,91664,47,316,91348,Europe
France,17-07-2020,325767,2023,1129,324638,Europe
France,17-07-2020,371435,1836,803,370632,Europe
Gabon,17-07-2020,425902,1330,1132,424770,Africa
Gambia,17-07-2020,131157,1977,1133,130024,Africa
Georgia,17-07-2020,141393,378,642,140751,Europe
Germany,17-07-2020,216335,479,1171,215164,Europe
Ghana,17-07-2020,109800,88,179,109621,Africa
Greece,17-07-2020,171275,831,87,171188,Europe
Guatemala,17-07-2020,154171,1218,205,153966,Americas
Guinea,17-07-2020,144872,959,977,143895,Africa
Guyana,17-07-2020,133686,832,26,133660,Americas
Haiti,17-07-2020,197573,2277,1075,196498,Americas
Holy See,17-07-2020,252276,75,314,251962,Europe
Honduras,17-07-2020,80559,466,687,79872,Americas
Hungary,17-07-2020,300573,2145,468,300105,Europe
Iceland,17-07-2020,372231,2075,1033,371198,Europe
India,17-07-2020,162049,255,404,161645,South-East Asia
Indonesia,17-07-2020,24791,1101,18,24773,South-East Asia
Iran,17-07-2020,204022,421,945,203077,Eastern Mediterranean
Iraq,17-07-2020,111041,456,442,110599,Eastern Mediterranean
Ireland,17-07-2020,221614,497,483,221131,Europe
Israel,17-07-2020,303257,153,953,302304,Europe
Italy,17-07-2020,415861,2412,427,415434,Europe
Jamaica,17-07-2020,377402,128,106,377296,Americas
Japan,17-07-2020,391975,1620,947,391028,Western Pacific
Jordan,17-07-2020,363357,173,148,363209,Eastern Mediterranean
Kazakhstan,17-07-2020,7883,1274,372,7511,Europe
Kenya,17-07-2020,117710,586,78,117632,Africa
South Korea,17-07-2020,403279,1366,570,402709,Western Pacific
Kuwait,17-07-2020,437913,1119,1135,436778,Eastern Mediterranean
Kyrgyzstan,17-07-2020,420255,780,1210,419045,Europe
Latvia,17-07-2020,281182,2453,804,280378,Europe
Lebanon,17-07-2020,430216,1506,277,429939,Eastern Mediterranean
Liberia,17-07-2020,373792,2115,232,373560,Africa
Liechtenstein,17-07-2020,373707,2302,606,373101,Europe
Lithuania,17-07-2020,106170,795,185,105985,Europe
Luxembourg,17-07-2020,404904,1025,781,404123,Europe
Madagascar,17-07-2020,320920,368,57,320863,Africa
Malaysia,17-07-2020,184423,599,1217,183206,Western Pacific
Maldives,17-07-2020,187175,2263,449,186726,South-East Asia
Malta,17-07-2020,30439,664,485,29954,Europe
Mauritania,17-07-2020,7658,1662,602,7056,Africa
Mauritius,17-07-2020,225097,1888,863,224234,Africa
Mexico,17-07-2020,49472,716,1130,48342,Americas
Moldova,17-07-2020,372283,1252,438,371845,Europe
Monaco,17-07-2020,194350,339,683,193667,Europe
Mongolia,17-07-2020,326198,1560,240,325958,Western Pacific
Montenegro,17-07-2020,117733,293,478,117255,Europe
Morocco,17-07-2020,310491,200,1021,309470,Eastern Mediterranean
Namibia,17-07-2020,236340,795,787,235553,Africa
Nepal,17-07-2020,126940,1615,474,126466,South-East Asia
Netherlands,17-07-2020,285284,836,55,285229,Europe
Netherlands,17-07-2020,216619,2307,775,215844,Europe
Netherlands,17-07-2020,163093,1755,1043,162050,Europe
Netherlands,17-07-2020,34290,1172,392,33898,Europe
New Zealand,17-07-2020,4834,1379,1155,3679,Western Pacific
Nicaragua,17-07-2020,172568,1386,177,172391,Americas
Niger,17-07-2020,238077,1100,354,237723,Africa
Nigeria,17-07-2020,359486,1941,294,359192,Africa
North Macedonia,17-07-2020,304809,1922,316,304493,Europe
Norway,17-07-2020,295115,534,1177,293938,Europe
Oman,17-07-2020,346865,1673,962,345903,Eastern Mediterranean
Pakistan,17-07-2020,438153,381,344,437809,Eastern Mediterranean
Panama,17-07-2020,239672,1631,54,239618,Americas
Papua New Guinea,17-07-2020,445081,187,393,444688,Western Pacific
Paraguay,17-07-2020,49390,880,800,48590,Americas
Peru,17-07-2020,15510,2111,1038,14472,Americas
Philippines,17-07-2020,229023,1136,295,228728,Western Pacific
Poland,17-07-2020,49338,1169,661,48677,Europe
Portugal,17-07-2020,61193,245,137,61056,Europe
Qatar,17-07-2020,203546,1867,372,203174,Eastern Mediterranean
Romania,17-07-2020,247642,2117,481,247161,Europe
Russia,17-07-2020,427840,1019,723,427117,Europe
Rwanda,17-07-2020,228302,721,71,228231,Africa
Saint Lucia,17-07-2020,215521,23,469,215052,Americas
Saint Vincent and the Grenadines,17-07-2020,399124,509,1182,397942,Americas
San Marino,17-07-2020,389360,1731,692,388668,Europe
Saudi Arabia,17-07-2020,338504,1258,1015,337489,Eastern Mediterranean
Senegal,17-07-2020,330956,1027,137,330819,Africa
Serbia,17-07-2020,23129,1278,583,22546,Europe
Seychelles,17-07-2020,422191,593,625,421566,Africa
Singapore,17-07-2020,252693,572,616,252077,Western Pacific
Slovakia,17-07-2020,183473,396,181,183292,Europe
Slovenia,17-07-2020,225474,2217,109,225365,Europe
Somalia,17-07-2020,375649,2408,717,374932,Eastern Mediterranean
South Africa,17-07-2020,418360,13,1191,417169,Africa
Spain,17-07-2020,338476,1117,253,338223,Europe
Sri Lanka,17-07-2020,365199,1635,323,364876,South-East Asia
Sudan,17-07-2020,281209,1870,926,280283,Eastern Mediterranean
Suriname,17-07-2020,100077,726,1048,99029,Americas
Sweden,17-07-2020,349819,1161,542,349277,Europe
Switzerland,17-07-2020,90494,916,466,90028,Europe
Taiwan*,17-07-2020,279014,1702,539,278475,Western Pacific
Tanzania,17-07-2020,444247,2143,360,443887,Africa
Thailand,17-07-2020,266917,539,506,266411,South-East Asia
Togo,17-07-2020,303729,493,252,303477,Africa
Trinidad and Tobago,17-07-2020,212061,1471,745,211316,Americas
Tunisia,17-07-2020,17985,2483,208,17777,Eastern Mediterranean
Turkey,17-07-2020,217214,1944,886,216328,Europe
Uganda,17-07-2020,38768,1109,630,38138,Africa
Ukraine,17-07-2020,151612,2122,523,151089,Europe
United Arab Emirates,17-07-2020,367415,518,329,367086,Eastern Mediterranean
United Kingdom,17-07-2020,296781,2268,647,296134,Europe
United Kingdom,17-07-2020,173658,2072,164,173494,Europe
United Kingdom,17-07-2020,433054,2483,269,432785,Europe
United Kingdom,17-07-2020,409378,544,368,409010,Europe
United Kingdom,17-07-2020,33085,1704,857,32228,Europe
United Kingdom,17-07-2020,91831,1277,22,91809,Europe
United Kingdom,17-07-2020,370460,1131,923,369537,Europe
Uruguay,17-07-2020,39410,2037,622,38788,Americas
US,17-07-2020,320689,503,620,320069,Americas
Uzbekistan,17-07-2020,272393,1697,136,272257,Europe
Venezuela,17-07-2020,250081,450,357,249724,Americas
Vietnam,17-07-2020,276419,2123,436,275983,Western Pacific
Zambia,17-07-2020,221876,1475,549,221327,Africa
Zimbabwe,17-07-2020,113319,746,1226,112093,Africa
Dominica,17-07-2020,308931,586,564,308367,Americas
Grenada,17-07-2020,260087,732,388,259699,Americas
Mozambique,17-07-2020,359697,1454,902,358795,Africa
Syria,17-07-2020,122250,218,536,121714,Eastern Mediterranean
Timor-Leste,17-07-2020,286697,724,1200,285497,South-East Asia
Belize,17-07-2020,304740,2066,356,304384,Americas
Laos,17-07-2020,248452,1345,989,247463,Western Pacific
Libya,17-07-2020,143667,174,629,143038,Eastern Mediterranean
West Bank and Gaza,17-07-2020,340331,2452,545,339786,Eastern Mediterranean
Guinea-Bissau,17-07-2020,55202,1607,182,55020,Africa
Mali,17-07-2020,335144,541,569,334575,Africa
Saint Kitts and Nevis,17-07-2020,61937,1576,741,61196,Americas
Canada,17-07-2020,307282,659,325,306957,Americas
Canada,17-07-2020,105132,361,1183,103949,Americas
Kosovo,17-07-2020,247570,2481,366,247204,Europe
Burma,17-07-2020,132982,2216,500,132482,South-East Asia
United Kingdom,17-07-2020,115987,2376,1130,114857,Europe
United Kingdom,17-07-2020,63892,2449,875,63017,Europe
United Kingdom,17-07-2020,95996,2181,881,95115,Europe
Botswana,17-07-2020,435482,976,123,435359,Africa
Burundi,17-07-2020,259896,1530,682,259214,Africa
Sierra Leone,17-07-2020,107480,1492,1104,106376,Africa
Malawi,17-07-2020,314933,1894,237,314696,Africa
United Kingdom,17-07-2020,56007,503,579,55428,Europe
France,17-07-2020,385315,1717,609,384706,Europe
South Sudan,17-07-2020,301114,1552,294,300820,Africa
Western Sahara,17-07-2020,170068,225,869,169199,Africa
Sao Tome and Principe,17-07-2020,404146,2469,229,403917,Africa
Yemen,17-07-2020,126455,1738,440,126015,Eastern Mediterranean
Comoros,17-07-2020,386200,657,1250,384950,Africa
Tajikistan,17-07-2020,448210,847,859,447351,Europe
Lesotho,17-07-2020,13664,836,629,13035,Africa
Afghanistan,18-07-2020,211761,983,335,211426,Eastern Mediterranean
Albania,18-07-2020,394230,76,852,393378,Europe
Algeria,18-07-2020,316062,1194,420,315642,Africa
Andorra,18-07-2020,262968,1761,564,262404,Europe
Angola,18-07-2020,109157,2063,502,108655,Africa
Antigua and Barbuda,18-07-2020,232113,876,10,232103,Americas
Argentina,18-07-2020,35349,557,1053,34296,Americas
Armenia,18-07-2020,447308,1998,99,447209,Europe
Australia,18-07-2020,758,858,768,-10,Western Pacific
Australia,18-07-2020,145463,159,1214,144249,Western Pacific
Australia,18-07-2020,59874,268,1130,58744,Western Pacific
Australia,18-07-2020,131446,1642,241,131205,Western Pacific
Australia,18-07-2020,241844,2158,227,241617,Western Pacific
Australia,18-07-2020,110597,1444,365,110232,Western Pacific
Australia,18-07-2020,170086,1705,261,169825,Western Pacific
Australia,18-07-2020,64379,1108,536,63843,Western Pacific
Austria,18-07-2020,138356,2472,997,137359,Europe
Azerbaijan,18-07-2020,326659,263,202,326457,Europe
Bahamas,18-07-2020,247698,1290,499,247199,Americas
Bahrain,18-07-2020,23261,1867,1154,22107,Eastern Mediterranean
Bangladesh,18-07-2020,195626,1234,823,194803,South-East Asia
Barbados,18-07-2020,196796,758,153,196643,Americas
Belarus,18-07-2020,376700,501,826,375874,Europe
Belgium,18-07-2020,162987,1119,1140,161847,Europe
Benin,18-07-2020,295296,767,781,294515,Africa
Bhutan,18-07-2020,329478,1179,233,329245,South-East Asia
Bolivia,18-07-2020,358836,930,1125,357711,Americas
Bosnia and Herzegovina,18-07-2020,309275,214,1032,308243,Europe
Brazil,18-07-2020,288480,1220,1205,287275,Americas
Brunei,18-07-2020,331255,716,1188,330067,Western Pacific
Bulgaria,18-07-2020,62341,1559,1204,61137,Europe
Burkina Faso,18-07-2020,234431,1294,1011,233420,Africa
Cabo Verde,18-07-2020,227402,1912,1032,226370,Africa
Cambodia,18-07-2020,353730,529,756,352974,Western Pacific
Cameroon,18-07-2020,29803,1744,1051,28752,Africa
Canada,18-07-2020,189374,1231,827,188547,Americas
Canada,18-07-2020,175003,1660,987,174016,Americas
Canada,18-07-2020,434373,1202,1117,433256,Americas
Canada,18-07-2020,19702,1717,534,19168,Americas
Canada,18-07-2020,270552,2067,809,269743,Americas
Canada,18-07-2020,134186,1281,1210,132976,Americas
Canada,18-07-2020,445356,1218,522,444834,Americas
Canada,18-07-2020,413991,1626,990,413001,Americas
Canada,18-07-2020,384549,1387,796,383753,Americas
Canada,18-07-2020,167569,727,443,167126,Americas
Central African Republic,18-07-2020,50425,192,873,49552,Africa
Chad,18-07-2020,165165,767,526,164639,Africa
Chile,18-07-2020,76978,325,1149,75829,Americas
China,18-07-2020,392883,1693,852,392031,Western Pacific
China,18-07-2020,362481,1448,1083,361398,Western Pacific
China,18-07-2020,361046,2010,1095,359951,Western Pacific
China,18-07-2020,101055,817,898,100157,Western Pacific
China,18-07-2020,267301,1825,1029,266272,Western Pacific
China,18-07-2020,126750,2171,535,126215,Western Pacific
China,18-07-2020,143006,1980,672,142334,Western Pacific
China,18-07-2020,256676,1508,774,255902,Western Pacific
China,18-07-2020,244269,2322,136,244133,Western Pacific
China,18-07-2020,811,1959,256,555,Western Pacific
China,18-07-2020,143057,385,227,142830,Western Pacific
China,18-07-2020,176018,358,1071,174947,Western Pacific
China,18-07-2020,8315,715,273,8042,Western Pacific
China,18-07-2020,182677,1532,416,182261,Western Pacific
China,18-07-2020,143223,1622,848,142375,Western Pacific
China,18-07-2020,45482,2414,1156,44326,Western Pacific
China,18-07-2020,416077,1248,267,415810,Western Pacific
China,18-07-2020,209635,92,346,209289,Western Pacific
China,18-07-2020,446814,319,1055,445759,Western Pacific
China,18-07-2020,251793,134,1091,250702,Western Pacific
China,18-07-2020,398573,1522,945,397628,Western Pacific
China,18-07-2020,438751,1550,910,437841,Western Pacific
China,18-07-2020,182804,2307,1181,181623,Western Pacific
China,18-07-2020,406138,438,913,405225,Western Pacific
China,18-07-2020,441966,483,1127,440839,Western Pacific
China,18-07-2020,358068,2227,740,357328,Western Pacific
China,18-07-2020,257338,999,657,256681,Western Pacific
China,18-07-2020,103171,1487,501,102670,Western Pacific
China,18-07-2020,421557,1423,66,421491,Western Pacific
China,18-07-2020,164882,2446,669,164213,Western Pacific
China,18-07-2020,346587,1019,220,346367,Western Pacific
China,18-07-2020,259653,816,657,258996,Western Pacific
China,18-07-2020,388370,2439,799,387571,Western Pacific
Colombia,18-07-2020,232704,177,1165,231539,Americas
Congo (Brazzaville),18-07-2020,120379,2327,1085,119294,Africa
Congo (Kinshasa),18-07-2020,194261,1458,585,193676,Africa
Costa Rica,18-07-2020,297862,1200,540,297322,Americas
Cote d'Ivoire,18-07-2020,282059,12,733,281326,Africa
Croatia,18-07-2020,411235,2158,823,410412,Europe
Cuba,18-07-2020,354239,2284,498,353741,Americas
Cyprus,18-07-2020,440885,1021,1067,439818,Europe
Czechia,18-07-2020,375287,2116,655,374632,Europe
Denmark,18-07-2020,338182,863,426,337756,Europe
Greenland,18-07-2020,180059,458,318,179741,Europe
Denmark,18-07-2020,223772,1860,522,223250,Europe
Djibouti,18-07-2020,204193,1138,1189,203004,Eastern Mediterranean
Dominican Republic,18-07-2020,198126,1044,1028,197098,Americas
Ecuador,18-07-2020,195089,2136,87,195002,Americas
Egypt,18-07-2020,97739,898,1105,96634,Eastern Mediterranean
El Salvador,18-07-2020,440995,1547,732,440263,Americas
Equatorial Guinea,18-07-2020,158060,1316,749,157311,Africa
Eritrea,18-07-2020,317845,732,1164,316681,Africa
Estonia,18-07-2020,345696,1567,4,345692,Europe
Eswatini,18-07-2020,178687,1224,525,178162,Africa
Ethiopia,18-07-2020,234382,2246,206,234176,Africa
Fiji,18-07-2020,300484,427,690,299794,Western Pacific
Finland,18-07-2020,302076,1231,484,301592,Europe
France,18-07-2020,166865,134,1207,165658,Europe
France,18-07-2020,387606,430,658,386948,Europe
France,18-07-2020,130378,2021,30,130348,Europe
France,18-07-2020,47038,1494,506,46532,Europe
France,18-07-2020,109682,1960,658,109024,Europe
France,18-07-2020,329996,1638,49,329947,Europe
France,18-07-2020,418312,1762,315,417997,Europe
France,18-07-2020,258761,1135,1098,257663,Europe
France,18-07-2020,354514,249,591,353923,Europe
France,18-07-2020,79088,1445,1181,77907,Europe
Gabon,18-07-2020,332238,1328,1043,331195,Africa
Gambia,18-07-2020,358174,1989,374,357800,Africa
Georgia,18-07-2020,49614,1983,182,49432,Europe
Germany,18-07-2020,378506,2074,545,377961,Europe
Ghana,18-07-2020,202540,1582,468,202072,Africa
Greece,18-07-2020,234844,334,548,234296,Europe
Guatemala,18-07-2020,324320,1555,385,323935,Americas
Guinea,18-07-2020,227837,1040,1080,226757,Africa
Guyana,18-07-2020,122399,2166,1175,121224,Americas
Haiti,18-07-2020,382729,2367,892,381837,Americas
Holy See,18-07-2020,366844,2244,68,366776,Europe
Honduras,18-07-2020,319522,1709,526,318996,Americas
Hungary,18-07-2020,260474,688,326,260148,Europe
Iceland,18-07-2020,406921,1369,379,406542,Europe
India,18-07-2020,27072,1393,112,26960,South-East Asia
Indonesia,18-07-2020,333721,2211,1188,332533,South-East Asia
Iran,18-07-2020,230953,1494,929,230024,Eastern Mediterranean
Iraq,18-07-2020,261811,2025,677,261134,Eastern Mediterranean
Ireland,18-07-2020,395129,1651,20,395109,Europe
Israel,18-07-2020,279420,71,847,278573,Europe
Italy,18-07-2020,217731,1670,208,217523,Europe
Jamaica,18-07-2020,327820,2355,1222,326598,Americas
Japan,18-07-2020,446433,2071,320,446113,Western Pacific
Jordan,18-07-2020,141821,2384,469,141352,Eastern Mediterranean
Kazakhstan,18-07-2020,179907,1375,131,179776,Europe
Kenya,18-07-2020,114148,1492,130,114018,Africa
South Korea,18-07-2020,23483,128,918,22565,Western Pacific
Kuwait,18-07-2020,40516,1204,963,39553,Eastern Mediterranean
Kyrgyzstan,18-07-2020,362046,2063,874,361172,Europe
Latvia,18-07-2020,410312,2227,88,410224,Europe
Lebanon,18-07-2020,155449,2349,751,154698,Eastern Mediterranean
Liberia,18-07-2020,5525,2300,450,5075,Africa
Liechtenstein,18-07-2020,333743,735,154,333589,Europe
Lithuania,18-07-2020,123977,600,1207,122770,Europe
Luxembourg,18-07-2020,419998,841,1092,418906,Europe
Madagascar,18-07-2020,194495,2323,1173,193322,Africa
Malaysia,18-07-2020,380044,1842,1120,378924,Western Pacific
Maldives,18-07-2020,223628,644,1188,222440,South-East Asia
Malta,18-07-2020,205795,1918,171,205624,Europe
Mauritania,18-07-2020,373609,2044,1244,372365,Africa
Mauritius,18-07-2020,65591,2054,879,64712,Africa
Mexico,18-07-2020,261617,899,896,260721,Americas
Moldova,18-07-2020,286276,1056,497,285779,Europe
Monaco,18-07-2020,282794,115,810,281984,Europe
Mongolia,18-07-2020,304099,517,638,303461,Western Pacific
Montenegro,18-07-2020,191777,508,930,190847,Europe
Morocco,18-07-2020,108514,1051,399,108115,Eastern Mediterranean
Namibia,18-07-2020,121521,1071,843,120678,Africa
Nepal,18-07-2020,377534,770,702,376832,South-East Asia
Netherlands,18-07-2020,303629,1835,214,303415,Europe
Netherlands,18-07-2020,438768,1886,476,438292,Europe
Netherlands,18-07-2020,433922,240,940,432982,Europe
Netherlands,18-07-2020,187739,1142,768,186971,Europe
New Zealand,18-07-2020,340719,1471,945,339774,Western Pacific
Nicaragua,18-07-2020,354002,1384,1181,352821,Americas
Niger,18-07-2020,411654,971,1002,410652,Africa
Nigeria,18-07-2020,191516,1240,802,190714,Africa
North Macedonia,18-07-2020,68884,1035,1242,67642,Europe
Norway,18-07-2020,162705,586,709,161996,Europe
Oman,18-07-2020,184101,730,231,183870,Eastern Mediterranean
Pakistan,18-07-2020,70105,624,285,69820,Eastern Mediterranean
Panama,18-07-2020,30262,1232,939,29323,Americas
Papua New Guinea,18-07-2020,62391,544,553,61838,Western Pacific
Paraguay,18-07-2020,55354,906,470,54884,Americas
Peru,18-07-2020,167633,767,189,167444,Americas
Philippines,18-07-2020,432262,647,175,432087,Western Pacific
Poland,18-07-2020,303986,388,1228,302758,Europe
Portugal,18-07-2020,95036,2365,35,95001,Europe
Qatar,18-07-2020,168550,1146,628,167922,Eastern Mediterranean
Romania,18-07-2020,131615,203,969,130646,Europe
Russia,18-07-2020,319317,1349,1156,318161,Europe
Rwanda,18-07-2020,195907,993,33,195874,Africa
Saint Lucia,18-07-2020,306651,2269,319,306332,Americas
Saint Vincent and the Grenadines,18-07-2020,114381,273,1219,113162,Americas
San Marino,18-07-2020,255373,1469,77,255296,Europe
Saudi Arabia,18-07-2020,31980,2235,661,31319,Eastern Mediterranean
Senegal,18-07-2020,295641,523,284,295357,Africa
Serbia,18-07-2020,221496,133,840,220656,Europe
Seychelles,18-07-2020,350724,552,606,350118,Africa
Singapore,18-07-2020,232016,2308,965,231051,Western Pacific
Slovakia,18-07-2020,411848,1601,1175,410673,Europe
Slovenia,18-07-2020,237742,1998,215,237527,Europe
Somalia,18-07-2020,255638,2367,258,255380,Eastern Mediterranean
South Africa,18-07-2020,12457,2239,988,11469,Africa
Spain,18-07-2020,285928,981,815,285113,Europe
Sri Lanka,18-07-2020,403469,1291,137,403332,South-East Asia
Sudan,18-07-2020,377098,812,430,376668,Eastern Mediterranean
Suriname,18-07-2020,15003,2009,1103,13900,Americas
Sweden,18-07-2020,219303,73,1147,218156,Europe
Switzerland,18-07-2020,291704,770,113,291591,Europe
Taiwan*,18-07-2020,281023,2243,537,280486,Western Pacific
Tanzania,18-07-2020,200430,2413,494,199936,Africa
Thailand,18-07-2020,363792,664,334,363458,South-East Asia
Togo,18-07-2020,322930,2013,763,322167,Africa
Trinidad and Tobago,18-07-2020,277692,517,638,277054,Americas
Tunisia,18-07-2020,810,2038,503,307,Eastern Mediterranean
Turkey,18-07-2020,212570,1398,1199,211371,Europe
Uganda,18-07-2020,130586,1263,1060,129526,Africa
Ukraine,18-07-2020,256560,2214,371,256189,Europe
United Arab Emirates,18-07-2020,226341,13,172,226169,Eastern Mediterranean
United Kingdom,18-07-2020,126132,1159,608,125524,Europe
United Kingdom,18-07-2020,135466,584,445,135021,Europe
United Kingdom,18-07-2020,340762,1974,1073,339689,Europe
United Kingdom,18-07-2020,430369,1988,695,429674,Europe
United Kingdom,18-07-2020,19386,345,228,19158,Europe
United Kingdom,18-07-2020,413106,1033,340,412766,Europe
United Kingdom,18-07-2020,127722,551,19,127703,Europe
Uruguay,18-07-2020,143614,1341,206,143408,Americas
US,18-07-2020,104608,1526,1183,103425,Americas
Uzbekistan,18-07-2020,204753,786,687,204066,Europe
Venezuela,18-07-2020,391216,1152,517,390699,Americas
Vietnam,18-07-2020,149259,1432,53,149206,Western Pacific
Zambia,18-07-2020,424842,1352,207,424635,Africa
Zimbabwe,18-07-2020,113761,2028,1023,112738,Africa
Dominica,18-07-2020,245569,1900,243,245326,Americas
Grenada,18-07-2020,168290,363,512,167778,Americas
Mozambique,18-07-2020,182676,148,115,182561,Africa
Syria,18-07-2020,371711,959,1174,370537,Eastern Mediterranean
Timor-Leste,18-07-2020,320729,1328,8,320721,South-East Asia
Belize,18-07-2020,361199,2001,116,361083,Americas
Laos,18-07-2020,11019,1026,812,10207,Western Pacific
Libya,18-07-2020,228181,2077,627,227554,Eastern Mediterranean
West Bank and Gaza,18-07-2020,228574,1230,504,228070,Eastern Mediterranean
Guinea-Bissau,18-07-2020,447212,916,226,446986,Africa
Mali,18-07-2020,414032,1448,206,413826,Africa
Saint Kitts and Nevis,18-07-2020,397999,191,644,397355,Americas
Canada,18-07-2020,377237,557,73,377164,Americas
Canada,18-07-2020,356822,1654,820,356002,Americas
Kosovo,18-07-2020,336835,665,1129,335706,Europe
Burma,18-07-2020,198656,407,450,198206,South-East Asia
United Kingdom,18-07-2020,222010,719,379,221631,Europe
United Kingdom,18-07-2020,174127,2220,1036,173091,Europe
United Kingdom,18-07-2020,265981,832,73,265908,Europe
Botswana,18-07-2020,357146,2044,1157,355989,Africa
Burundi,18-07-2020,321886,481,1044,320842,Africa
Sierra Leone,18-07-2020,163198,814,1156,162042,Africa
Malawi,18-07-2020,41972,1875,634,41338,Africa
United Kingdom,18-07-2020,330053,984,308,329745,Europe
France,18-07-2020,386706,2117,889,385817,Europe
South Sudan,18-07-2020,19562,1149,797,18765,Africa
Western Sahara,18-07-2020,234298,894,78,234220,Africa
Sao Tome and Principe,18-07-2020,327104,2153,76,327028,Africa
Yemen,18-07-2020,210522,2215,151,210371,Eastern Mediterranean
Comoros,18-07-2020,435519,610,885,434634,Africa
Tajikistan,18-07-2020,209672,2345,728,208944,Europe
Lesotho,18-07-2020,171298,1652,1191,170107,Africa
Afghanistan,19-07-2020,255275,1348,93,255182,Eastern Mediterranean
Albania,19-07-2020,270064,1872,603,269461,Europe
Algeria,19-07-2020,154075,2312,1072,153003,Africa
Andorra,19-07-2020,73035,1565,944,72091,Europe
Angola,19-07-2020,118302,1419,1123,117179,Africa
Antigua and Barbuda,19-07-2020,235729,1374,799,234930,Americas
Argentina,19-07-2020,301687,894,984,300703,Americas
Armenia,19-07-2020,232760,1665,631,232129,Europe
Australia,19-07-2020,179365,305,1016,178349,Western Pacific
Australia,19-07-2020,273641,1355,495,273146,Western Pacific
Australia,19-07-2020,95506,1323,221,95285,Western Pacific
Australia,19-07-2020,64092,283,568,63524,Western Pacific
Australia,19-07-2020,152032,1525,1091,150941,Western Pacific
Australia,19-07-2020,407310,766,319,406991,Western Pacific
Australia,19-07-2020,178288,908,131,178157,Western Pacific
Australia,19-07-2020,223341,1379,894,222447,Western Pacific
Austria,19-07-2020,33892,2038,737,33155,Europe
Azerbaijan,19-07-2020,200300,877,1096,199204,Europe
Bahamas,19-07-2020,121109,2143,81,121028,Americas
Bahrain,19-07-2020,292348,1332,1199,291149,Eastern Mediterranean
Bangladesh,19-07-2020,142222,806,350,141872,South-East Asia
Barbados,19-07-2020,162547,231,175,162372,Americas
Belarus,19-07-2020,97409,2063,994,96415,Europe
Belgium,19-07-2020,149880,692,696,149184,Europe
Benin,19-07-2020,225125,854,703,224422,Africa
Bhutan,19-07-2020,380220,1096,40,380180,South-East Asia
Bolivia,19-07-2020,200111,421,166,199945,Americas
Bosnia and Herzegovina,19-07-2020,420617,672,601,420016,Europe
Brazil,19-07-2020,261242,1821,983,260259,Americas
Brunei,19-07-2020,210495,731,820,209675,Western Pacific
Bulgaria,19-07-2020,85499,2036,601,84898,Europe
Burkina Faso,19-07-2020,73827,145,175,73652,Africa
Cabo Verde,19-07-2020,104849,2429,1069,103780,Africa
Cambodia,19-07-2020,153929,332,471,153458,Western Pacific
Cameroon,19-07-2020,969,2129,645,324,Africa
Canada,19-07-2020,133254,2290,878,132376,Americas
Canada,19-07-2020,429414,1917,231,429183,Americas
Canada,19-07-2020,171776,2346,547,171229,Americas
Canada,19-07-2020,295342,1222,15,295327,Americas
Canada,19-07-2020,346432,1473,882,345550,Americas
Canada,19-07-2020,26907,1530,1003,25904,Americas
Canada,19-07-2020,7167,1458,1238,5929,Americas
Canada,19-07-2020,187895,1167,105,187790,Americas
Canada,19-07-2020,269917,370,1077,268840,Americas
Canada,19-07-2020,261389,596,366,261023,Americas
Central African Republic,19-07-2020,369100,466,1076,368024,Africa
Chad,19-07-2020,41708,226,114,41594,Africa
Chile,19-07-2020,173275,1345,1093,172182,Americas
China,19-07-2020,406575,92,200,406375,Western Pacific
China,19-07-2020,345410,209,817,344593,Western Pacific
China,19-07-2020,160416,357,729,159687,Western Pacific
China,19-07-2020,201594,2386,762,200832,Western Pacific
China,19-07-2020,152976,755,828,152148,Western Pacific
China,19-07-2020,110676,1539,1052,109624,Western Pacific
China,19-07-2020,45631,2090,793,44838,Western Pacific
China,19-07-2020,440442,486,421,440021,Western Pacific
China,19-07-2020,297184,1384,673,296511,Western Pacific
China,19-07-2020,418242,135,263,417979,Western Pacific
China,19-07-2020,225020,62,881,224139,Western Pacific
China,19-07-2020,268649,2246,1055,267594,Western Pacific
China,19-07-2020,170011,2237,836,169175,Western Pacific
China,19-07-2020,413175,1778,2,413173,Western Pacific
China,19-07-2020,232900,1534,975,231925,Western Pacific
China,19-07-2020,198710,2499,933,197777,Western Pacific
China,19-07-2020,305593,185,677,304916,Western Pacific
China,19-07-2020,113127,260,324,112803,Western Pacific
China,19-07-2020,311567,2047,882,310685,Western Pacific
China,19-07-2020,182031,2385,682,181349,Western Pacific
China,19-07-2020,331958,1084,835,331123,Western Pacific
China,19-07-2020,137693,130,348,137345,Western Pacific
China,19-07-2020,41667,172,713,40954,Western Pacific
China,19-07-2020,225625,576,1235,224390,Western Pacific
China,19-07-2020,400653,1837,427,400226,Western Pacific
China,19-07-2020,321363,1639,538,320825,Western Pacific
China,19-07-2020,388531,1387,797,387734,Western Pacific
China,19-07-2020,236258,669,262,235996,Western Pacific
China,19-07-2020,383480,358,11,383469,Western Pacific
China,19-07-2020,285584,1948,1069,284515,Western Pacific
China,19-07-2020,115328,1229,903,114425,Western Pacific
China,19-07-2020,129421,1070,362,129059,Western Pacific
China,19-07-2020,217125,1844,681,216444,Western Pacific
Colombia,19-07-2020,327592,2157,1079,326513,Americas
Congo (Brazzaville),19-07-2020,148493,1998,488,148005,Africa
Congo (Kinshasa),19-07-2020,296476,2306,451,296025,Africa
Costa Rica,19-07-2020,11258,1827,231,11027,Americas
Cote d'Ivoire,19-07-2020,114838,25,938,113900,Africa
Croatia,19-07-2020,252474,1486,762,251712,Europe
Cuba,19-07-2020,328425,154,1191,327234,Americas
Cyprus,19-07-2020,285219,1311,565,284654,Europe
Czechia,19-07-2020,175486,1222,301,175185,Europe
Denmark,19-07-2020,4675,1143,1146,3529,Europe
Greenland,19-07-2020,265390,1383,261,265129,Europe
Denmark,19-07-2020,36910,1999,785,36125,Europe
Djibouti,19-07-2020,316512,1706,982,315530,Eastern Mediterranean
Dominican Republic,19-07-2020,150480,703,871,149609,Americas
Ecuador,19-07-2020,184076,443,376,183700,Americas
Egypt,19-07-2020,242412,2028,1158,241254,Eastern Mediterranean
El Salvador,19-07-2020,34851,2262,501,34350,Americas
Equatorial Guinea,19-07-2020,58104,856,958,57146,Africa
Eritrea,19-07-2020,35478,1737,898,34580,Africa
Estonia,19-07-2020,263041,945,858,262183,Europe
Eswatini,19-07-2020,22039,796,275,21764,Africa
Ethiopia,19-07-2020,72914,665,426,72488,Africa
Fiji,19-07-2020,140920,28,132,140788,Western Pacific
Finland,19-07-2020,114189,448,904,113285,Europe
France,19-07-2020,284940,2158,750,284190,Europe
France,19-07-2020,351632,450,879,350753,Europe
France,19-07-2020,178762,1348,1240,177522,Europe
France,19-07-2020,1498,1376,271,1227,Europe
France,19-07-2020,417307,1586,955,416352,Europe
France,19-07-2020,431795,210,1027,430768,Europe
France,19-07-2020,404488,415,1009,403479,Europe
France,19-07-2020,390669,1003,1017,389652,Europe
France,19-07-2020,9946,1647,548,9398,Europe
France,19-07-2020,260540,822,493,260047,Europe
Gabon,19-07-2020,278200,910,1143,277057,Africa
Gambia,19-07-2020,118434,1818,341,118093,Africa
Georgia,19-07-2020,183971,557,633,183338,Europe
Germany,19-07-2020,395265,566,1176,394089,Europe
Ghana,19-07-2020,405062,1629,562,404500,Africa
Greece,19-07-2020,158560,1738,478,158082,Europe
Guatemala,19-07-2020,6208,1710,81,6127,Americas
Guinea,19-07-2020,248714,913,733,247981,Africa
Guyana,19-07-2020,230511,1014,1207,229304,Americas
Haiti,19-07-2020,84300,1411,963,83337,Americas
Holy See,19-07-2020,103518,1441,439,103079,Europe
Honduras,19-07-2020,3228,745,274,2954,Americas
Hungary,19-07-2020,67619,631,1016,66603,Europe
Iceland,19-07-2020,90096,2170,1107,88989,Europe
India,19-07-2020,309476,2061,958,308518,South-East Asia
Indonesia,19-07-2020,298874,1516,1082,297792,South-East Asia
Iran,19-07-2020,138371,2383,756,137615,Eastern Mediterranean
Iraq,19-07-2020,131240,43,563,130677,Eastern Mediterranean
Ireland,19-07-2020,40764,393,126,40638,Europe
Israel,19-07-2020,45731,193,259,45472,Europe
Italy,19-07-2020,103570,1392,686,102884,Europe
Jamaica,19-07-2020,411400,2442,147,411253,Americas
Japan,19-07-2020,372710,216,1064,371646,Western Pacific
Jordan,19-07-2020,245562,1096,621,244941,Eastern Mediterranean
Kazakhstan,19-07-2020,446665,954,1110,445555,Europe
Kenya,19-07-2020,170842,858,508,170334,Africa
South Korea,19-07-2020,245376,1945,636,244740,Western Pacific
Kuwait,19-07-2020,289001,227,646,288355,Eastern Mediterranean
Kyrgyzstan,19-07-2020,188947,761,896,188051,Europe
Latvia,19-07-2020,1930,1534,1144,786,Europe
Lebanon,19-07-2020,315868,708,426,315442,Eastern Mediterranean
Liberia,19-07-2020,134426,1097,1046,133380,Africa
Liechtenstein,19-07-2020,206868,1830,450,206418,Europe
Lithuania,19-07-2020,317745,911,614,317131,Europe
Luxembourg,19-07-2020,171564,369,727,170837,Europe
Madagascar,19-07-2020,381517,2099,1091,380426,Africa
Malaysia,19-07-2020,317580,119,1189,316391,Western Pacific
Maldives,19-07-2020,144125,1541,290,143835,South-East Asia
Malta,19-07-2020,256628,287,634,255994,Europe
Mauritania,19-07-2020,201440,2253,168,201272,Africa
Mauritius,19-07-2020,194269,1556,912,193357,Africa
Mexico,19-07-2020,284947,2127,15,284932,Americas
Moldova,19-07-2020,248637,1087,493,248144,Europe
Monaco,19-07-2020,187550,1360,1142,186408,Europe
Mongolia,19-07-2020,445937,1136,668,445269,Western Pacific
Montenegro,19-07-2020,287929,936,894,287035,Europe
Morocco,19-07-2020,230194,1372,977,229217,Eastern Mediterranean
Namibia,19-07-2020,214593,1983,339,214254,Africa
Nepal,19-07-2020,153560,77,970,152590,South-East Asia
Netherlands,19-07-2020,326206,2484,478,325728,Europe
Netherlands,19-07-2020,70124,1013,1055,69069,Europe
Netherlands,19-07-2020,320541,214,5,320536,Europe
Netherlands,19-07-2020,206485,864,581,205904,Europe
New Zealand,19-07-2020,259105,2474,1237,257868,Western Pacific
Nicaragua,19-07-2020,70796,1413,1199,69597,Americas
Niger,19-07-2020,18163,1759,224,17939,Africa
Nigeria,19-07-2020,169343,1811,567,168776,Africa
North Macedonia,19-07-2020,176437,1504,268,176169,Europe
Norway,19-07-2020,53023,2419,221,52802,Europe
Oman,19-07-2020,415264,1967,28,415236,Eastern Mediterranean
Pakistan,19-07-2020,169903,1175,1131,168772,Eastern Mediterranean
Panama,19-07-2020,286848,1689,727,286121,Americas
Papua New Guinea,19-07-2020,153246,819,507,152739,Western Pacific
Paraguay,19-07-2020,169754,1065,959,168795,Americas
Peru,19-07-2020,411122,36,453,410669,Americas
Philippines,19-07-2020,290171,1854,430,289741,Western Pacific
Poland,19-07-2020,333342,646,187,333155,Europe
Portugal,19-07-2020,287867,1838,911,286956,Europe
Qatar,19-07-2020,162312,267,644,161668,Eastern Mediterranean
Romania,19-07-2020,277266,2291,864,276402,Europe
Russia,19-07-2020,177377,166,146,177231,Europe
Rwanda,19-07-2020,336554,1141,1041,335513,Africa
Saint Lucia,19-07-2020,71450,858,630,70820,Americas
Saint Vincent and the Grenadines,19-07-2020,346745,2053,330,346415,Americas
San Marino,19-07-2020,81717,460,700,81017,Europe
Saudi Arabia,19-07-2020,386006,925,218,385788,Eastern Mediterranean
Senegal,19-07-2020,38740,2108,499,38241,Africa
Serbia,19-07-2020,28160,593,217,27943,Europe
Seychelles,19-07-2020,201473,285,577,200896,Africa
Singapore,19-07-2020,287046,249,531,286515,Western Pacific
Slovakia,19-07-2020,361138,981,226,360912,Europe
Slovenia,19-07-2020,206923,904,767,206156,Europe
Somalia,19-07-2020,26586,1970,946,25640,Eastern Mediterranean
South Africa,19-07-2020,369454,2408,777,368677,Africa
Spain,19-07-2020,266924,1654,422,266502,Europe
Sri Lanka,19-07-2020,169978,1731,603,169375,South-East Asia
Sudan,19-07-2020,33177,779,176,33001,Eastern Mediterranean
Suriname,19-07-2020,214690,755,531,214159,Americas
Sweden,19-07-2020,294134,2466,535,293599,Europe
Switzerland,19-07-2020,47564,1325,728,46836,Europe
Taiwan*,19-07-2020,9010,276,1122,7888,Western Pacific
Tanzania,19-07-2020,10470,1716,493,9977,Africa
Thailand,19-07-2020,235890,26,675,235215,South-East Asia
Togo,19-07-2020,185478,1015,782,184696,Africa
Trinidad and Tobago,19-07-2020,77306,1442,788,76518,Americas
Tunisia,19-07-2020,180961,2485,1082,179879,Eastern Mediterranean
Turkey,19-07-2020,118871,436,428,118443,Europe
Uganda,19-07-2020,81888,579,577,81311,Africa
Ukraine,19-07-2020,218274,1305,1070,217204,Europe
United Arab Emirates,19-07-2020,130102,669,893,129209,Eastern Mediterranean
United Kingdom,19-07-2020,365778,1998,1005,364773,Europe
United Kingdom,19-07-2020,210325,2378,504,209821,Europe
United Kingdom,19-07-2020,164636,2001,306,164330,Europe
United Kingdom,19-07-2020,280859,1738,480,280379,Europe
United Kingdom,19-07-2020,88679,1925,632,88047,Europe
United Kingdom,19-07-2020,306437,1150,235,306202,Europe
United Kingdom,19-07-2020,112898,2269,1130,111768,Europe
Uruguay,19-07-2020,389053,954,684,388369,Americas
US,19-07-2020,406179,694,706,405473,Americas
Uzbekistan,19-07-2020,329665,1097,619,329046,Europe
Venezuela,19-07-2020,270125,409,828,269297,Americas
Vietnam,19-07-2020,297014,1758,886,296128,Western Pacific
Zambia,19-07-2020,179942,60,906,179036,Africa
Zimbabwe,19-07-2020,125197,2115,455,124742,Africa
Dominica,19-07-2020,119282,1510,238,119044,Americas
Grenada,19-07-2020,243832,134,743,243089,Americas
Mozambique,19-07-2020,102799,775,1242,101557,Africa
Syria,19-07-2020,53590,368,869,52721,Eastern Mediterranean
Timor-Leste,19-07-2020,353539,2173,169,353370,South-East Asia
Belize,19-07-2020,312207,1190,391,311816,Americas
Laos,19-07-2020,81371,1452,557,80814,Western Pacific
Libya,19-07-2020,311639,488,0,311639,Eastern Mediterranean
West Bank and Gaza,19-07-2020,420483,2123,832,419651,Eastern Mediterranean
Guinea-Bissau,19-07-2020,131408,216,814,130594,Africa
Mali,19-07-2020,329078,351,994,328084,Africa
Saint Kitts and Nevis,19-07-2020,275169,757,998,274171,Americas
Canada,19-07-2020,349231,751,301,348930,Americas
Canada,19-07-2020,444012,1958,25,443987,Americas
Kosovo,19-07-2020,55451,633,488,54963,Europe
Burma,19-07-2020,165512,1422,63,165449,South-East Asia
United Kingdom,19-07-2020,27259,2432,578,26681,Europe
United Kingdom,19-07-2020,72792,1058,800,71992,Europe
United Kingdom,19-07-2020,264068,1336,92,263976,Europe
Botswana,19-07-2020,403163,632,406,402757,Africa
Burundi,19-07-2020,342441,749,144,342297,Africa
Sierra Leone,19-07-2020,85736,2335,322,85414,Africa
Malawi,19-07-2020,100362,1419,240,100122,Africa
United Kingdom,19-07-2020,368118,1076,813,367305,Europe
France,19-07-2020,218476,2091,1152,217324,Europe
South Sudan,19-07-2020,324909,1830,1077,323832,Africa
Western Sahara,19-07-2020,157915,599,525,157390,Africa
Sao Tome and Principe,19-07-2020,288883,1596,268,288615,Africa
Yemen,19-07-2020,442931,1680,1014,441917,Eastern Mediterranean
Comoros,19-07-2020,366890,1994,1097,365793,Africa
Tajikistan,19-07-2020,117343,592,379,116964,Europe
Lesotho,19-07-2020,328392,1220,438,327954,Africa
Afghanistan,20-07-2020,251673,314,697,250976,Eastern Mediterranean
Albania,20-07-2020,59413,1307,710,58703,Europe
Algeria,20-07-2020,8267,1365,933,7334,Africa
Andorra,20-07-2020,167869,2149,1158,166711,Europe
Angola,20-07-2020,131833,2285,558,131275,Africa
Antigua and Barbuda,20-07-2020,108671,1990,1008,107663,Americas
Argentina,20-07-2020,359085,1401,226,358859,Americas
Armenia,20-07-2020,248034,1511,287,247747,Europe
Australia,20-07-2020,384338,1592,812,383526,Western Pacific
Australia,20-07-2020,277845,1136,667,277178,Western Pacific
Australia,20-07-2020,59769,2176,618,59151,Western Pacific
Australia,20-07-2020,255575,1094,1070,254505,Western Pacific
Australia,20-07-2020,419996,584,624,419372,Western Pacific
Australia,20-07-2020,25409,224,855,24554,Western Pacific
Australia,20-07-2020,46459,657,960,45499,Western Pacific
Australia,20-07-2020,141495,1358,731,140764,Western Pacific
Austria,20-07-2020,337159,2019,782,336377,Europe
Azerbaijan,20-07-2020,260724,1403,582,260142,Europe
Bahamas,20-07-2020,108746,2214,634,108112,Americas
Bahrain,20-07-2020,214265,78,130,214135,Eastern Mediterranean
Bangladesh,20-07-2020,284147,1058,140,284007,South-East Asia
Barbados,20-07-2020,376541,1129,289,376252,Americas
Belarus,20-07-2020,1458,2078,856,602,Europe
Belgium,20-07-2020,154309,601,248,154061,Europe
Benin,20-07-2020,394830,104,205,394625,Africa
Bhutan,20-07-2020,363786,654,825,362961,South-East Asia
Bolivia,20-07-2020,265600,1110,743,264857,Americas
Bosnia and Herzegovina,20-07-2020,442915,264,427,442488,Europe
Brazil,20-07-2020,197282,2332,1167,196115,Americas
Brunei,20-07-2020,195586,582,168,195418,Western Pacific
Bulgaria,20-07-2020,174823,230,785,174038,Europe
Burkina Faso,20-07-2020,186790,925,994,185796,Africa
Cabo Verde,20-07-2020,292899,504,135,292764,Africa
Cambodia,20-07-2020,137799,1278,454,137345,Western Pacific
Cameroon,20-07-2020,146772,1810,263,146509,Africa
Canada,20-07-2020,285625,2305,959,284666,Americas
Canada,20-07-2020,318099,963,753,317346,Americas
Canada,20-07-2020,272890,2235,1183,271707,Americas
Canada,20-07-2020,160317,1242,892,159425,Americas
Canada,20-07-2020,395026,1418,1160,393866,Americas
Canada,20-07-2020,254230,1739,1196,253034,Americas
Canada,20-07-2020,412327,2058,825,411502,Americas
Canada,20-07-2020,216491,1506,734,215757,Americas
Canada,20-07-2020,277649,1169,230,277419,Americas
Canada,20-07-2020,446149,1656,1068,445081,Americas
Central African Republic,20-07-2020,49515,1943,174,49341,Africa
Chad,20-07-2020,326225,258,520,325705,Africa
Chile,20-07-2020,373101,1729,57,373044,Americas
China,20-07-2020,123694,1535,505,123189,Western Pacific
China,20-07-2020,381314,1514,301,381013,Western Pacific
China,20-07-2020,66165,990,952,65213,Western Pacific
China,20-07-2020,359765,1731,991,358774,Western Pacific
China,20-07-2020,206015,680,666,205349,Western Pacific
China,20-07-2020,322977,1836,159,322818,Western Pacific
China,20-07-2020,359106,1532,386,358720,Western Pacific
China,20-07-2020,298498,2107,1204,297294,Western Pacific
China,20-07-2020,80551,527,711,79840,Western Pacific
China,20-07-2020,383535,2066,916,382619,Western Pacific
China,20-07-2020,418063,839,5,418058,Western Pacific
China,20-07-2020,311780,1537,1237,310543,Western Pacific
China,20-07-2020,319062,2013,1205,317857,Western Pacific
China,20-07-2020,111407,360,1026,110381,Western Pacific
China,20-07-2020,264470,1233,903,263567,Western Pacific
China,20-07-2020,30651,395,1078,29573,Western Pacific
China,20-07-2020,13283,2356,437,12846,Western Pacific
China,20-07-2020,239557,1425,347,239210,Western Pacific
China,20-07-2020,222283,1560,582,221701,Western Pacific
China,20-07-2020,65080,146,162,64918,Western Pacific
China,20-07-2020,449926,20,298,449628,Western Pacific
China,20-07-2020,417165,597,119,417046,Western Pacific
China,20-07-2020,191065,407,366,190699,Western Pacific
China,20-07-2020,74556,2157,907,73649,Western Pacific
China,20-07-2020,60605,1369,389,60216,Western Pacific
China,20-07-2020,36952,1326,535,36417,Western Pacific
China,20-07-2020,249185,1792,801,248384,Western Pacific
China,20-07-2020,163292,2365,1062,162230,Western Pacific
China,20-07-2020,225941,2382,649,225292,Western Pacific
China,20-07-2020,56023,1234,396,55627,Western Pacific
China,20-07-2020,426062,451,511,425551,Western Pacific
China,20-07-2020,66106,791,96,66010,Western Pacific
China,20-07-2020,107959,104,401,107558,Western Pacific
Colombia,20-07-2020,285284,1841,1115,284169,Americas
Congo (Brazzaville),20-07-2020,155514,1277,768,154746,Africa
Congo (Kinshasa),20-07-2020,156571,135,245,156326,Africa
Costa Rica,20-07-2020,361683,1256,568,361115,Americas
Cote d'Ivoire,20-07-2020,78062,1029,1249,76813,Africa
Croatia,20-07-2020,225121,371,959,224162,Europe
Cuba,20-07-2020,227897,1611,784,227113,Americas
Cyprus,20-07-2020,330681,1237,817,329864,Europe
Czechia,20-07-2020,415175,2161,815,414360,Europe
Denmark,20-07-2020,186686,760,1043,185643,Europe
Greenland,20-07-2020,388151,975,812,387339,Europe
Denmark,20-07-2020,406245,2316,776,405469,Europe
Djibouti,20-07-2020,368436,689,193,368243,Eastern Mediterranean
Dominican Republic,20-07-2020,91268,2166,132,91136,Americas
Ecuador,20-07-2020,242839,2344,120,242719,Americas
Egypt,20-07-2020,217294,1991,1005,216289,Eastern Mediterranean
El Salvador,20-07-2020,260,871,961,-701,Americas
Equatorial Guinea,20-07-2020,275252,2463,282,274970,Africa
Eritrea,20-07-2020,232325,2032,616,231709,Africa
Estonia,20-07-2020,37331,2225,628,36703,Europe
Eswatini,20-07-2020,212662,2232,113,212549,Africa
Ethiopia,20-07-2020,90962,1104,556,90406,Africa
Fiji,20-07-2020,155763,1201,744,155019,Western Pacific
Finland,20-07-2020,446265,2317,617,445648,Europe
France,20-07-2020,388578,2372,855,387723,Europe
France,20-07-2020,192502,313,389,192113,Europe
France,20-07-2020,142831,1023,1238,141593,Europe
France,20-07-2020,155060,1597,80,154980,Europe
France,20-07-2020,242607,407,813,241794,Europe
France,20-07-2020,261225,1828,646,260579,Europe
France,20-07-2020,220410,1080,691,219719,Europe
France,20-07-2020,182070,13,1250,180820,Europe
France,20-07-2020,213727,755,918,212809,Europe
France,20-07-2020,310817,2168,813,310004,Europe
Gabon,20-07-2020,416217,1935,341,415876,Africa
Gambia,20-07-2020,139249,1275,711,138538,Africa
Georgia,20-07-2020,360223,376,265,359958,Europe
Germany,20-07-2020,164608,2247,992,163616,Europe
Ghana,20-07-2020,241677,1076,414,241263,Africa
Greece,20-07-2020,209528,435,171,209357,Europe
Guatemala,20-07-2020,216996,2493,1097,215899,Americas
Guinea,20-07-2020,411291,714,277,411014,Africa
Guyana,20-07-2020,448229,1297,568,447661,Americas
Haiti,20-07-2020,315611,2058,366,315245,Americas
Holy See,20-07-2020,292401,1809,872,291529,Europe
Honduras,20-07-2020,17711,326,525,17186,Americas
Hungary,20-07-2020,13009,2049,963,12046,Europe
Iceland,20-07-2020,36230,295,983,35247,Europe
India,20-07-2020,67089,368,1176,65913,South-East Asia
Indonesia,20-07-2020,163971,271,450,163521,South-East Asia
Iran,20-07-2020,411702,2021,587,411115,Eastern Mediterranean
Iraq,20-07-2020,36162,1869,65,36097,Eastern Mediterranean
Ireland,20-07-2020,2370,2124,91,2279,Europe
Israel,20-07-2020,364208,1174,549,363659,Europe
Italy,20-07-2020,350794,589,516,350278,Europe
Jamaica,20-07-2020,442882,446,42,442840,Americas
Japan,20-07-2020,180856,1329,602,180254,Western Pacific
Jordan,20-07-2020,361815,117,609,361206,Eastern Mediterranean
Kazakhstan,20-07-2020,385693,364,696,384997,Europe
Kenya,20-07-2020,417462,2258,1141,416321,Africa
South Korea,20-07-2020,378933,2426,317,378616,Western Pacific
Kuwait,20-07-2020,128689,319,1207,127482,Eastern Mediterranean
Kyrgyzstan,20-07-2020,96985,2147,406,96579,Europe
Latvia,20-07-2020,211098,2043,780,210318,Europe
Lebanon,20-07-2020,234643,1673,625,234018,Eastern Mediterranean
Liberia,20-07-2020,127198,1446,21,127177,Africa
Liechtenstein,20-07-2020,131642,1752,1234,130408,Europe
Lithuania,20-07-2020,43437,536,668,42769,Europe
Luxembourg,20-07-2020,234120,36,1051,233069,Europe
Madagascar,20-07-2020,408403,825,111,408292,Africa
Malaysia,20-07-2020,135205,1662,239,134966,Western Pacific
Maldives,20-07-2020,362787,609,423,362364,South-East Asia
Malta,20-07-2020,399093,1173,823,398270,Europe
Mauritania,20-07-2020,108433,1647,302,108131,Africa
Mauritius,20-07-2020,211498,1133,995,210503,Africa
Mexico,20-07-2020,269569,992,228,269341,Americas
Moldova,20-07-2020,163429,1021,679,162750,Europe
Monaco,20-07-2020,266254,1850,403,265851,Europe
Mongolia,20-07-2020,144742,2052,275,144467,Western Pacific
Montenegro,20-07-2020,360646,6,1065,359581,Europe
Morocco,20-07-2020,438516,1233,1062,437454,Eastern Mediterranean
Namibia,20-07-2020,359677,2001,811,358866,Africa
Nepal,20-07-2020,415469,1878,320,415149,South-East Asia
Netherlands,20-07-2020,167622,2080,423,167199,Europe
Netherlands,20-07-2020,1708,1737,50,1658,Europe
Netherlands,20-07-2020,96738,1034,591,96147,Europe
Netherlands,20-07-2020,310306,1246,1187,309119,Europe
New Zealand,20-07-2020,78994,1754,506,78488,Western Pacific
Nicaragua,20-07-2020,46176,2172,489,45687,Americas
Niger,20-07-2020,188362,2405,2,188360,Africa
Nigeria,20-07-2020,378705,1895,245,378460,Africa
North Macedonia,20-07-2020,96951,2368,783,96168,Europe
Norway,20-07-2020,99065,2473,1189,97876,Europe
Oman,20-07-2020,37967,2254,1216,36751,Eastern Mediterranean
Pakistan,20-07-2020,75487,505,568,74919,Eastern Mediterranean
Panama,20-07-2020,434355,656,481,433874,Americas
Papua New Guinea,20-07-2020,199182,869,645,198537,Western Pacific
Paraguay,20-07-2020,263344,1390,644,262700,Americas
Peru,20-07-2020,227358,1689,1128,226230,Americas
Philippines,20-07-2020,148507,1462,792,147715,Western Pacific
Poland,20-07-2020,361848,286,288,361560,Europe
Portugal,20-07-2020,80048,1874,207,79841,Europe
Qatar,20-07-2020,286508,31,832,285676,Eastern Mediterranean
Romania,20-07-2020,78490,68,890,77600,Europe
Russia,20-07-2020,188712,2271,298,188414,Europe
Rwanda,20-07-2020,66903,2316,566,66337,Africa
Saint Lucia,20-07-2020,205438,100,945,204493,Americas
Saint Vincent and the Grenadines,20-07-2020,412942,41,866,412076,Americas
San Marino,20-07-2020,30090,2356,110,29980,Europe
Saudi Arabia,20-07-2020,363054,13,807,362247,Eastern Mediterranean
Senegal,20-07-2020,124309,1737,1241,123068,Africa
Serbia,20-07-2020,352201,679,960,351241,Europe
Seychelles,20-07-2020,35183,496,777,34406,Africa
Singapore,20-07-2020,220060,1277,1235,218825,Western Pacific
Slovakia,20-07-2020,390941,1076,834,390107,Europe
Slovenia,20-07-2020,19594,974,500,19094,Europe
Somalia,20-07-2020,705,8,840,-135,Eastern Mediterranean
South Africa,20-07-2020,128623,1375,962,127661,Africa
Spain,20-07-2020,224568,0,1041,223527,Europe
Sri Lanka,20-07-2020,43102,2121,213,42889,South-East Asia
Sudan,20-07-2020,51232,1825,711,50521,Eastern Mediterranean
Suriname,20-07-2020,355762,247,156,355606,Americas
Sweden,20-07-2020,198197,223,385,197812,Europe
Switzerland,20-07-2020,358580,2407,764,357816,Europe
Taiwan*,20-07-2020,288169,2189,1022,287147,Western Pacific
Tanzania,20-07-2020,190409,2365,260,190149,Africa
Thailand,20-07-2020,92260,1384,446,91814,South-East Asia
Togo,20-07-2020,217615,2404,389,217226,Africa
Trinidad and Tobago,20-07-2020,237531,1147,281,237250,Americas
Tunisia,20-07-2020,63288,722,155,63133,Eastern Mediterranean
Turkey,20-07-2020,317624,400,918,316706,Europe
Uganda,20-07-2020,429940,740,567,429373,Africa
Ukraine,20-07-2020,352016,1771,638,351378,Europe
United Arab Emirates,20-07-2020,266686,236,910,265776,Eastern Mediterranean
United Kingdom,20-07-2020,397603,2153,808,396795,Europe
United Kingdom,20-07-2020,13100,2133,34,13066,Europe
United Kingdom,20-07-2020,98761,600,561,98200,Europe
United Kingdom,20-07-2020,149781,524,294,149487,Europe
United Kingdom,20-07-2020,170780,1336,188,170592,Europe
United Kingdom,20-07-2020,110879,1678,178,110701,Europe
United Kingdom,20-07-2020,122004,556,808,121196,Europe
Uruguay,20-07-2020,233084,370,364,232720,Americas
US,20-07-2020,351632,505,1076,350556,Americas
Uzbekistan,20-07-2020,62895,451,1111,61784,Europe
Venezuela,20-07-2020,101397,41,613,100784,Americas
Vietnam,20-07-2020,115520,1829,1057,114463,Western Pacific
Zambia,20-07-2020,35952,1468,922,35030,Africa
Zimbabwe,20-07-2020,43950,1319,1154,42796,Africa
Dominica,20-07-2020,223164,315,1150,222014,Americas
Grenada,20-07-2020,41769,355,1228,40541,Americas
Mozambique,20-07-2020,262061,1429,1180,260881,Africa
Syria,20-07-2020,169377,632,900,168477,Eastern Mediterranean
Timor-Leste,20-07-2020,427143,361,757,426386,South-East Asia
Belize,20-07-2020,365013,345,491,364522,Americas
Laos,20-07-2020,249942,1122,829,249113,Western Pacific
Libya,20-07-2020,316331,1783,239,316092,Eastern Mediterranean
West Bank and Gaza,20-07-2020,85694,952,872,84822,Eastern Mediterranean
Guinea-Bissau,20-07-2020,348409,2059,71,348338,Africa
Mali,20-07-2020,226328,1384,414,225914,Africa
Saint Kitts and Nevis,20-07-2020,184712,2037,530,184182,Americas
Canada,20-07-2020,374123,409,893,373230,Americas
Canada,20-07-2020,281459,1266,909,280550,Americas
Kosovo,20-07-2020,352869,2188,1091,351778,Europe
Burma,20-07-2020,6631,1213,161,6470,South-East Asia
United Kingdom,20-07-2020,246140,88,267,245873,Europe
United Kingdom,20-07-2020,213738,1775,1101,212637,Europe
United Kingdom,20-07-2020,167708,994,1181,166527,Europe
Botswana,20-07-2020,419158,2254,702,418456,Africa
Burundi,20-07-2020,92621,56,527,92094,Africa
Sierra Leone,20-07-2020,67069,843,667,66402,Africa
Malawi,20-07-2020,105756,1046,950,104806,Africa
United Kingdom,20-07-2020,320660,1794,163,320497,Europe
France,20-07-2020,127987,2488,675,127312,Europe
South Sudan,20-07-2020,279456,1158,920,278536,Africa
Western Sahara,20-07-2020,207980,849,428,207552,Africa
Sao Tome and Principe,20-07-2020,445398,2263,330,445068,Africa
Yemen,20-07-2020,432929,107,1006,431923,Eastern Mediterranean
Comoros,20-07-2020,3428,1544,991,2437,Africa
Tajikistan,20-07-2020,281039,2047,63,280976,Europe
Lesotho,20-07-2020,159994,510,208,159786,Africa
Afghanistan,21-07-2020,430749,1012,230,430519,Eastern Mediterranean
Albania,21-07-2020,65228,196,282,64946,Europe
Algeria,21-07-2020,310809,2420,894,309915,Africa
Andorra,21-07-2020,249434,1090,90,249344,Europe
Angola,21-07-2020,188603,199,116,188487,Africa
Antigua and Barbuda,21-07-2020,25371,1785,1060,24311,Americas
Argentina,21-07-2020,396223,808,1195,395028,Americas
Armenia,21-07-2020,429740,1880,610,429130,Europe
Australia,21-07-2020,25630,406,612,25018,Western Pacific
Australia,21-07-2020,389467,2197,1221,388246,Western Pacific
Australia,21-07-2020,118247,605,1142,117105,Western Pacific
Australia,21-07-2020,291552,2493,459,291093,Western Pacific
Australia,21-07-2020,200821,533,1239,199582,Western Pacific
Australia,21-07-2020,307333,594,107,307226,Western Pacific
Australia,21-07-2020,338536,1154,1042,337494,Western Pacific
Australia,21-07-2020,89445,2292,579,88866,Western Pacific
Austria,21-07-2020,74349,729,260,74089,Europe
Azerbaijan,21-07-2020,285191,320,868,284323,Europe
Bahamas,21-07-2020,26737,485,800,25937,Americas
Bahrain,21-07-2020,392406,749,559,391847,Eastern Mediterranean
Bangladesh,21-07-2020,336528,1273,276,336252,South-East Asia
Barbados,21-07-2020,353402,1629,1093,352309,Americas
Belarus,21-07-2020,188725,601,256,188469,Europe
Belgium,21-07-2020,414763,346,1075,413688,Europe
Benin,21-07-2020,387639,1341,213,387426,Africa
Bhutan,21-07-2020,414092,2098,1092,413000,South-East Asia
Bolivia,21-07-2020,267738,1390,849,266889,Americas
Bosnia and Herzegovina,21-07-2020,357920,177,690,357230,Europe
Brazil,21-07-2020,98846,32,1005,97841,Americas
Brunei,21-07-2020,416007,285,971,415036,Western Pacific
Bulgaria,21-07-2020,142830,1217,1165,141665,Europe
Burkina Faso,21-07-2020,311152,846,812,310340,Africa
Cabo Verde,21-07-2020,362375,914,888,361487,Africa
Cambodia,21-07-2020,242827,88,1011,241816,Western Pacific
Cameroon,21-07-2020,396859,2431,566,396293,Africa
Canada,21-07-2020,227920,407,958,226962,Americas
Canada,21-07-2020,268997,757,621,268376,Americas
Canada,21-07-2020,377005,754,726,376279,Americas
Canada,21-07-2020,85546,1296,754,84792,Americas
Canada,21-07-2020,257348,1898,371,256977,Americas
Canada,21-07-2020,114245,1607,672,113573,Americas
Canada,21-07-2020,313748,477,453,313295,Americas
Canada,21-07-2020,250337,1967,703,249634,Americas
Canada,21-07-2020,286515,435,953,285562,Americas
Canada,21-07-2020,295148,700,1083,294065,Americas
Central African Republic,21-07-2020,56996,1378,108,56888,Africa
Chad,21-07-2020,133731,1170,365,133366,Africa
Chile,21-07-2020,421545,2231,757,420788,Americas
China,21-07-2020,47039,800,550,46489,Western Pacific
China,21-07-2020,29518,2314,204,29314,Western Pacific
China,21-07-2020,158769,212,852,157917,Western Pacific
China,21-07-2020,420898,1538,1001,419897,Western Pacific
China,21-07-2020,440784,283,835,439949,Western Pacific
China,21-07-2020,363469,467,60,363409,Western Pacific
China,21-07-2020,288064,461,1000,287064,Western Pacific
China,21-07-2020,237764,759,6,237758,Western Pacific
China,21-07-2020,319231,1762,239,318992,Western Pacific
China,21-07-2020,249772,91,417,249355,Western Pacific
China,21-07-2020,136807,1763,421,136386,Western Pacific
China,21-07-2020,158191,2003,722,157469,Western Pacific
China,21-07-2020,126895,1200,592,126303,Western Pacific
China,21-07-2020,332240,920,1192,331048,Western Pacific
China,21-07-2020,37549,2211,176,37373,Western Pacific
China,21-07-2020,173704,892,278,173426,Western Pacific
China,21-07-2020,315954,1790,610,315344,Western Pacific
China,21-07-2020,384028,615,1008,383020,Western Pacific
China,21-07-2020,189587,328,364,189223,Western Pacific
China,21-07-2020,214145,2287,441,213704,Western Pacific
China,21-07-2020,90569,1918,703,89866,Western Pacific
China,21-07-2020,445157,684,821,444336,Western Pacific
China,21-07-2020,358883,715,342,358541,Western Pacific
China,21-07-2020,252192,518,397,251795,Western Pacific
China,21-07-2020,88828,2354,263,88565,Western Pacific
China,21-07-2020,126298,2024,109,126189,Western Pacific
China,21-07-2020,369959,799,996,368963,Western Pacific
China,21-07-2020,190355,722,361,189994,Western Pacific
China,21-07-2020,391010,1838,643,390367,Western Pacific
China,21-07-2020,428266,2444,20,428246,Western Pacific
China,21-07-2020,37356,929,539,36817,Western Pacific
China,21-07-2020,111189,1428,546,110643,Western Pacific
China,21-07-2020,386041,971,36,386005,Western Pacific
Colombia,21-07-2020,91722,2474,591,91131,Americas
Congo (Brazzaville),21-07-2020,146869,328,1212,145657,Africa
Congo (Kinshasa),21-07-2020,232263,1792,706,231557,Africa
Costa Rica,21-07-2020,418604,2141,145,418459,Americas
Cote d'Ivoire,21-07-2020,83138,2496,56,83082,Africa
Croatia,21-07-2020,262385,2314,693,261692,Europe
Cuba,21-07-2020,263614,2117,618,262996,Americas
Cyprus,21-07-2020,19435,621,1248,18187,Europe
Czechia,21-07-2020,334720,2128,452,334268,Europe
Denmark,21-07-2020,63513,182,192,63321,Europe
Greenland,21-07-2020,51289,1776,395,50894,Europe
Denmark,21-07-2020,37694,1105,397,37297,Europe
Djibouti,21-07-2020,284577,258,543,284034,Eastern Mediterranean
Dominican Republic,21-07-2020,201418,1097,263,201155,Americas
Ecuador,21-07-2020,42928,667,410,42518,Americas
Egypt,21-07-2020,392715,2044,851,391864,Eastern Mediterranean
El Salvador,21-07-2020,316074,17,1102,314972,Americas
Equatorial Guinea,21-07-2020,304518,522,195,304323,Africa
Eritrea,21-07-2020,224308,2222,328,223980,Africa
Estonia,21-07-2020,49487,1444,895,48592,Europe
Eswatini,21-07-2020,98733,2120,968,97765,Africa
Ethiopia,21-07-2020,333386,2307,600,332786,Africa
Fiji,21-07-2020,280558,724,748,279810,Western Pacific
Finland,21-07-2020,145658,1722,1143,144515,Europe
France,21-07-2020,256360,1320,894,255466,Europe
France,21-07-2020,214107,1532,696,213411,Europe
France,21-07-2020,238466,2108,534,237932,Europe
France,21-07-2020,76236,452,937,75299,Europe
France,21-07-2020,63104,865,1006,62098,Europe
France,21-07-2020,389478,698,504,388974,Europe
France,21-07-2020,62055,462,76,61979,Europe
France,21-07-2020,286762,99,1036,285726,Europe
France,21-07-2020,142311,1948,255,142056,Europe
France,21-07-2020,259066,2345,859,258207,Europe
Gabon,21-07-2020,225079,2360,290,224789,Africa
Gambia,21-07-2020,326101,1938,554,325547,Africa
Georgia,21-07-2020,22725,1453,545,22180,Europe
Germany,21-07-2020,339024,109,200,338824,Europe
Ghana,21-07-2020,140907,741,501,140406,Africa
Greece,21-07-2020,103799,1036,485,103314,Europe
Guatemala,21-07-2020,272954,1292,885,272069,Americas
Guinea,21-07-2020,53763,1419,1026,52737,Africa
Guyana,21-07-2020,291987,670,524,291463,Americas
Haiti,21-07-2020,191968,610,316,191652,Americas
Holy See,21-07-2020,341608,1697,1093,340515,Europe
Honduras,21-07-2020,145092,52,151,144941,Americas
Hungary,21-07-2020,65493,1295,1042,64451,Europe
Iceland,21-07-2020,77009,1490,216,76793,Europe
India,21-07-2020,19686,1480,467,19219,South-East Asia
Indonesia,21-07-2020,70610,2269,926,69684,South-East Asia
Iran,21-07-2020,238232,1764,75,238157,Eastern Mediterranean
Iraq,21-07-2020,176545,224,548,175997,Eastern Mediterranean
Ireland,21-07-2020,408501,2267,571,407930,Europe
Israel,21-07-2020,252381,249,1076,251305,Europe
Italy,21-07-2020,239453,1577,1097,238356,Europe
Jamaica,21-07-2020,79974,1878,1210,78764,Americas
Japan,21-07-2020,17021,892,367,16654,Western Pacific
Jordan,21-07-2020,9639,1257,178,9461,Eastern Mediterranean
Kazakhstan,21-07-2020,123483,1076,184,123299,Europe
Kenya,21-07-2020,164194,1172,547,163647,Africa
South Korea,21-07-2020,125756,806,527,125229,Western Pacific
Kuwait,21-07-2020,345890,798,268,345622,Eastern Mediterranean
Kyrgyzstan,21-07-2020,87026,1039,214,86812,Europe
Latvia,21-07-2020,305811,2247,1216,304595,Europe
Lebanon,21-07-2020,336644,1069,388,336256,Eastern Mediterranean
Liberia,21-07-2020,361707,2362,873,360834,Africa
Liechtenstein,21-07-2020,383290,1179,555,382735,Europe
Lithuania,21-07-2020,25496,595,956,24540,Europe
Luxembourg,21-07-2020,214961,173,1161,213800,Europe
Madagascar,21-07-2020,156550,571,982,155568,Africa
Malaysia,21-07-2020,278432,1517,876,277556,Western Pacific
Maldives,21-07-2020,326836,1446,758,326078,South-East Asia
Malta,21-07-2020,147831,1517,848,146983,Europe
Mauritania,21-07-2020,227833,216,879,226954,Africa
Mauritius,21-07-2020,183004,815,730,182274,Africa
Mexico,21-07-2020,53101,774,718,52383,Americas
Moldova,21-07-2020,427010,1751,23,426987,Europe
Monaco,21-07-2020,91807,1443,1167,90640,Europe
Mongolia,21-07-2020,413264,614,638,412626,Western Pacific
Montenegro,21-07-2020,294833,2053,537,294296,Europe
Morocco,21-07-2020,339677,955,416,339261,Eastern Mediterranean
Namibia,21-07-2020,93825,2265,729,93096,Africa
Nepal,21-07-2020,23534,2215,964,22570,South-East Asia
Netherlands,21-07-2020,155730,907,119,155611,Europe
Netherlands,21-07-2020,425989,1821,88,425901,Europe
Netherlands,21-07-2020,262776,286,269,262507,Europe
Netherlands,21-07-2020,247507,1869,192,247315,Europe
New Zealand,21-07-2020,380271,1644,308,379963,Western Pacific
Nicaragua,21-07-2020,244962,876,268,244694,Americas
Niger,21-07-2020,122146,544,84,122062,Africa
Nigeria,21-07-2020,393430,2003,331,393099,Africa
North Macedonia,21-07-2020,430172,98,79,430093,Europe
Norway,21-07-2020,185022,2046,507,184515,Europe
Oman,21-07-2020,88037,26,45,87992,Eastern Mediterranean
Pakistan,21-07-2020,441307,2072,935,440372,Eastern Mediterranean
Panama,21-07-2020,130938,20,540,130398,Americas
Papua New Guinea,21-07-2020,439011,2019,466,438545,Western Pacific
Paraguay,21-07-2020,92577,1955,1210,91367,Americas
Peru,21-07-2020,157620,2324,246,157374,Americas
Philippines,21-07-2020,415755,1735,675,415080,Western Pacific
Poland,21-07-2020,153086,1521,206,152880,Europe
Portugal,21-07-2020,372708,2447,118,372590,Europe
Qatar,21-07-2020,313581,2213,827,312754,Eastern Mediterranean
Romania,21-07-2020,288321,577,467,287854,Europe
Russia,21-07-2020,288826,1165,632,288194,Europe
Rwanda,21-07-2020,160275,2024,1159,159116,Africa
Saint Lucia,21-07-2020,45297,989,1009,44288,Americas
Saint Vincent and the Grenadines,21-07-2020,222802,584,583,222219,Americas
San Marino,21-07-2020,21298,1553,916,20382,Europe
Saudi Arabia,21-07-2020,141322,1988,686,140636,Eastern Mediterranean
Senegal,21-07-2020,70149,2163,239,69910,Africa
Serbia,21-07-2020,282526,2062,930,281596,Europe
Seychelles,21-07-2020,107152,1788,531,106621,Africa
Singapore,21-07-2020,410132,1790,426,409706,Western Pacific
Slovakia,21-07-2020,886,1299,453,433,Europe
Slovenia,21-07-2020,308783,283,205,308578,Europe
Somalia,21-07-2020,78855,2411,950,77905,Eastern Mediterranean
South Africa,21-07-2020,170363,1647,1030,169333,Africa
Spain,21-07-2020,164020,2163,641,163379,Europe
Sri Lanka,21-07-2020,116020,1946,198,115822,South-East Asia
Sudan,21-07-2020,168798,111,1095,167703,Eastern Mediterranean
Suriname,21-07-2020,194567,428,943,193624,Americas
Sweden,21-07-2020,223919,1680,937,222982,Europe
Switzerland,21-07-2020,268978,1971,847,268131,Europe
Taiwan*,21-07-2020,93624,2221,810,92814,Western Pacific
Tanzania,21-07-2020,150624,1997,219,150405,Africa
Thailand,21-07-2020,138818,1039,27,138791,South-East Asia
Togo,21-07-2020,423002,88,457,422545,Africa
Trinidad and Tobago,21-07-2020,114052,995,520,113532,Americas
Tunisia,21-07-2020,404943,2402,383,404560,Eastern Mediterranean
Turkey,21-07-2020,331067,75,387,330680,Europe
Uganda,21-07-2020,396018,1595,466,395552,Africa
Ukraine,21-07-2020,14539,140,871,13668,Europe
United Arab Emirates,21-07-2020,340796,1488,524,340272,Eastern Mediterranean
United Kingdom,21-07-2020,275943,775,828,275115,Europe
United Kingdom,21-07-2020,330482,905,470,330012,Europe
United Kingdom,21-07-2020,175681,1421,390,175291,Europe
United Kingdom,21-07-2020,88194,2078,72,88122,Europe
United Kingdom,21-07-2020,243814,914,47,243767,Europe
United Kingdom,21-07-2020,424816,2153,855,423961,Europe
United Kingdom,21-07-2020,357914,2463,672,357242,Europe
Uruguay,21-07-2020,220166,1569,598,219568,Americas
US,21-07-2020,223887,1679,1015,222872,Americas
Uzbekistan,21-07-2020,265387,2299,734,264653,Europe
Venezuela,21-07-2020,37006,302,12,36994,Americas
Vietnam,21-07-2020,287750,1426,789,286961,Western Pacific
Zambia,21-07-2020,344125,869,302,343823,Africa
Zimbabwe,21-07-2020,49271,1847,885,48386,Africa
Dominica,21-07-2020,334089,441,92,333997,Americas
Grenada,21-07-2020,394930,1275,968,393962,Americas
Mozambique,21-07-2020,442465,564,72,442393,Africa
Syria,21-07-2020,296821,1328,651,296170,Eastern Mediterranean
Timor-Leste,21-07-2020,161029,213,637,160392,South-East Asia
Belize,21-07-2020,182667,895,1015,181652,Americas
Laos,21-07-2020,388085,1195,295,387790,Western Pacific
Libya,21-07-2020,40738,519,830,39908,Eastern Mediterranean
West Bank and Gaza,21-07-2020,92892,402,333,92559,Eastern Mediterranean
Guinea-Bissau,21-07-2020,181556,779,443,181113,Africa
Mali,21-07-2020,22020,1221,685,21335,Africa
Saint Kitts and Nevis,21-07-2020,93112,705,101,93011,Americas
Canada,21-07-2020,186672,2272,254,186418,Americas
Canada,21-07-2020,399385,2334,741,398644,Americas
Kosovo,21-07-2020,373200,2402,1218,371982,Europe
Burma,21-07-2020,90882,2133,115,90767,South-East Asia
United Kingdom,21-07-2020,112729,1379,258,112471,Europe
United Kingdom,21-07-2020,365759,997,1046,364713,Europe
United Kingdom,21-07-2020,155768,1380,1145,154623,Europe
Botswana,21-07-2020,233847,2477,193,233654,Africa
Burundi,21-07-2020,198668,2424,76,198592,Africa
Sierra Leone,21-07-2020,201929,1554,1007,200922,Africa
Malawi,21-07-2020,410096,130,997,409099,Africa
United Kingdom,21-07-2020,41668,2414,1170,40498,Europe
France,21-07-2020,216582,378,1028,215554,Europe
South Sudan,21-07-2020,438442,1211,838,437604,Africa
Western Sahara,21-07-2020,379170,1019,815,378355,Africa
Sao Tome and Principe,21-07-2020,127133,2174,820,126313,Africa
Yemen,21-07-2020,100084,1408,1187,98897,Eastern Mediterranean
Comoros,21-07-2020,390294,73,458,389836,Africa
Tajikistan,21-07-2020,163080,619,734,162346,Europe
Lesotho,21-07-2020,206365,2294,294,206071,Africa
Afghanistan,22-07-2020,186070,2357,102,185968,Eastern Mediterranean
Albania,22-07-2020,338083,1750,1130,336953,Europe
Algeria,22-07-2020,445522,1314,152,445370,Africa
Andorra,22-07-2020,289577,843,461,289116,Europe
Angola,22-07-2020,373098,1417,324,372774,Africa
Antigua and Barbuda,22-07-2020,372478,114,814,371664,Americas
Argentina,22-07-2020,34100,1109,403,33697,Americas
Armenia,22-07-2020,339611,1465,960,338651,Europe
Australia,22-07-2020,72594,167,466,72128,Western Pacific
Australia,22-07-2020,122593,1694,262,122331,Western Pacific
Australia,22-07-2020,73424,696,318,73106,Western Pacific
Australia,22-07-2020,405193,326,599,404594,Western Pacific
Australia,22-07-2020,278991,499,34,278957,Western Pacific
Australia,22-07-2020,331832,1907,411,331421,Western Pacific
Australia,22-07-2020,193198,394,615,192583,Western Pacific
Australia,22-07-2020,104108,1723,1198,102910,Western Pacific
Austria,22-07-2020,209148,1210,116,209032,Europe
Azerbaijan,22-07-2020,355128,2224,290,354838,Europe
Bahamas,22-07-2020,275996,806,836,275160,Americas
Bahrain,22-07-2020,128750,509,792,127958,Eastern Mediterranean
Bangladesh,22-07-2020,11651,1356,408,11243,South-East Asia
Barbados,22-07-2020,189775,1688,328,189447,Americas
Belarus,22-07-2020,296155,1994,860,295295,Europe
Belgium,22-07-2020,7206,2352,569,6637,Europe
Benin,22-07-2020,152659,1986,1171,151488,Africa
Bhutan,22-07-2020,17728,521,340,17388,South-East Asia
Bolivia,22-07-2020,129874,2189,711,129163,Americas
Bosnia and Herzegovina,22-07-2020,303381,1657,343,303038,Europe
Brazil,22-07-2020,370673,2410,336,370337,Americas
Brunei,22-07-2020,268231,1483,701,267530,Western Pacific
Bulgaria,22-07-2020,80150,1276,1091,79059,Europe
Burkina Faso,22-07-2020,17505,1609,1208,16297,Africa
Cabo Verde,22-07-2020,25238,720,121,25117,Africa
Cambodia,22-07-2020,258352,811,736,257616,Western Pacific
Cameroon,22-07-2020,38291,1533,819,37472,Africa
Canada,22-07-2020,433566,585,89,433477,Americas
Canada,22-07-2020,114777,2180,708,114069,Americas
Canada,22-07-2020,140094,1066,726,139368,Americas
Canada,22-07-2020,410669,2266,206,410463,Americas
Canada,22-07-2020,428938,1038,918,428020,Americas
Canada,22-07-2020,430121,2398,988,429133,Americas
Canada,22-07-2020,310098,2424,336,309762,Americas
Canada,22-07-2020,129601,1694,617,128984,Americas
Canada,22-07-2020,14329,1737,1056,13273,Americas
Canada,22-07-2020,258572,2235,171,258401,Americas
Central African Republic,22-07-2020,61949,1235,471,61478,Africa
Chad,22-07-2020,128963,441,340,128623,Africa
Chile,22-07-2020,289939,511,120,289819,Americas
China,22-07-2020,10273,1599,685,9588,Western Pacific
China,22-07-2020,134318,1769,157,134161,Western Pacific
China,22-07-2020,224669,2223,631,224038,Western Pacific
China,22-07-2020,201990,174,966,201024,Western Pacific
China,22-07-2020,114311,1606,130,114181,Western Pacific
China,22-07-2020,368223,1922,927,367296,Western Pacific
China,22-07-2020,383639,2080,1066,382573,Western Pacific
China,22-07-2020,147219,956,521,146698,Western Pacific
China,22-07-2020,413437,1095,743,412694,Western Pacific
China,22-07-2020,292720,952,150,292570,Western Pacific
China,22-07-2020,184761,892,394,184367,Western Pacific
China,22-07-2020,405037,1047,1113,403924,Western Pacific
China,22-07-2020,449071,1438,829,448242,Western Pacific
China,22-07-2020,372790,796,420,372370,Western Pacific
China,22-07-2020,272469,2017,1183,271286,Western Pacific
China,22-07-2020,33827,1669,138,33689,Western Pacific
China,22-07-2020,183391,1926,399,182992,Western Pacific
China,22-07-2020,196809,2156,1206,195603,Western Pacific
China,22-07-2020,128342,1775,391,127951,Western Pacific
China,22-07-2020,372922,88,695,372227,Western Pacific
China,22-07-2020,17603,39,958,16645,Western Pacific
China,22-07-2020,416331,2422,489,415842,Western Pacific
China,22-07-2020,416198,1175,355,415843,Western Pacific
China,22-07-2020,210451,1432,566,209885,Western Pacific
China,22-07-2020,178741,1869,579,178162,Western Pacific
China,22-07-2020,336856,1227,1019,335837,Western Pacific
China,22-07-2020,330900,1572,736,330164,Western Pacific
China,22-07-2020,285703,1311,859,284844,Western Pacific
China,22-07-2020,383138,443,576,382562,Western Pacific
China,22-07-2020,446126,2483,846,445280,Western Pacific
China,22-07-2020,178747,461,133,178614,Western Pacific
China,22-07-2020,202173,1258,249,201924,Western Pacific
China,22-07-2020,185960,2085,164,185796,Western Pacific
Colombia,22-07-2020,209478,1710,1157,208321,Americas
Congo (Brazzaville),22-07-2020,302343,1626,285,302058,Africa
Congo (Kinshasa),22-07-2020,248663,133,1180,247483,Africa
Costa Rica,22-07-2020,326790,199,132,326658,Americas
Cote d'Ivoire,22-07-2020,106366,2057,892,105474,Africa
Croatia,22-07-2020,189957,1544,577,189380,Europe
Cuba,22-07-2020,93393,319,1215,92178,Americas
Cyprus,22-07-2020,236027,2404,111,235916,Europe
Czechia,22-07-2020,115262,488,444,114818,Europe
Denmark,22-07-2020,36138,2391,1004,35134,Europe
Greenland,22-07-2020,420941,1664,292,420649,Europe
Denmark,22-07-2020,12337,2186,987,11350,Europe
Djibouti,22-07-2020,419834,1875,991,418843,Eastern Mediterranean
Dominican Republic,22-07-2020,4082,1742,1194,2888,Americas
Ecuador,22-07-2020,168780,197,495,168285,Americas
Egypt,22-07-2020,230413,1087,502,229911,Eastern Mediterranean
El Salvador,22-07-2020,105956,2189,470,105486,Americas
Equatorial Guinea,22-07-2020,195907,1484,600,195307,Africa
Eritrea,22-07-2020,213083,847,741,212342,Africa
Estonia,22-07-2020,267567,2449,1217,266350,Europe
Eswatini,22-07-2020,179224,230,1129,178095,Africa
Ethiopia,22-07-2020,418625,1348,909,417716,Africa
Fiji,22-07-2020,168900,1681,238,168662,Western Pacific
Finland,22-07-2020,342536,1934,225,342311,Europe
France,22-07-2020,166983,1083,587,166396,Europe
France,22-07-2020,181686,529,1206,180480,Europe
France,22-07-2020,446388,362,1145,445243,Europe
France,22-07-2020,59809,1857,898,58911,Europe
France,22-07-2020,376895,2226,275,376620,Europe
France,22-07-2020,225778,87,1151,224627,Europe
France,22-07-2020,74697,489,378,74319,Europe
France,22-07-2020,371711,1577,150,371561,Europe
France,22-07-2020,436424,1266,1226,435198,Europe
France,22-07-2020,297992,603,186,297806,Europe
Gabon,22-07-2020,172639,807,1115,171524,Africa
Gambia,22-07-2020,150184,1359,1049,149135,Africa
Georgia,22-07-2020,53397,2045,1091,52306,Europe
Germany,22-07-2020,395061,223,608,394453,Europe
Ghana,22-07-2020,186126,1725,939,185187,Africa
Greece,22-07-2020,180362,877,1029,179333,Europe
Guatemala,22-07-2020,34156,492,609,33547,Americas
Guinea,22-07-2020,19086,285,608,18478,Africa
Guyana,22-07-2020,308833,1135,804,308029,Americas
Haiti,22-07-2020,250109,216,30,250079,Americas
Holy See,22-07-2020,315845,1688,300,315545,Europe
Honduras,22-07-2020,250409,1009,18,250391,Americas
Hungary,22-07-2020,401181,470,1157,400024,Europe
Iceland,22-07-2020,447121,1564,576,446545,Europe
India,22-07-2020,274449,776,1186,273263,South-East Asia
Indonesia,22-07-2020,289693,547,506,289187,South-East Asia
Iran,22-07-2020,91149,2078,453,90696,Eastern Mediterranean
Iraq,22-07-2020,308498,1271,815,307683,Eastern Mediterranean
Ireland,22-07-2020,444563,831,506,444057,Europe
Israel,22-07-2020,384977,2130,37,384940,Europe
Italy,22-07-2020,277182,1973,553,276629,Europe
Jamaica,22-07-2020,258206,365,410,257796,Americas
Japan,22-07-2020,212217,329,284,211933,Western Pacific
Jordan,22-07-2020,149865,1476,836,149029,Eastern Mediterranean
Kazakhstan,22-07-2020,105395,1458,150,105245,Europe
Kenya,22-07-2020,252864,1966,599,252265,Africa
South Korea,22-07-2020,369043,1553,1038,368005,Western Pacific
Kuwait,22-07-2020,268531,1334,1122,267409,Eastern Mediterranean
Kyrgyzstan,22-07-2020,342032,2119,248,341784,Europe
Latvia,22-07-2020,259839,1658,261,259578,Europe
Lebanon,22-07-2020,255226,991,226,255000,Eastern Mediterranean
Liberia,22-07-2020,332720,394,876,331844,Africa
Liechtenstein,22-07-2020,368685,1631,480,368205,Europe
Lithuania,22-07-2020,212315,1043,648,211667,Europe
Luxembourg,22-07-2020,173719,595,1021,172698,Europe
Madagascar,22-07-2020,254313,1968,608,253705,Africa
Malaysia,22-07-2020,370996,250,144,370852,Western Pacific
Maldives,22-07-2020,383356,1247,150,383206,South-East Asia
Malta,22-07-2020,132347,411,375,131972,Europe
Mauritania,22-07-2020,213689,1916,1070,212619,Africa
Mauritius,22-07-2020,217570,991,396,217174,Africa
Mexico,22-07-2020,258050,2045,100,257950,Americas
Moldova,22-07-2020,353287,1597,804,352483,Europe
Monaco,22-07-2020,148742,1947,215,148527,Europe
Mongolia,22-07-2020,415692,2328,771,414921,Western Pacific
Montenegro,22-07-2020,371109,2045,268,370841,Europe
Morocco,22-07-2020,127226,1384,1074,126152,Eastern Mediterranean
Namibia,22-07-2020,418450,1307,390,418060,Africa
Nepal,22-07-2020,301597,2375,99,301498,South-East Asia
Netherlands,22-07-2020,168374,1940,1036,167338,Europe
Netherlands,22-07-2020,419518,1528,581,418937,Europe
Netherlands,22-07-2020,195710,1485,852,194858,Europe
Netherlands,22-07-2020,309171,1784,728,308443,Europe
New Zealand,22-07-2020,399554,1725,635,398919,Western Pacific
Nicaragua,22-07-2020,211305,1864,773,210532,Americas
Niger,22-07-2020,12336,699,908,11428,Africa
Nigeria,22-07-2020,352015,1517,590,351425,Africa
North Macedonia,22-07-2020,288133,1746,110,288023,Europe
Norway,22-07-2020,58615,1100,167,58448,Europe
Oman,22-07-2020,236317,46,447,235870,Eastern Mediterranean
Pakistan,22-07-2020,333984,1330,611,333373,Eastern Mediterranean
Panama,22-07-2020,163257,325,474,162783,Americas
Papua New Guinea,22-07-2020,414859,2393,198,414661,Western Pacific
Paraguay,22-07-2020,372554,401,13,372541,Americas
Peru,22-07-2020,267393,927,176,267217,Americas
Philippines,22-07-2020,208518,2087,800,207718,Western Pacific
Poland,22-07-2020,338658,441,457,338201,Europe
Portugal,22-07-2020,430765,1036,428,430337,Europe
Qatar,22-07-2020,402073,1783,11,402062,Eastern Mediterranean
Romania,22-07-2020,231672,2482,281,231391,Europe
Russia,22-07-2020,101696,841,657,101039,Europe
Rwanda,22-07-2020,408557,48,111,408446,Africa
Saint Lucia,22-07-2020,25796,683,633,25163,Americas
Saint Vincent and the Grenadines,22-07-2020,440325,1789,122,440203,Americas
San Marino,22-07-2020,357177,2047,147,357030,Europe
Saudi Arabia,22-07-2020,262356,2324,71,262285,Eastern Mediterranean
Senegal,22-07-2020,351697,1373,209,351488,Africa
Serbia,22-07-2020,193397,925,879,192518,Europe
Seychelles,22-07-2020,349300,890,512,348788,Africa
Singapore,22-07-2020,195934,169,701,195233,Western Pacific
Slovakia,22-07-2020,108068,1105,345,107723,Europe
Slovenia,22-07-2020,97827,2311,13,97814,Europe
Somalia,22-07-2020,229535,2402,1134,228401,Eastern Mediterranean
South Africa,22-07-2020,215620,2028,471,215149,Africa
Spain,22-07-2020,335560,32,146,335414,Europe
Sri Lanka,22-07-2020,183100,2405,509,182591,South-East Asia
Sudan,22-07-2020,303833,2007,281,303552,Eastern Mediterranean
Suriname,22-07-2020,373218,1887,907,372311,Americas
Sweden,22-07-2020,16265,1782,932,15333,Europe
Switzerland,22-07-2020,350333,787,1071,349262,Europe
Taiwan*,22-07-2020,256736,448,755,255981,Western Pacific
Tanzania,22-07-2020,387015,828,1241,385774,Africa
Thailand,22-07-2020,325248,1974,187,325061,South-East Asia
Togo,22-07-2020,398184,2088,1100,397084,Africa
Trinidad and Tobago,22-07-2020,408467,211,702,407765,Americas
Tunisia,22-07-2020,38513,782,600,37913,Eastern Mediterranean
Turkey,22-07-2020,143896,465,1212,142684,Europe
Uganda,22-07-2020,378911,1230,1107,377804,Africa
Ukraine,22-07-2020,48533,1039,833,47700,Europe
United Arab Emirates,22-07-2020,81960,2128,323,81637,Eastern Mediterranean
United Kingdom,22-07-2020,419746,1593,621,419125,Europe
United Kingdom,22-07-2020,127885,1039,594,127291,Europe
United Kingdom,22-07-2020,67246,799,667,66579,Europe
United Kingdom,22-07-2020,393342,2249,1052,392290,Europe
United Kingdom,22-07-2020,336769,2033,816,335953,Europe
United Kingdom,22-07-2020,364739,290,620,364119,Europe
United Kingdom,22-07-2020,314870,522,808,314062,Europe
Uruguay,22-07-2020,436667,2286,9,436658,Americas
US,22-07-2020,224004,2290,476,223528,Americas
Uzbekistan,22-07-2020,299368,1113,879,298489,Europe
Venezuela,22-07-2020,130736,214,414,130322,Americas
Vietnam,22-07-2020,192399,2301,641,191758,Western Pacific
Zambia,22-07-2020,146995,672,320,146675,Africa
Zimbabwe,22-07-2020,18267,1626,932,17335,Africa
Dominica,22-07-2020,195414,377,706,194708,Americas
Grenada,22-07-2020,444233,2475,1154,443079,Americas
Mozambique,22-07-2020,85846,1313,739,85107,Africa
Syria,22-07-2020,133622,1639,399,133223,Eastern Mediterranean
Timor-Leste,22-07-2020,247383,2086,695,246688,South-East Asia
Belize,22-07-2020,393788,1771,724,393064,Americas
Laos,22-07-2020,372888,713,73,372815,Western Pacific
Libya,22-07-2020,33186,1779,1068,32118,Eastern Mediterranean
West Bank and Gaza,22-07-2020,257208,1915,106,257102,Eastern Mediterranean
Guinea-Bissau,22-07-2020,52382,255,809,51573,Africa
Mali,22-07-2020,121362,853,733,120629,Africa
Saint Kitts and Nevis,22-07-2020,300483,574,174,300309,Americas
Canada,22-07-2020,369801,2166,294,369507,Americas
Canada,22-07-2020,352118,1206,887,351231,Americas
Kosovo,22-07-2020,328609,705,789,327820,Europe
Burma,22-07-2020,285374,802,56,285318,South-East Asia
United Kingdom,22-07-2020,117491,1187,536,116955,Europe
United Kingdom,22-07-2020,162338,2380,1246,161092,Europe
United Kingdom,22-07-2020,179108,876,267,178841,Europe
Botswana,22-07-2020,379428,1481,294,379134,Africa
Burundi,22-07-2020,167303,822,617,166686,Africa
Sierra Leone,22-07-2020,155686,1571,1,155685,Africa
Malawi,22-07-2020,188417,2015,15,188402,Africa
United Kingdom,22-07-2020,53385,375,341,53044,Europe
France,22-07-2020,349443,1372,80,349363,Europe
South Sudan,22-07-2020,369575,832,531,369044,Africa
Western Sahara,22-07-2020,198270,2034,339,197931,Africa
Sao Tome and Principe,22-07-2020,139110,2047,947,138163,Africa
Yemen,22-07-2020,94375,1081,51,94324,Eastern Mediterranean
Comoros,22-07-2020,376213,763,465,375748,Africa
Tajikistan,22-07-2020,183892,403,340,183552,Europe
Lesotho,22-07-2020,326896,2379,802,326094,Africa
Afghanistan,23-07-2020,431401,53,232,431169,Eastern Mediterranean
Albania,23-07-2020,1033,782,1223,-190,Europe
Algeria,23-07-2020,89778,548,1185,88593,Africa
Andorra,23-07-2020,149690,139,777,148913,Europe
Angola,23-07-2020,251431,2038,1247,250184,Africa
Antigua and Barbuda,23-07-2020,33131,2185,52,33079,Americas
Argentina,23-07-2020,444013,1120,398,443615,Americas
Armenia,23-07-2020,138461,1766,1035,137426,Europe
Australia,23-07-2020,187045,173,251,186794,Western Pacific
Australia,23-07-2020,422327,1505,270,422057,Western Pacific
Australia,23-07-2020,100809,1111,778,100031,Western Pacific
Australia,23-07-2020,106599,15,323,106276,Western Pacific
Australia,23-07-2020,182791,1476,639,182152,Western Pacific
Australia,23-07-2020,220925,1024,1126,219799,Western Pacific
Australia,23-07-2020,207522,2430,419,207103,Western Pacific
Australia,23-07-2020,102645,1540,871,101774,Western Pacific
Austria,23-07-2020,387781,10,360,387421,Europe
Azerbaijan,23-07-2020,393071,1309,161,392910,Europe
Bahamas,23-07-2020,431875,1516,760,431115,Americas
Bahrain,23-07-2020,331331,1858,754,330577,Eastern Mediterranean
Bangladesh,23-07-2020,364200,1477,610,363590,South-East Asia
Barbados,23-07-2020,214783,78,1015,213768,Americas
Belarus,23-07-2020,210871,1617,1017,209854,Europe
Belgium,23-07-2020,95756,310,987,94769,Europe
Benin,23-07-2020,403080,1198,541,402539,Africa
Bhutan,23-07-2020,323640,411,531,323109,South-East Asia
Bolivia,23-07-2020,178378,123,638,177740,Americas
Bosnia and Herzegovina,23-07-2020,134341,966,1030,133311,Europe
Brazil,23-07-2020,264908,800,1223,263685,Americas
Brunei,23-07-2020,449594,1382,615,448979,Western Pacific
Bulgaria,23-07-2020,170177,2338,987,169190,Europe
Burkina Faso,23-07-2020,156322,495,1201,155121,Africa
Cabo Verde,23-07-2020,302657,1840,1218,301439,Africa
Cambodia,23-07-2020,430986,389,690,430296,Western Pacific
Cameroon,23-07-2020,233448,1980,958,232490,Africa
Canada,23-07-2020,214278,201,238,214040,Americas
Canada,23-07-2020,300548,2182,225,300323,Americas
Canada,23-07-2020,11466,1950,893,10573,Americas
Canada,23-07-2020,39213,610,544,38669,Americas
Canada,23-07-2020,205687,505,791,204896,Americas
Canada,23-07-2020,106386,1826,464,105922,Americas
Canada,23-07-2020,324822,941,386,324436,Americas
Canada,23-07-2020,140073,1657,629,139444,Americas
Canada,23-07-2020,16021,974,861,15160,Americas
Canada,23-07-2020,338928,83,917,338011,Americas
Central African Republic,23-07-2020,415212,1260,133,415079,Africa
Chad,23-07-2020,338472,609,64,338408,Africa
Chile,23-07-2020,403805,1655,134,403671,Americas
China,23-07-2020,169555,1769,714,168841,Western Pacific
China,23-07-2020,252213,1877,231,251982,Western Pacific
China,23-07-2020,289764,1991,721,289043,Western Pacific
China,23-07-2020,304023,581,310,303713,Western Pacific
China,23-07-2020,248196,756,483,247713,Western Pacific
China,23-07-2020,26444,15,630,25814,Western Pacific
China,23-07-2020,79859,378,1056,78803,Western Pacific
China,23-07-2020,429895,715,197,429698,Western Pacific
China,23-07-2020,334689,2186,1181,333508,Western Pacific
China,23-07-2020,305863,1787,902,304961,Western Pacific
China,23-07-2020,254386,901,920,253466,Western Pacific
China,23-07-2020,18345,606,1171,17174,Western Pacific
China,23-07-2020,134513,1075,749,133764,Western Pacific
China,23-07-2020,27458,212,346,27112,Western Pacific
China,23-07-2020,208595,1794,428,208167,Western Pacific
China,23-07-2020,444299,1298,739,443560,Western Pacific
China,23-07-2020,436202,1776,951,435251,Western Pacific
China,23-07-2020,259719,1300,590,259129,Western Pacific
China,23-07-2020,167780,1373,420,167360,Western Pacific
China,23-07-2020,18587,329,611,17976,Western Pacific
China,23-07-2020,368931,821,84,368847,Western Pacific
China,23-07-2020,240803,1020,588,240215,Western Pacific
China,23-07-2020,338453,33,532,337921,Western Pacific
China,23-07-2020,399034,1205,804,398230,Western Pacific
China,23-07-2020,99876,2417,1011,98865,Western Pacific
China,23-07-2020,304280,1460,1196,303084,Western Pacific
China,23-07-2020,398196,1239,1047,397149,Western Pacific
China,23-07-2020,446954,160,664,446290,Western Pacific
China,23-07-2020,79801,1089,596,79205,Western Pacific
China,23-07-2020,202800,1841,414,202386,Western Pacific
China,23-07-2020,339655,90,165,339490,Western Pacific
China,23-07-2020,320150,2218,15,320135,Western Pacific
China,23-07-2020,140212,1680,221,139991,Western Pacific
Colombia,23-07-2020,17822,1883,365,17457,Americas
Congo (Brazzaville),23-07-2020,227330,1596,1204,226126,Africa
Congo (Kinshasa),23-07-2020,6276,2125,1140,5136,Africa
Costa Rica,23-07-2020,189678,1659,975,188703,Americas
Cote d'Ivoire,23-07-2020,102388,1529,543,101845,Africa
Croatia,23-07-2020,106502,2193,772,105730,Europe
Cuba,23-07-2020,297003,1041,879,296124,Americas
Cyprus,23-07-2020,86968,2049,487,86481,Europe
Czechia,23-07-2020,380943,2268,50,380893,Europe
Denmark,23-07-2020,373403,360,1031,372372,Europe
Greenland,23-07-2020,201099,962,1154,199945,Europe
Denmark,23-07-2020,168489,2078,107,168382,Europe
Djibouti,23-07-2020,105940,1419,158,105782,Eastern Mediterranean
Dominican Republic,23-07-2020,314596,1153,1186,313410,Americas
Ecuador,23-07-2020,21946,265,1140,20806,Americas
Egypt,23-07-2020,34189,1047,1204,32985,Eastern Mediterranean
El Salvador,23-07-2020,345388,693,462,344926,Americas
Equatorial Guinea,23-07-2020,23455,1143,62,23393,Africa
Eritrea,23-07-2020,407097,2442,1194,405903,Africa
Estonia,23-07-2020,18378,47,948,17430,Europe
Eswatini,23-07-2020,219563,301,1181,218382,Africa
Ethiopia,23-07-2020,3922,356,532,3390,Africa
Fiji,23-07-2020,352040,1616,795,351245,Western Pacific
Finland,23-07-2020,437165,2081,515,436650,Europe
France,23-07-2020,117715,1035,692,117023,Europe
France,23-07-2020,50038,452,684,49354,Europe
France,23-07-2020,183912,1716,349,183563,Europe
France,23-07-2020,233913,835,301,233612,Europe
France,23-07-2020,76004,229,919,75085,Europe
France,23-07-2020,167734,2269,213,167521,Europe
France,23-07-2020,120736,816,660,120076,Europe
France,23-07-2020,47639,1274,1004,46635,Europe
France,23-07-2020,351595,902,1199,350396,Europe
France,23-07-2020,296810,453,745,296065,Europe
Gabon,23-07-2020,294814,1221,858,293956,Africa
Gambia,23-07-2020,191670,2323,557,191113,Africa
Georgia,23-07-2020,129524,495,781,128743,Europe
Germany,23-07-2020,120927,209,627,120300,Europe
Ghana,23-07-2020,244261,941,828,243433,Africa
Greece,23-07-2020,274442,625,75,274367,Europe
Guatemala,23-07-2020,411818,60,718,411100,Americas
Guinea,23-07-2020,241824,1881,1098,240726,Africa
Guyana,23-07-2020,228873,2457,31,228842,Americas
Haiti,23-07-2020,397545,1033,1031,396514,Americas
Holy See,23-07-2020,93233,1690,1117,92116,Europe
Honduras,23-07-2020,32887,513,1138,31749,Americas
Hungary,23-07-2020,431323,1935,1204,430119,Europe
Iceland,23-07-2020,2748,636,746,2002,Europe
India,23-07-2020,232563,1280,209,232354,South-East Asia
Indonesia,23-07-2020,395820,1398,132,395688,South-East Asia
Iran,23-07-2020,309964,2298,925,309039,Eastern Mediterranean
Iraq,23-07-2020,14890,1682,166,14724,Eastern Mediterranean
Ireland,23-07-2020,156035,1001,563,155472,Europe
Israel,23-07-2020,315849,2311,417,315432,Europe
Italy,23-07-2020,324840,1225,299,324541,Europe
Jamaica,23-07-2020,380660,2329,1113,379547,Americas
Japan,23-07-2020,137622,1580,478,137144,Western Pacific
Jordan,23-07-2020,423435,39,831,422604,Eastern Mediterranean
Kazakhstan,23-07-2020,195414,2261,253,195161,Europe
Kenya,23-07-2020,106829,2314,912,105917,Africa
South Korea,23-07-2020,107774,707,96,107678,Western Pacific
Kuwait,23-07-2020,409986,578,236,409750,Eastern Mediterranean
Kyrgyzstan,23-07-2020,426404,338,1201,425203,Europe
Latvia,23-07-2020,207665,760,16,207649,Europe
Lebanon,23-07-2020,370380,362,1104,369276,Eastern Mediterranean
Liberia,23-07-2020,192755,2436,99,192656,Africa
Liechtenstein,23-07-2020,186288,1686,380,185908,Europe
Lithuania,23-07-2020,213656,339,471,213185,Europe
Luxembourg,23-07-2020,77841,925,304,77537,Europe
Madagascar,23-07-2020,30126,727,460,29666,Africa
Malaysia,23-07-2020,14784,2421,608,14176,Western Pacific
Maldives,23-07-2020,92612,590,432,92180,South-East Asia
Malta,23-07-2020,105950,773,86,105864,Europe
Mauritania,23-07-2020,351974,2467,740,351234,Africa
Mauritius,23-07-2020,375561,1859,868,374693,Africa
Mexico,23-07-2020,289275,277,999,288276,Americas
Moldova,23-07-2020,266620,337,926,265694,Europe
Monaco,23-07-2020,398152,2049,116,398036,Europe
Mongolia,23-07-2020,113372,1412,1121,112251,Western Pacific
Montenegro,23-07-2020,68817,1624,229,68588,Europe
Morocco,23-07-2020,361955,451,917,361038,Eastern Mediterranean
Namibia,23-07-2020,83030,1693,49,82981,Africa
Nepal,23-07-2020,333135,1040,1179,331956,South-East Asia
Netherlands,23-07-2020,370827,1566,134,370693,Europe
Netherlands,23-07-2020,286147,2141,313,285834,Europe
Netherlands,23-07-2020,439699,2020,1078,438621,Europe
Netherlands,23-07-2020,352339,1965,424,351915,Europe
New Zealand,23-07-2020,366803,857,532,366271,Western Pacific
Nicaragua,23-07-2020,393722,834,534,393188,Americas
Niger,23-07-2020,423083,2393,1053,422030,Africa
Nigeria,23-07-2020,221056,1323,1147,219909,Africa
North Macedonia,23-07-2020,428492,1603,970,427522,Europe
Norway,23-07-2020,439048,1751,523,438525,Europe
Oman,23-07-2020,231713,255,820,230893,Eastern Mediterranean
Pakistan,23-07-2020,394968,2327,788,394180,Eastern Mediterranean
Panama,23-07-2020,110402,1676,14,110388,Americas
Papua New Guinea,23-07-2020,233192,661,430,232762,Western Pacific
Paraguay,23-07-2020,183905,787,575,183330,Americas
Peru,23-07-2020,367459,2062,150,367309,Americas
Philippines,23-07-2020,211925,880,116,211809,Western Pacific
Poland,23-07-2020,410481,1517,231,410250,Europe
Portugal,23-07-2020,275893,1103,469,275424,Europe
Qatar,23-07-2020,211609,1621,707,210902,Eastern Mediterranean
Romania,23-07-2020,38138,1678,953,37185,Europe
Russia,23-07-2020,139749,1246,1006,138743,Europe
Rwanda,23-07-2020,382783,1993,665,382118,Africa
Saint Lucia,23-07-2020,123069,1456,336,122733,Americas
Saint Vincent and the Grenadines,23-07-2020,376123,1824,626,375497,Americas
San Marino,23-07-2020,396443,877,247,396196,Europe
Saudi Arabia,23-07-2020,57603,8,677,56926,Eastern Mediterranean
Senegal,23-07-2020,395474,141,565,394909,Africa
Serbia,23-07-2020,308982,285,368,308614,Europe
Seychelles,23-07-2020,158528,1733,77,158451,Africa
Singapore,23-07-2020,144167,1835,965,143202,Western Pacific
Slovakia,23-07-2020,206173,2176,579,205594,Europe
Slovenia,23-07-2020,141334,2435,1230,140104,Europe
Somalia,23-07-2020,415937,1312,880,415057,Eastern Mediterranean
South Africa,23-07-2020,279510,1490,649,278861,Africa
Spain,23-07-2020,205017,2052,490,204527,Europe
Sri Lanka,23-07-2020,298327,569,363,297964,South-East Asia
Sudan,23-07-2020,135903,617,537,135366,Eastern Mediterranean
Suriname,23-07-2020,169037,509,1091,167946,Americas
Sweden,23-07-2020,436714,878,486,436228,Europe
Switzerland,23-07-2020,189960,798,1054,188906,Europe
Taiwan*,23-07-2020,58284,2285,785,57499,Western Pacific
Tanzania,23-07-2020,298455,1899,1136,297319,Africa
Thailand,23-07-2020,135321,181,913,134408,South-East Asia
Togo,23-07-2020,425324,778,240,425084,Africa
Trinidad and Tobago,23-07-2020,219995,337,1040,218955,Americas
Tunisia,23-07-2020,332829,1374,14,332815,Eastern Mediterranean
Turkey,23-07-2020,316652,721,732,315920,Europe
Uganda,23-07-2020,70347,1120,161,70186,Africa
Ukraine,23-07-2020,160841,621,910,159931,Europe
United Arab Emirates,23-07-2020,303542,1823,1227,302315,Eastern Mediterranean
United Kingdom,23-07-2020,122563,269,739,121824,Europe
United Kingdom,23-07-2020,250211,68,755,249456,Europe
United Kingdom,23-07-2020,48790,1236,1205,47585,Europe
United Kingdom,23-07-2020,177255,666,971,176284,Europe
United Kingdom,23-07-2020,101004,201,731,100273,Europe
United Kingdom,23-07-2020,384142,1604,102,384040,Europe
United Kingdom,23-07-2020,428664,500,185,428479,Europe
Uruguay,23-07-2020,208205,865,477,207728,Americas
US,23-07-2020,250774,98,816,249958,Americas
Uzbekistan,23-07-2020,382003,979,1180,380823,Europe
Venezuela,23-07-2020,361740,892,978,360762,Americas
Vietnam,23-07-2020,376962,808,988,375974,Western Pacific
Zambia,23-07-2020,251559,1041,915,250644,Africa
Zimbabwe,23-07-2020,208971,338,986,207985,Africa
Dominica,23-07-2020,37011,1534,452,36559,Americas
Grenada,23-07-2020,223168,1116,638,222530,Americas
Mozambique,23-07-2020,348771,259,892,347879,Africa
Syria,23-07-2020,283019,2051,1243,281776,Eastern Mediterranean
Timor-Leste,23-07-2020,41062,1809,168,40894,South-East Asia
Belize,23-07-2020,39621,2030,245,39376,Americas
Laos,23-07-2020,42678,795,668,42010,Western Pacific
Libya,23-07-2020,249220,722,591,248629,Eastern Mediterranean
West Bank and Gaza,23-07-2020,224905,117,938,223967,Eastern Mediterranean
Guinea-Bissau,23-07-2020,38579,352,1045,37534,Africa
Mali,23-07-2020,329790,1467,742,329048,Africa
Saint Kitts and Nevis,23-07-2020,71432,882,238,71194,Americas
Canada,23-07-2020,425373,577,143,425230,Americas
Canada,23-07-2020,115874,96,785,115089,Americas
Kosovo,23-07-2020,196838,1712,958,195880,Europe
Burma,23-07-2020,70333,228,813,69520,South-East Asia
United Kingdom,23-07-2020,92462,1351,920,91542,Europe
United Kingdom,23-07-2020,24226,1897,517,23709,Europe
United Kingdom,23-07-2020,347883,2408,777,347106,Europe
Botswana,23-07-2020,282920,832,949,281971,Africa
Burundi,23-07-2020,221345,1435,905,220440,Africa
Sierra Leone,23-07-2020,34898,852,392,34506,Africa
Malawi,23-07-2020,357401,2461,534,356867,Africa
United Kingdom,23-07-2020,132737,1618,334,132403,Europe
France,23-07-2020,364375,827,791,363584,Europe
South Sudan,23-07-2020,139486,2222,1152,138334,Africa
Western Sahara,23-07-2020,264359,1676,1089,263270,Africa
Sao Tome and Principe,23-07-2020,250628,1177,1091,249537,Africa
Yemen,23-07-2020,360672,1637,968,359704,Eastern Mediterranean
Comoros,23-07-2020,329377,1964,1208,328169,Africa
Tajikistan,23-07-2020,189538,1609,562,188976,Europe
Lesotho,23-07-2020,409520,56,1055,408465,Africa
Afghanistan,24-07-2020,145012,1201,1027,143985,Eastern Mediterranean
Albania,24-07-2020,94161,185,27,94134,Europe
Algeria,24-07-2020,371898,2463,987,370911,Africa
Andorra,24-07-2020,144177,159,539,143638,Europe
Angola,24-07-2020,261624,1480,398,261226,Africa
Antigua and Barbuda,24-07-2020,250167,1024,1027,249140,Americas
Argentina,24-07-2020,404422,2030,207,404215,Americas
Armenia,24-07-2020,444401,254,14,444387,Europe
Australia,24-07-2020,253077,1064,669,252408,Western Pacific
Australia,24-07-2020,183232,366,225,183007,Western Pacific
Australia,24-07-2020,118001,1943,1243,116758,Western Pacific
Australia,24-07-2020,444318,970,2,444316,Western Pacific
Australia,24-07-2020,41859,741,1007,40852,Western Pacific
Australia,24-07-2020,156518,111,401,156117,Western Pacific
Australia,24-07-2020,429492,472,99,429393,Western Pacific
Australia,24-07-2020,127470,2364,458,127012,Western Pacific
Austria,24-07-2020,449472,2437,148,449324,Europe
Azerbaijan,24-07-2020,163688,2346,151,163537,Europe
Bahamas,24-07-2020,250598,339,483,250115,Americas
Bahrain,24-07-2020,93148,136,61,93087,Eastern Mediterranean
Bangladesh,24-07-2020,350680,916,283,350397,South-East Asia
Barbados,24-07-2020,361991,1579,633,361358,Americas
Belarus,24-07-2020,397446,691,778,396668,Europe
Belgium,24-07-2020,442808,399,349,442459,Europe
Benin,24-07-2020,424661,906,821,423840,Africa
Bhutan,24-07-2020,169803,51,420,169383,South-East Asia
Bolivia,24-07-2020,345669,189,454,345215,Americas
Bosnia and Herzegovina,24-07-2020,66409,1820,417,65992,Europe
Brazil,24-07-2020,16487,797,1217,15270,Americas
Brunei,24-07-2020,132882,1354,489,132393,Western Pacific
Bulgaria,24-07-2020,250340,161,102,250238,Europe
Burkina Faso,24-07-2020,233922,450,982,232940,Africa
Cabo Verde,24-07-2020,62837,1924,488,62349,Africa
Cambodia,24-07-2020,124082,2415,1054,123028,Western Pacific
Cameroon,24-07-2020,108925,1748,410,108515,Africa
Canada,24-07-2020,133481,2341,302,133179,Americas
Canada,24-07-2020,412484,1255,117,412367,Americas
Canada,24-07-2020,198358,2471,510,197848,Americas
Canada,24-07-2020,78201,332,298,77903,Americas
Canada,24-07-2020,233319,1195,997,232322,Americas
Canada,24-07-2020,309532,312,539,308993,Americas
Canada,24-07-2020,52797,483,352,52445,Americas
Canada,24-07-2020,355747,2193,116,355631,Americas
Canada,24-07-2020,30904,1396,1237,29667,Americas
Canada,24-07-2020,47474,1970,1075,46399,Americas
Central African Republic,24-07-2020,403251,1242,523,402728,Africa
Chad,24-07-2020,187916,1238,1129,186787,Africa
Chile,24-07-2020,212289,2363,113,212176,Americas
China,24-07-2020,46157,2178,402,45755,Western Pacific
China,24-07-2020,136253,1739,573,135680,Western Pacific
China,24-07-2020,119577,1792,339,119238,Western Pacific
China,24-07-2020,90428,1578,537,89891,Western Pacific
China,24-07-2020,331470,86,1016,330454,Western Pacific
China,24-07-2020,318943,273,789,318154,Western Pacific
China,24-07-2020,12589,1444,1225,11364,Western Pacific
China,24-07-2020,310526,1408,1020,309506,Western Pacific
China,24-07-2020,239681,2433,519,239162,Western Pacific
China,24-07-2020,159424,752,1048,158376,Western Pacific
China,24-07-2020,176704,485,1079,175625,Western Pacific
China,24-07-2020,173870,108,1140,172730,Western Pacific
China,24-07-2020,38441,727,345,38096,Western Pacific
China,24-07-2020,288404,546,1159,287245,Western Pacific
China,24-07-2020,17442,1484,284,17158,Western Pacific
China,24-07-2020,408688,103,983,407705,Western Pacific
China,24-07-2020,388259,2294,1159,387100,Western Pacific
China,24-07-2020,34569,1989,892,33677,Western Pacific
China,24-07-2020,294251,120,139,294112,Western Pacific
China,24-07-2020,228434,1631,241,228193,Western Pacific
China,24-07-2020,64490,2105,844,63646,Western Pacific
China,24-07-2020,364905,1041,762,364143,Western Pacific
China,24-07-2020,126803,348,454,126349,Western Pacific
China,24-07-2020,299156,1815,671,298485,Western Pacific
China,24-07-2020,225727,2419,1069,224658,Western Pacific
China,24-07-2020,140047,41,670,139377,Western Pacific
China,24-07-2020,448529,2118,485,448044,Western Pacific
China,24-07-2020,226818,2134,19,226799,Western Pacific
China,24-07-2020,280556,1009,552,280004,Western Pacific
China,24-07-2020,166935,1779,142,166793,Western Pacific
China,24-07-2020,368862,1665,692,368170,Western Pacific
China,24-07-2020,1998,277,363,1635,Western Pacific
China,24-07-2020,335263,277,47,335216,Western Pacific
Colombia,24-07-2020,116162,79,795,115367,Americas
Congo (Brazzaville),24-07-2020,332501,1885,1178,331323,Africa
Congo (Kinshasa),24-07-2020,246789,1190,1220,245569,Africa
Costa Rica,24-07-2020,341008,803,164,340844,Americas
Cote d'Ivoire,24-07-2020,319542,320,917,318625,Africa
Croatia,24-07-2020,129883,1387,833,129050,Europe
Cuba,24-07-2020,217421,1912,1223,216198,Americas
Cyprus,24-07-2020,153497,33,174,153323,Europe
Czechia,24-07-2020,49802,1848,1058,48744,Europe
Denmark,24-07-2020,449937,297,514,449423,Europe
Greenland,24-07-2020,187109,594,1204,185905,Europe
Denmark,24-07-2020,205309,1575,1133,204176,Europe
Djibouti,24-07-2020,273244,306,72,273172,Eastern Mediterranean
Dominican Republic,24-07-2020,53382,2405,145,53237,Americas
Ecuador,24-07-2020,439771,1504,260,439511,Americas
Egypt,24-07-2020,405153,1323,1156,403997,Eastern Mediterranean
El Salvador,24-07-2020,182293,574,1155,181138,Americas
Equatorial Guinea,24-07-2020,16886,1892,883,16003,Africa
Eritrea,24-07-2020,434354,1432,733,433621,Africa
Estonia,24-07-2020,175571,83,30,175541,Europe
Eswatini,24-07-2020,227945,1448,398,227547,Africa
Ethiopia,24-07-2020,302997,443,95,302902,Africa
Fiji,24-07-2020,2651,1775,109,2542,Western Pacific
Finland,24-07-2020,391891,366,421,391470,Europe
France,24-07-2020,34500,615,785,33715,Europe
France,24-07-2020,14699,300,961,13738,Europe
France,24-07-2020,112549,835,544,112005,Europe
France,24-07-2020,146234,1980,830,145404,Europe
France,24-07-2020,169623,361,89,169534,Europe
France,24-07-2020,180021,2161,163,179858,Europe
France,24-07-2020,212353,1936,419,211934,Europe
France,24-07-2020,75629,1309,266,75363,Europe
France,24-07-2020,299242,182,689,298553,Europe
France,24-07-2020,338483,665,358,338125,Europe
Gabon,24-07-2020,249327,1748,111,249216,Africa
Gambia,24-07-2020,162205,1560,589,161616,Africa
Georgia,24-07-2020,438418,1969,763,437655,Europe
Germany,24-07-2020,271930,1197,342,271588,Europe
Ghana,24-07-2020,102022,1821,643,101379,Africa
Greece,24-07-2020,27608,765,260,27348,Europe
Guatemala,24-07-2020,324878,913,473,324405,Americas
Guinea,24-07-2020,354780,1863,445,354335,Africa
Guyana,24-07-2020,242125,2377,858,241267,Americas
Haiti,24-07-2020,153115,1770,456,152659,Americas
Holy See,24-07-2020,96488,125,465,96023,Europe
Honduras,24-07-2020,417328,43,993,416335,Americas
Hungary,24-07-2020,213291,2273,897,212394,Europe
Iceland,24-07-2020,277460,1104,798,276662,Europe
India,24-07-2020,434217,50,1199,433018,South-East Asia
Indonesia,24-07-2020,187044,32,871,186173,South-East Asia
Iran,24-07-2020,312515,330,254,312261,Eastern Mediterranean
Iraq,24-07-2020,12165,2480,284,11881,Eastern Mediterranean
Ireland,24-07-2020,69721,955,957,68764,Europe
Israel,24-07-2020,226714,2112,1228,225486,Europe
Italy,24-07-2020,387284,1764,318,386966,Europe
Jamaica,24-07-2020,139991,1908,56,139935,Americas
Japan,24-07-2020,60990,268,510,60480,Western Pacific
Jordan,24-07-2020,332876,1029,498,332378,Eastern Mediterranean
Kazakhstan,24-07-2020,178538,1027,403,178135,Europe
Kenya,24-07-2020,276780,485,970,275810,Africa
South Korea,24-07-2020,116016,1896,50,115966,Western Pacific
Kuwait,24-07-2020,285655,1592,96,285559,Eastern Mediterranean
Kyrgyzstan,24-07-2020,59215,1079,40,59175,Europe
Latvia,24-07-2020,271024,2303,715,270309,Europe
Lebanon,24-07-2020,421372,654,1184,420188,Eastern Mediterranean
Liberia,24-07-2020,261377,2149,124,261253,Africa
Liechtenstein,24-07-2020,354075,1673,973,353102,Europe
Lithuania,24-07-2020,148772,2111,857,147915,Europe
Luxembourg,24-07-2020,431323,2463,679,430644,Europe
Madagascar,24-07-2020,104103,1992,403,103700,Africa
Malaysia,24-07-2020,325024,1506,1133,323891,Western Pacific
Maldives,24-07-2020,341599,510,75,341524,South-East Asia
Malta,24-07-2020,300351,1222,694,299657,Europe
Mauritania,24-07-2020,331027,2036,87,330940,Africa
Mauritius,24-07-2020,54438,1056,514,53924,Africa
Mexico,24-07-2020,346892,1534,34,346858,Americas
Moldova,24-07-2020,214096,265,9,214087,Europe
Monaco,24-07-2020,22242,1298,1138,21104,Europe
Mongolia,24-07-2020,149129,2444,365,148764,Western Pacific
Montenegro,24-07-2020,980,1250,1092,-112,Europe
Morocco,24-07-2020,110384,2359,584,109800,Eastern Mediterranean
Namibia,24-07-2020,393126,2346,244,392882,Africa
Nepal,24-07-2020,421226,2094,5,421221,South-East Asia
Netherlands,24-07-2020,195456,1708,538,194918,Europe
Netherlands,24-07-2020,59487,947,745,58742,Europe
Netherlands,24-07-2020,296744,123,1161,295583,Europe
Netherlands,24-07-2020,369895,2467,1069,368826,Europe
New Zealand,24-07-2020,78523,2187,938,77585,Western Pacific
Nicaragua,24-07-2020,357789,1832,241,357548,Americas
Niger,24-07-2020,295981,1341,420,295561,Africa
Nigeria,24-07-2020,256672,199,143,256529,Africa
North Macedonia,24-07-2020,447747,1671,502,447245,Europe
Norway,24-07-2020,213427,630,383,213044,Europe
Oman,24-07-2020,447934,1537,587,447347,Eastern Mediterranean
Pakistan,24-07-2020,444501,986,445,444056,Eastern Mediterranean
Panama,24-07-2020,108404,1694,826,107578,Americas
Papua New Guinea,24-07-2020,352765,911,991,351774,Western Pacific
Paraguay,24-07-2020,267599,2417,329,267270,Americas
Peru,24-07-2020,15236,2465,816,14420,Americas
Philippines,24-07-2020,70852,35,406,70446,Western Pacific
Poland,24-07-2020,791,1377,1030,-239,Europe
Portugal,24-07-2020,393138,716,78,393060,Europe
Qatar,24-07-2020,83651,1475,1201,82450,Eastern Mediterranean
Romania,24-07-2020,348428,1997,997,347431,Europe
Russia,24-07-2020,427680,1173,69,427611,Europe
Rwanda,24-07-2020,75865,1157,494,75371,Africa
Saint Lucia,24-07-2020,108011,2437,81,107930,Americas
Saint Vincent and the Grenadines,24-07-2020,429916,1887,731,429185,Americas
San Marino,24-07-2020,297625,1005,1027,296598,Europe
Saudi Arabia,24-07-2020,157465,2305,840,156625,Eastern Mediterranean
Senegal,24-07-2020,30598,2191,350,30248,Africa
Serbia,24-07-2020,343920,1942,62,343858,Europe
Seychelles,24-07-2020,48077,1467,489,47588,Africa
Singapore,24-07-2020,143366,135,1062,142304,Western Pacific
Slovakia,24-07-2020,225101,1476,1076,224025,Europe
Slovenia,24-07-2020,376277,882,557,375720,Europe
Somalia,24-07-2020,426794,615,331,426463,Eastern Mediterranean
South Africa,24-07-2020,105511,1837,780,104731,Africa
Spain,24-07-2020,398931,532,1123,397808,Europe
Sri Lanka,24-07-2020,406264,1161,874,405390,South-East Asia
Sudan,24-07-2020,268945,1888,888,268057,Eastern Mediterranean
Suriname,24-07-2020,51556,308,133,51423,Americas
Sweden,24-07-2020,244081,1337,568,243513,Europe
Switzerland,24-07-2020,447631,181,75,447556,Europe
Taiwan*,24-07-2020,384280,1609,707,383573,Western Pacific
Tanzania,24-07-2020,317853,329,68,317785,Africa
Thailand,24-07-2020,273212,1071,649,272563,South-East Asia
Togo,24-07-2020,91296,975,937,90359,Africa
Trinidad and Tobago,24-07-2020,94328,489,956,93372,Americas
Tunisia,24-07-2020,396181,1209,573,395608,Eastern Mediterranean
Turkey,24-07-2020,192244,1982,514,191730,Europe
Uganda,24-07-2020,30563,319,205,30358,Africa
Ukraine,24-07-2020,144825,404,1211,143614,Europe
United Arab Emirates,24-07-2020,233645,2053,330,233315,Eastern Mediterranean
United Kingdom,24-07-2020,283842,2046,469,283373,Europe
United Kingdom,24-07-2020,34535,324,19,34516,Europe
United Kingdom,24-07-2020,309843,28,706,309137,Europe
United Kingdom,24-07-2020,319840,1852,615,319225,Europe
United Kingdom,24-07-2020,399533,328,785,398748,Europe
United Kingdom,24-07-2020,259029,1029,30,258999,Europe
United Kingdom,24-07-2020,28869,2446,325,28544,Europe
Uruguay,24-07-2020,444558,1123,1240,443318,Americas
US,24-07-2020,219497,2109,1034,218463,Americas
Uzbekistan,24-07-2020,393517,706,609,392908,Europe
Venezuela,24-07-2020,322255,692,614,321641,Americas
Vietnam,24-07-2020,198665,1751,354,198311,Western Pacific
Zambia,24-07-2020,449602,1814,563,449039,Africa
Zimbabwe,24-07-2020,301653,76,625,301028,Africa
Dominica,24-07-2020,258818,836,225,258593,Americas
Grenada,24-07-2020,185969,96,587,185382,Americas
Mozambique,24-07-2020,176850,1926,61,176789,Africa
Syria,24-07-2020,437596,505,145,437451,Eastern Mediterranean
Timor-Leste,24-07-2020,212721,1651,85,212636,South-East Asia
Belize,24-07-2020,258298,2442,591,257707,Americas
Laos,24-07-2020,161658,1525,852,160806,Western Pacific
Libya,24-07-2020,115338,1214,790,114548,Eastern Mediterranean
West Bank and Gaza,24-07-2020,354457,4,324,354133,Eastern Mediterranean
Guinea-Bissau,24-07-2020,289086,451,1014,288072,Africa
Mali,24-07-2020,154872,1985,908,153964,Africa
Saint Kitts and Nevis,24-07-2020,24344,699,1021,23323,Americas
Canada,24-07-2020,176754,1041,714,176040,Americas
Canada,24-07-2020,63867,1367,1014,62853,Americas
Kosovo,24-07-2020,104550,2222,847,103703,Europe
Burma,24-07-2020,421556,2318,1085,420471,South-East Asia
United Kingdom,24-07-2020,405651,301,795,404856,Europe
United Kingdom,24-07-2020,275454,1114,850,274604,Europe
United Kingdom,24-07-2020,110111,1213,684,109427,Europe
Botswana,24-07-2020,267154,2152,228,266926,Africa
Burundi,24-07-2020,362471,1460,660,361811,Africa
Sierra Leone,24-07-2020,59741,1394,712,59029,Africa
Malawi,24-07-2020,103318,926,44,103274,Africa
United Kingdom,24-07-2020,375125,1914,965,374160,Europe
France,24-07-2020,128055,1641,734,127321,Europe
South Sudan,24-07-2020,56664,1332,258,56406,Africa
Western Sahara,24-07-2020,7764,1513,1185,6579,Africa
Sao Tome and Principe,24-07-2020,66190,1637,260,65930,Africa
Yemen,24-07-2020,39072,495,1117,37955,Eastern Mediterranean
Comoros,24-07-2020,172706,159,304,172402,Africa
Tajikistan,24-07-2020,179108,617,202,178906,Europe
Lesotho,24-07-2020,351295,764,778,350517,Africa
Afghanistan,25-07-2020,257194,2249,874,256320,Eastern Mediterranean
Albania,25-07-2020,248277,2140,396,247881,Europe
Algeria,25-07-2020,278696,103,882,277814,Africa
Andorra,25-07-2020,421174,929,906,420268,Europe
Angola,25-07-2020,234872,1174,32,234840,Africa
Antigua and Barbuda,25-07-2020,273636,616,843,272793,Americas
Argentina,25-07-2020,352945,2118,102,352843,Americas
Armenia,25-07-2020,112872,1584,495,112377,Europe
Australia,25-07-2020,29630,1508,704,28926,Western Pacific
Australia,25-07-2020,245330,363,105,245225,Western Pacific
Australia,25-07-2020,299451,1959,241,299210,Western Pacific
Australia,25-07-2020,71936,1552,581,71355,Western Pacific
Australia,25-07-2020,168444,1982,1012,167432,Western Pacific
Australia,25-07-2020,413010,348,283,412727,Western Pacific
Australia,25-07-2020,49514,1718,785,48729,Western Pacific
Australia,25-07-2020,237115,950,999,236116,Western Pacific
Austria,25-07-2020,407525,1774,717,406808,Europe
Azerbaijan,25-07-2020,23885,968,1162,22723,Europe
Bahamas,25-07-2020,70673,1341,1000,69673,Americas
Bahrain,25-07-2020,311885,423,249,311636,Eastern Mediterranean
Bangladesh,25-07-2020,94174,2028,998,93176,South-East Asia
Barbados,25-07-2020,236376,83,992,235384,Americas
Belarus,25-07-2020,298656,474,751,297905,Europe
Belgium,25-07-2020,110552,934,1128,109424,Europe
Benin,25-07-2020,314953,357,434,314519,Africa
Bhutan,25-07-2020,10724,846,396,10328,South-East Asia
Bolivia,25-07-2020,258104,1348,186,257918,Americas
Bosnia and Herzegovina,25-07-2020,17746,2462,407,17339,Europe
Brazil,25-07-2020,122215,2446,917,121298,Americas
Brunei,25-07-2020,105514,631,1248,104266,Western Pacific
Bulgaria,25-07-2020,12580,1856,409,12171,Europe
Burkina Faso,25-07-2020,64166,1962,755,63411,Africa
Cabo Verde,25-07-2020,447865,1395,582,447283,Africa
Cambodia,25-07-2020,41996,499,76,41920,Western Pacific
Cameroon,25-07-2020,197796,635,15,197781,Africa
Canada,25-07-2020,149426,419,1014,148412,Americas
Canada,25-07-2020,309275,1714,800,308475,Americas
Canada,25-07-2020,279806,1218,631,279175,Americas
Canada,25-07-2020,92328,1444,1046,91282,Americas
Canada,25-07-2020,171162,1377,1076,170086,Americas
Canada,25-07-2020,313294,901,1125,312169,Americas
Canada,25-07-2020,444071,1905,1250,442821,Americas
Canada,25-07-2020,409649,2342,1113,408536,Americas
Canada,25-07-2020,344846,1957,1052,343794,Americas
Canada,25-07-2020,258147,1687,577,257570,Americas
Central African Republic,25-07-2020,156128,2366,1044,155084,Africa
Chad,25-07-2020,388661,1471,830,387831,Africa
Chile,25-07-2020,435516,2336,541,434975,Americas
China,25-07-2020,432370,487,875,431495,Western Pacific
China,25-07-2020,230771,2424,919,229852,Western Pacific
China,25-07-2020,91094,1064,657,90437,Western Pacific
China,25-07-2020,68869,2449,410,68459,Western Pacific
China,25-07-2020,230259,1209,302,229957,Western Pacific
China,25-07-2020,206275,2500,1000,205275,Western Pacific
China,25-07-2020,158855,140,123,158732,Western Pacific
China,25-07-2020,127264,60,569,126695,Western Pacific
China,25-07-2020,176611,1336,40,176571,Western Pacific
China,25-07-2020,143244,1836,420,142824,Western Pacific
China,25-07-2020,39169,430,329,38840,Western Pacific
China,25-07-2020,308369,281,766,307603,Western Pacific
China,25-07-2020,293303,1770,387,292916,Western Pacific
China,25-07-2020,311581,1842,246,311335,Western Pacific
China,25-07-2020,284499,2415,141,284358,Western Pacific
China,25-07-2020,224543,64,633,223910,Western Pacific
China,25-07-2020,118901,2456,548,118353,Western Pacific
China,25-07-2020,226171,1917,1149,225022,Western Pacific
China,25-07-2020,18754,629,562,18192,Western Pacific
China,25-07-2020,178134,805,146,177988,Western Pacific
China,25-07-2020,256475,2125,0,256475,Western Pacific
China,25-07-2020,407990,1898,374,407616,Western Pacific
China,25-07-2020,193739,2448,115,193624,Western Pacific
China,25-07-2020,91433,1002,3,91430,Western Pacific
China,25-07-2020,276319,2348,758,275561,Western Pacific
China,25-07-2020,120878,857,323,120555,Western Pacific
China,25-07-2020,346051,1847,1022,345029,Western Pacific
China,25-07-2020,402778,1290,53,402725,Western Pacific
China,25-07-2020,346320,130,1047,345273,Western Pacific
China,25-07-2020,361022,961,358,360664,Western Pacific
China,25-07-2020,272520,2488,61,272459,Western Pacific
China,25-07-2020,41319,1423,140,41179,Western Pacific
China,25-07-2020,275031,1364,134,274897,Western Pacific
Colombia,25-07-2020,30423,842,896,29527,Americas
Congo (Brazzaville),25-07-2020,7373,292,976,6397,Africa
Congo (Kinshasa),25-07-2020,239858,1574,735,239123,Africa
Costa Rica,25-07-2020,390790,1828,897,389893,Americas
Cote d'Ivoire,25-07-2020,190574,2441,1073,189501,Africa
Croatia,25-07-2020,19204,145,254,18950,Europe
Cuba,25-07-2020,19038,2047,945,18093,Americas
Cyprus,25-07-2020,237211,1017,823,236388,Europe
Czechia,25-07-2020,100225,1618,977,99248,Europe
Denmark,25-07-2020,54545,1965,1217,53328,Europe
Greenland,25-07-2020,228952,1577,652,228300,Europe
Denmark,25-07-2020,125019,2301,701,124318,Europe
Djibouti,25-07-2020,240515,2042,826,239689,Eastern Mediterranean
Dominican Republic,25-07-2020,4458,198,845,3613,Americas
Ecuador,25-07-2020,431504,327,758,430746,Americas
Egypt,25-07-2020,128386,150,662,127724,Eastern Mediterranean
El Salvador,25-07-2020,114884,567,538,114346,Americas
Equatorial Guinea,25-07-2020,200809,394,852,199957,Africa
Eritrea,25-07-2020,239686,1810,246,239440,Africa
Estonia,25-07-2020,8093,1735,817,7276,Europe
Eswatini,25-07-2020,31497,24,606,30891,Africa
Ethiopia,25-07-2020,226655,692,1092,225563,Africa
Fiji,25-07-2020,47233,702,714,46519,Western Pacific
Finland,25-07-2020,181027,214,620,180407,Europe
France,25-07-2020,12182,262,1148,11034,Europe
France,25-07-2020,293560,2118,1041,292519,Europe
France,25-07-2020,72189,1970,529,71660,Europe
France,25-07-2020,242503,2176,197,242306,Europe
France,25-07-2020,59942,1420,481,59461,Europe
France,25-07-2020,373178,1180,488,372690,Europe
France,25-07-2020,372527,1510,1118,371409,Europe
France,25-07-2020,62011,2294,489,61522,Europe
France,25-07-2020,150275,97,238,150037,Europe
France,25-07-2020,145861,1756,1019,144842,Europe
Gabon,25-07-2020,210923,1290,631,210292,Africa
Gambia,25-07-2020,242842,2244,991,241851,Africa
Georgia,25-07-2020,119684,2436,244,119440,Europe
Germany,25-07-2020,20011,2304,726,19285,Europe
Ghana,25-07-2020,264950,2272,1029,263921,Africa
Greece,25-07-2020,412638,784,891,411747,Europe
Guatemala,25-07-2020,363863,728,152,363711,Americas
Guinea,25-07-2020,126155,2497,663,125492,Africa
Guyana,25-07-2020,17009,693,531,16478,Americas
Haiti,25-07-2020,371220,1540,1161,370059,Americas
Holy See,25-07-2020,128354,645,153,128201,Europe
Honduras,25-07-2020,78456,728,736,77720,Americas
Hungary,25-07-2020,260299,642,612,259687,Europe
Iceland,25-07-2020,47883,1502,563,47320,Europe
India,25-07-2020,295069,369,871,294198,South-East Asia
Indonesia,25-07-2020,282122,1244,378,281744,South-East Asia
Iran,25-07-2020,224644,1297,1172,223472,Eastern Mediterranean
Iraq,25-07-2020,260566,522,1023,259543,Eastern Mediterranean
Ireland,25-07-2020,19635,1352,15,19620,Europe
Israel,25-07-2020,136971,1399,160,136811,Europe
Italy,25-07-2020,397672,1033,344,397328,Europe
Jamaica,25-07-2020,445560,92,425,445135,Americas
Japan,25-07-2020,41891,2049,420,41471,Western Pacific
Jordan,25-07-2020,208857,66,289,208568,Eastern Mediterranean
Kazakhstan,25-07-2020,389704,1942,949,388755,Europe
Kenya,25-07-2020,270703,2026,1159,269544,Africa
South Korea,25-07-2020,176940,1866,254,176686,Western Pacific
Kuwait,25-07-2020,238079,808,1130,236949,Eastern Mediterranean
Kyrgyzstan,25-07-2020,134692,2309,294,134398,Europe
Latvia,25-07-2020,186341,758,820,185521,Europe
Lebanon,25-07-2020,415150,2060,890,414260,Eastern Mediterranean
Liberia,25-07-2020,379075,1735,664,378411,Africa
Liechtenstein,25-07-2020,373938,2357,778,373160,Europe
Lithuania,25-07-2020,192204,1677,489,191715,Europe
Luxembourg,25-07-2020,323477,1260,353,323124,Europe
Madagascar,25-07-2020,54705,282,936,53769,Africa
Malaysia,25-07-2020,254336,489,1144,253192,Western Pacific
Maldives,25-07-2020,72440,1956,805,71635,South-East Asia
Malta,25-07-2020,272626,406,989,271637,Europe
Mauritania,25-07-2020,119041,1799,37,119004,Africa
Mauritius,25-07-2020,210723,1766,543,210180,Africa
Mexico,25-07-2020,175857,2313,163,175694,Americas
Moldova,25-07-2020,388584,1748,603,387981,Europe
Monaco,25-07-2020,357914,1651,626,357288,Europe
Mongolia,25-07-2020,327909,1792,1238,326671,Western Pacific
Montenegro,25-07-2020,128944,604,455,128489,Europe
Morocco,25-07-2020,115577,1015,315,115262,Eastern Mediterranean
Namibia,25-07-2020,10873,693,421,10452,Africa
Nepal,25-07-2020,193163,420,285,192878,South-East Asia
Netherlands,25-07-2020,59192,2338,408,58784,Europe
Netherlands,25-07-2020,435825,2070,624,435201,Europe
Netherlands,25-07-2020,351892,143,754,351138,Europe
Netherlands,25-07-2020,380320,1889,365,379955,Europe
New Zealand,25-07-2020,164099,199,594,163505,Western Pacific
Nicaragua,25-07-2020,333701,1890,1055,332646,Americas
Niger,25-07-2020,106928,1107,507,106421,Africa
Nigeria,25-07-2020,104083,2193,543,103540,Africa
North Macedonia,25-07-2020,132432,1209,749,131683,Europe
Norway,25-07-2020,276926,1020,514,276412,Europe
Oman,25-07-2020,160764,2143,151,160613,Eastern Mediterranean
Pakistan,25-07-2020,69985,2386,1174,68811,Eastern Mediterranean
Panama,25-07-2020,370625,1011,437,370188,Americas
Papua New Guinea,25-07-2020,131308,2413,1189,130119,Western Pacific
Paraguay,25-07-2020,423764,736,299,423465,Americas
Peru,25-07-2020,84247,2442,905,83342,Americas
Philippines,25-07-2020,374207,2391,365,373842,Western Pacific
Poland,25-07-2020,115424,2178,64,115360,Europe
Portugal,25-07-2020,258878,1286,872,258006,Europe
Qatar,25-07-2020,397878,811,1071,396807,Eastern Mediterranean
Romania,25-07-2020,341242,361,933,340309,Europe
Russia,25-07-2020,404862,502,115,404747,Europe
Rwanda,25-07-2020,219953,1825,673,219280,Africa
Saint Lucia,25-07-2020,351760,1922,600,351160,Americas
Saint Vincent and the Grenadines,25-07-2020,267190,1205,1025,266165,Americas
San Marino,25-07-2020,235903,2007,1070,234833,Europe
Saudi Arabia,25-07-2020,210977,1794,345,210632,Eastern Mediterranean
Senegal,25-07-2020,231185,0,637,230548,Africa
Serbia,25-07-2020,358425,536,370,358055,Europe
Seychelles,25-07-2020,335248,1541,99,335149,Africa
Singapore,25-07-2020,382536,1246,831,381705,Western Pacific
Slovakia,25-07-2020,106891,1615,684,106207,Europe
Slovenia,25-07-2020,360412,895,679,359733,Europe
Somalia,25-07-2020,226989,993,846,226143,Eastern Mediterranean
South Africa,25-07-2020,407631,638,1191,406440,Africa
Spain,25-07-2020,440711,2415,859,439852,Europe
Sri Lanka,25-07-2020,209448,483,694,208754,South-East Asia
Sudan,25-07-2020,446697,937,116,446581,Eastern Mediterranean
Suriname,25-07-2020,253290,1911,779,252511,Americas
Sweden,25-07-2020,174138,608,1238,172900,Europe
Switzerland,25-07-2020,44438,474,95,44343,Europe
Taiwan*,25-07-2020,158616,2410,844,157772,Western Pacific
Tanzania,25-07-2020,52774,2300,829,51945,Africa
Thailand,25-07-2020,33128,673,742,32386,South-East Asia
Togo,25-07-2020,198092,1879,12,198080,Africa
Trinidad and Tobago,25-07-2020,48012,56,470,47542,Americas
Tunisia,25-07-2020,359767,2037,984,358783,Eastern Mediterranean
Turkey,25-07-2020,159827,2364,1236,158591,Europe
Uganda,25-07-2020,220634,742,1221,219413,Africa
Ukraine,25-07-2020,189764,1574,545,189219,Europe
United Arab Emirates,25-07-2020,62099,2262,218,61881,Eastern Mediterranean
United Kingdom,25-07-2020,110239,1916,1198,109041,Europe
United Kingdom,25-07-2020,330617,1883,750,329867,Europe
United Kingdom,25-07-2020,81549,753,834,80715,Europe
United Kingdom,25-07-2020,353200,213,869,352331,Europe
United Kingdom,25-07-2020,137081,1859,100,136981,Europe
United Kingdom,25-07-2020,376939,1359,40,376899,Europe
United Kingdom,25-07-2020,153058,533,343,152715,Europe
Uruguay,25-07-2020,240678,423,485,240193,Americas
US,25-07-2020,284812,2477,594,284218,Americas
Uzbekistan,25-07-2020,4540,699,783,3757,Europe
Venezuela,25-07-2020,240810,979,685,240125,Americas
Vietnam,25-07-2020,83624,2230,779,82845,Western Pacific
Zambia,25-07-2020,54234,2330,301,53933,Africa
Zimbabwe,25-07-2020,164366,2251,1088,163278,Africa
Dominica,25-07-2020,240999,2315,358,240641,Americas
Grenada,25-07-2020,129299,402,826,128473,Americas
Mozambique,25-07-2020,222678,1613,596,222082,Africa
Syria,25-07-2020,130635,591,796,129839,Eastern Mediterranean
Timor-Leste,25-07-2020,255362,2215,445,254917,South-East Asia
Belize,25-07-2020,100958,396,403,100555,Americas
Laos,25-07-2020,259631,2446,460,259171,Western Pacific
Libya,25-07-2020,252208,372,867,251341,Eastern Mediterranean
West Bank and Gaza,25-07-2020,129970,410,401,129569,Eastern Mediterranean
Guinea-Bissau,25-07-2020,14660,335,924,13736,Africa
Mali,25-07-2020,82693,328,197,82496,Africa
Saint Kitts and Nevis,25-07-2020,257614,1209,1241,256373,Americas
Canada,25-07-2020,44064,1259,69,43995,Americas
Canada,25-07-2020,199455,98,955,198500,Americas
Kosovo,25-07-2020,408972,2303,665,408307,Europe
Burma,25-07-2020,50677,479,186,50491,South-East Asia
United Kingdom,25-07-2020,144969,1972,1058,143911,Europe
United Kingdom,25-07-2020,362709,2288,663,362046,Europe
United Kingdom,25-07-2020,184456,1893,339,184117,Europe
Botswana,25-07-2020,308888,2255,443,308445,Africa
Burundi,25-07-2020,84826,1922,217,84609,Africa
Sierra Leone,25-07-2020,169994,1125,1031,168963,Africa
Malawi,25-07-2020,400373,1382,1192,399181,Africa
United Kingdom,25-07-2020,274401,739,151,274250,Europe
France,25-07-2020,446832,1714,342,446490,Europe
South Sudan,25-07-2020,288106,2311,338,287768,Africa
Western Sahara,25-07-2020,377560,1613,990,376570,Africa
Sao Tome and Principe,25-07-2020,274579,1698,369,274210,Africa
Yemen,25-07-2020,44515,589,394,44121,Eastern Mediterranean
Comoros,25-07-2020,190185,1919,142,190043,Africa
Tajikistan,25-07-2020,127659,1112,624,127035,Europe
Lesotho,25-07-2020,98352,78,813,97539,Africa
Afghanistan,26-07-2020,265583,2188,885,264698,Eastern Mediterranean
Albania,26-07-2020,33425,655,684,32741,Europe
Algeria,26-07-2020,438272,2298,1194,437078,Africa
Andorra,26-07-2020,314598,1275,646,313952,Europe
Angola,26-07-2020,124869,1074,1107,123762,Africa
Antigua and Barbuda,26-07-2020,284797,1228,1057,283740,Americas
Argentina,26-07-2020,47565,1402,247,47318,Americas
Armenia,26-07-2020,153115,620,477,152638,Europe
Australia,26-07-2020,150057,2127,174,149883,Western Pacific
Australia,26-07-2020,102426,680,1109,101317,Western Pacific
Australia,26-07-2020,227291,747,514,226777,Western Pacific
Australia,26-07-2020,213294,1117,991,212303,Western Pacific
Australia,26-07-2020,377644,2461,753,376891,Western Pacific
Australia,26-07-2020,304801,80,936,303865,Western Pacific
Australia,26-07-2020,424174,153,255,423919,Western Pacific
Australia,26-07-2020,336239,64,650,335589,Western Pacific
Austria,26-07-2020,111021,2351,743,110278,Europe
Azerbaijan,26-07-2020,168041,758,975,167066,Europe
Bahamas,26-07-2020,448648,106,461,448187,Americas
Bahrain,26-07-2020,52921,2495,899,52022,Eastern Mediterranean
Bangladesh,26-07-2020,23596,1458,306,23290,South-East Asia
Barbados,26-07-2020,158056,1307,1063,156993,Americas
Belarus,26-07-2020,215220,1494,284,214936,Europe
Belgium,26-07-2020,389934,1366,327,389607,Europe
Benin,26-07-2020,311026,553,717,310309,Africa
Bhutan,26-07-2020,259788,1185,1018,258770,South-East Asia
Bolivia,26-07-2020,164502,2059,604,163898,Americas
Bosnia and Herzegovina,26-07-2020,124976,2005,1128,123848,Europe
Brazil,26-07-2020,269714,1296,109,269605,Americas
Brunei,26-07-2020,15387,1824,39,15348,Western Pacific
Bulgaria,26-07-2020,156322,2428,774,155548,Europe
Burkina Faso,26-07-2020,279535,494,549,278986,Africa
Cabo Verde,26-07-2020,199054,244,98,198956,Africa
Cambodia,26-07-2020,72609,514,31,72578,Western Pacific
Cameroon,26-07-2020,317541,1528,1112,316429,Africa
Canada,26-07-2020,215265,1989,873,214392,Americas
Canada,26-07-2020,89821,1958,894,88927,Americas
Canada,26-07-2020,439178,627,566,438612,Americas
Canada,26-07-2020,366161,1196,612,365549,Americas
Canada,26-07-2020,67177,702,184,66993,Americas
Canada,26-07-2020,235008,2118,1197,233811,Americas
Canada,26-07-2020,426575,491,337,426238,Americas
Canada,26-07-2020,364576,1299,231,364345,Americas
Canada,26-07-2020,429286,466,144,429142,Americas
Canada,26-07-2020,317566,977,465,317101,Americas
Central African Republic,26-07-2020,97969,1393,860,97109,Africa
Chad,26-07-2020,246388,2021,709,245679,Africa
Chile,26-07-2020,82837,909,421,82416,Americas
China,26-07-2020,278486,844,969,277517,Western Pacific
China,26-07-2020,67049,1244,25,67024,Western Pacific
China,26-07-2020,426849,15,556,426293,Western Pacific
China,26-07-2020,127969,1565,933,127036,Western Pacific
China,26-07-2020,34477,1366,686,33791,Western Pacific
China,26-07-2020,245569,1532,627,244942,Western Pacific
China,26-07-2020,21820,643,508,21312,Western Pacific
China,26-07-2020,23681,1575,1225,22456,Western Pacific
China,26-07-2020,67041,425,102,66939,Western Pacific
China,26-07-2020,333223,1031,1010,332213,Western Pacific
China,26-07-2020,193128,2265,290,192838,Western Pacific
China,26-07-2020,67552,853,322,67230,Western Pacific
China,26-07-2020,391976,2087,1186,390790,Western Pacific
China,26-07-2020,365632,447,919,364713,Western Pacific
China,26-07-2020,42556,542,67,42489,Western Pacific
China,26-07-2020,342029,1372,125,341904,Western Pacific
China,26-07-2020,202709,526,415,202294,Western Pacific
China,26-07-2020,136378,1279,78,136300,Western Pacific
China,26-07-2020,47193,70,1151,46042,Western Pacific
China,26-07-2020,69656,1465,1243,68413,Western Pacific
China,26-07-2020,148089,1983,1247,146842,Western Pacific
China,26-07-2020,436816,133,1,436815,Western Pacific
China,26-07-2020,177395,390,1211,176184,Western Pacific
China,26-07-2020,128357,1498,918,127439,Western Pacific
China,26-07-2020,423944,1027,149,423795,Western Pacific
China,26-07-2020,305790,148,1046,304744,Western Pacific
China,26-07-2020,124734,685,1174,123560,Western Pacific
China,26-07-2020,437561,1201,923,436638,Western Pacific
China,26-07-2020,59438,2058,682,58756,Western Pacific
China,26-07-2020,190891,985,944,189947,Western Pacific
China,26-07-2020,215064,1214,1225,213839,Western Pacific
China,26-07-2020,260696,752,311,260385,Western Pacific
China,26-07-2020,397486,1147,481,397005,Western Pacific
Colombia,26-07-2020,91610,1264,1022,90588,Americas
Congo (Brazzaville),26-07-2020,144430,1008,888,143542,Africa
Congo (Kinshasa),26-07-2020,346781,1395,1096,345685,Africa
Costa Rica,26-07-2020,20285,173,1246,19039,Americas
Cote d'Ivoire,26-07-2020,245316,235,104,245212,Africa
Croatia,26-07-2020,441511,1569,149,441362,Europe
Cuba,26-07-2020,435960,852,1048,434912,Americas
Cyprus,26-07-2020,243894,1129,1013,242881,Europe
Czechia,26-07-2020,218648,486,1162,217486,Europe
Denmark,26-07-2020,256998,2050,841,256157,Europe
Greenland,26-07-2020,196123,428,993,195130,Europe
Denmark,26-07-2020,124729,2045,962,123767,Europe
Djibouti,26-07-2020,64067,2259,584,63483,Eastern Mediterranean
Dominican Republic,26-07-2020,52387,846,488,51899,Americas
Ecuador,26-07-2020,210296,2361,464,209832,Americas
Egypt,26-07-2020,38063,49,678,37385,Eastern Mediterranean
El Salvador,26-07-2020,201757,720,730,201027,Americas
Equatorial Guinea,26-07-2020,146965,1061,599,146366,Africa
Eritrea,26-07-2020,210323,1139,835,209488,Africa
Estonia,26-07-2020,407896,1641,1182,406714,Europe
Eswatini,26-07-2020,410653,574,1130,409523,Africa
Ethiopia,26-07-2020,202280,1189,859,201421,Africa
Fiji,26-07-2020,341435,299,851,340584,Western Pacific
Finland,26-07-2020,362697,1424,88,362609,Europe
France,26-07-2020,146042,1175,634,145408,Europe
France,26-07-2020,237701,2303,761,236940,Europe
France,26-07-2020,414213,391,770,413443,Europe
France,26-07-2020,302107,1416,380,301727,Europe
France,26-07-2020,263445,2242,302,263143,Europe
France,26-07-2020,118107,1730,907,117200,Europe
France,26-07-2020,20808,953,430,20378,Europe
France,26-07-2020,52302,1892,1057,51245,Europe
France,26-07-2020,200076,1912,661,199415,Europe
France,26-07-2020,295538,585,121,295417,Europe
Gabon,26-07-2020,67220,1959,296,66924,Africa
Gambia,26-07-2020,219729,1549,1217,218512,Africa
Georgia,26-07-2020,178476,1646,156,178320,Europe
Germany,26-07-2020,310898,1889,324,310574,Europe
Ghana,26-07-2020,77211,1344,493,76718,Africa
Greece,26-07-2020,48862,1003,889,47973,Europe
Guatemala,26-07-2020,431917,2010,25,431892,Americas
Guinea,26-07-2020,213996,1960,46,213950,Africa
Guyana,26-07-2020,230221,2110,1004,229217,Americas
Haiti,26-07-2020,283679,1660,631,283048,Americas
Holy See,26-07-2020,67146,1709,560,66586,Europe
Honduras,26-07-2020,149792,1470,757,149035,Americas
Hungary,26-07-2020,99451,1693,126,99325,Europe
Iceland,26-07-2020,373836,345,933,372903,Europe
India,26-07-2020,446093,189,119,445974,South-East Asia
Indonesia,26-07-2020,65247,2162,1037,64210,South-East Asia
Iran,26-07-2020,366572,1226,646,365926,Eastern Mediterranean
Iraq,26-07-2020,335658,1924,1165,334493,Eastern Mediterranean
Ireland,26-07-2020,414300,1746,1033,413267,Europe
Israel,26-07-2020,187231,1120,324,186907,Europe
Italy,26-07-2020,323799,1578,1027,322772,Europe
Jamaica,26-07-2020,48569,365,622,47947,Americas
Japan,26-07-2020,379229,278,514,378715,Western Pacific
Jordan,26-07-2020,125726,2292,444,125282,Eastern Mediterranean
Kazakhstan,26-07-2020,279829,1714,462,279367,Europe
Kenya,26-07-2020,73105,1147,265,72840,Africa
South Korea,26-07-2020,424339,1011,965,423374,Western Pacific
Kuwait,26-07-2020,265869,844,930,264939,Eastern Mediterranean
Kyrgyzstan,26-07-2020,111875,1521,1069,110806,Europe
Latvia,26-07-2020,107589,892,76,107513,Europe
Lebanon,26-07-2020,272302,2179,258,272044,Eastern Mediterranean
Liberia,26-07-2020,276944,1372,966,275978,Africa
Liechtenstein,26-07-2020,309835,83,73,309762,Europe
Lithuania,26-07-2020,101686,2398,5,101681,Europe
Luxembourg,26-07-2020,277880,1646,374,277506,Europe
Madagascar,26-07-2020,168712,766,1057,167655,Africa
Malaysia,26-07-2020,321406,1177,842,320564,Western Pacific
Maldives,26-07-2020,16818,358,408,16410,South-East Asia
Malta,26-07-2020,37443,1427,1145,36298,Europe
Mauritania,26-07-2020,362993,977,378,362615,Africa
Mauritius,26-07-2020,312589,2305,173,312416,Africa
Mexico,26-07-2020,407396,153,553,406843,Americas
Moldova,26-07-2020,394482,1414,873,393609,Europe
Monaco,26-07-2020,126008,2306,180,125828,Europe
Mongolia,26-07-2020,212898,2250,66,212832,Western Pacific
Montenegro,26-07-2020,85331,929,391,84940,Europe
Morocco,26-07-2020,296993,1883,137,296856,Eastern Mediterranean
Namibia,26-07-2020,340198,49,859,339339,Africa
Nepal,26-07-2020,347409,1179,1162,346247,South-East Asia
Netherlands,26-07-2020,164075,463,739,163336,Europe
Netherlands,26-07-2020,401261,218,284,400977,Europe
Netherlands,26-07-2020,32985,1032,623,32362,Europe
Netherlands,26-07-2020,108921,1569,910,108011,Europe
New Zealand,26-07-2020,345512,1566,902,344610,Western Pacific
Nicaragua,26-07-2020,150339,1849,93,150246,Americas
Niger,26-07-2020,47765,589,446,47319,Africa
Nigeria,26-07-2020,10661,1291,769,9892,Africa
North Macedonia,26-07-2020,233645,2479,107,233538,Europe
Norway,26-07-2020,346656,2086,1135,345521,Europe
Oman,26-07-2020,399209,2113,329,398880,Eastern Mediterranean
Pakistan,26-07-2020,440773,1258,1177,439596,Eastern Mediterranean
Panama,26-07-2020,106695,1992,508,106187,Americas
Papua New Guinea,26-07-2020,370485,2334,148,370337,Western Pacific
Paraguay,26-07-2020,257980,772,341,257639,Americas
Peru,26-07-2020,122572,1746,251,122321,Americas
Philippines,26-07-2020,45676,2120,338,45338,Western Pacific
Poland,26-07-2020,312234,400,131,312103,Europe
Portugal,26-07-2020,42551,1802,868,41683,Europe
Qatar,26-07-2020,178889,2098,96,178793,Eastern Mediterranean
Romania,26-07-2020,74776,230,324,74452,Europe
Russia,26-07-2020,274880,2296,820,274060,Europe
Rwanda,26-07-2020,206589,1110,1208,205381,Africa
Saint Lucia,26-07-2020,124966,1580,13,124953,Americas
Saint Vincent and the Grenadines,26-07-2020,76028,365,221,75807,Americas
San Marino,26-07-2020,116060,2120,437,115623,Europe
Saudi Arabia,26-07-2020,203280,2087,438,202842,Eastern Mediterranean
Senegal,26-07-2020,307697,1009,1048,306649,Africa
Serbia,26-07-2020,373471,1401,191,373280,Europe
Seychelles,26-07-2020,180925,1928,333,180592,Africa
Singapore,26-07-2020,32020,2498,526,31494,Western Pacific
Slovakia,26-07-2020,354669,1386,243,354426,Europe
Slovenia,26-07-2020,197378,1596,682,196696,Europe
Somalia,26-07-2020,34015,314,184,33831,Eastern Mediterranean
South Africa,26-07-2020,103516,1325,225,103291,Africa
Spain,26-07-2020,272591,709,299,272292,Europe
Sri Lanka,26-07-2020,273933,1683,230,273703,South-East Asia
Sudan,26-07-2020,201960,2353,912,201048,Eastern Mediterranean
Suriname,26-07-2020,67254,1863,560,66694,Americas
Sweden,26-07-2020,362775,2293,356,362419,Europe
Switzerland,26-07-2020,401985,1500,796,401189,Europe
Taiwan*,26-07-2020,307369,908,1045,306324,Western Pacific
Tanzania,26-07-2020,23566,1903,1116,22450,Africa
Thailand,26-07-2020,352263,130,20,352243,South-East Asia
Togo,26-07-2020,248354,23,985,247369,Africa
Trinidad and Tobago,26-07-2020,182286,1624,551,181735,Americas
Tunisia,26-07-2020,156284,2139,53,156231,Eastern Mediterranean
Turkey,26-07-2020,49273,440,417,48856,Europe
Uganda,26-07-2020,330794,671,132,330662,Africa
Ukraine,26-07-2020,328559,750,373,328186,Europe
United Arab Emirates,26-07-2020,162581,1931,73,162508,Eastern Mediterranean
United Kingdom,26-07-2020,90140,1279,576,89564,Europe
United Kingdom,26-07-2020,107616,491,1068,106548,Europe
United Kingdom,26-07-2020,391738,1007,698,391040,Europe
United Kingdom,26-07-2020,402607,1890,751,401856,Europe
United Kingdom,26-07-2020,292720,1627,81,292639,Europe
United Kingdom,26-07-2020,195776,2080,728,195048,Europe
United Kingdom,26-07-2020,283781,1754,1088,282693,Europe
Uruguay,26-07-2020,15705,2296,55,15650,Americas
US,26-07-2020,337794,1949,1169,336625,Americas
Uzbekistan,26-07-2020,56757,1583,928,55829,Europe
Venezuela,26-07-2020,311659,38,807,310852,Americas
Vietnam,26-07-2020,375911,638,553,375358,Western Pacific
Zambia,26-07-2020,160716,314,1038,159678,Africa
Zimbabwe,26-07-2020,38260,1791,1242,37018,Africa
Dominica,26-07-2020,19539,553,68,19471,Americas
Grenada,26-07-2020,41601,2327,1193,40408,Americas
Mozambique,26-07-2020,323655,745,932,322723,Africa
Syria,26-07-2020,439683,1879,919,438764,Eastern Mediterranean
Timor-Leste,26-07-2020,163379,911,572,162807,South-East Asia
Belize,26-07-2020,42293,1530,251,42042,Americas
Laos,26-07-2020,2537,1122,852,1685,Western Pacific
Libya,26-07-2020,195955,570,604,195351,Eastern Mediterranean
West Bank and Gaza,26-07-2020,213170,1198,179,212991,Eastern Mediterranean
Guinea-Bissau,26-07-2020,435356,1821,535,434821,Africa
Mali,26-07-2020,298407,671,285,298122,Africa
Saint Kitts and Nevis,26-07-2020,169906,454,1163,168743,Americas
Canada,26-07-2020,36815,1143,552,36263,Americas
Canada,26-07-2020,4891,1856,1073,3818,Americas
Kosovo,26-07-2020,165370,141,1105,164265,Europe
Burma,26-07-2020,413000,2252,1028,411972,South-East Asia
United Kingdom,26-07-2020,410488,2426,1195,409293,Europe
United Kingdom,26-07-2020,367292,1214,1145,366147,Europe
United Kingdom,26-07-2020,59795,1611,333,59462,Europe
Botswana,26-07-2020,18288,1215,941,17347,Africa
Burundi,26-07-2020,228262,1021,65,228197,Africa
Sierra Leone,26-07-2020,231308,2034,330,230978,Africa
Malawi,26-07-2020,319390,1931,772,318618,Africa
United Kingdom,26-07-2020,255390,1773,237,255153,Europe
France,26-07-2020,279201,1017,374,278827,Europe
South Sudan,26-07-2020,321484,616,720,320764,Africa
Western Sahara,26-07-2020,145910,1273,828,145082,Africa
Sao Tome and Principe,26-07-2020,61269,1549,911,60358,Africa
Yemen,26-07-2020,214776,76,966,213810,Eastern Mediterranean
Comoros,26-07-2020,317486,951,445,317041,Africa
Tajikistan,26-07-2020,286183,1608,849,285334,Europe
Lesotho,26-07-2020,441961,965,751,441210,Africa
Afghanistan,27-07-2020,173832,562,573,173259,Eastern Mediterranean
Albania,27-07-2020,139371,1937,1048,138323,Europe
Algeria,27-07-2020,38068,1904,826,37242,Africa
Andorra,27-07-2020,195366,240,149,195217,Europe
Angola,27-07-2020,76518,1016,488,76030,Africa
Antigua and Barbuda,27-07-2020,55960,2339,1173,54787,Americas
Argentina,27-07-2020,143524,1988,1030,142494,Americas
Armenia,27-07-2020,414219,1011,535,413684,Europe
Australia,27-07-2020,377850,1101,650,377200,Western Pacific
Australia,27-07-2020,443740,1416,1023,442717,Western Pacific
Australia,27-07-2020,238491,443,404,238087,Western Pacific
Australia,27-07-2020,156598,789,116,156482,Western Pacific
Australia,27-07-2020,258320,1151,1105,257215,Western Pacific
Australia,27-07-2020,207160,733,1158,206002,Western Pacific
Australia,27-07-2020,191884,428,753,191131,Western Pacific
Australia,27-07-2020,208856,2383,319,208537,Western Pacific
Austria,27-07-2020,105637,35,1068,104569,Europe
Azerbaijan,27-07-2020,107297,71,195,107102,Europe
Bahamas,27-07-2020,375559,1267,253,375306,Americas
Bahrain,27-07-2020,403998,2484,913,403085,Eastern Mediterranean
Bangladesh,27-07-2020,134816,1959,320,134496,South-East Asia
Barbados,27-07-2020,258426,168,1129,257297,Americas
Belarus,27-07-2020,12736,559,1005,11731,Europe
Belgium,27-07-2020,289215,2239,531,288684,Europe
Benin,27-07-2020,269741,2341,73,269668,Africa
Bhutan,27-07-2020,90817,1138,579,90238,South-East Asia
Bolivia,27-07-2020,79405,15,486,78919,Americas
Bosnia and Herzegovina,27-07-2020,426724,2007,1036,425688,Europe
Brazil,27-07-2020,163753,2158,840,162913,Americas
Brunei,27-07-2020,230092,1979,81,230011,Western Pacific
Bulgaria,27-07-2020,31661,1077,45,31616,Europe
Burkina Faso,27-07-2020,103197,1807,334,102863,Africa
Cabo Verde,27-07-2020,377874,1364,292,377582,Africa
Cambodia,27-07-2020,297127,559,1077,296050,Western Pacific
Cameroon,27-07-2020,121042,2374,453,120589,Africa
Canada,27-07-2020,301752,935,1186,300566,Americas
Canada,27-07-2020,125758,1454,588,125170,Americas
Canada,27-07-2020,128238,1722,621,127617,Americas
Canada,27-07-2020,98145,918,127,98018,Americas
Canada,27-07-2020,107507,2298,337,107170,Americas
Canada,27-07-2020,359395,2003,152,359243,Americas
Canada,27-07-2020,309068,809,553,308515,Americas
Canada,27-07-2020,177982,458,1020,176962,Americas
Canada,27-07-2020,279132,1403,184,278948,Americas
Canada,27-07-2020,295806,1294,501,295305,Americas
Central African Republic,27-07-2020,198046,966,796,197250,Africa
Chad,27-07-2020,406952,1983,414,406538,Africa
Chile,27-07-2020,72206,1777,117,72089,Americas
China,27-07-2020,151132,1232,350,150782,Western Pacific
China,27-07-2020,93712,1995,508,93204,Western Pacific
China,27-07-2020,187194,1772,1025,186169,Western Pacific
China,27-07-2020,11764,2118,392,11372,Western Pacific
China,27-07-2020,219844,1177,920,218924,Western Pacific
China,27-07-2020,351490,2151,736,350754,Western Pacific
China,27-07-2020,289709,544,249,289460,Western Pacific
China,27-07-2020,231927,1082,558,231369,Western Pacific
China,27-07-2020,36035,1998,312,35723,Western Pacific
China,27-07-2020,283709,1965,145,283564,Western Pacific
China,27-07-2020,73383,503,714,72669,Western Pacific
China,27-07-2020,66354,1845,1224,65130,Western Pacific
China,27-07-2020,140633,1883,529,140104,Western Pacific
China,27-07-2020,180694,2173,82,180612,Western Pacific
China,27-07-2020,88056,2331,107,87949,Western Pacific
China,27-07-2020,133303,2222,1210,132093,Western Pacific
China,27-07-2020,284783,1000,917,283866,Western Pacific
China,27-07-2020,268924,794,231,268693,Western Pacific
China,27-07-2020,441598,1397,412,441186,Western Pacific
China,27-07-2020,249251,46,86,249165,Western Pacific
China,27-07-2020,342387,425,984,341403,Western Pacific
China,27-07-2020,150052,1867,306,149746,Western Pacific
China,27-07-2020,42997,1682,312,42685,Western Pacific
China,27-07-2020,60370,78,617,59753,Western Pacific
China,27-07-2020,205357,1507,621,204736,Western Pacific
China,27-07-2020,433521,1182,838,432683,Western Pacific
China,27-07-2020,386996,2104,90,386906,Western Pacific
China,27-07-2020,77406,2087,32,77374,Western Pacific
China,27-07-2020,221556,1118,541,221015,Western Pacific
China,27-07-2020,21045,662,753,20292,Western Pacific
China,27-07-2020,49426,2090,36,49390,Western Pacific
China,27-07-2020,70397,281,539,69858,Western Pacific
China,27-07-2020,181750,1764,4,181746,Western Pacific
Colombia,27-07-2020,408649,1760,197,408452,Americas
Congo (Brazzaville),27-07-2020,335225,738,961,334264,Africa
Congo (Kinshasa),27-07-2020,97741,821,1143,96598,Africa
Costa Rica,27-07-2020,162625,1790,666,161959,Americas
Cote d'Ivoire,27-07-2020,368162,1394,1199,366963,Africa
Croatia,27-07-2020,243316,2193,653,242663,Europe
Cuba,27-07-2020,103641,1350,247,103394,Americas
Cyprus,27-07-2020,65133,1376,142,64991,Europe
Czechia,27-07-2020,88073,1877,98,87975,Europe
Denmark,27-07-2020,310494,1963,161,310333,Europe
Greenland,27-07-2020,120237,2032,98,120139,Europe
Denmark,27-07-2020,374950,622,117,374833,Europe
Djibouti,27-07-2020,338200,145,72,338128,Eastern Mediterranean
Dominican Republic,27-07-2020,226907,908,868,226039,Americas
Ecuador,27-07-2020,280649,735,782,279867,Americas
Egypt,27-07-2020,20360,2187,72,20288,Eastern Mediterranean
El Salvador,27-07-2020,340493,1737,1234,339259,Americas
Equatorial Guinea,27-07-2020,268706,1215,1228,267478,Africa
Eritrea,27-07-2020,187739,569,1001,186738,Africa
Estonia,27-07-2020,368804,909,238,368566,Europe
Eswatini,27-07-2020,248972,1154,1228,247744,Africa
Ethiopia,27-07-2020,310341,55,110,310231,Africa
Fiji,27-07-2020,8349,151,1233,7116,Western Pacific
Finland,27-07-2020,111077,2245,199,110878,Europe
France,27-07-2020,354955,116,1076,353879,Europe
France,27-07-2020,412725,1822,535,412190,Europe
France,27-07-2020,46170,1326,74,46096,Europe
France,27-07-2020,138896,1332,1025,137871,Europe
France,27-07-2020,25282,1090,116,25166,Europe
France,27-07-2020,194337,855,216,194121,Europe
France,27-07-2020,294366,655,1040,293326,Europe
France,27-07-2020,386894,2270,749,386145,Europe
France,27-07-2020,175569,1397,615,174954,Europe
France,27-07-2020,307904,132,641,307263,Europe
Gabon,27-07-2020,131511,649,39,131472,Africa
Gambia,27-07-2020,395776,1778,1178,394598,Africa
Georgia,27-07-2020,234827,2360,392,234435,Europe
Germany,27-07-2020,31026,2482,0,31026,Europe
Ghana,27-07-2020,388912,1090,977,387935,Africa
Greece,27-07-2020,79890,1942,272,79618,Europe
Guatemala,27-07-2020,271140,1022,283,270857,Americas
Guinea,27-07-2020,269087,2385,381,268706,Africa
Guyana,27-07-2020,202295,947,1103,201192,Americas
Haiti,27-07-2020,184534,1292,373,184161,Americas
Holy See,27-07-2020,282428,673,386,282042,Europe
Honduras,27-07-2020,300776,1533,97,300679,Americas
Hungary,27-07-2020,408175,1332,1098,407077,Europe
Iceland,27-07-2020,382405,962,405,382000,Europe
India,27-07-2020,8999,635,185,8814,South-East Asia
Indonesia,27-07-2020,219675,900,1058,218617,South-East Asia
Iran,27-07-2020,201050,2395,814,200236,Eastern Mediterranean
Iraq,27-07-2020,323173,2373,174,322999,Eastern Mediterranean
Ireland,27-07-2020,242223,826,259,241964,Europe
Israel,27-07-2020,148785,1930,414,148371,Europe
Italy,27-07-2020,79195,1387,1111,78084,Europe
Jamaica,27-07-2020,448877,1908,80,448797,Americas
Japan,27-07-2020,243970,1661,609,243361,Western Pacific
Jordan,27-07-2020,337541,950,201,337340,Eastern Mediterranean
Kazakhstan,27-07-2020,1806,986,1221,585,Europe
Kenya,27-07-2020,335284,193,1038,334246,Africa
South Korea,27-07-2020,305916,770,508,305408,Western Pacific
Kuwait,27-07-2020,381564,571,891,380673,Eastern Mediterranean
Kyrgyzstan,27-07-2020,356285,745,777,355508,Europe
Latvia,27-07-2020,263444,1634,1234,262210,Europe
Lebanon,27-07-2020,293571,158,406,293165,Eastern Mediterranean
Liberia,27-07-2020,132764,614,452,132312,Africa
Liechtenstein,27-07-2020,325127,659,1163,323964,Europe
Lithuania,27-07-2020,209911,447,1151,208760,Europe
Luxembourg,27-07-2020,75934,2289,1155,74779,Europe
Madagascar,27-07-2020,367694,1767,753,366941,Africa
Malaysia,27-07-2020,84774,1826,95,84679,Western Pacific
Maldives,27-07-2020,214044,1872,491,213553,South-East Asia
Malta,27-07-2020,332095,854,126,331969,Europe
Mauritania,27-07-2020,35512,2271,867,34645,Africa
Mauritius,27-07-2020,249613,44,648,248965,Africa
Mexico,27-07-2020,199453,2238,99,199354,Americas
Moldova,27-07-2020,105380,1140,584,104796,Europe
Monaco,27-07-2020,80945,1417,1038,79907,Europe
Mongolia,27-07-2020,426512,1995,429,426083,Western Pacific
Montenegro,27-07-2020,203418,1847,504,202914,Europe
Morocco,27-07-2020,321698,68,533,321165,Eastern Mediterranean
Namibia,27-07-2020,444438,1971,908,443530,Africa
Nepal,27-07-2020,73005,1761,862,72143,South-East Asia
Netherlands,27-07-2020,408001,1250,600,407401,Europe
Netherlands,27-07-2020,64756,67,697,64059,Europe
Netherlands,27-07-2020,146842,2020,763,146079,Europe
Netherlands,27-07-2020,356321,1730,252,356069,Europe
New Zealand,27-07-2020,135969,152,339,135630,Western Pacific
Nicaragua,27-07-2020,370672,466,704,369968,Americas
Niger,27-07-2020,38894,840,773,38121,Africa
Nigeria,27-07-2020,132241,789,302,131939,Africa
North Macedonia,27-07-2020,62623,1346,832,61791,Europe
Norway,27-07-2020,154721,1341,427,154294,Europe
Oman,27-07-2020,137758,1839,103,137655,Eastern Mediterranean
Pakistan,27-07-2020,65693,2162,1143,64550,Eastern Mediterranean
Panama,27-07-2020,100923,2351,19,100904,Americas
Papua New Guinea,27-07-2020,408274,1216,355,407919,Western Pacific
Paraguay,27-07-2020,56256,2067,39,56217,Americas
Peru,27-07-2020,179991,776,75,179916,Americas
Philippines,27-07-2020,323334,1471,808,322526,Western Pacific
Poland,27-07-2020,292229,1551,320,291909,Europe
Portugal,27-07-2020,359291,2441,608,358683,Europe
Qatar,27-07-2020,275867,1319,719,275148,Eastern Mediterranean
Romania,27-07-2020,307557,1406,516,307041,Europe
Russia,27-07-2020,194535,504,227,194308,Europe
Rwanda,27-07-2020,274674,1889,1143,273531,Africa
Saint Lucia,27-07-2020,433061,2278,19,433042,Americas
Saint Vincent and the Grenadines,27-07-2020,115665,96,148,115517,Americas
San Marino,27-07-2020,113249,605,1248,112001,Europe
Saudi Arabia,27-07-2020,229751,2444,826,228925,Eastern Mediterranean
Senegal,27-07-2020,254466,1366,662,253804,Africa
Serbia,27-07-2020,45346,336,1227,44119,Europe
Seychelles,27-07-2020,4022,720,1158,2864,Africa
Singapore,27-07-2020,369847,379,631,369216,Western Pacific
Slovakia,27-07-2020,223382,992,1077,222305,Europe
Slovenia,27-07-2020,445276,1648,1069,444207,Europe
Somalia,27-07-2020,323913,1510,618,323295,Eastern Mediterranean
South Africa,27-07-2020,241200,1019,1242,239958,Africa
Spain,27-07-2020,365131,22,374,364757,Europe
Sri Lanka,27-07-2020,110291,532,260,110031,South-East Asia
Sudan,27-07-2020,239001,1532,375,238626,Eastern Mediterranean
Suriname,27-07-2020,40285,134,641,39644,Americas
Sweden,27-07-2020,368125,1472,350,367775,Europe
Switzerland,27-07-2020,197705,1924,870,196835,Europe
Taiwan*,27-07-2020,211439,444,515,210924,Western Pacific
Tanzania,27-07-2020,16877,726,460,16417,Africa
Thailand,27-07-2020,385297,1433,1152,384145,South-East Asia
Togo,27-07-2020,404040,1044,995,403045,Africa
Trinidad and Tobago,27-07-2020,406600,882,1066,405534,Americas
Tunisia,27-07-2020,170954,1478,283,170671,Eastern Mediterranean
Turkey,27-07-2020,324560,1702,59,324501,Europe
Uganda,27-07-2020,377342,2308,640,376702,Africa
Ukraine,27-07-2020,8396,2487,573,7823,Europe
United Arab Emirates,27-07-2020,42805,2355,884,41921,Eastern Mediterranean
United Kingdom,27-07-2020,387415,1538,597,386818,Europe
United Kingdom,27-07-2020,54864,1310,1173,53691,Europe
United Kingdom,27-07-2020,262075,1188,29,262046,Europe
United Kingdom,27-07-2020,95046,1891,1132,93914,Europe
United Kingdom,27-07-2020,184627,22,113,184514,Europe
United Kingdom,27-07-2020,373735,724,376,373359,Europe
United Kingdom,27-07-2020,204961,1270,1229,203732,Europe
Uruguay,27-07-2020,386799,236,665,386134,Americas
US,27-07-2020,307438,2174,476,306962,Americas
Uzbekistan,27-07-2020,110889,1844,1081,109808,Europe
Venezuela,27-07-2020,231693,2210,739,230954,Americas
Vietnam,27-07-2020,193540,1320,521,193019,Western Pacific
Zambia,27-07-2020,244324,2262,972,243352,Africa
Zimbabwe,27-07-2020,115863,1734,871,114992,Africa
Dominica,27-07-2020,261146,966,990,260156,Americas
Grenada,27-07-2020,160167,625,55,160112,Americas
Mozambique,27-07-2020,344708,1687,1238,343470,Africa
Syria,27-07-2020,28323,2429,1204,27119,Eastern Mediterranean
Timor-Leste,27-07-2020,136361,563,1140,135221,South-East Asia
Belize,27-07-2020,62073,955,474,61599,Americas
Laos,27-07-2020,416673,504,455,416218,Western Pacific
Libya,27-07-2020,230416,238,701,229715,Eastern Mediterranean
West Bank and Gaza,27-07-2020,331573,2134,262,331311,Eastern Mediterranean
Guinea-Bissau,27-07-2020,391804,2026,80,391724,Africa
Mali,27-07-2020,10768,1954,520,10248,Africa
Saint Kitts and Nevis,27-07-2020,298464,1186,837,297627,Americas
Canada,27-07-2020,244497,1555,793,243704,Americas
Canada,27-07-2020,189229,2179,199,189030,Americas
Kosovo,27-07-2020,368791,1145,48,368743,Europe
Burma,27-07-2020,4766,1043,1212,3554,South-East Asia
United Kingdom,27-07-2020,221332,2332,498,220834,Europe
United Kingdom,27-07-2020,198283,773,289,197994,Europe
United Kingdom,27-07-2020,74047,39,633,73414,Europe
Botswana,27-07-2020,201261,2227,938,200323,Africa
Burundi,27-07-2020,139482,438,510,138972,Africa
Sierra Leone,27-07-2020,261202,1238,333,260869,Africa
Malawi,27-07-2020,315458,1709,717,314741,Africa
United Kingdom,27-07-2020,234103,823,880,233223,Europe
France,27-07-2020,27510,863,775,26735,Europe
South Sudan,27-07-2020,435789,2131,138,435651,Africa
Western Sahara,27-07-2020,362948,105,428,362520,Africa
Sao Tome and Principe,27-07-2020,57435,2443,600,56835,Africa
Yemen,27-07-2020,206898,2031,1179,205719,Eastern Mediterranean
Comoros,27-07-2020,112969,915,448,112521,Africa
Tajikistan,27-07-2020,280346,656,820,279526,Europe
Lesotho,27-07-2020,203539,1796,614,202925,Africa
